ncbi_gene_id,name,landmark,gene_orientation,gene_start,gene_end,sum,len,all_sum,row_id,intron_count
24,ABCA4,chr1,R,93992836,94121149,128313,128313,128313,0,49
27,ABL2,chr1,R,179099326,179229693,258680,130367,258680,1,13
34,ACADM,chr1,F,75724346,75763679,298013,39333,298013,2,12
58,ACTA1,chr1,R,229431244,229434096,300865,2852,300865,3,6
88,ACTN2,chr1,F,236686453,236764631,379043,78178,379043,4,22
103,ADAR,chr1,R,154582056,154628013,425000,45957,425000,5,17
134,ADORA1,chr1,F,203127704,203167405,464701,39701,464701,6,4
140,ADORA3,chr1,R,111499428,111504121,469394,4693,469394,7,1
142,PARP1,chr1,R,226360690,226408100,516804,47410,516804,8,22
159,ADSS,chr1,R,244408491,244452134,560447,43643,560447,9,13
178,AGL,chr1,F,99850076,99924023,634394,73947,634394,10,35
183,AGT,chr1,R,230702522,230714590,646462,12068,646462,11,4
204,AK2,chr1,R,33007939,33036911,675434,28972,675434,12,7
205,AK4,chr1,F,65147548,65232145,760031,84597,760031,13,6
223,ALDH9A1,chr1,R,165662211,165698663,796483,36452,796483,14,10
249,ALPL,chr1,F,21508981,21578412,865914,69431,865914,15,14
257,ALX3,chr1,R,110060374,110070700,876240,10326,876240,16,3
270,AMPD1,chr1,R,114673097,114695618,898761,22521,898761,17,15
271,AMPD2,chr1,F,109619658,109632055,911158,12397,911158,18,18
276,AMY1A,chr1,F,103655518,103664551,920191,9033,920191,19,10
277,AMY1B,chr1,R,103687414,103696452,929229,9038,929229,20,11
278,AMY1C,chr1,F,103749655,103758692,938266,9037,938266,21,10
279,AMY2A,chr1,F,103617331,103625780,946715,8449,946715,22,9
280,AMY2B,chr1,F,103554643,103579534,971606,24891,971606,23,11
325,APCS,chr1,F,159587825,159588871,972652,1046,972652,24,1
336,APOA2,chr1,R,161222292,161223628,973988,1336,973988,25,3
356,FASLG,chr1,F,172659007,172666873,981854,7866,981854,26,3
375,ARF1,chr1,F,228082659,228099212,998407,16553,998407,27,5
389,RHOC,chr1,R,112701126,112707403,1004684,6277,1004684,28,6
405,ARNT,chr1,R,150809704,150876768,1071748,67064,1071748,29,24
460,ASTN1,chr1,R,176857304,177164904,1379348,307600,1379348,30,25
462,SERPINC1,chr1,R,173903799,173917378,1392927,13579,1392927,31,7
467,ATF3,chr1,F,212565333,212620777,1448371,55444,1448371,32,6
473,RERE,chr1,R,8352403,8817691,1913659,465288,1913659,33,27
476,ATP1A1,chr1,F,116372184,116404774,1946249,32590,1946249,34,25
477,ATP1A2,chr1,F,160115729,160143591,1974111,27862,1974111,35,22
480,ATP1A4,chr1,F,160151561,160186977,2009527,35416,2009527,36,22
481,ATP1B1,chr1,F,169106708,169132722,2035541,26014,2035541,37,5
493,ATP2B4,chr1,F,203626786,203744081,2152836,117295,2152836,38,21
515,ATP5F1,chr1,F,111449120,111461918,2165634,12798,2165634,39,6
533,ATP6V0B,chr1,F,43974647,43978300,2169287,3653,2169287,40,6
553,AVPR1B,chr1,R,206109848,206117048,2176487,7200,2176487,41,1
576,ADGRB2,chr1,R,31727104,31764063,2213446,36959,2213446,42,32
607,BCL9,chr1,F,147541400,147626219,2298265,84819,2298265,43,11
632,BGLAP,chr1,F,156242159,156243332,2299438,1173,2299438,44,6
656,BMP8B,chr1,R,39757181,39788861,2331118,31680,2331118,45,11
676,BRDT,chr1,F,91949370,92014428,2396176,65058,2396176,46,20
712,C1QA,chr1,F,22636624,22639682,2399234,3058,2399234,47,2
713,C1QB,chr1,F,22653178,22661552,2407608,8374,2407608,48,3
714,C1QC,chr1,F,22643624,22648110,2412094,4486,2412094,49,2
722,C4BPA,chr1,F,207104237,207144972,2452829,40735,2452829,50,11
725,C4BPB,chr1,F,207088849,207099993,2463973,11144,2463973,51,7
731,C8A,chr1,F,56854769,56918221,2527425,63452,2527425,52,11
732,C8B,chr1,R,56929209,56966140,2564356,36931,2564356,53,13
765,CA6,chr1,F,8945784,8975092,2593664,29308,2593664,54,9
777,CACNA1E,chr1,F,181483310,181806784,2917138,323474,2917138,55,47
779,CACNA1S,chr1,R,201039506,201112566,2990198,73060,2990198,56,43
824,CAPN2,chr1,F,223701592,223776018,3064624,74426,3064624,57,22
829,CAPZA1,chr1,F,112619452,112671619,3116791,52167,3116791,58,10
832,CAPZB,chr1,R,19338772,19485641,3263660,146869,3263660,59,13
842,CASP9,chr1,R,15491400,15526529,3298789,35129,3298789,60,13
844,CASQ1,chr1,F,160190494,160201886,3310181,11392,3310181,61,10
845,CASQ2,chr1,R,115700002,115768805,3378984,68803,3378984,62,10
864,RUNX3,chr1,R,24899510,24965157,3444631,65647,3444631,63,6
909,CD1A,chr1,F,158248328,158258269,3454572,9941,3454572,64,6
910,CD1B,chr1,R,158327949,158331531,3458154,3582,3458154,65,5
911,CD1C,chr1,F,158289772,158294774,3463156,5002,3463156,66,5
912,CD1D,chr1,F,158178037,158186427,3471546,8390,3471546,67,7
913,CD1E,chr1,F,158353434,158357553,3475665,4119,3475665,68,5
914,CD2,chr1,F,116754434,116769229,3490460,14795,3490460,69,4
919,CD247,chr1,R,167430639,167518616,3578437,87977,3578437,70,8
922,CD5L,chr1,R,157827070,157841844,3593211,14774,3593211,71,6
943,TNFRSF8,chr1,F,12063329,12144207,3674089,80878,3674089,72,17
947,CD34,chr1,R,207881027,207911338,3704400,30311,3704400,73,8
962,CD48,chr1,R,160678745,160711851,3737506,33106,3737506,74,4
963,CD53,chr1,F,110871198,110899936,3766244,28738,3766244,75,8
965,CD58,chr1,R,116514533,116571093,3822804,56560,3822804,76,5
978,CDA,chr1,F,20588950,20618908,3852762,29958,3852762,77,3
984,CDK11B,chr1,R,1635225,1659839,3877376,24614,3877376,78,21
991,CDC20,chr1,F,43358954,43363203,3881625,4249,3881625,79,10
998,CDC42,chr1,F,22052626,22092943,3921942,40317,3921942,80,7
1031,CDKN2C,chr1,F,50968694,50974637,3927885,5943,3927885,81,2
1043,CD52,chr1,F,26317919,26320523,3930489,2604,3930489,82,1
1063,CENPF,chr1,F,214603178,214664571,3991882,61393,3991882,83,20
1104,RCC1,chr1,F,28505942,28539196,4025136,33254,4025136,84,14
1116,CHI3L1,chr1,R,203178930,203186960,4033166,8030,4033166,85,8
1117,CHI3L2,chr1,F,111227658,111243440,4048948,15782,4048948,86,10
1118,CHIT1,chr1,R,203212822,203230099,4066225,17277,4066225,87,14
1122,CHML,chr1,R,241628863,241635930,4073292,7067,4073292,88,0
1130,LYST,chr1,R,235661030,235883708,4295970,222678,4295970,89,60
1131,CHRM3,chr1,F,239386564,239911462,4820868,524898,4820868,90,11
1141,CHRNB2,chr1,F,154567780,154579878,4832966,12098,4832966,91,5
1163,CKS1B,chr1,F,154974641,154979249,4837574,4608,4837574,92,2
1179,CLCA1,chr1,F,86468842,86500294,4869026,31452,4869026,93,13
1185,CLCN6,chr1,F,11806095,11843144,4906075,37049,4906075,94,22
1187,CLCNKA,chr1,F,16021990,16034050,4918135,12060,4918135,95,19
1188,CLCNKB,chr1,F,16043735,16057326,4931726,13591,4931726,96,21
1196,CLK2,chr1,R,155262867,155273529,4942388,10662,4942388,97,13
1263,PLK3,chr1,F,44799951,44805995,4948432,6044,4948432,98,14
1266,CNN3,chr1,R,94896948,94927223,4978707,30275,4978707,99,7
1269,CNR2,chr1,R,23873462,23913327,5018572,39865,5018572,100,4
1296,COL8A2,chr1,R,36095235,36125770,5049107,30535,5049107,101,4
1298,COL9A2,chr1,R,40300486,40317690,5066311,17204,5066311,102,34
1301,COL11A1,chr1,R,102876466,103108576,5298421,232110,5298421,103,70
1307,COL16A1,chr1,R,31652246,31704167,5350342,51921,5350342,104,73
1314,COPA,chr1,R,160288586,160343564,5405320,54978,5405320,105,32
1325,CORT,chr1,F,10449718,10452003,5407605,2285,5407605,106,1
1376,CPT2,chr1,F,53196428,53214197,5425374,17769,5425374,107,4
1378,CR1,chr1,F,207496127,207641765,5571012,145638,5571012,108,47
1379,CR1L,chr1,F,207645112,207723691,5649591,78579,5649591,109,11
1380,CR2,chr1,F,207454299,207489897,5685189,35598,5685189,110,20
1382,CRABP2,chr1,R,156699605,156705816,5691400,6211,5691400,111,4
1401,CRP,chr1,R,159712288,159714609,5693721,2321,5693721,112,1
1429,CRYZ,chr1,R,74705481,74733408,5721648,27927,5721648,113,10
1435,CSF1,chr1,F,109910610,109930994,5742032,20384,5742032,114,9
1441,CSF3R,chr1,R,36466042,36483314,5759304,17272,5759304,115,17
1465,CSRP1,chr1,R,201483529,201507259,5783034,23730,5783034,116,7
1486,CTBS,chr1,R,84553120,84574480,5804394,21360,5804394,117,6
1491,CTH,chr1,F,70411217,70440114,5833291,28897,5833291,118,12
1503,CTPS1,chr1,F,40979298,41012565,5866558,33267,5866558,119,22
1510,CTSE,chr1,R,206009263,206023909,5881204,14646,5881204,120,8
1513,CTSK,chr1,R,150796207,150808441,5893438,12234,5893438,121,7
1520,CTSS,chr1,R,150730195,150765957,5929200,35762,5929200,122,7
1573,CYP2J2,chr1,R,59893307,59926773,5962666,33466,5962666,123,9
1579,CYP4A11,chr1,R,46929173,46941499,5974992,12326,5974992,124,12
1580,CYP4B1,chr1,F,46798994,46819349,5995347,20355,5995347,125,11
1600,DAB1,chr1,R,56997905,58250539,7247981,1252634,7247981,126,16
1604,CD55,chr1,F,207321471,207360966,7287476,39495,7287476,127,13
1629,DBT,chr1,R,100186921,100249863,7350418,62942,7350418,128,12
1647,GADD45A,chr1,F,67685176,67688338,7353580,3162,7353580,129,3
1650,DDOST,chr1,R,20651766,20661544,7363358,9778,7363358,130,10
1660,DHX9,chr1,F,182839303,182887982,7412037,48679,7412037,131,28
1676,DFFA,chr1,R,10460530,10472556,7424063,12026,7424063,132,4
1677,DFFB,chr1,F,3857142,3885429,7452350,28287,7452350,133,8
1718,DHCR24,chr1,R,54849626,54887248,7489972,37622,7489972,134,8
1733,DIO1,chr1,F,53894187,53911086,7506871,16899,7506871,135,3
1744,DLSTP1,chr1,R,75742001,75745013,7509883,3012,7509883,136,0
1802,DPH2,chr1,F,43969980,43973371,7513274,3391,7513274,137,5
1805,DPT,chr1,R,168695456,168729204,7547022,33748,7547022,138,3
1806,DPYD,chr1,R,97077742,97921059,8390339,843317,8390339,139,24
1810,DR1,chr1,F,93345920,93362592,8407011,16672,8407011,140,2
1818,DRD5P2,chr1,F,144689613,144691842,8409240,2229,8409240,141,0
1855,DVL1,chr1,R,1335277,1349158,8423121,13881,8423121,142,15
1870,E2F2,chr1,R,23505973,23531250,8448398,25277,8448398,143,8
1889,ECE1,chr1,R,21217246,21345541,8576693,128295,8576693,144,22
1893,ECM1,chr1,F,150508010,150513789,8582472,5779,8582472,145,9
1901,S1PR1,chr1,F,101236748,101241520,8587244,4772,8587244,146,1
1907,EDN2,chr1,R,41478774,41484683,8593153,5909,8593153,147,4
1912,PHC2,chr1,R,33323622,33430610,8700141,106988,8700141,148,23
1939,EIF2D,chr1,R,206571296,206612551,8741396,41255,8741396,149,18
1942,EFNA1,chr1,F,155127872,155134910,8748434,7038,8748434,150,5
1944,EFNA3,chr1,F,155078871,155087538,8757101,8667,8757101,151,4
1945,EFNA4,chr1,F,155063736,155069553,8762918,5817,8762918,152,3
1952,CELSR2,chr1,F,109249714,109275756,8788960,26042,8788960,153,33
1953,MEGF6,chr1,R,3487941,3624757,8925776,136816,8925776,154,40
1969,EPHA2,chr1,R,16124336,16156087,8957527,31751,8957527,155,16
1996,ELAVL4,chr1,F,50048013,50203786,9113300,155773,9113300,156,14
1999,ELF3,chr1,F,202010518,202017188,9119970,6670,9119970,157,8
2005,ELK4,chr1,R,205593465,205634085,9160590,40620,9160590,158,10
2023,ENO1,chr1,R,8860999,8879092,9178683,18093,9178683,159,11
2029,ENSA,chr1,R,150622122,150629622,9186183,7500,9186183,160,5
2035,EPB41,chr1,F,28887090,29120046,9419139,232956,9419139,161,28
2046,EPHA8,chr1,F,22563507,22603594,9459226,40087,9459226,162,25
2048,EPHB2,chr1,F,22710769,22915330,9663787,204561,9663787,163,16
2052,EPHX1,chr1,F,225810073,225845563,9699277,35490,9699277,164,9
2058,EPRS,chr1,R,219968599,220046658,9777336,78059,9777336,165,31
2060,EPS15,chr1,R,51354262,51519354,9942428,165092,9942428,166,26
2104,ESRRG,chr1,R,216503245,217137755,10576938,634510,10576938,167,25
2117,ETV3,chr1,R,157121190,157138591,10594339,17401,10594339,168,4
2134,EXTL1,chr1,F,26021740,26036464,10609063,14724,10609063,169,11
2135,EXTL2,chr1,R,100872371,100895323,10632015,22952,10632015,170,7
2140,EYA3,chr1,R,27970343,28088675,10750347,118332,10750347,171,21
2152,F3,chr1,R,94529175,94541857,10763029,12682,10763029,172,5
2153,F5,chr1,R,169511953,169586531,10837607,74578,10837607,173,24
2165,F13B,chr1,R,197039190,197067267,10865684,28077,10865684,174,12
2166,FAAH,chr1,F,46394266,46413848,10885266,19582,10885266,175,14
2170,FABP3,chr1,R,31360417,31373283,10898132,12866,10898132,176,4
2205,FCER1A,chr1,F,159283887,159308224,10922469,24337,10922469,177,6
2207,FCER1G,chr1,F,161215296,161219248,10926421,3952,10926421,178,4
2209,FCGR1A,chr1,F,149781274,149792518,10937665,11244,10937665,179,5
2210,FCGR1B,chr1,F,121087344,121097161,10947482,9817,10947482,180,5
2212,FCGR2A,chr1,F,161505414,161524048,10966116,18634,10966116,181,9
2213,FCGR2B,chr1,F,161663114,161678654,10981656,15540,10981656,182,8
2214,FCGR3A,chr1,R,161541758,161550623,10990521,8865,10990521,183,5
2215,FCGR3B,chr1,R,161623195,161631963,10999289,8768,10999289,184,6
2224,FDPS,chr1,F,155308747,155320666,11011208,11919,11011208,185,10
2268,FGR,chr1,R,27612288,27635561,11034481,23273,11034481,186,17
2271,FH,chr1,R,241497556,241519785,11056710,22229,11056710,187,10
2275,FHL3,chr1,R,37996769,38005515,11065456,8746,11065456,188,5
2301,FOXE3,chr1,F,47416071,47418052,11067437,1981,11067437,189,0
2306,FOXD2,chr1,F,47436016,47440691,11072112,4675,11072112,190,0
2312,FLG,chr1,R,152302162,152325257,11095207,23095,11095207,191,2
2326,FMO1,chr1,F,171248470,171285978,11132715,37508,11132715,192,10
2327,FMO2,chr1,F,171185207,171212683,11160191,27476,11160191,193,8
2328,FMO3,chr1,F,171090876,171117821,11187136,26945,11187136,194,9
2329,FMO4,chr1,F,171314136,171342084,11215084,27948,11215084,195,10
2330,FMO5,chr1,R,147184299,147225798,11256583,41499,11256583,196,10
2331,FMOD,chr1,R,203340620,203351429,11267392,10809,11267392,197,2
2475,MTOR,chr1,R,11106530,11262557,11423419,156027,11423419,198,58
2494,NR5A2,chr1,F,200027601,200177424,11573242,149823,11573242,199,12
2517,FUCA1,chr1,R,23845076,23868369,11596535,23293,11596535,200,8
2532,ACKR1,chr1,F,159204012,159206500,11599023,2488,11599023,201,1
2537,IFI6,chr1,R,27666060,27672213,11605176,6153,11605176,202,4
2563,GABRD,chr1,F,2019328,2030753,11616601,11425,11616601,203,9
2582,GALE,chr1,R,23795598,23800804,11621807,5206,11621807,204,12
2590,GALNT2,chr1,F,230057788,230282130,11846149,224342,11846149,205,19
2629,GBA,chr1,R,155234447,155244862,11856564,10415,11856564,206,12
2630,GBAP1,chr1,R,155213824,155227534,11870274,13710,11870274,207,12
2633,GBP1,chr1,R,89052303,89065360,11883331,13057,11883331,208,11
2634,GBP2,chr1,R,89106131,89126159,11903359,20028,11903359,209,10
2635,GBP3,chr1,R,89006676,89022880,11919563,16204,11919563,210,12
2672,GFI1,chr1,R,92473042,92486876,11933397,13834,11933397,211,10
2701,GJA4,chr1,F,34792957,34795750,11936190,2793,11936190,212,1
2702,GJA5,chr1,R,147756198,147781067,11961059,24869,11961059,213,4
2703,GJA8,chr1,F,147902819,147915287,11973527,12468,11973527,214,2
2707,GJB3,chr1,F,34781188,34786366,11978705,5178,11978705,215,2
2709,GJB5,chr1,F,34755045,34758512,11982172,3467,11982172,216,1
2730,GCLM,chr1,R,93885204,93909598,12006566,24394,12006566,217,7
2752,GLUL,chr1,R,182378092,182392206,12020680,14114,12020680,218,8
2773,GNAI3,chr1,F,109548563,109595843,12067960,47280,12067960,219,8
2780,GNAT2,chr1,R,109602905,109619662,12084717,16757,12084717,220,8
2782,GNB1,chr1,R,1785284,1891117,12190550,105833,12190550,221,11
2786,GNG4,chr1,R,235547684,235650754,12293620,103070,12293620,222,9
2787,GNG5,chr1,R,84498322,84506579,12301877,8257,12301877,223,3
2810,SFN,chr1,F,26863141,26864456,12303192,1315,12303192,224,0
2827,GPR3,chr1,F,27392643,27395814,12306363,3171,12306363,225,1
2848,GPR25,chr1,F,200872954,200874178,12307587,1224,12307587,226,0
2882,GPX7,chr1,F,52602370,52609051,12314268,6681,12314268,227,2
2899,GRIK3,chr1,R,36795526,37034548,12553290,239022,12553290,228,17
2944,GSTM1,chr1,F,109687795,109693745,12559240,5950,12559240,229,7
2946,GSTM2,chr1,F,109668021,109683997,12575216,15976,12575216,230,9
2947,GSTM3,chr1,R,109733931,109741038,12582323,7107,12582323,231,8
2948,GSTM4,chr1,F,109656075,109665501,12591749,9426,12591749,232,9
2949,GSTM5,chr1,F,109711760,109718268,12598257,6508,12598257,233,8
2959,GTF2B,chr1,R,88852637,88891944,12637564,39307,12637564,234,7
2980,GUCA2A,chr1,R,42162690,42164724,12639598,2034,12639598,235,2
2981,GUCA2B,chr1,F,42153420,42155824,12642002,2404,12642002,236,2
2987,GUK1,chr1,F,228139642,228148955,12651315,9313,12651315,237,11
3020,H3F3A,chr1,F,226062706,226072002,12660611,9296,12660611,238,3
3061,HCRTR1,chr1,F,31617688,31632519,12675442,14831,12675442,239,10
3065,HDAC1,chr1,F,32292106,32333628,12716964,41522,12716964,240,14
3068,HDGF,chr1,R,156742106,156752448,12727306,10342,12727306,241,10
3075,CFH,chr1,F,196651877,196747504,12822933,95627,12822933,242,22
3078,CFHR1,chr1,F,196819730,196832189,12835392,12459,12835392,243,5
3080,CFHR2,chr1,F,196943757,196959226,12850861,15469,12850861,244,4
3104,ZBTB48,chr1,F,6579990,6589280,12860151,9290,12860151,245,10
3140,MR1,chr1,F,181033378,181061938,12888711,28560,12888711,246,7
3142,HLX,chr1,F,220879400,220885059,12894370,5659,12894370,247,3
3151,HMGN2,chr1,F,26472410,26476642,12898602,4232,12898602,248,5
3155,HMGCL,chr1,R,23801876,23825459,12922185,23583,12922185,249,8
3158,HMGCS2,chr1,R,119747995,119769125,12943315,21130,12943315,250,9
3192,HNRNPU,chr1,R,244850299,244864525,12957541,14226,12957541,251,13
3208,HPCA,chr1,F,32886086,32894646,12966101,8560,12966101,252,4
3283,HSD3B1,chr1,F,119507123,119515060,12974038,7937,12974038,253,3
3284,HSD3B2,chr1,F,119414930,119423039,12982147,8109,12982147,254,4
3290,HSD11B1,chr1,F,209686179,209734950,13030918,48771,13030918,255,6
3310,HSPA6,chr1,F,161524539,161526897,13033276,2358,13033276,256,0
3311,HSPA7,chr1,F,161606058,161608551,13035769,2493,13035769,257,0
3321,IGSF3,chr1,R,116574397,116667755,13129127,93358,13129127,258,14
3339,HSPG2,chr1,R,21822231,21937297,13244193,115066,13244193,259,103
3352,HTR1D,chr1,R,23191894,23194729,13247028,2835,13247028,260,0
3362,HTR6,chr1,F,19665286,19680966,13262708,15680,13262708,261,2
3399,ID3,chr1,R,23557929,23559794,13264573,1865,13264573,262,2
3428,IFI16,chr1,F,158999972,159055155,13319756,55183,13319756,263,12
3491,CYR61,chr1,F,85580760,85583967,13322963,3207,13322963,264,4
3570,IL6R,chr1,F,154405192,154469450,13387221,64258,13387221,265,11
3586,IL10,chr1,R,206767601,206774607,13394227,7006,13394227,266,5
3595,IL12RB2,chr1,F,67307350,67396900,13483777,89550,13483777,267,18
3604,TNFRSF9,chr1,R,7915870,7943165,13511072,27295,13511072,268,9
3608,ILF2,chr1,R,153661787,153671028,13520313,9241,13520313,269,13
3633,INPP5B,chr1,R,37860696,37947084,13606701,86388,13606701,270,31
3645,INSRR,chr1,R,156840872,156858920,13624749,18048,13624749,271,21
3652,IPP,chr1,R,45694323,45750813,13681239,56490,13681239,272,10
3664,IRF6,chr1,R,209785622,209806175,13701792,20553,13701792,273,8
3707,ITPKB,chr1,R,226631689,226739327,13809430,107638,13809430,274,8
3713,IVL,chr1,F,152908562,152911886,13812754,3324,13812754,275,2
3716,JAK1,chr1,R,64833222,64966910,13946442,133688,13946442,276,26
3725,JUN,chr1,R,58780790,58784113,13949765,3323,13949765,277,0
3737,KCNA2,chr1,R,110593579,110631514,13987700,37935,13987700,278,8
3738,KCNA3,chr1,R,110653559,110675033,14009174,21474,14009174,279,3
3744,KCNA10,chr1,R,110517216,110519175,14011133,1959,14011133,280,0
3749,KCNC4,chr1,F,110210713,110282617,14083037,71904,14083037,281,5
3752,KCND3,chr1,R,111775821,111989576,14296792,213755,14296792,282,13
3756,KCNH1,chr1,R,210678313,211134115,14752594,455802,14752594,283,11
3765,KCNJ9,chr1,F,160079952,160090563,14763205,10611,14763205,284,3
3766,KCNJ10,chr1,R,160037466,160070261,14796000,32795,14796000,285,1
3775,KCNK1,chr1,F,233614003,233672512,14854509,58509,14854509,286,5
3776,KCNK2,chr1,F,215002638,215237093,15088964,234455,15088964,287,12
3782,KCNN3,chr1,R,154697461,154870278,15261781,172817,15261781,288,9
3814,KISS1,chr1,R,204190340,204196491,15267932,6151,15267932,289,3
3898,LAD1,chr1,R,201380837,201399541,15286636,18704,15286636,290,10
3914,LAMB3,chr1,R,209614869,209652475,15324242,37606,15324242,291,23
3915,LAMC1,chr1,F,183023459,183145592,15446375,122133,15446375,292,27
3918,LAMC2,chr1,F,183186038,183245127,15505464,59089,15505464,293,22
3925,STMN1,chr1,R,25884185,25906877,15528156,22692,15528156,294,7
3930,LBR,chr1,R,225401501,225428855,15555510,27354,15555510,295,15
3932,LCK,chr1,F,32251238,32286170,15590442,34932,15590442,296,12
3953,LEPR,chr1,F,65420651,65637493,15807284,216842,15807284,297,23
3964,LGALS8,chr1,F,236518213,236552981,15842052,34768,15842052,298,14
4000,LMNA,chr1,F,156082545,156140089,15899596,57544,15899596,299,16
4009,LMX1A,chr1,R,165201866,165356715,16054445,154849,16054445,300,12
4014,LOR,chr1,F,153259634,153262125,16056936,2491,16056936,301,1
4063,LY9,chr1,F,160796073,160828256,16089119,32183,16089119,302,11
4070,TACSTD2,chr1,R,58575422,58577494,16091191,2072,16091191,303,0
4116,MAGOH,chr1,R,53226891,53238610,16102910,11719,16102910,304,4
4139,MARK1,chr1,F,220528182,220664457,16239185,136275,16239185,305,20
4146,MATN1,chr1,R,30711276,30723585,16251494,12309,16251494,306,7
4170,MCL1,chr1,R,150574550,150579738,16256682,5188,16256682,307,2
4179,CD46,chr1,F,207752037,207795516,16300161,43479,16300161,308,13
4184,SMCP,chr1,F,152878321,152885047,16306887,6726,16306887,309,1
4194,MDM4,chr1,F,204516378,204581681,16372190,65303,16372190,310,16
4209,MEF2D,chr1,R,156463720,156500842,16409312,37122,16409312,311,16
4237,MFAP2,chr1,R,16974499,16981643,16416456,7144,16416456,312,9
4259,MGST3,chr1,F,165630872,165656136,16441720,25264,16441720,313,6
4332,MNDA,chr1,F,158831377,158849480,16459823,18103,16459823,314,6
4343,MOV10,chr1,F,112674311,112700746,16486258,26435,16486258,315,20
4352,MPL,chr1,F,43337417,43354464,16503305,17047,16503305,316,11
4359,MPZ,chr1,R,161304734,161309972,16508543,5238,16508543,317,5
4438,MSH4,chr1,F,75796870,75913238,16624911,116368,16624911,318,19
4520,MTF1,chr1,R,37809566,37859624,16674969,50058,16674969,319,14
4524,MTHFR,chr1,R,11785729,11806103,16695343,20374,16695343,320,12
4548,MTR,chr1,F,236794303,236903981,16805021,109678,16805021,321,33
4580,MTX1,chr1,F,155208698,155213839,16810162,5141,16810162,322,8
4582,MUC1,chr1,R,155185823,155192915,16817254,7092,16817254,323,7
4595,MUTYH,chr1,R,45329241,45340470,16828483,11229,16828483,324,21
4608,MYBPH,chr1,R,203167810,203175966,16836639,8156,16836639,325,11
4610,MYCL,chr1,R,39895423,39902015,16843231,6592,16843231,326,1
4653,MYOC,chr1,R,171635416,171652633,16860448,17217,16860448,327,2
4656,MYOG,chr1,R,203083128,203086038,16863358,2910,16863358,328,2
4660,PPP1R12B,chr1,F,202348701,202588569,17103226,239868,17103226,329,33
4678,NASP,chr1,F,45583987,45618906,17138145,34919,17138145,330,15
4681,NBL1,chr1,F,19643228,19658456,17153373,15228,17153373,331,9
4688,NCF2,chr1,R,183555561,183590921,17188733,35360,17188733,332,16
4720,NDUFS2,chr1,F,161197418,161214395,17205710,16977,17205710,333,14
4725,NDUFS5,chr1,F,39026294,39034636,17214052,8342,17214052,334,2
4751,NEK2,chr1,R,211658255,211675630,17231427,17375,17231427,335,8
4774,NFIA,chr1,F,61077256,61462788,17616959,385532,17616959,336,14
4802,NFYC,chr1,F,40691569,40771603,17696993,80034,17696993,337,18
4803,NGF,chr1,R,115285915,115338384,17749462,52469,17749462,338,4
4807,NHLH1,chr1,F,160286368,160372848,17835942,86480,17835942,339,3
4808,NHLH2,chr1,R,115831910,115841127,17845159,9217,17845159,340,4
4811,NID1,chr1,R,235975829,236065181,17934511,89352,17934511,341,19
4817,NIT1,chr1,F,161118071,161125445,17941885,7374,17941885,342,7
4853,NOTCH2,chr1,R,119911552,120069703,18100036,158151,18100036,343,36
4878,NPPA,chr1,R,11845708,11847783,18102111,2075,18102111,344,2
4879,NPPB,chr1,R,11857463,11858935,18103583,1472,18103583,345,2
4881,NPR1,chr1,F,153678616,153693992,18118959,15376,18118959,346,21
4893,NRAS,chr1,R,114704463,114716894,18131390,12431,18131390,347,6
4898,NRD1,chr1,R,51789191,51878937,18221136,89746,18221136,348,35
4904,YBX1,chr1,F,42682388,42702363,18241111,19975,18241111,349,7
4914,NTRK1,chr1,F,156815749,156881850,18307212,66101,18307212,350,18
4919,ROR1,chr1,F,63774018,64181498,18714692,407480,18714692,351,9
4921,DDR2,chr1,F,162631264,162786591,18870019,155327,18870019,352,21
4931,NVL,chr1,R,224227333,224330201,18972887,102868,18972887,353,26
4985,OPRD1,chr1,F,28812141,28863696,19024442,51555,19024442,354,2
4998,ORC1,chr1,R,52372828,52404471,19056085,31643,19056085,355,16
5016,OVGP1,chr1,R,111414314,111427777,19069548,13463,19069548,356,10
5051,PAFAH2,chr1,R,25959763,25998581,19108366,38818,19108366,357,12
5052,PRDX1,chr1,R,45511034,45522890,19120222,11856,19120222,358,6
5081,PAX7,chr1,F,18631005,18748866,19238083,117861,19238083,359,8
5087,PBX1,chr1,F,164559359,164886047,19564771,326688,19564771,360,16
5129,CDK18,chr1,F,205504555,205532793,19593009,28238,19593009,361,15
5132,PDC,chr1,R,186443565,186461108,19610552,17543,19610552,362,4
5142,PDE4B,chr1,F,65792509,66374579,20192622,582070,20192622,363,24
5174,PDZK1,chr1,R,145670851,145707400,20229171,36549,20229171,364,12
5192,PEX10,chr1,R,2404801,2413780,20238150,8979,20238150,365,7
5195,PEX14,chr1,F,10474945,10630758,20393963,155813,20393963,366,12
5202,PFDN2,chr1,R,161100555,161118076,20411484,17521,20411484,367,4
5208,PFKFB2,chr1,F,207034415,207081023,20458092,46608,20458092,368,20
5226,PGD,chr1,F,10398991,10420511,20479612,21520,20479612,369,12
5236,PGM1,chr1,F,63593275,63660245,20546582,66970,20546582,370,12
5279,PIGC,chr1,R,172441456,172444090,20549216,2634,20549216,371,1
5284,PIGR,chr1,R,206928521,206946466,20567161,17945,20567161,372,11
5287,PIK3C2B,chr1,R,204422627,204494815,20639349,72188,20639349,373,36
5293,PIK3CD,chr1,F,9629888,9729114,20738575,99226,20738575,374,29
5298,PI4KB,chr1,R,151291796,151327715,20774494,35919,20774494,375,14
5301,PIN1P1,chr1,F,69919321,69920317,20775490,996,20775490,376,0
5313,PKLR,chr1,R,155289292,155308709,20794907,19417,20794907,377,12
5317,PKP1,chr1,F,201283451,201332993,20844449,49542,20844449,378,14
5320,PLA2G2A,chr1,R,19975430,19980439,20849458,5009,20849458,379,5
5321,PLA2G4A,chr1,F,186828899,186988981,21009540,160082,21009540,380,20
5322,PLA2G5,chr1,F,20028338,20091901,21073103,63563,21073103,381,13
5351,PLOD1,chr1,F,11934666,11975542,21113979,40876,21113979,382,20
5362,PLXNA2,chr1,R,208022241,208244384,21336122,222143,21336122,383,34
5394,EXOSC10,chr1,R,11066612,11099910,21369420,33298,21369420,384,25
5396,PRRX1,chr1,F,170662727,170739419,21446112,76692,21446112,385,5
5451,POU2F1,chr1,F,167220828,167427345,21652629,206517,21652629,386,19
5453,POU3F1,chr1,R,38043850,38046778,21655557,2928,21655557,387,0
5498,PPOX,chr1,F,161165727,161178277,21668107,12550,21668107,388,16
5511,PPP1R8,chr1,F,27830740,27851672,21689039,20932,21689039,389,6
5525,PPP2R5A,chr1,F,212285536,212361863,21765366,76327,21765366,390,13
5538,PPT1,chr1,R,40072709,40097470,21790127,24761,21790127,391,8
5546,PRCC,chr1,F,156767481,156800817,21823463,33336,21823463,392,8
5549,PRELP,chr1,F,203475754,203491352,21839061,15598,21839061,393,2
5563,PRKAA2,chr1,F,56645316,56715335,21909080,70019,21909080,394,8
5565,PRKAB2,chr1,R,147155105,147172589,21926564,17484,21926564,395,8
5567,PRKACB,chr1,F,84077974,84238498,22087088,160524,22087088,396,17
5586,PKN2,chr1,F,88684192,88836255,22239151,152063,22239151,397,23
5590,PRKCZ,chr1,F,2050469,2185395,22374077,134926,22374077,398,25
5629,PROX1,chr1,F,213983225,214041510,22432362,58285,22432362,399,8
5664,PSEN2,chr1,F,226870571,226896103,22457894,25532,22457894,400,14
5686,PSMA5,chr1,R,109399030,109426486,22485350,27456,22485350,401,8
5690,PSMB2,chr1,R,35599540,35641844,22527654,42304,22527654,402,6
5692,PSMB4,chr1,F,151399564,151401936,22530026,2372,22530026,403,6
5710,PSMD4,chr1,F,151254699,151267479,22542806,12780,22542806,404,9
5724,PTAFR,chr1,R,28147165,28193936,22589577,46771,22589577,405,3
5733,PTGER3,chr1,R,70852352,71047814,22785039,195462,22785039,406,10
5737,PTGFR,chr1,F,78476239,78540701,22849501,64462,22849501,407,6
5738,PTGFRN,chr1,F,116909922,116990358,22929937,80436,22929937,408,8
5743,PTGS2,chr1,R,186671811,186680427,22938553,8616,22938553,409,9
5768,QSOX1,chr1,F,180154832,180198034,22981755,43202,22981755,410,11
5778,PTPN7,chr1,R,202147011,202161592,22996336,14581,22996336,411,10
5784,PTPN14,chr1,R,214336941,214551681,23211076,214740,23211076,412,21
5788,PTPRC,chr1,F,198638967,198757476,23329585,118509,23329585,413,33
5792,PTPRF,chr1,F,43522237,43623672,23431020,101435,23431020,414,39
5824,PEX19,chr1,R,160276808,160285151,23439363,8343,23439363,415,7
5825,ABCD3,chr1,F,94418085,94518663,23539941,100578,23539941,416,26
5865,RAB3B,chr1,R,51907955,51990764,23622750,82809,23622750,417,5
5867,RAB4A,chr1,F,229271061,229305894,23657583,34833,23657583,418,7
5872,RAB13,chr1,R,153981616,153986377,23662344,4761,23662344,419,8
5876,RABGGTB,chr1,F,75786193,75795090,23671241,8897,23671241,420,10
5877,RABIF,chr1,R,202878281,202889257,23682217,10976,23682217,421,1
5906,RAP1A,chr1,F,111619782,111716695,23779130,96913,23779130,422,10
5909,RAP1GAP,chr1,R,21596214,21669375,23852291,73161,23852291,423,29
5928,RBBP4,chr1,F,32651147,32686211,23887355,35064,23887355,424,12
5929,RBBP5,chr1,R,205086141,205122022,23923236,35881,23923236,425,13
5972,REN,chr1,R,204154815,204166337,23934758,11522,23934758,426,9
5993,RFX5,chr1,R,151340639,151347293,23941412,6654,23941412,427,11
5996,RGS1,chr1,F,192575726,192580029,23945715,4303,23945715,428,4
5997,RGS2,chr1,F,192809038,192812277,23948954,3239,23948954,429,4
5999,RGS4,chr1,F,163068605,163076802,23957151,8197,23957151,430,5
6000,RGS7,chr1,R,240775513,241357230,24538868,581717,24538868,431,22
6003,RGS13,chr1,F,192636137,192660311,24563042,24174,24563042,432,6
6004,RGS16,chr1,R,182598622,182604413,24568833,5791,24568833,433,4
6006,RHCE,chr1,R,25360658,25430192,24638367,69534,24638367,434,13
6007,RHD,chr1,F,25272392,25330445,24696420,58053,24696420,435,12
6016,RIT1,chr1,R,155897807,155911402,24710015,13595,24710015,436,6
6018,RLF,chr1,F,40161368,40240921,24789568,79553,24789568,437,8
6041,RNASEL,chr1,R,182573633,182589285,24805220,15652,24805220,438,7
6045,RNF2,chr1,F,185045418,185102608,24862410,57190,24862410,439,8
6051,RNPEP,chr1,F,201982637,202006147,24885920,23510,24885920,440,11
6060,RNU1-4,chr1,F,16740515,16740679,24886084,164,24886084,441,0
6080,SNORA73A,chr1,F,28507364,28507571,24886291,207,24886291,442,0
6083,SNORD21,chr1,F,92837288,92837383,24886386,95,24886386,443,0
6097,RORC,chr1,R,151806070,151832238,24912554,26168,24912554,444,12
6118,RPA2,chr1,R,27891523,27914797,24935828,23274,24935828,445,8
6121,RPE65,chr1,R,68428823,68449959,24956964,21136,24956964,446,13
6125,RPL5,chr1,F,92832036,92841924,24966852,9888,24966852,447,7
6135,RPL11,chr1,F,23691778,23696425,24971499,4647,24971499,448,5
6146,RPL22,chr1,R,6185019,6199619,24986099,14600,24986099,449,3
6195,RPS6KA1,chr1,F,26529757,26575030,25031372,45273,25031372,450,25
6202,RPS8,chr1,F,44775573,44778740,25034539,3167,25034539,451,5
6232,RPS27,chr1,F,153990762,153992155,25035932,1393,25035932,452,3
6248,RSC1A1,chr1,F,15659868,15661722,25037786,1854,25037786,453,0
6258,RXRG,chr1,R,165400921,165445355,25082220,44434,25082220,454,11
6262,RYR2,chr1,F,237042237,237833988,25873971,791751,25873971,455,106
6271,S100A1,chr1,F,153628396,153632037,25877612,3641,25877612,456,2
6272,SORT1,chr1,R,109309564,109397941,25965989,88377,25965989,457,22
6273,S100A2,chr1,R,153561107,153565830,25970712,4723,25970712,458,2
6274,S100A3,chr1,R,153547332,153549258,25972638,1926,25972638,459,2
6275,S100A4,chr1,R,153543618,153545806,25974826,2188,25974826,460,3
6276,S100A5,chr1,R,153537146,153542175,25979855,5029,25979855,461,2
6277,S100A6,chr1,R,153534599,153536241,25981497,1642,25981497,462,2
6278,S100A7,chr1,R,153457743,153460661,25984415,2918,25984415,463,2
6279,S100A8,chr1,R,153390031,153422578,26016962,32547,26016962,464,3
6280,S100A9,chr1,F,153357853,153361027,26020136,3174,26020136,465,2
6281,S100A10,chr1,R,151982909,151994238,26031465,11329,26031465,466,2
6282,S100A11,chr1,R,152032505,152037035,26035995,4530,26035995,467,2
6283,S100A12,chr1,R,153373707,153375599,26037887,1892,26037887,468,2
6284,S100A13,chr1,R,153618798,153634092,26053181,15294,26053181,469,9
6301,SARS,chr1,F,109213892,109238182,26077471,24290,26077471,470,12
6339,SCNN1D,chr1,F,1280414,1292029,26089086,11615,26089086,471,16
6342,SCP2,chr1,F,52927228,53051617,26213475,124389,26213475,472,17
6375,XCL1,chr1,F,168576060,168582077,26219492,6017,26219492,473,3
6390,SDHB,chr1,R,17018721,17054170,26254941,35449,26254941,474,7
6391,SDHC,chr1,F,161314375,161364751,26305317,50376,26305317,475,6
6401,SELE,chr1,R,169722639,169734079,26316757,11440,26316757,476,13
6402,SELL,chr1,R,169690664,169711702,26337795,21038,26337795,477,8
6403,SELP,chr1,R,169588848,169630139,26379086,41291,26379086,478,17
6421,SFPQ,chr1,R,35176379,35193158,26395865,16779,26395865,479,12
6429,SRSF4,chr1,R,29147737,29182125,26430253,34388,26430253,480,5
6464,SHC1,chr1,R,154962297,154974492,26442448,12195,26442448,481,12
6487,ST3GAL3,chr1,F,43705823,43931165,26667790,225342,26667790,482,26
6491,STIL,chr1,R,47250138,47314781,26732433,64643,26732433,483,19
6497,SKI,chr1,F,2228694,2310213,26813952,81519,26813952,484,7
6504,SLAMF1,chr1,R,160608110,160647537,26853379,39427,26853379,485,7
6512,SLC1A7,chr1,R,53087178,53142632,26908833,55454,26908833,486,12
6513,SLC2A1,chr1,R,42925374,42959176,26942635,33802,26942635,487,9
6518,SLC2A5,chr1,R,9036942,9071704,26977397,34762,26977397,488,13
6536,SLC6A9,chr1,R,43996482,44031492,27012407,35010,27012407,489,16
6548,SLC9A1,chr1,R,27098808,27155130,27068729,56322,27068729,490,12
6566,SLC16A1,chr1,R,112911846,112956353,27113236,44507,27113236,491,6
6635,SNRPE,chr1,F,203861584,203871152,27122804,9568,27122804,492,4
6646,SOAT1,chr1,F,179293713,179358680,27187771,64967,27187771,493,16
6675,UAP1,chr1,F,162561505,162599843,27226109,38338,27226109,494,12
6698,SPRR1A,chr1,F,152984087,152985814,27227836,1727,27227836,495,1
6699,SPRR1B,chr1,F,153031202,153032900,27229534,1698,27229534,496,1
6700,SPRR2A,chr1,R,153056119,153057512,27230927,1393,27230927,497,1
6701,SPRR2B,chr1,R,153070227,153071608,27232308,1381,27232308,498,1
6702,SPRR2C,chr1,R,153140117,153141493,27233684,1376,27233684,499,1
6703,SPRR2D,chr1,R,153039724,153041118,27235078,1394,27235078,500,1
6704,SPRR2E,chr1,R,153093134,153094528,27236472,1394,27236472,501,1
6705,SPRR2F,chr1,R,153112123,153113515,27237864,1392,27237864,502,1
6706,SPRR2G,chr1,R,153149581,153150951,27239234,1370,27239234,503,1
6707,SPRR3,chr1,F,153001746,153003856,27241344,2110,27241344,504,2
6708,SPTA1,chr1,R,158610497,158686716,27317563,76219,27317563,505,51
6723,SRM,chr1,R,11054591,11060034,27323006,5443,27323006,506,7
6726,SRP9,chr1,F,225777812,225790466,27335660,12654,27335660,507,3
6738,TROVE2,chr1,F,193059421,193091777,27368016,32356,27368016,508,13
6746,SSR2,chr1,R,156009047,156020991,27379960,11944,27379960,509,6
6791,AURKAPS1,chr1,R,220266178,220267715,27381497,1537,27381497,510,0
6814,STXBP3,chr1,F,108746662,108809526,27444361,62864,27444361,511,18
6846,XCL2,chr1,R,168540764,168543997,27447594,3233,27447594,512,2
6847,SYCP1,chr1,F,114854415,114995370,27588549,140955,27588549,513,35
6883,TAF12,chr1,R,28603095,28643109,27628563,40014,27628563,514,6
6884,TAF13,chr1,R,109064375,109076002,27640190,11627,27640190,515,3
6886,TAL1,chr1,R,47216289,47232373,27656274,16084,27656274,516,7
6894,TARBP1,chr1,R,234391312,234479158,27744120,87846,27744120,517,33
6900,CNTN2,chr1,F,205043201,205078043,27778962,34842,27778962,518,23
6905,TBCE,chr1,F,235367359,235448968,27860571,81609,27860571,519,17
6913,TBX15,chr1,R,118883042,118989556,27967085,106514,27967085,520,10
6920,TCEA3,chr1,R,23380908,23424779,28010956,43871,28010956,521,13
6924,TCEB3,chr1,F,23743365,23762059,28029650,18694,28029650,522,10
6944,VPS72,chr1,R,151176299,151190213,28043564,13914,28043564,523,5
7042,TGFB2,chr1,F,218345333,218444619,28142850,99286,28142850,524,7
7044,LEFTY2,chr1,R,225936597,225941383,28147636,4786,28147636,525,4
7049,TGFBR3,chr1,R,91680342,91906002,28373296,225660,28373296,526,21
7059,THBS3,chr1,R,155195583,155209180,28386893,13597,28386893,527,25
7062,TCHH,chr1,R,152106316,152115454,28396031,9138,28396031,528,2
7075,TIE1,chr1,F,43300894,43323110,28418247,22216,28418247,529,24
7100,TLR5,chr1,R,223109403,223143282,28452126,33879,28452126,530,6
7107,GPR137B,chr1,F,236142501,236208909,28518534,66408,28518534,531,7
7133,TNFRSF1B,chr1,F,12166948,12209222,28560808,42274,28560808,532,11
7135,TNNI1,chr1,R,201403766,201421746,28578788,17980,28578788,533,8
7139,TNNT2,chr1,R,201359007,201377765,28597546,18758,28597546,534,17
7143,TNR,chr1,R,175322798,175743702,29018450,420904,29018450,535,24
7151,TOP1P1,chr1,F,171338895,171341326,29020881,2431,29020881,536,0
7159,TP53BP2,chr1,R,223779892,223845981,29086970,66089,29086970,537,19
7161,TP73,chr1,F,3652564,3736201,29170607,83637,29170607,538,16
7170,TPM3,chr1,R,154155303,154192135,29207439,36832,29207439,539,15
7175,TPR,chr1,R,186311651,186375848,29271636,64197,29271636,540,50
7188,TRAF5,chr1,F,211326578,211374946,29320004,48368,29320004,541,11
7193,TRE-TTC3-1,chr1,F,16872582,16872654,29320076,72,29320076,542,0
7195,TRNAG1,chr1,R,16545938,16546009,29320147,71,29320147,543,0
7203,CCT3,chr1,R,156308960,156338415,29349602,29455,29349602,544,15
7214,TRN-GTT2-1,chr1,F,145287765,145287839,29349676,74,29349676,545,0
7252,TSHB,chr1,F,115029823,115034309,29354162,4486,29354162,546,2
7257,TSNAX,chr1,F,231528652,231566524,29392034,37872,29392034,547,5
7268,TTC4,chr1,F,54715821,54742657,29418870,26836,29418870,548,33
7286,TUFT1,chr1,F,151540299,151583583,29462154,43284,29462154,549,13
7292,TNFSF4,chr1,R,173183730,173208072,29486496,24342,29486496,550,4
7293,TNFRSF4,chr1,R,1211325,1214638,29489809,3313,29489809,551,6
7371,UCK2,chr1,F,165827494,165911618,29573933,84124,29573933,552,8
7388,UQCRH,chr1,F,46303612,46316777,29587098,13165,29587098,553,4
7389,UROD,chr1,F,45012132,45015669,29590635,3537,29590635,554,9
7391,USF1,chr1,R,161039250,161045979,29597364,6729,29597364,555,11
7398,USP1,chr1,F,62436303,62451804,29612865,15501,29612865,556,9
7399,USH2A,chr1,R,215622893,216423396,30413368,800503,30413368,557,71
7412,VCAM1,chr1,F,100719639,100739045,30432774,19406,30432774,558,8
7482,WNT2B,chr1,F,112466540,112521288,30487522,54748,30487522,559,6
7483,WNT9A,chr1,R,227918657,227947975,30516840,29318,30516840,560,4
7579,ZSCAN20,chr1,F,33472630,33500693,30544903,28063,30544903,561,8
7678,ZNF124,chr1,R,247121974,247172438,30595367,50464,30595367,562,7
7709,ZBTB17,chr1,R,15941868,15976132,30629631,34264,30629631,563,15
7779,SLC30A1,chr1,R,211575038,211578757,30633350,3719,30633350,564,1
7780,SLC30A2,chr1,R,26038021,26046138,30641467,8117,30641467,565,7
7798,LUZP1,chr1,R,23084022,23177808,30735253,93786,30735253,566,5
7799,PRDM2,chr1,F,13700239,13825079,30860093,124840,30860093,567,14
7802,DNALI1,chr1,F,37556918,37566857,30870032,9939,30870032,568,5
7804,LRP8,chr1,R,53242363,53328149,30955818,85786,30955818,569,21
7805,LAPTM5,chr1,R,30732467,30757836,30981187,25369,30981187,570,7
7809,BSND,chr1,F,54998943,55008792,30991036,9849,30991036,571,4
7812,CSDE1,chr1,R,114716912,114758050,31032174,41138,31032174,572,20
7813,EVI5,chr1,R,92508695,92792404,31315883,283709,31315883,573,26
7818,DAP3,chr1,F,155689088,155739010,31365805,49922,31365805,574,13
7827,NPHS2,chr1,R,179550538,179575976,31391243,25438,31391243,575,8
7832,BTG2,chr1,F,203305535,203309602,31395310,4067,31395310,576,1
8073,PTP4A2,chr1,R,31906420,31938387,31427277,31967,31427277,577,8
8289,ARID1A,chr1,F,26696030,26782110,31513357,86080,31513357,578,19
8290,HIST3H3,chr1,R,228424844,228425325,31513838,481,31513838,579,0
8317,CDC7,chr1,F,91500813,91525764,31538789,24951,31538789,580,13
8337,HIST2H2AA3,chr1,R,149842217,149842751,31539323,534,31539323,581,0
8338,HIST2H2AC,chr1,F,149886974,149887411,31539760,437,31539760,582,0
8349,HIST2H2BE,chr1,R,149884459,149886682,31541983,2223,31541983,583,0
8370,HIST2H4A,chr1,F,149832656,149833052,31542379,396,31542379,584,0
8394,PIP5K1A,chr1,F,151197953,151249535,31593961,51582,31593961,585,19
8407,TAGLN2,chr1,R,159918106,159925542,31601397,7436,31601397,586,6
8412,BCAR3,chr1,R,93561785,93847150,31886762,285365,31886762,587,18
8416,ANXA9,chr1,F,150982022,150996063,31900803,14041,31900803,588,13
8420,SNHG3,chr1,F,28505942,28510892,31905753,4950,31905753,589,3
8431,NR0B2,chr1,R,26911483,26914076,31908346,2593,31908346,590,2
8438,RAD54L,chr1,F,46247694,46278473,31939125,30779,31939125,591,17
8443,GNPAT,chr1,F,231241172,231277973,31975926,36801,31975926,592,16
8444,DYRK3,chr1,F,206635533,206649197,31989590,13664,31989590,593,6
8458,TTF2,chr1,F,117060287,117102870,32032173,42583,32032173,594,23
8476,CDC42BPA,chr1,R,226989857,227318492,32360808,328635,32360808,595,39
8490,RGS5,chr1,R,163142298,163321791,32540301,179493,32540301,596,8
8497,PPFIA4,chr1,F,203026520,203078736,32592517,52216,32592517,597,31
8503,PIK3R3,chr1,R,46040139,46176495,32728873,136356,32728873,598,10
8510,MMP23B,chr1,F,1632180,1634654,32731347,2474,32731347,599,7
8511,MMP23A,chr1,F,1699938,1701808,32733217,1870,32733217,600,5
8514,KCNAB2,chr1,F,5992297,6101193,32842113,108896,32842113,601,21
8515,ITGA10,chr1,R,145891207,145910411,32861317,19204,32861317,602,29
8543,LMO4,chr1,F,87328467,87348923,32881773,20456,32881773,603,5
8547,FCN3,chr1,R,27369109,27374825,32887489,5716,32887489,604,8
8548,BLZF1,chr1,F,169367955,169396544,32916078,28589,32916078,605,7
8556,CDC14A,chr1,F,100345041,100520277,33091314,175236,33091314,606,21
8560,DEGS1,chr1,F,224183207,224193441,33101548,10234,33101548,607,4
8564,KMO,chr1,F,241531888,241595647,33165307,63759,33165307,608,15
8565,YARS,chr1,R,32775238,32818032,33208101,42794,33208101,609,13
8569,MKNK1,chr1,R,46557406,46604294,33254989,46888,33254989,610,19
8574,AKR7A2,chr1,R,19302707,19312146,33264428,9439,33264428,611,6
8613,PPAP2B,chr1,R,56494746,56579584,33349266,84838,33349266,612,5
8634,RTCA,chr1,F,100266157,100292769,33375878,26612,33375878,613,11
8643,PTCH2,chr1,R,44819843,44842944,33398979,23101,33398979,614,22
8659,ALDH4A1,chr1,R,18871429,18902799,33430349,31370,33430349,615,15
8668,EIF3I,chr1,F,32221866,32231604,33440087,9738,33440087,616,11
8672,EIF4G3,chr1,R,20806291,21177320,33811116,371029,33811116,617,44
8674,VAMP4,chr1,R,171700155,171742239,33853200,42084,33853200,618,7
8682,PEA15,chr1,F,160205318,160215376,33863258,10058,33863258,619,5
8703,B4GALT3,chr1,R,161171309,161177968,33869917,6659,33869917,620,8
8704,B4GALT2,chr1,F,43979201,43991171,33881887,11970,33881887,621,8
8707,B3GALT2,chr1,R,193178729,193186613,33889771,7884,33889771,622,1
8718,TNFRSF25,chr1,R,6461150,6466195,33894816,5045,33894816,623,9
8751,ADAM15,chr1,F,155051271,155062776,33906321,11505,33906321,624,23
8761,PABPC4,chr1,R,39560812,39576849,33922358,16037,33922358,625,15
8764,TNFRSF14,chr1,F,2556364,2565622,33931616,9258,33931616,626,7
8784,TNFRSF18,chr1,R,1203507,1206709,33934818,3202,33934818,627,4
8790,FPGT,chr1,F,74198211,74208702,33945309,10491,33945309,628,3
8799,PEX11B,chr1,R,145911347,145918924,33952886,7577,33952886,629,4
8804,CREG1,chr1,R,167541012,167553819,33965693,12807,33965693,630,3
8832,CD84,chr1,R,160541093,160579516,34004116,38423,34004116,631,8
8863,PER3,chr1,F,7784379,7845181,34064918,60802,34064918,632,23
8880,FUBP1,chr1,R,77944054,77979205,34100069,35151,34100069,633,20
8891,EIF2B3,chr1,R,44850521,44986722,34236270,136201,34236270,634,11
8915,BCL10,chr1,R,85265775,85276904,34247399,11129,34247399,635,4
8934,RAB29,chr1,R,205767985,205775487,34254901,7502,34254901,636,5
8991,SELENBP1,chr1,R,151364301,151372734,34263334,8433,34263334,637,12
8995,TNFSF18,chr1,R,173041219,173050963,34273078,9744,34273078,638,2
9015,TAF1A,chr1,R,222557901,222590096,34305273,32195,34305273,639,13
9019,MPZL1,chr1,F,167721949,167791919,34375243,69970,34375243,640,5
9047,SH2D2A,chr1,R,156806242,156816862,34385863,10620,34385863,641,8
9048,ARTN,chr1,F,43931896,43937241,34391208,5345,34391208,642,2
9064,MAP3K6,chr1,R,27355178,27368014,34404044,12836,34404044,643,28
9068,ANGPTL1,chr1,R,178849534,178871353,34425863,21819,34425863,644,6
9077,DIRAS3,chr1,R,68045961,68051733,34431635,5772,34431635,645,2
9095,TBX19,chr1,F,168281039,168314426,34465022,33387,34465022,646,7
9103,FCGR2C,chr1,F,161581338,161601220,34484904,19882,34484904,647,6
9122,SLC16A4,chr1,R,110362850,110391409,34513463,28559,34513463,648,9
9129,PRPF3,chr1,F,150321478,150353228,34545213,31750,34545213,649,18
9132,KCNQ4,chr1,F,40784011,40840452,34601654,56441,34601654,650,17
9156,EXO1,chr1,F,241847966,241909165,34662853,61199,34662853,651,21
9181,ARHGEF2,chr1,R,155946639,156002635,34718849,55996,34718849,652,35
9191,DEDD,chr1,R,161120976,161132783,34730656,11807,34730656,653,7
9202,ZMYM4,chr1,F,35268713,35421944,34883887,153231,34883887,654,35
9204,ZMYM6,chr1,R,34986164,35031968,34929691,45804,34929691,655,15
9213,XPR1,chr1,F,180632009,180890279,35187961,258270,35187961,656,14
9214,FAIM3,chr1,R,206903284,206922033,35206710,18749,35206710,657,7
9249,DHRS3,chr1,R,12567909,12618361,35257162,50452,35257162,658,7
9261,MAPKAPK2,chr1,F,206684911,206734285,35306536,49374,35306536,659,9
9283,GPR37L1,chr1,F,202118704,202131425,35319257,12721,35319257,660,2
9293,GPR52,chr1,F,174448073,174449545,35320729,1472,35320729,661,0
9295,SRSF11,chr1,F,70205681,70252020,35367068,46339,35367068,662,12
9341,VAMP3,chr1,F,7771268,7781432,35377232,10164,35377232,663,4
9372,ZFYVE9,chr1,F,52142093,52346686,35581825,204593,35581825,664,19
9398,CD101,chr1,F,117001749,117036551,35616627,34802,35616627,665,10
9403,SEP15,chr1,R,86862444,86914424,35668607,51980,35668607,666,4
9406,ZRANB2,chr1,R,71063290,71081289,35686606,17999,35686606,667,10
9410,SNRNP40,chr1,R,31259567,31296797,35723836,37230,35723836,668,9
9411,ARHGAP29,chr1,R,94168906,94275068,35829998,106162,35829998,669,24
9447,AIM2,chr1,R,159062478,159076895,35844415,14417,35844415,670,5
9453,GGPS1,chr1,F,235328437,235344532,35860510,16095,35860510,671,4
9462,RASAL2,chr1,F,178093728,178479514,36246296,385786,36246296,672,20
9473,THEMIS2,chr1,F,27872542,27886685,36260439,14143,36260439,673,5
9507,ADAMTS4,chr1,R,161189747,161199055,36269747,9308,36269747,674,8
9528,TMEM59,chr1,R,54031672,54053462,36291537,21790,36291537,675,7
9554,SEC22B,chr1,R,120155941,120176521,36312117,20580,36312117,676,4
9557,CHD1L,chr1,F,147242640,147295766,36365243,53126,36365243,677,22
9563,H6PD,chr1,F,9234775,9271337,36401805,36562,36401805,678,6
9580,SOX13,chr1,F,204073108,204127743,36456440,54635,36456440,679,13
9588,PRDX6,chr1,F,173477346,173488807,36467901,11461,36467901,680,4
9629,CLCA3P,chr1,F,86634275,86655376,36489002,21101,36489002,681,14
9635,CLCA2,chr1,F,86424085,86456558,36521475,32473,36521475,682,14
9636,ISG15,chr1,F,1013466,1014540,36522549,1074,36522549,683,1
9641,IKBKE,chr1,F,206470242,206496890,36549197,26648,36549197,684,21
9651,PLCH2,chr1,F,2415781,2505530,36638946,89749,36638946,685,27
9653,HS2ST1,chr1,F,86914651,87109998,36834293,195347,36834293,686,6
9659,PDE4DIP,chr1,F,148808166,149033019,37059146,224853,37059146,687,53
9670,IPO13,chr1,F,43946805,43968022,37080363,21217,37080363,688,20
9672,SDC3,chr1,R,30869465,30909735,37120633,40270,37120633,689,9
9673,SLC25A44,chr1,F,156193931,156212796,37139498,18865,37139498,690,5
9674,KIAA0040,chr1,R,175156986,175193093,37175605,36107,37175605,691,4
9682,KDM4A,chr1,F,43650125,43705518,37230998,55393,37230998,692,24
9696,CROCC,chr1,F,16895706,16972979,37308271,77273,37308271,693,40
9698,PUM1,chr1,R,30931505,31065717,37442483,134212,37442483,694,21
9722,NOS1AP,chr1,F,162069790,162370023,37742716,300233,37742716,695,9
9725,TMEM63A,chr1,R,225840569,225882720,37784867,42151,37784867,696,27
9731,CEP104,chr1,R,3812080,3857387,37830174,45307,37830174,697,23
9783,RIMS3,chr1,R,40620679,40692084,37901579,71405,37901579,698,10
9804,TOMM20,chr1,R,235109340,235128941,37921180,19601,37921180,699,4
9813,EFCAB14,chr1,R,46675158,46719064,37965086,43906,37965086,700,10
9816,URB2,chr1,F,229626204,229660887,37999769,34683,37999769,701,9
9826,ARHGEF11,chr1,R,156934839,157046640,38111570,111801,38111570,702,47
9829,DNAJC6,chr1,F,65248147,65415869,38279292,167722,38279292,703,25
9857,CEP350,chr1,F,179954772,180114880,38439400,160108,38439400,704,39
9859,CEP170,chr1,R,243124427,243255406,38570379,130979,38570379,705,20
9860,LRIG2,chr1,F,113073169,113125202,38622412,52033,38622412,706,18
9869,SETDB1,chr1,F,150926338,150964901,38660975,38563,38660975,707,21
9877,ZC3H11A,chr1,F,203795536,203854128,38719567,58592,38719567,708,19
9887,SMG7,chr1,F,183472370,183554193,38801390,81823,38801390,709,27
9890,LPPR4,chr1,F,99262952,99309584,38848022,46632,38848022,710,7
9898,UBAP2L,chr1,F,154219950,154271510,38899582,51560,38899582,711,32
9900,SV2A,chr1,R,149903317,149917882,38914147,14565,38914147,712,12
9903,KLHL21,chr1,R,6590723,6602898,38926322,12175,38926322,713,4
9906,SLC35E2,chr1,R,1724837,1745999,38947484,21162,38947484,714,7
9909,DENND4B,chr1,R,153929500,153946681,38964665,17181,38964665,715,28
9910,RABGAP1L,chr1,F,174159413,174995308,39800560,835895,39800560,716,32
9911,TMCC2,chr1,F,205227909,205273343,39845994,45434,39845994,717,10
9917,FAM20B,chr1,F,179025808,179076567,39896753,50759,39896753,718,10
9923,ZBTB40,chr1,F,22428837,22531157,39999073,102320,39999073,719,20
9926,LPGAT1,chr1,R,211743456,211830832,40086449,87376,40086449,720,8
9927,MFN2,chr1,F,11980180,12013515,40119784,33335,40119784,721,19
9928,KIF14,chr1,R,200551496,200620791,40189079,69295,40189079,722,30
9939,RBM8A,chr1,R,145921555,145927536,40195060,5981,40195060,723,5
9967,THRAP3,chr1,F,36224415,36305357,40276002,80942,40276002,724,13
9970,NR1I3,chr1,R,161229665,161238598,40284935,8933,40284935,725,8
10000,AKT3,chr1,R,243488232,243851079,40647782,362847,40647782,726,22
10022,INSL5,chr1,R,66797740,66801259,40651301,3519,40651301,727,1
10026,PIGK,chr1,R,77088980,77219447,40781768,130467,40781768,728,10
10067,SCAMP3,chr1,R,155255978,155262434,40788224,6456,40788224,729,8
10076,PTPRU,chr1,F,29236515,29326813,40878522,90298,40878522,730,33
10092,ARPC5,chr1,R,183626192,183635941,40888271,9749,40888271,731,3
10100,TSPAN2,chr1,R,115048010,115089500,40929761,41490,40929761,732,7
10103,TSPAN1,chr1,F,46175076,46196489,40951174,21413,40951174,733,10
10136,CELA3A,chr1,F,22001655,22012542,40962061,10887,40962061,734,7
10158,PDZK1IP1,chr1,R,47183588,47190099,40968572,6511,40968572,735,3
10163,WASF2,chr1,R,27404225,27490187,41054534,85962,41054534,736,8
10207,INADL,chr1,F,61742476,62163920,41475978,421444,41475978,737,50
10216,PRG4,chr1,F,186296272,186314562,41494268,18290,41494268,738,12
10218,ANGPTL7,chr1,F,11189288,11195981,41500961,6693,41500961,739,4
10223,GPA33,chr1,R,167052835,167090631,41538757,37796,41538757,740,6
10228,STX6,chr1,R,180949689,181023121,41612189,73432,41612189,741,8
10236,HNRNPR,chr1,R,23304687,23344650,41652152,39963,41652152,742,10
10250,SRRM1,chr1,F,24643011,24673281,41682422,30270,41682422,743,19
10256,CNKSR1,chr1,F,26177489,26189884,41694817,12395,41694817,744,21
10262,SF3B4,chr1,R,149923316,149928252,41699753,4936,41699753,745,5
10269,ZMPSTE24,chr1,F,40258049,40294184,41735888,36135,41735888,746,11
10277,UBE4B,chr1,F,10032982,10181239,41884145,148257,41884145,747,30
10286,BCAS2,chr1,R,114567556,114581644,41898233,14088,41898233,748,6
10327,AKR1A1,chr1,F,45550782,45570051,41917502,19269,41917502,749,9
10352,WARS2,chr1,R,119031215,119140788,42027075,109573,42027075,750,7
10380,BPNT1,chr1,R,220057481,220089927,42059521,32446,42059521,751,10
10390,CEPT1,chr1,F,111139626,111185102,42104997,45476,42104997,752,12
10401,PIAS3,chr1,R,145848521,145859081,42115557,10560,42115557,753,13
10420,TESK2,chr1,R,45343882,45491342,42263017,147460,42263017,754,13
10440,TIMM17A,chr1,F,201955490,201970661,42278188,15171,42278188,755,5
10446,LRRN2,chr1,R,204617169,204685733,42346752,68564,42346752,756,4
10450,PPIE,chr1,F,39738844,39763914,42371822,25070,42371822,757,12
10451,VAV3,chr1,R,107571159,107964923,42765586,393764,42765586,758,31
10456,HAX1,chr1,F,154272562,154275875,42768899,3313,42768899,759,6
10459,MAD2L2,chr1,R,11674479,11691788,42786208,17309,42786208,760,10
10465,PPIH,chr1,F,42657769,42681654,42810093,23885,42810093,761,15
10472,ZBTB18,chr1,F,244048938,244057476,42818631,8538,42818631,762,3
10485,C1orf61,chr1,R,156404255,156434325,42848701,30070,42848701,763,14
10487,CAP1,chr1,F,40040239,40072649,42881111,32410,42881111,764,13
10489,LRRC41,chr1,R,46278399,46303366,42906078,24967,42906078,765,10
10500,SEMA6C,chr1,R,151131684,151146664,42921058,14980,42921058,766,19
10542,LAMTOR5,chr1,R,110401252,110407924,42927730,6672,42927730,767,3
10560,SLC19A2,chr1,R,169463908,169486079,42949901,22171,42949901,768,6
10561,IFI44,chr1,F,78648942,78664078,42965037,15136,42965037,769,10
10623,POLR3C,chr1,F,145824068,145844402,42985371,20334,42985371,770,16
10625,IVNS1ABP,chr1,R,185296387,185317343,43006327,20956,43006327,771,15
10628,TXNIP,chr1,R,145992434,145996631,43010524,4197,43010524,772,7
10630,PDPN,chr1,F,13583756,13617957,43044725,34201,43044725,773,7
10637,LEFTY1,chr1,R,225886281,225889146,43047590,2865,43047590,774,3
10638,SPHAR,chr1,F,229304381,229305504,43048713,1123,43048713,775,0
10654,PMVK,chr1,R,154924731,154937310,43061292,12579,43061292,776,5
10657,KHDRBS1,chr1,F,32013693,32060859,43108458,47166,43108458,777,10
10691,GMEB1,chr1,F,28668721,28715603,43155340,46882,43155340,778,10
10712,FAM189B,chr1,R,155247204,155255483,43163619,8279,43163619,779,11
10717,AP4B1,chr1,R,113894747,113905206,43174078,10459,43174078,780,12
10726,NUDC,chr1,F,26911127,26946871,43209822,35744,43209822,781,10
10745,PHTF1,chr1,R,113697201,113759892,43272513,62691,43272513,782,21
10747,MASP2,chr1,R,11026522,11047239,43293230,20717,43293230,783,11
10753,CAPN9,chr1,F,230747333,230802003,43347900,54670,43347900,784,21
10763,NES,chr1,R,156668762,156677397,43356535,8635,43356535,785,3
10765,KDM5B,chr1,R,202727402,202808468,43437601,81066,43437601,786,30
10768,AHCYL1,chr1,F,109984740,110023742,43476603,39002,43476603,787,19
10772,SRSF10,chr1,R,23964346,23980463,43492720,16117,43492720,788,6
10806,SDCCAG8,chr1,F,243255418,243500091,43737393,244673,43737393,789,24
10877,CFHR4,chr1,F,196888013,196918812,43768192,30799,43768192,790,13
10878,CFHR3,chr1,F,196774799,196794073,43787466,19274,43787466,791,6
10885,WDR3,chr1,F,117929748,117960426,43818144,30678,43818144,792,26
10896,OCLM,chr1,F,186400571,186401455,43819028,884,43819028,793,0
10899,JTB,chr1,R,153974268,153977975,43822735,3707,43822735,794,4
10903,MTMR11,chr1,R,149928649,149936898,43830984,8249,43830984,795,14
10905,MAN1A2,chr1,F,117367392,117528872,43992464,161480,43992464,796,13
10911,UTS2,chr1,R,7847611,7913610,44058463,65999,44058463,797,5
10946,SF3A3,chr1,R,37956974,37990490,44091979,33516,44091979,798,16
10962,MLLT11,chr1,F,151059674,151068497,44100802,8823,44100802,799,1
10964,IFI44L,chr1,F,78620381,78646145,44126566,25764,44126566,800,9
10969,EBNA1BP2,chr1,R,43164173,43172570,44134963,8397,44134963,801,8
11000,SLC27A3,chr1,F,153775291,153780157,44139829,4866,44139829,802,9
11004,KIF2C,chr1,F,44739711,44767767,44167885,28056,44167885,803,21
11009,IL24,chr1,F,206897097,206904139,44174927,7042,44174927,804,6
11022,TDRKH,chr1,R,151770263,151790534,44195198,20271,44195198,805,14
11079,RER1,chr1,F,2391313,2405444,44209329,14131,44209329,806,10
11080,DNAJB4,chr1,F,77979216,78018721,44248834,39505,44248834,807,3
11085,ADAM30,chr1,R,119893532,119896524,44251826,2992,44251826,808,0
11123,RCAN3,chr1,F,24502350,24537020,44286496,34670,44286496,809,6
11124,FAF1,chr1,R,50441262,50960264,44805498,519002,44805498,810,18
11126,CD160,chr1,F,145719432,145739288,44825354,19856,44825354,811,5
11146,GLMN,chr1,R,92246397,92441946,45020903,195549,45020903,812,23
11147,HHLA3,chr1,F,70354796,70368023,45034130,13227,45034130,813,4
11189,CELF3,chr1,R,151700051,151716821,45050900,16770,45050900,814,14
11209,MST1P2,chr1,F,16645573,16650420,45055747,4847,45055747,815,13
11218,DDX20,chr1,F,111755567,111767577,45067757,12010,45067757,816,10
11221,DUSP10,chr1,R,221701419,221742176,45108514,40757,45108514,817,6
11223,MST1L,chr1,R,16754633,16764480,45118361,9847,45118361,818,14
11240,PADI2,chr1,R,17066760,17119453,45171054,52693,45171054,819,15
11243,PMF1,chr1,F,156212987,156240077,45198144,27090,45198144,820,5
11266,DUSP12,chr1,F,161749767,161757164,45205541,7397,45205541,821,5
11311,VPS45,chr1,F,150067292,150145327,45283576,78035,45283576,822,17
11313,LYPLA2,chr1,F,23790784,23795539,45288331,4755,45288331,823,9
11315,PARK7,chr1,F,7961653,7985283,45311961,23630,45311961,824,7
11330,CTRC,chr1,F,15438441,15449247,45322767,10806,45322767,825,7
11332,ACOT7,chr1,R,6264271,6393766,45452262,129495,45452262,826,11
22796,COG2,chr1,F,230642455,230693985,45503792,51530,45503792,827,17
22802,CLCA4,chr1,F,86547075,86580758,45537475,33683,45537475,828,14
22823,MTF2,chr1,F,93079234,93139081,45597322,59847,45597322,829,15
22826,DNAJC8,chr1,R,28200277,28233031,45630076,32754,45630076,830,8
22854,NTNG1,chr1,F,107139917,107484899,45975058,344982,45975058,831,10
22874,PLEKHA6,chr1,R,204218850,204377763,46133971,158913,46133971,832,38
22883,CLSTN1,chr1,R,9729020,9824526,46229477,95506,46229477,833,18
22887,FOXJ3,chr1,R,42176538,42335877,46388816,159339,46388816,834,17
22889,KIAA0907,chr1,R,155913042,155934442,46410216,21400,46410216,835,13
22911,WDR47,chr1,R,108970210,109042228,46482234,72018,46482234,836,15
22920,KIFAP3,chr1,R,169921328,170074741,46635647,153413,46635647,837,23
22926,ATF6,chr1,F,161766243,161964070,46833474,197827,46833474,838,16
22955,SCMH1,chr1,R,41027198,41242159,47048435,214961,47048435,839,22
22977,AKR7A3,chr1,R,19274324,19289346,47063457,15022,47063457,840,7
22996,TTC39A,chr1,R,51287257,51345116,47121316,57859,47121316,841,24
23013,SPEN,chr1,F,15847863,15940455,47213908,92592,47213908,842,14
23028,KDM1A,chr1,F,23019442,23083691,47278157,64249,47278157,843,21
23029,RBM34,chr1,R,235131182,235161616,47308591,30434,47308591,844,11
23032,USP33,chr1,R,77695986,77759879,47372484,63893,47372484,845,25
23038,WDTC1,chr1,F,27234515,27308633,47446602,74118,47446602,846,17
23046,KIF21B,chr1,R,200969385,201023700,47500917,54315,47500917,847,35
23057,NMNAT2,chr1,R,183248236,183418499,47671180,170263,47671180,848,11
23065,EMC1,chr1,R,19215663,19251559,47707076,35896,47707076,849,23
23095,KIF1B,chr1,F,10210705,10381603,47877974,170898,47877974,850,47
23114,NFASC,chr1,F,204828653,205022822,48072143,194169,48072143,851,34
23126,POGZ,chr1,R,151402723,151459465,48128885,56742,48128885,852,23
23127,COLGALT2,chr1,R,183929661,184051611,48250835,121950,48250835,853,16
23139,MAST2,chr1,F,45786991,46036124,48499968,249133,48499968,854,36
23154,NCDN,chr1,F,35557791,35566779,48508956,8988,48508956,855,6
23155,CLCC1,chr1,R,108929507,108963499,48542948,33992,48542948,856,11
23169,SLC35D1,chr1,R,66999331,67054397,48598014,55066,48598014,857,12
23179,RGL1,chr1,F,183636046,183928551,48890519,292505,48890519,858,22
23207,PLEKHM2,chr1,F,15684266,15734769,48941022,50503,48941022,859,20
23208,SYT11,chr1,F,155859468,155885199,48966753,25731,48966753,860,3
23215,PRRC2C,chr1,F,171485512,171593511,49074752,107999,49074752,861,35
23219,FBXO28,chr1,F,224114086,224162047,49122713,47961,49122713,862,4
23248,RPRD2,chr1,F,150364110,150476566,49235169,112456,49235169,863,10
23252,OTUD3,chr1,F,19881701,19912945,49266413,31244,49266413,864,9
23254,KAZN,chr1,F,13893514,15118048,50490947,1224534,50490947,865,21
23261,CAMTA1,chr1,F,6785323,7769706,51475330,984383,51475330,866,28
23266,ADGRL2,chr1,F,81306198,81992738,52161870,686540,52161870,867,36
23271,CAMSAP2,chr1,F,200739557,200860707,52283020,121150,52283020,868,17
23285,KIAA1107,chr1,F,92167051,92184723,52300692,17672,52300692,869,8
23318,ZCCHC11,chr1,R,52423274,52553463,52430881,130189,52430881,870,34
23334,SZT2,chr1,F,43384829,43454247,52500299,69418,52500299,871,75
23341,DNAJC16,chr1,F,15526812,15571733,52545220,44921,52545220,872,14
23352,UBR4,chr1,R,19074505,19210319,52681034,135814,52681034,873,107
23358,USP24,chr1,R,55066358,55215368,52830044,149010,52830044,874,71
23380,SRGAP2,chr1,F,206203463,206464443,53091024,260980,53091024,875,26
23381,SMG5,chr1,R,156249223,156282885,53124686,33662,53124686,876,23
23385,NCSTN,chr1,F,160343272,160358952,53140366,15680,53140366,877,19
23400,ATP13A2,chr1,R,16985957,17011972,53166381,26015,53166381,878,28
23418,CRB1,chr1,F,197201461,197478455,53443375,276994,53443375,879,16
23421,ITGB3BP,chr1,R,63440769,63529159,53531765,88390,53531765,880,13
23432,GPR161,chr1,R,168079541,168137667,53589891,58126,53589891,881,12
23435,TARDBP,chr1,F,11012621,11025492,53602762,12871,53602762,882,5
23436,CELA3B,chr1,F,21976924,21998642,53624480,21718,53624480,883,10
23443,SLC35A3,chr1,F,99968886,100026979,53682573,58093,53682573,884,10
23456,ABCB10,chr1,R,229516581,229558695,53724687,42114,53724687,885,13
23463,ICMT,chr1,R,6221192,6235984,53739479,14792,53739479,886,5
23499,MACF1,chr1,F,39081416,39487138,54145201,405722,54145201,887,108
23507,LRRC8B,chr1,F,89524143,89601539,54222597,77396,54222597,888,11
23528,ZNF281,chr1,R,200404946,200410058,54227709,5112,54227709,889,1
23557,SNAPIN,chr1,F,153658653,153661852,54230908,3199,54230908,890,3
23566,LPAR3,chr1,R,84811601,84893213,54312520,81612,54312520,891,3
23569,PADI4,chr1,F,17308194,17364004,54368330,55810,54368330,892,17
23576,DDAH1,chr1,R,85318484,85578363,54628209,259879,54628209,893,10
23585,TMEM50A,chr1,F,25338297,25362361,54652273,24064,54652273,894,7
23596,OPN3,chr1,R,241593149,241640399,54699523,47250,54699523,895,3
23612,PHLDA3,chr1,R,201465478,201469171,54703216,3693,54703216,896,2
23623,RUSC1,chr1,F,155320848,155331118,54713486,10270,54713486,897,9
23632,CA14,chr1,F,150257158,150265078,54721406,7920,54721406,898,10
23633,KPNA6,chr1,F,32108042,32176568,54789932,68526,54789932,899,15
23648,SSBP3,chr1,R,54225430,54413485,54977987,188055,54977987,900,19
23673,STX12,chr1,F,27773182,27824452,55029257,51270,55029257,901,8
25778,DSTYK,chr1,R,205142502,205211599,55098354,69097,55098354,902,13
25782,RAB3GAP2,chr1,R,220148267,220272501,55222588,124234,55222588,903,34
25790,CFAP45,chr1,R,159872363,159900116,55250341,27753,55250341,904,11
25802,LMOD1,chr1,R,201896455,201946588,55300474,50133,55300474,905,2
25832,NBPF14,chr1,R,148531384,148595947,55365037,64563,55365037,906,66
25874,MPC2,chr1,R,167916674,167937069,55385432,20395,55385432,907,6
25893,TRIM58,chr1,F,247857198,247880138,55408372,22940,55408372,908,5
25896,INTS7,chr1,R,211940398,212035677,55503651,95279,55503651,909,21
25903,OLFML2B,chr1,R,161983191,162024465,55544925,41274,55544925,910,8
25909,AHCTF1,chr1,R,246839097,246931978,55637806,92881,55637806,911,38
25912,C1orf43,chr1,R,154206700,154220797,55651903,14097,55651903,912,6
25932,CLIC4,chr1,F,24745268,24844324,55750959,99056,55750959,913,6
25936,NSL1,chr1,R,212726152,212791797,55816604,65645,55816604,914,6
25949,SYF2,chr1,R,25222275,25232522,55826851,10247,55826851,915,6
25950,RWDD3,chr1,F,95234154,95247225,55839922,13071,55839922,916,4
25973,PARS2,chr1,R,54755518,54764553,55848957,9035,55848957,917,2
25974,MMACHC,chr1,F,45500183,45511067,55859841,10884,55859841,918,3
26009,ZZZ3,chr1,R,77561520,77683426,55981747,121906,55981747,919,16
26027,ACOT11,chr1,F,54548133,54634744,56068358,86611,56068358,920,17
26038,CHD5,chr1,R,6101786,6180134,56146706,78348,56146706,921,41
26052,DNM3,chr1,F,171841477,172418466,56723695,576989,56723695,922,27
26092,TOR1AIP1,chr1,F,179882041,179920077,56761731,38036,56761731,923,10
26097,CHTOP,chr1,F,153633981,153646306,56774056,12325,56774056,924,6
26099,SZRD1,chr1,F,16367029,16398148,56805175,31119,56805175,925,4
26119,LDLRAP1,chr1,F,25543579,25591287,56852883,47708,56852883,926,13
26135,SERBP1,chr1,R,67407809,67430440,56875514,22631,56875514,927,7
26155,NOC2L,chr1,R,944202,959299,56890611,15097,56890611,928,18
26188,OR1C1,chr1,R,247757461,247758406,56891556,945,56891556,929,0
26191,PTPN22,chr1,R,113813810,113871757,56949503,57947,56949503,930,21
26227,PHGDH,chr1,F,119711736,119744226,56981993,32490,56981993,931,16
26232,FBXO2,chr1,R,11648360,11654831,56988464,6471,56988464,932,5
26239,LCE2B,chr1,F,152686122,152687401,56989743,1279,56989743,933,1
26245,OR2M4,chr1,F,248238928,248239864,56990679,936,56990679,934,0
26246,OR2L2,chr1,F,248035509,248039332,56994502,3823,56994502,935,1
26247,OR2L1P,chr1,F,247990266,247991191,56995427,925,56995427,936,0
26254,OPTC,chr1,F,203494142,203508949,57010234,14807,57010234,937,7
26270,FBXO6,chr1,F,11664092,11674354,57020496,10262,57020496,938,10
26279,PLA2G2D,chr1,R,20112649,20119566,57027413,6917,57027413,939,3
26289,AK5,chr1,F,77281976,77559969,57305406,277993,57305406,940,14
26292,MYCBP,chr1,R,38862489,38873378,57316295,10889,57316295,941,4
26476,OR10J1,chr1,F,159397493,159440967,57359769,43474,57359769,942,4
26508,HEYL,chr1,R,39623430,39639676,57376015,16246,57376015,943,5
26523,AGO1,chr1,F,35869790,35924298,57430523,54508,57430523,944,19
26696,OR2T1,chr1,F,248405994,248407104,57431633,1110,57431633,945,0
26750,RPS6KC1,chr1,F,213051232,213273465,57653866,222233,57653866,946,17
26768,SNORA73B,chr1,F,28508557,28508715,57654024,158,57654024,947,0
26769,SNORD81,chr1,R,173864174,173864217,57654067,43,57654067,948,0
26770,SNORD79,chr1,R,173865349,173865430,57654148,81,57654148,949,0
26774,SNORD80,chr1,R,173864832,173864903,57654219,71,57654219,950,0
26782,SNORA66,chr1,F,92840718,92840851,57654352,133,57654352,951,0
26802,SNORD47,chr1,R,173864368,173864445,57654429,77,57654429,952,0
26804,SNORD45B,chr1,F,75789476,75789547,57654500,71,57654500,953,0
26805,SNORD45A,chr1,F,75787888,75787972,57654584,84,57654584,954,0
26806,SNORD44,chr1,R,173865967,173866028,57654645,61,57654645,955,0
26811,SNORD55,chr1,F,44775864,44775938,57654719,74,57654719,956,0
26824,RNU11,chr1,F,28648599,28648734,57654854,135,57654854,957,0
26828,RNU5F-1,chr1,R,44721785,44721901,57654970,116,57654970,958,0
26829,RNU5E-1,chr1,F,11908153,11908272,57655089,119,57655089,959,0
26830,RNU5D-1,chr1,R,44731068,44731168,57655189,100,57655189,960,0
26860,RNU1-13P,chr1,R,148388489,148388651,57655351,162,57655351,961,0
26863,RNVU1-18,chr1,R,143729406,143729570,57655515,164,57655515,962,0
26864,RNVU1-7,chr1,R,148038752,148038916,57655679,164,57655679,963,0
26869,RNU1-3,chr1,R,16666784,16666948,57655843,164,57655843,964,0
26870,RNU1-2,chr1,F,16895979,16896143,57656007,164,57656007,965,0
26871,RNU1-1,chr1,R,16514121,16514285,57656171,164,57656171,966,0
26994,RNF11,chr1,F,51236272,51273447,57693346,37175,57693346,967,2
27005,USP21,chr1,F,161159463,161165726,57699609,6263,57699609,968,13
27022,FOXD3,chr1,F,63323058,63325126,57701677,2068,57701677,969,0
27042,DIEXF,chr1,F,209827966,209857565,57731276,29599,57731276,970,11
27095,TRAPPC3,chr1,R,36136568,36156053,57750761,19485,57750761,971,5
27097,TAF5L,chr1,R,229593110,229626047,57783698,32937,57783698,972,8
27101,CACYBP,chr1,F,174999434,175012027,57796291,12593,57796291,973,6
27129,HSPB7,chr1,R,16014027,16018796,57801060,4769,57801060,974,2
27159,CHIA,chr1,F,111290851,111320566,57830775,29715,57830775,975,12
27173,SLC39A1,chr1,R,153959098,153968184,57839861,9086,57839861,976,6
27184,DISC2,chr1,R,231814625,231818517,57843753,3892,57843753,977,0
27185,DISC1,chr1,F,231626814,232041272,58258211,414458,58258211,978,18
27237,ARHGEF16,chr1,F,3454582,3481115,58284744,26533,58284744,979,17
27245,AHDC1,chr1,R,27534244,27604178,58354678,69934,58354678,980,11
27246,RNF115,chr1,R,145746081,145824123,58432720,78042,58432720,981,9
27252,KLHL20,chr1,F,173714911,173786822,58504631,71911,58504631,982,12
27285,TEKT2,chr1,F,36084074,36088276,58508833,4202,58508833,983,9
27293,SMPDL3B,chr1,F,27934947,27959157,58533043,24210,58533043,984,9
27329,ANGPTL3,chr1,F,62597486,62606305,58541862,8819,58541862,985,6
28956,LAMTOR2,chr1,F,156054725,156058510,58545647,3785,58545647,986,3
28982,FLVCR1,chr1,F,212858254,212899363,58586756,41109,58586756,987,11
29089,UBE2T,chr1,R,202331656,202341966,58597066,10310,58597066,988,6
29092,LINC00339,chr1,F,22025190,22031224,58603100,6034,58603100,989,3
29097,CNIH4,chr1,F,224356810,224379452,58625742,22642,58625742,990,7
29101,SSU72,chr1,R,1541672,1574882,58658952,33210,58658952,991,4
29765,TMOD4,chr1,R,151169985,151176304,58665271,6319,58665271,992,9
29889,GNL2,chr1,R,37566811,37595985,58694445,29174,58694445,993,16
29899,GPSM2,chr1,F,108875349,108930422,58749518,55073,58749518,994,17
29914,UBIAD1,chr1,F,11273197,11296595,58772916,23398,58772916,995,3
29920,PYCR2,chr1,R,225919876,225924340,58777380,4464,58777380,996,6
29922,NME7,chr1,R,169131997,169367963,59013346,235966,59013346,997,12
29929,ALG6,chr1,F,63367589,63438562,59084319,70973,59084319,998,14
29937,NENF,chr1,F,212432886,212446379,59097812,13493,59097812,999,3
29943,PADI1,chr1,F,17205122,17246006,59138696,40884,59138696,1000,17
29949,IL19,chr1,F,206798869,206842981,59182808,44112,59182808,1001,7
29956,CERS2,chr1,R,150965172,150975003,59192639,9831,59192639,1002,12
29957,SLC25A24,chr1,R,108134721,108200358,59258276,65637,59258276,1003,10
30814,PLA2G2E,chr1,R,19920306,19923617,59261587,3311,59261587,1004,3
30836,DNTTIP2,chr1,R,93869457,93879206,59271336,9749,59271336,1005,6
49856,WRAP73,chr1,R,3630766,3650107,59290677,19341,59290677,1006,12
49860,CRNN,chr1,R,152409242,152414274,59295709,5032,59295709,1007,2
50486,G0S2,chr1,F,209675324,209676390,59296775,1066,59296775,1008,1
50604,IL20,chr1,F,206865353,206869223,59300645,3870,59300645,1009,5
50651,SLC45A1,chr1,F,8318084,8344167,59326728,26083,59326728,1010,8
50717,DCAF8,chr1,R,160215714,160262560,59373574,46846,59373574,1011,13
50809,HP1BP3,chr1,R,20742676,20787310,59418208,44634,59418208,1012,13
50848,F11R,chr1,R,160995210,161021343,59444341,26133,59444341,1013,9
50999,TMED5,chr1,R,93149741,93180689,59475289,30948,59475289,1014,5
51018,RRP15,chr1,F,218285284,218337983,59527988,52699,59527988,1015,5
51022,GLRX2,chr1,R,193096464,193106549,59538073,10085,59538073,1016,5
51027,BOLA1,chr1,F,149899601,149900795,59539267,1194,59539267,1017,1
51029,DESI2,chr1,F,244653047,244709034,59595254,55987,59595254,1018,9
51032,CELA2B,chr1,F,15476100,15491400,59610554,15300,59610554,1019,7
51042,ZNF593,chr1,F,26169896,26170873,59611531,977,59611531,1020,2
51043,ZBTB7B,chr1,F,155002626,155018525,59627430,15899,59627430,1021,6
51058,ZNF691,chr1,F,42846572,42852477,59633335,5905,59633335,1022,4
51060,TXNDC12,chr1,R,52020130,52056171,59669376,36041,59669376,1023,7
51086,TNNI3K,chr1,F,74235386,74544432,59978422,309046,59978422,1024,24
51093,RRNAD1,chr1,F,156728470,156736960,59986912,8490,59986912,1025,7
51094,ADIPOR1,chr1,R,202940824,202958572,60004660,17748,60004660,1026,10
51097,SCCPDH,chr1,F,246724075,246768137,60048722,44062,60048722,1027,11
51100,SH3GLB1,chr1,F,86704569,86748184,60092337,43615,60092337,1028,10
51102,MECR,chr1,R,29167695,29230958,60155600,63263,60155600,1029,18
51107,APH1A,chr1,R,150265398,150269209,60159411,3811,60159411,1030,5
51118,UTP11L,chr1,F,38012711,38024825,60171525,12114,60171525,1031,7
51127,TRIM17,chr1,R,228407934,228416882,60180473,8948,60180473,1032,6
51133,KCTD3,chr1,F,215567184,215621807,60235096,54623,60235096,1033,17
51150,SDF4,chr1,R,1216907,1232067,60250256,15160,60250256,1034,7
51154,MRTO4,chr1,F,19251580,19260128,60258804,8548,60258804,1035,7
51177,PLEKHO1,chr1,F,150149433,150160065,60269436,10632,60269436,1036,6
51179,HAO2,chr1,F,119368775,119394130,60294791,25355,60294791,1037,9
51205,ACP6,chr1,R,147629285,147670512,60336018,41227,60336018,1038,11
51249,TMEM69,chr1,F,45688174,45694436,60342280,6262,60342280,1039,2
51253,MRPL37,chr1,F,54200166,54226682,60368796,26516,60368796,1040,7
51278,IER5,chr1,F,181088501,181090843,60371138,2342,60371138,1041,0
51361,HOOK1,chr1,F,59814860,59876378,60432656,61518,60432656,1042,22
51375,SNX7,chr1,F,98661661,98760500,60531495,98839,60531495,1043,10
51377,UCHL5,chr1,R,193012365,193060107,60579237,47742,60579237,1044,15
51430,SUCO,chr1,F,172532348,172611833,60658722,79485,60658722,1045,25
51440,HPCAL4,chr1,R,39678647,39691710,60671785,13063,60671785,1046,4
51441,YTHDF2,chr1,F,28736620,28769775,60704940,33155,60704940,1047,4
51463,GPR89B,chr1,F,147928392,147993521,60770069,65129,60770069,1048,17
51478,HSD17B7,chr1,F,162790701,162812818,60792186,22117,60792186,1049,9
51506,UFC1,chr1,F,161153743,161158856,60797299,5113,60797299,1050,5
51514,DTL,chr1,F,212035552,212105006,60866753,69454,60866753,1051,15
51538,ZCCHC17,chr1,F,31296981,31365722,60935494,68741,60935494,1052,8
51592,TRIM33,chr1,R,114392776,114511160,61053878,118384,61053878,1053,20
51603,METTL13,chr1,F,171781620,171797716,61069974,16096,61069974,1054,7
51611,DPH5,chr1,R,100989622,101025806,61106158,36184,61106158,1055,7
51668,HSPB11,chr1,R,53921560,53946303,61130901,24743,61130901,1056,6
51686,OAZ3,chr1,F,151762968,151771330,61139263,8362,61139263,1057,6
51702,PADI3,chr1,F,17249081,17284233,61174415,35152,61174415,1058,17
51706,CYB5R1,chr1,R,202961872,202967276,61179819,5404,61179819,1059,8
51727,CMPK1,chr1,F,47333796,47378839,61224862,45043,61224862,1060,6
51742,ARID4B,chr1,R,235166894,235328298,61386266,161404,61386266,1061,27
51744,CD244,chr1,R,160830157,160862902,61419011,32745,61419011,1062,9
54112,GPR88,chr1,F,100538171,100542027,61422867,3856,61422867,1063,1
54206,ERRFI1,chr1,R,8011718,8026333,61437482,14615,61437482,1064,4
54344,DPM3,chr1,R,155139890,155140520,61438112,630,61438112,1065,1
54361,WNT4,chr1,R,22117304,22143981,61464789,26677,61464789,1066,7
54432,YIPF1,chr1,R,53849789,53889820,61504820,40031,61504820,1067,13
54455,FBXO42,chr1,R,16246839,16352491,61610472,105652,61610472,1068,10
54460,MRPS21,chr1,F,150293841,150308979,61625610,15138,61625610,1069,1
54482,TRMT13,chr1,F,100133146,100150498,61642962,17352,61642962,1070,10
54499,TMCO1,chr1,R,165724290,165768922,61687594,44632,61687594,1071,6
54507,ADAMTSL4,chr1,F,150549368,150560937,61699163,11569,61699163,1072,21
54544,CRCT1,chr1,F,152514501,152516010,61700672,1509,61700672,1073,1
54546,RNF186,chr1,R,19814028,19815278,61701922,1250,61701922,1074,0
54558,SPATA6,chr1,R,48260552,48472208,61913578,211656,61913578,1075,17
54583,EGLN1,chr1,R,231363750,231425044,61974872,61294,61974872,1076,4
54587,MXRA8,chr1,R,1352688,1363541,61985725,10853,61985725,1077,11
54596,L1TD1,chr1,F,62194801,62212328,62003252,17527,62003252,1078,4
54626,HES2,chr1,R,6415231,6424664,62012685,9433,62012685,1079,5
54627,MAP10,chr1,F,232804891,232810346,62018140,5455,62018140,1080,0
54665,RSBN1,chr1,R,113761831,113812476,62068785,50645,62068785,1081,7
54680,ZNHIT6,chr1,R,85649422,85708463,62127826,59041,62127826,1082,12
54707,GPN2,chr1,R,26879381,26890378,62138823,10997,62138823,1083,4
54741,LEPROT,chr1,F,65420447,65436007,62154383,15560,62154383,1084,5
54751,FBLIM1,chr1,F,15756170,15786589,62184802,30419,62184802,1085,12
54797,MED18,chr1,F,28329001,28335967,62191768,6966,62191768,1086,3
54802,TRIT1,chr1,R,39841030,39883511,62234249,42481,62234249,1087,11
54810,GIPC2,chr1,F,78024369,78138449,62348329,114080,62348329,1088,7
54823,SWT1,chr1,F,185157022,185291781,62483088,134759,62483088,1089,20
54834,GDAP2,chr1,R,117863484,117929679,62549283,66195,62549283,1090,15
54855,FAM46C,chr1,F,117605981,117628389,62571691,22408,62571691,1091,1
54856,GON4L,chr1,R,155749657,155859400,62681434,109743,62681434,1092,34
54865,GPATCH4,chr1,R,156594307,156601496,62688623,7189,62688623,1093,7
54873,PALMD,chr1,F,99645874,99694541,62737290,48667,62737290,1094,7
54874,FNBP1L,chr1,F,93448075,93570905,62860120,122830,62860120,1095,18
54879,ST7L,chr1,R,112517803,112620838,62963155,103035,62963155,1096,21
54896,PQLC2,chr1,F,19312245,19332431,62983341,20186,62983341,1097,8
54897,CASZ1,chr1,R,10636603,10796676,63143414,160073,63143414,1098,22
54900,LAX1,chr1,F,203765145,203776372,63154641,11227,63154641,1099,5
54933,RHBDL2,chr1,R,38885805,38941830,63210666,56025,63210666,1100,8
54935,DUSP23,chr1,F,159780939,159782543,63212270,1604,63212270,1101,2
54936,ADPRHL2,chr1,F,36088851,36093932,63217351,5081,63217351,1102,5
54952,TRNAU1AP,chr1,F,28553016,28578545,63242880,25529,63242880,1103,9
54953,C1orf27,chr1,F,186375757,186421375,63288498,45618,63288498,1104,14
54955,C1orf109,chr1,R,37681569,37692336,63299265,10767,63299265,1105,6
54964,C1orf56,chr1,F,151047782,151051420,63302903,3638,63302903,1106,1
54973,CPSF3L,chr1,R,1311584,1324687,63316006,13103,63316006,1107,18
54987,C1orf123,chr1,R,53214098,53220639,63322547,6541,63322547,1108,7
54991,C1orf159,chr1,R,1081817,1116356,63357086,34539,63357086,1109,16
54996,MARC2,chr1,F,220747501,220784815,63394400,37314,63394400,1110,10
54998,AURKAIP1,chr1,R,1373729,1375438,63396109,1709,63396109,1111,3
55001,TTC22,chr1,R,54779711,54801717,63418115,22006,63418115,1112,7
55052,MRPL20,chr1,R,1401895,1407834,63424054,5939,63424054,1113,3
55057,AIM1L,chr1,R,26321858,26354130,63456326,32272,63456326,1114,21
55061,SUSD4,chr1,R,223220818,223364202,63599710,143384,63599710,1115,12
55083,KIF26B,chr1,F,245154984,245709432,64154158,554448,64154158,1116,18
55092,TMEM51,chr1,F,15152531,15220478,64222105,67947,64222105,1117,6
55103,RALGPS2,chr1,F,178725146,178921842,64418801,196696,64418801,1118,20
55105,GPATCH2,chr1,R,217426991,217631102,64622912,204111,64622912,1119,14
55108,BSDC1,chr1,R,32364632,32394461,64652741,29829,64652741,1120,10
55113,XKR8,chr1,F,27959461,27968096,64661376,8635,64661376,1121,4
55116,TMEM39B,chr1,F,32072030,32102866,64692212,30836,64692212,1122,14
55119,PRPF38B,chr1,F,108692291,108701803,64701724,9512,64701724,1123,7
55127,HEATR1,chr1,R,236536172,236604541,64770093,68369,64770093,1124,45
55143,CDCA8,chr1,F,37692400,37709719,64787412,17319,64787412,1125,9
55144,LRRC8D,chr1,F,89821013,89936432,64902831,115419,64902831,1126,5
55154,MSTO1,chr1,F,155610169,155614967,64907629,4798,64907629,1127,11
55157,DARS2,chr1,F,173824644,173858544,64941529,33900,64941529,1128,17
55160,ARHGEF10L,chr1,F,17520196,17697875,65119208,177679,65119208,1129,33
55170,PRMT6,chr1,F,107056644,107059294,65121858,2650,65121858,1130,0
55182,RNF220,chr1,F,44404782,44651724,65368800,246942,65368800,1131,21
55187,VPS13D,chr1,F,12230038,12512047,65650809,282009,65650809,1132,69
55194,EVA1B,chr1,R,36322029,36324154,65652934,2125,65652934,1133,3
55204,GOLPH3L,chr1,R,150646224,150697956,65704666,51732,65704666,1134,6
55210,ATAD3A,chr1,F,1512142,1534687,65727211,22545,65727211,1135,16
55219,TMEM57,chr1,F,25430857,25500209,65796563,69352,65796563,1136,10
55220,KLHDC8A,chr1,R,205336064,205357090,65817589,21026,65817589,1137,7
55223,TRIM62,chr1,R,33145398,33182070,65854261,36672,65854261,1138,5
55224,ETNK2,chr1,R,204131060,204152182,65875383,21122,65875383,1139,8
55225,RAVER2,chr1,F,64744963,64833232,65963652,88269,65963652,1140,12
55229,PANK4,chr1,R,2508530,2526628,65981750,18098,65981750,1141,19
55243,KIRREL,chr1,F,157993272,158100262,66088740,106990,66088740,1142,15
55248,TMEM206,chr1,R,212364473,212415508,66139775,51035,66139775,1143,8
55249,YY1AP1,chr1,R,155659441,155689032,66169366,29591,66169366,1144,13
55268,ECHDC2,chr1,R,52895909,52927212,66200669,31303,66200669,1145,14
55277,FGGY,chr1,F,59296404,59762730,66666995,466326,66666995,1146,25
55283,MCOLN3,chr1,R,85018081,85048902,66697816,30821,66697816,1147,15
55356,SLC22A15,chr1,F,115976497,116070054,66791373,93557,66791373,1148,18
55432,YOD1,chr1,R,207043848,207053133,66800658,9285,66800658,1149,4
55450,CAMK2N1,chr1,R,20482390,20486235,66804503,3845,66804503,1150,1
55509,BATF3,chr1,R,212686416,212699985,66818072,13569,66818072,1151,3
55532,SLC30A10,chr1,R,219913918,219959315,66863469,45397,66863469,1152,4
55585,UBE2Q1,chr1,R,154548574,154558644,66873539,10070,66873539,1153,12
55599,RNPC3,chr1,F,103525955,103555239,66902823,29284,66902823,1154,14
55600,ITLN1,chr1,R,160876539,160885170,66911454,8631,66911454,1155,7
55616,ASAP3,chr1,R,23428562,23484567,66967459,56005,66967459,1156,26
55624,POMGNT1,chr1,R,46188680,46220305,66999084,31625,66999084,1157,23
55629,PNRC2,chr1,F,23959810,23963462,67002736,3652,67002736,1158,2
55631,LRRC40,chr1,R,70144801,70205678,67063613,60877,67063613,1159,15
55635,DEPDC1,chr1,R,68474151,68497221,67086683,23070,67086683,1160,11
55650,PIGV,chr1,F,26787962,26798403,67097124,10441,67097124,1161,3
55657,ZNF692,chr1,R,248850003,248860798,67107919,10795,67107919,1162,11
55672,NBPF1,chr1,R,16562426,16613605,67159098,51179,67159098,1163,27
55699,IARS2,chr1,F,220094112,220148041,67213027,53929,67213027,1164,22
55700,MAP7D1,chr1,F,36155964,36180849,67237912,24885,67237912,1165,17
55705,IPO9,chr1,F,201829159,201884294,67293047,55135,67293047,1166,24
55706,NDC1,chr1,R,53765459,53838552,67366140,73093,67366140,1167,18
55707,NECAP2,chr1,F,16440671,16460090,67385559,19419,67385559,1168,8
55721,IQCC,chr1,F,32205634,32208687,67388612,3053,67388612,1169,4
55732,C1orf112,chr1,F,169795004,169853088,67446696,58084,67446696,1170,25
55733,HHAT,chr1,F,210328251,210676298,67794743,348047,67794743,1171,15
55735,DNAJC11,chr1,R,6634167,6701906,67862482,67739,67862482,1172,15
55740,ENAH,chr1,R,225486831,225661676,68037327,174845,68037327,1173,20
55746,NUP133,chr1,R,229441296,229508341,68104372,67045,68104372,1174,25
55758,RCOR3,chr1,F,211259365,211316385,68161392,57020,68161392,1175,17
55765,C1orf106,chr1,F,200891073,200915736,68186055,24663,68186055,1176,11
55791,LRIF1,chr1,R,110947189,110964197,68203063,17008,68203063,1177,3
55793,FAM63A,chr1,R,150996824,151008378,68214617,11554,68214617,1178,11
55811,ADCY10,chr1,R,167809079,167915526,68321064,106447,68321064,1179,35
55827,DCAF6,chr1,F,167936558,168075843,68460349,139285,68460349,1180,22
55870,ASH1L,chr1,R,155335260,155562850,68687939,227590,68687939,1181,29
55891,LENEP,chr1,F,154993585,154994315,68688669,730,68688669,1182,1
55917,CTTNBP2NL,chr1,F,112396177,112461164,68753656,64987,68753656,1183,6
55920,RCC2,chr1,R,17406754,17439754,68786656,33000,68786656,1184,12
55924,FAM212B,chr1,R,111722062,111755797,68820391,33735,68820391,1185,3
55929,DMAP1,chr1,F,44213431,44220679,68827639,7248,68827639,1186,10
55966,AJAP1,chr1,F,4655044,4792534,68965129,137490,68965129,1187,8
55970,GNG12,chr1,R,67701465,67833779,69097443,132314,69097443,1188,5
55974,SLC50A1,chr1,F,155135343,155138858,69100958,3515,69100958,1189,6
56063,TMEM234,chr1,R,32204805,32222353,69118506,17548,69118506,1190,7
56181,MTFR1L,chr1,F,25819905,25832942,69131543,13037,69131543,1191,8
56256,SERTAD4,chr1,F,210232849,210246858,69145552,14009,69145552,1192,4
56267,CCBL2,chr1,R,88935772,88992960,69202740,57188,69202740,1193,13
56605,ERO1LB,chr1,R,236215121,236282039,69269658,66918,69269658,1194,15
56776,FMN2,chr1,F,240091884,240475189,69652963,383305,69652963,1195,20
56833,SLAMF8,chr1,F,159826649,159837497,69663811,10848,69663811,1196,5
56882,CDC42SE1,chr1,R,151050970,151059649,69672490,8679,69672490,1197,5
56893,UBQLN4,chr1,R,156033134,156053825,69693181,20691,69693181,1198,12
56900,TMEM167B,chr1,F,109090761,109096934,69699354,6173,69699354,1199,2
56944,OLFML3,chr1,F,113979390,113982254,69702218,2864,69702218,1200,3
56950,SMYD2,chr1,F,214281221,214337134,69758131,55913,69758131,1201,11
56956,LHX9,chr1,F,197912504,197935476,69781103,22972,69781103,1202,7
56957,OTUD7B,chr1,R,149940329,150010772,69851546,70443,69851546,1203,14
56997,ADCK3,chr1,F,226940236,226987545,69898855,47309,69898855,1204,17
56998,CTNNBIP1,chr1,R,9848275,9910258,69960838,61983,69960838,1205,5
57035,RSRP1,chr1,R,25242248,25267915,69986505,25667,69986505,1206,4
57085,AGTRAP,chr1,F,11735473,11750771,70001803,15298,70001803,1207,7
57095,PITHD1,chr1,F,23778385,23788232,70011650,9847,70011650,1208,5
57111,RAB25,chr1,F,156061174,156070504,70020980,9330,70020980,1209,4
57115,PGLYRP4,chr1,R,153327379,153348841,70042442,21462,70042442,1210,9
57116,ZNF695,chr1,R,246945546,247008093,70104989,62547,70104989,1211,5
57127,RHBG,chr1,F,156366042,156385234,70124181,19192,70124181,1212,14
57134,MAN1C1,chr1,F,25617467,25786207,70292921,168740,70292921,1213,11
57147,SCYL3,chr1,R,169853073,169894267,70334115,41194,70334115,1214,15
57165,GJC2,chr1,F,228149713,228159826,70344228,10113,70344228,1215,1
57172,CAMK1G,chr1,F,209583699,209613939,70374468,30240,70374468,1216,12
57185,NIPAL3,chr1,F,24413673,24472983,70433778,59310,70433778,1217,13
57190,SEPN1,chr1,F,25800175,25818222,70451825,18047,70451825,1218,12
57198,ATP8B2,chr1,F,154325559,154351304,70477570,25745,70477570,1219,29
57212,TP73-AS1,chr1,R,3735983,3747373,70488960,11390,70488960,1220,3
57216,VANGL2,chr1,F,160400573,160428678,70517065,28105,70517065,1221,10
57234,LINC00869,chr1,F,149607011,149679523,70589577,72512,70589577,1222,8
57326,PBXIP1,chr1,R,154944079,154956091,70601589,12012,70601589,1223,10
57402,S100A14,chr1,R,153614254,153616332,70603667,2078,70603667,1224,4
57413,TMIGD3,chr1,R,111483347,111564003,70684323,80656,70684323,1225,6
57449,PLEKHG5,chr1,R,6466091,6520061,70738293,53970,70738293,1226,27
57459,GATAD2B,chr1,R,153804724,153922975,70856544,118251,70856544,1227,13
57463,AMIGO1,chr1,R,109504177,109509717,70862084,5540,70862084,1228,1
57470,LRRC47,chr1,R,3780219,3796504,70878369,16285,70878369,1229,6
57489,ODF2L,chr1,R,86346823,86396342,70927888,49519,70927888,1230,21
57530,CGN,chr1,F,151510876,151538692,70955704,27816,70955704,1231,21
57535,KIAA1324,chr1,F,109113962,109206781,71048523,92819,71048523,1232,23
57540,PTCHD2,chr1,F,11479237,11537583,71106869,58346,71106869,1233,24
57549,IGSF9,chr1,R,159927038,159945596,71125427,18558,71125427,1234,22
57554,LRRC7,chr1,F,69568772,70148192,71704847,579420,71704847,1235,28
57568,SIPA1L2,chr1,R,232397964,232630696,71937579,232732,71937579,1236,26
57576,KIF17,chr1,R,20661642,20718017,71993954,56375,71993954,1237,16
57592,ZNF687,chr1,F,151281554,151291905,72004305,10351,72004305,1238,12
57643,ZSWIM5,chr1,R,45016398,45206578,72194485,190180,72194485,1239,14
57645,POGK,chr1,F,166839448,166854472,72209509,15024,72209509,1240,7
57648,KIAA1522,chr1,F,32741910,32774970,72242569,33060,72242569,1241,8
57657,HCN3,chr1,F,155277426,155289848,72254991,12422,72254991,1242,8
57685,CACHD1,chr1,F,64470792,64693058,72477257,222266,72477257,1243,27
57708,MIER1,chr1,F,66924894,66988619,72540982,63725,72540982,1244,19
57710,KIAA1614,chr1,F,180913176,180946103,72573909,32927,72573909,1245,8
57795,BRINP2,chr1,F,177170921,177282422,72685410,111501,72685410,1246,10
57801,HES4,chr1,R,998961,1001285,72687734,2324,72687734,1247,2
57821,CCDC181,chr1,R,169394869,169460669,72753534,65800,72753534,1248,7
57822,GRHL3,chr1,F,24319321,24364482,72798695,45161,72798695,1249,18
57823,SLAMF7,chr1,F,160739056,160754821,72814460,15765,72814460,1250,6
57829,ZP4,chr1,R,237877863,237890922,72827519,13059,72827519,1251,12
57863,CADM3,chr1,F,159171586,159203142,72859075,31556,72859075,1252,9
58155,PTBP2,chr1,F,96721604,96815049,72952520,93445,72952520,1253,15
58480,RHOU,chr1,F,228644646,228746669,73054543,102023,73054543,1254,3
58497,PRUNE,chr1,F,151008390,151035713,73081866,27323,73081866,1255,7
58511,DNASE2B,chr1,F,84398531,84415895,73099230,17364,73099230,1256,5
58512,DLGAP3,chr1,R,34862119,34929585,73166696,67466,73166696,1257,13
58985,IL22RA1,chr1,R,24119770,24143285,73190211,23515,73190211,1258,7
59269,HIVEP3,chr1,R,41506364,42035931,73719778,529567,73719778,1259,14
59349,KLHL12,chr1,R,202891095,202928644,73757327,37549,73757327,1260,13
59352,LGR6,chr1,F,202193989,202319785,73883123,125796,73883123,1261,24
60313,GPBP1L1,chr1,R,45627303,45688110,73943930,60807,73943930,1262,13
60484,HAPLN2,chr1,F,156618800,156625725,73950855,6925,73950855,1263,6
60672,MIIP,chr1,F,12019241,12032049,73963663,12808,73963663,1264,12
60674,GAS5,chr1,R,173863900,173867987,73967750,4087,73967750,1265,11
60676,PAPPA2,chr1,F,176463170,176845601,74350181,382431,74350181,1266,26
63036,CELA2A,chr1,F,15456727,15472091,74365545,15364,74365545,1267,7
63827,BCAN,chr1,F,156641947,156659532,74383130,17585,74383130,1268,13
63906,GPATCH3,chr1,R,26890487,26901065,74393708,10578,74393708,1269,7
63923,TNN,chr1,F,175067857,175148066,74473917,80209,74473917,1270,18
63931,MRPS14,chr1,R,175012957,175023455,74484415,10498,74484415,1271,2
63948,DMRTB1,chr1,F,53459398,53467488,74492505,8090,74492505,1272,3
63950,DMRTA2,chr1,R,50417549,50423447,74498403,5898,74498403,1273,2
63967,CLSPN,chr1,R,35720690,35769997,74547710,49307,74547710,1274,25
63976,PRDM16,chr1,F,3068226,3438621,74918105,370395,74918105,1275,17
64064,OXCT2,chr1,R,39769524,39771348,74919929,1824,74919929,1276,0
64121,RRAGC,chr1,R,38838196,38859823,74941556,21627,74941556,1277,6
64123,ADGRL4,chr1,R,78889763,79006810,75058603,117047,75058603,1278,14
64129,TINAGL1,chr1,F,31576383,31587686,75069906,11303,75069906,1279,12
64175,P3H1,chr1,R,42746334,42767084,75090656,20750,75090656,1280,14
64216,TFB2M,chr1,R,246540560,246566319,75116415,25759,75116415,1281,7
64218,SEMA4A,chr1,F,156147358,156177751,75146808,30393,75146808,1282,18
64222,TOR3A,chr1,F,179081976,179095996,75160828,14020,75160828,1283,5
64326,RFWD2,chr1,R,175944825,176207279,75423282,262454,75423282,1284,20
64388,GREM2,chr1,R,240489572,240612272,75545982,122700,75545982,1285,3
64407,RGS18,chr1,F,192158461,192187172,75574693,28711,75574693,1286,5
64600,PLA2G2F,chr1,F,20139325,20150386,75585754,11061,75585754,1287,5
64645,HIAT1,chr1,F,100038077,100083377,75631054,45300,75631054,1288,12
64710,NUCKS1,chr1,R,205712818,205750244,75668480,37426,75668480,1289,6
64744,SMAP2,chr1,F,40344843,40423326,75746963,78483,75746963,1290,15
64746,ACBD3,chr1,R,226144678,226186722,75789007,42044,75789007,1291,7
64754,SMYD3,chr1,R,245749339,246507342,76547010,758003,76547010,1292,21
64756,ATPAF1,chr1,R,46635038,46668427,76580399,33389,76580399,1293,10
64757,MARC1,chr1,F,220786696,220814399,76608102,27703,76608102,1294,10
64766,S100PBP,chr1,F,32816766,32858879,76650215,42113,76650215,1295,12
64769,MEAF6,chr1,R,37489959,37514819,76675075,24860,76675075,1296,10
64783,RBM15,chr1,F,110338425,110373218,76709868,34793,76709868,1297,4
64789,EXO5,chr1,F,40508718,40517725,76718875,9007,76718875,1298,3
64793,CEP85,chr1,F,26234152,26279038,76763761,44886,76763761,1299,14
64801,ARV1,chr1,F,230979074,231000733,76785420,21659,76785420,1300,6
64802,NMNAT1,chr1,F,9942922,9985501,76827999,42579,76827999,1301,6
64834,ELOVL1,chr1,R,43363396,43368074,76832677,4678,76832677,1302,8
64853,AIDA,chr1,R,222668012,222712901,76877566,44889,76877566,1303,9
64856,VWA1,chr1,F,1435522,1442882,76884926,7360,76884926,1304,2
64858,DCLRE1B,chr1,F,113905292,113914086,76893720,8794,76893720,1305,3
64960,MRPS15,chr1,R,36455760,36464439,76902399,8679,76902399,1306,7
65005,MRPL9,chr1,R,151759642,151763916,76906673,4274,76906673,1307,6
65018,PINK1,chr1,F,20633454,20651511,76924730,18057,76924730,1308,7
65094,JMJD4,chr1,R,227731188,227735499,76929041,4311,76929041,1309,5
65108,MARCKSL1,chr1,R,32333828,32336239,76931452,2411,76931452,1310,1
65121,PRAMEF1,chr1,F,12791396,12796628,76936684,5232,76936684,1311,4
65122,PRAMEF2,chr1,F,12857085,12861909,76941508,4824,76941508,1312,4
65123,INTS3,chr1,F,153728049,153774808,76988267,46759,76988267,1313,32
65220,NADK,chr1,R,1751231,1780514,77017550,29283,77017550,1314,19
65243,ZFP69B,chr1,F,40450085,40463718,77031183,13633,77031183,1315,5
65260,COA7,chr1,R,52686341,52698366,77043208,12025,77043208,1316,2
65979,PHACTR4,chr1,F,28369581,28500369,77173996,130788,77173996,1317,18
79000,AUNIP,chr1,R,25831912,25859458,77201542,27546,77201542,1318,3
79005,SCNM1,chr1,F,151166021,151170297,77205818,4276,77205818,1319,6
79033,ERI3,chr1,R,44221069,44355279,77340028,134210,77340028,1320,8
79078,C1orf50,chr1,F,42767244,42775742,77348526,8498,77348526,1321,4
79084,WDR77,chr1,R,111439889,111449208,77357845,9319,77357845,1322,9
79098,C1orf116,chr1,R,207018520,207032761,77372086,14241,77372086,1323,3
79100,LINC00626,chr1,F,168786940,168792888,77378034,5948,77378034,1324,2
79140,CCDC28B,chr1,F,32200385,32205390,77383039,5005,77383039,1325,5
79169,C1orf35,chr1,R,228100726,228105411,77387724,4685,77387724,1326,8
79180,EFHD2,chr1,F,15409894,15430343,77408173,20449,77408173,1327,4
79258,MMEL1,chr1,R,2590638,2633042,77450577,42404,77450577,1328,26
79363,RSG1,chr1,R,16231686,16237452,77456343,5766,77456343,1329,4
79368,FCRL2,chr1,R,157745732,157777439,77488050,31707,77488050,1330,11
79469,DLEU2L,chr1,F,63548979,63550636,77489707,1657,77489707,1331,0
79501,OR4F5,chr1,F,69090,70008,77490625,918,77490625,1332,0
79570,NKAIN1,chr1,R,31179744,31239887,77550768,60143,77550768,1333,6
79573,TTC13,chr1,R,230906240,230978872,77623400,72632,77623400,1334,24
79574,EPS8L3,chr1,R,109750079,109764022,77637343,13943,77637343,1335,19
79577,CDC73,chr1,F,193121957,193254815,77770201,132858,77770201,1336,17
79590,MRPL24,chr1,R,156737301,156741266,77774166,3965,77774166,1337,6
79594,MUL1,chr1,R,20499447,20508181,77782900,8734,77782900,1338,4
79605,PGBD5,chr1,R,230321645,230425928,77887183,104283,77887183,1339,6
79626,TNFAIP8L2,chr1,F,151156628,151159749,77890304,3121,77890304,1340,1
79630,C1orf54,chr1,F,150269003,150280924,77902225,11921,77902225,1341,7
79639,TMEM53,chr1,R,44653246,44674608,77923587,21362,77923587,1342,3
79647,AKIRIN1,chr1,F,38991243,39006065,77938409,14822,77938409,1343,5
79654,HECTD3,chr1,R,45002545,45011355,77947219,8810,77947219,1344,20
79656,BEND5,chr1,R,48727522,48776969,77996666,49447,77996666,1345,7
79679,VTCN1,chr1,R,117143586,117270368,78123448,126782,78123448,1346,9
79693,YRDC,chr1,R,37802941,37808193,78128700,5252,78128700,1347,4
79699,ZYG11B,chr1,F,52726458,52827342,78229584,100884,78229584,1348,14
79707,NOL9,chr1,R,6521346,6554598,78262836,33252,78262836,1349,11
79717,PPCS,chr1,F,42456340,42473381,78279877,17041,78279877,1350,2
79727,LIN28A,chr1,F,26410777,26429728,78298828,18951,78298828,1351,3
79729,SH3D21,chr1,F,36305725,36321962,78315065,16237,78315065,1352,17
79739,TTLL7,chr1,R,83869373,83999167,78444859,129794,78444859,1353,25
79753,SNIP1,chr1,R,37534448,37554344,78464755,19896,78464755,1354,4
79762,C1orf115,chr1,F,220690285,220699157,78473627,8872,78473627,1355,1
79802,HHIPL2,chr1,R,222522259,222548102,78499470,25843,78499470,1356,11
79805,VASH2,chr1,F,212935542,212991585,78555513,56043,78555513,1357,22
79814,AGMAT,chr1,R,15571698,15585110,78568925,13412,78568925,1358,6
79819,WDR78,chr1,R,66812884,66925095,78681136,112211,78681136,1359,16
79830,ZMYM1,chr1,F,35059785,35115859,78737210,56074,78737210,1360,12
79854,LINC00115,chr1,R,826205,827522,78738527,1317,78738527,1361,0
79862,ZNF669,chr1,R,247099961,247104400,78742966,4439,78742966,1362,3
79871,RPAP2,chr1,F,92298964,92388175,78832177,89211,78832177,1363,16
79894,ZNF672,chr1,F,248838177,248849517,78843517,11340,78843517,1364,3
79906,MORN1,chr1,R,2321252,2391751,78914016,70499,78914016,1365,19
79927,FAM110D,chr1,F,26159007,26162628,78917637,3621,78917637,1366,2
79932,KIAA0319L,chr1,R,35433489,35557670,79041818,124181,79041818,1367,23
79947,DHDDS,chr1,F,26432281,26471306,79080843,39025,79080843,1368,8
79957,PAQR6,chr1,R,156243320,156248488,79086011,5168,79086011,1369,7
79961,DENND2D,chr1,R,111185968,111204791,79104834,18823,79104834,1370,17
79971,WLS,chr1,R,68098458,68233000,79239376,134542,79239376,1371,13
80003,PCNXL2,chr1,R,232984100,233295713,79550989,311613,79550989,1372,37
80045,GPR157,chr1,R,9103390,9129170,79576769,25780,79576769,1373,3
80128,TRIM46,chr1,F,155173786,155184971,79587954,11185,79587954,1374,15
80133,MROH9,chr1,F,170935470,171065985,79718469,130515,79718469,1375,22
80135,RPF1,chr1,F,84479236,84498350,79737583,19114,79737583,1376,8
80143,SIKE1,chr1,R,114769478,114780687,79748792,11209,79748792,1377,4
80149,ZC3H12A,chr1,F,37473454,37484377,79759715,10923,79759715,1378,6
80176,SPSB1,chr1,F,9292881,9369532,79836366,76651,79836366,1379,2
80222,TARS2,chr1,F,150487363,150507609,79856612,20246,79856612,1380,17
80232,WDR26,chr1,R,224385142,224434299,79905769,49157,79905769,1381,16
80263,TRIM45,chr1,R,117111054,117121789,79916504,10735,79916504,1382,5
80267,EDEM3,chr1,R,184690490,184754907,79980921,64417,79980921,1383,21
80308,FLAD1,chr1,F,154983293,154993111,79990739,9818,79990739,1384,6
80342,TRAF3IP3,chr1,F,209756031,209782323,80017031,26292,80017031,1385,17
80772,CPTP,chr1,F,1324755,1328896,80021172,4141,80021172,1386,4
80818,ZNF436,chr1,R,23359447,23369864,80031589,10417,80031589,1387,3
80834,TAS1R2,chr1,R,18839598,18859661,80051652,20063,80051652,1388,5
80835,TAS1R1,chr1,F,6555277,6579757,80076132,24480,80076132,1389,8
80851,SH3BP5L,chr1,R,248810445,248825955,80091642,15510,80091642,1390,7
80896,NPL,chr1,F,182789448,182830384,80132578,40936,80132578,1391,12
81025,GJA9,chr1,R,38874066,38881626,80140138,7560,80140138,1392,1
81399,OR4F16,chr1,R,685715,686654,80141077,939,80141077,1393,0
81442,OR6N2,chr1,R,158776681,158777635,80142031,954,80142031,1394,0
81448,OR6K2,chr1,R,158699677,158700652,80143006,975,80143006,1395,0
81466,OR2L5,chr1,F,248021947,248022886,80143945,939,80143945,1396,0
81469,OR2G3,chr1,F,247605585,247606515,80144875,930,80144875,1397,0
81470,OR2G2,chr1,F,247588359,247589313,80145829,954,80145829,1398,0
81472,OR2C3,chr1,R,247530131,247533839,80149537,3708,80149537,1399,1
81493,SYNC,chr1,R,32679905,32702760,80172392,22855,80172392,1400,4
81494,CFHR5,chr1,F,196975036,197009678,80207034,34642,80207034,1401,10
81559,TRIM11,chr1,R,228393671,228406877,80220240,13206,80220240,1402,5
81563,C1orf21,chr1,F,184387015,184629021,80462246,242006,80462246,1403,5
81569,ACTL8,chr1,F,17711999,17827063,80577310,115064,80577310,1404,12
81573,ANKRD13C,chr1,R,70259001,70354788,80673097,95787,80673097,1405,13
81607,PVRL4,chr1,R,161070990,161089595,80691702,18605,80691702,1406,8
81609,SNX27,chr1,F,151611983,151699083,80778802,87100,80778802,1407,12
81611,ANP32E,chr1,R,150218416,150236156,80796542,17740,80796542,1408,7
81626,SHCBP1L,chr1,R,182899864,182953418,80850096,53554,80850096,1409,9
81627,TRMT1L,chr1,R,185118084,185157098,80889110,39014,80889110,1410,15
81629,TSSK3,chr1,F,32362260,32364325,80891175,2065,80891175,1411,1
81669,CCNL2,chr1,R,1385710,1399338,80904803,13628,80904803,1412,12
81788,NUAK2,chr1,R,205302058,205321791,80924536,19733,80924536,1413,7
81839,VANGL1,chr1,F,115641952,115698224,80980808,56272,80980808,1414,8
81849,ST6GALNAC5,chr1,F,76867440,77069167,81182535,201727,81182535,1415,4
81875,ISG20L2,chr1,R,156721890,156728472,81189117,6582,81189117,1416,4
81888,HYI,chr1,R,43450606,43455882,81194393,5276,81194393,1417,8
83416,FCRL5,chr1,R,157513376,157552520,81233537,39144,81233537,1418,16
83417,FCRL4,chr1,R,157573748,157598080,81257869,24332,81257869,1419,11
83442,SH3BGRL3,chr1,F,26279721,26281522,81259670,1801,81259670,1420,2
83479,DDX59,chr1,R,200640806,200669998,81288862,29192,81288862,1421,10
83540,NUF2,chr1,F,163321932,163355764,81322694,33832,81322694,1422,13
83593,RASSF5,chr1,F,206507529,206589284,81404449,81755,81404449,1423,6
83667,SESN2,chr1,F,28259451,28282491,81427489,23040,81427489,1424,9
83715,ESPN,chr1,F,6424775,6460944,81463658,36169,81463658,1425,18
83756,TAS1R3,chr1,F,1328998,1335320,81469980,6322,81469980,1426,5
83858,ATAD3B,chr1,F,1471731,1509479,81507728,37748,81507728,1427,17
83872,HMCN1,chr1,F,185734380,186190953,81964301,456573,81964301,1428,106
83873,GPR61,chr1,F,109539871,109547260,81971690,7389,81971690,1429,2
83881,MIXL1,chr1,F,226223548,226227056,81975198,3508,81975198,1430,1
83931,STK40,chr1,R,36339618,36385927,82021507,46309,82021507,1431,11
83932,SPRTN,chr1,F,231337935,231370551,82054123,32616,82054123,1432,6
83941,TM2D1,chr1,R,61681045,61725423,82098501,44378,82098501,1433,7
83953,FCAMR,chr1,R,206957646,206970659,82111514,13013,82111514,1434,8
83998,REG4,chr1,R,119794017,119811580,82129077,17563,82129077,1435,6
84033,OBSCN,chr1,F,228208071,228378876,82299882,170805,82299882,1436,121
84065,TMEM222,chr1,F,27322144,27336400,82314138,14256,82314138,1437,7
84066,TEX35,chr1,F,178513076,178523500,82324562,10424,82324562,1438,10
84069,PLEKHN1,chr1,F,966496,975108,82333174,8612,82333174,1439,14
84072,HORMAD1,chr1,R,150698058,150720909,82356025,22851,82356025,1440,16
84134,TOMM40L,chr1,F,161225938,161230746,82360833,4808,82360833,1441,9
84144,SYDE2,chr1,R,85157672,85201704,82404865,44032,82404865,1442,10
84146,ZNF644,chr1,R,90915297,91022255,82511823,106958,82511823,1443,9
84196,USP48,chr1,R,21678297,21783199,82616725,104902,82616725,1444,28
84217,ZMYND12,chr1,R,42430328,42456267,82642664,25939,82642664,1445,7
84224,NBPF3,chr1,F,21435317,21484900,82692247,49583,82692247,1446,23
84230,LRRC8C,chr1,F,89615872,89719535,82795910,103663,82795910,1447,5
84243,ZDHHC18,chr1,F,26826709,26855720,82824921,29011,82824921,1448,7
84251,SGIP1,chr1,F,66533310,66748999,83040610,215689,83040610,1449,28
84265,POLR3GL,chr1,F,145959006,145978848,83060452,19842,83060452,1450,8
84275,SLC25A33,chr1,F,9539468,9582773,83103757,43305,83103757,1451,8
84283,TMEM79,chr1,F,156282912,156292443,83113288,9531,83113288,1452,4
84284,NTPCR,chr1,F,232950535,232978799,83141552,28264,83141552,1453,4
84288,EFCAB2,chr1,F,244969738,245125228,83297042,155490,83297042,1454,9
84301,DDI2,chr1,F,15617457,15661057,83340642,43600,83340642,1455,9
84320,ACBD6,chr1,R,180287384,180502967,83556225,215583,83556225,1456,8
84328,LZIC,chr1,R,9922109,9943402,83577518,21293,83577518,1457,9
84432,PROK1,chr1,F,110451165,110457354,83583707,6189,83583707,1458,2
84451,KIAA1804,chr1,F,233327742,233385148,83641113,57406,83641113,1459,9
84455,EFCAB7,chr1,F,63523300,63585365,83703178,62065,83703178,1460,16
84614,ZBTB37,chr1,F,173868081,173887458,83722555,19377,83722555,1461,5
84618,NT5C1A,chr1,R,39659120,39672038,83735473,12918,83735473,1462,5
84648,LCE3D,chr1,R,152579383,152580504,83736594,1121,83736594,1463,1
84676,TRIM63,chr1,R,26051303,26067634,83752925,16331,83752925,1464,8
84719,LINC00260,chr1,F,203730576,203731853,83754202,1277,83754202,1465,0
84722,PSRC1,chr1,R,109279553,109283168,83757817,3615,83757817,1466,7
84734,FAM167B,chr1,F,32247216,32248860,83759461,1644,83759461,1467,1
84791,LINC00467,chr1,F,211382754,211432535,83809242,49781,83809242,1468,5
84793,FOXD2-AS1,chr1,R,47432132,47434641,83811751,2509,83811751,1469,0
84808,PERM1,chr1,R,975198,982117,83818670,6919,83818670,1470,3
84809,CROCCP2,chr1,R,16618255,16630906,83831321,12651,83831321,1471,6
84824,FCRLA,chr1,F,161706971,161714352,83838702,7381,83838702,1472,5
84832,ANKRD36BP1,chr1,R,168245564,168247430,83840568,1866,83840568,1473,0
84838,ZNF496,chr1,R,247297412,247333376,83876532,35964,83876532,1474,14
84842,HPDL,chr1,F,45326872,45328675,83878335,1803,83878335,1475,0
84852,ATP1A1-AS1,chr1,R,116392864,116418622,83904093,25758,83904093,1476,6
84871,AGBL4,chr1,R,48532833,50023954,85395214,1491121,85395214,1477,16
84879,MFSD2A,chr1,F,39955111,39969968,85410071,14857,85410071,1478,13
84886,C1orf198,chr1,R,230837118,230869589,85442542,32471,85442542,1479,6
84919,PPP1R15B,chr1,R,204400274,204411817,85454085,11543,85454085,1480,2
84938,ATG4C,chr1,F,62784105,62865270,85535250,81165,85535250,1481,12
84944,MAEL,chr1,F,166975581,167022214,85581883,46633,85581883,1482,13
84950,PRPF38A,chr1,F,52404546,52418320,85595657,13774,85595657,1483,9
84958,SYTL1,chr1,F,27341991,27353932,85607598,11941,85607598,1484,14
84966,IGSF21,chr1,F,18107745,18378484,85878337,270739,85878337,1485,11
84967,LSM10,chr1,R,36393419,36397959,85882877,4540,85882877,1486,1
84970,C1orf94,chr1,F,34166882,34219131,85935126,52249,85935126,1487,7
84976,DISP1,chr1,F,222814513,223005995,86126608,191482,86126608,1488,21
85028,SNHG12,chr1,R,28578537,28581854,86129925,3317,86129925,1489,5
85369,STRIP1,chr1,F,110031576,110054641,86152990,23065,86152990,1490,23
85397,RGS8,chr1,R,182643340,182753307,86262957,109967,86262957,1491,14
85414,SLC45A3,chr1,R,205657850,205680502,86285609,22652,86285609,1492,8
85440,DOCK7,chr1,R,62454725,62688368,86519252,233643,86519252,1493,52
85452,CFAP74,chr1,R,1921950,2003837,86601139,81887,86601139,1494,43
89780,WNT3A,chr1,F,228007021,228066711,86660829,59690,86660829,1495,5
89796,NAV1,chr1,F,201539101,201826974,86948702,287873,86948702,1496,32
89866,SEC16B,chr1,R,177929106,177969915,86989511,40809,86989511,1497,25
89872,AQP10,chr1,F,154321066,154325325,86993770,4259,86993770,1498,5
89884,LHX4,chr1,F,180228802,180275053,87040021,46251,87040021,1499,9
89886,SLAMF9,chr1,R,159951491,159954254,87042784,2763,87042784,1500,3
90231,KIAA2013,chr1,R,11919587,11926428,87049625,6841,87049625,1501,2
90326,THAP3,chr1,F,6624864,6635586,87060347,10722,87060347,1502,7
90529,STPG1,chr1,R,24356998,24415497,87118846,58499,87118846,1503,11
90780,PYGO2,chr1,R,154957025,154961782,87123603,4757,87123603,1504,2
90806,ANGEL2,chr1,R,212992181,213015875,87147297,23694,87147297,1505,10
90853,SPOCD1,chr1,R,31790421,31816051,87172927,25630,87172927,1506,17
90874,ZNF697,chr1,R,119619376,119648170,87201721,28794,87201721,1507,5
91156,IGFN1,chr1,F,201190805,201228952,87239868,38147,87239868,1508,24
91181,NUP210L,chr1,R,153992689,154155116,87402295,162427,87402295,1509,39
91408,BTF3L4,chr1,F,52056184,52090716,87436827,34532,87436827,1510,5
91544,UBXN11,chr1,R,26282281,26318265,87472811,35984,87472811,1511,16
91548,LOC91548,chr1,F,211675721,211725694,87522784,49973,87522784,1512,5
91624,NEXN,chr1,F,77888514,77948643,87582913,60129,87582913,1513,12
91687,CENPL,chr1,R,173799549,173824639,87608003,25090,87608003,1514,6
92235,DUSP27,chr1,F,167094076,167129897,87643824,35821,87643824,1515,5
92241,RCSD1,chr1,F,167630236,167708696,87722284,78460,87722284,1516,6
92312,MEX3A,chr1,R,156072012,156081998,87732270,9986,87732270,1517,1
92342,METTL18,chr1,R,169792528,169794959,87734701,2431,87734701,1518,3
92344,GORAB,chr1,F,170532121,170553834,87756414,21713,87756414,1519,6
92346,C1orf105,chr1,F,172420514,172468829,87804729,48315,87804729,1520,10
92703,TMEM183A,chr1,F,203007382,203024848,87822195,17466,87822195,1521,8
92815,HIST3H2A,chr1,R,228457363,228457859,87822691,496,87822691,1522,0
93183,PIGM,chr1,R,160027671,160031993,87827013,4322,87827013,1523,0
93185,IGSF8,chr1,R,160091338,160098860,87834535,7522,87834535,1524,9
93190,C1orf158,chr1,F,12746185,12761169,87849519,14984,87849519,1525,3
93273,LEMD1,chr1,R,205381377,205449950,87918092,68573,87918092,1526,10
93474,ZNF670,chr1,R,247034637,247078813,87962268,44176,87962268,1527,6
93611,FBXO44,chr1,F,11654374,11663327,87971221,8953,87971221,1528,8
93974,ATPIF1,chr1,F,28236090,28238105,87973236,2015,87973236,1529,1
94161,SNORD46,chr1,F,44776491,44776589,87973334,98,87973334,1530,0
94162,SNORD38A,chr1,F,44777841,44777912,87973405,71,87973405,1531,0
94163,SNORD38B,chr1,F,44778389,44778458,87973474,69,87973474,1532,0
94236,DNAJA1P5,chr1,F,101872011,101894743,87996206,22732,87996206,1533,1
112770,GLMP,chr1,R,156292686,156295689,87999209,3003,87999209,1534,6
112950,MED8,chr1,R,43383907,43389812,88005114,5905,88005114,1535,6
112970,KTI12,chr1,R,52032104,52033800,88006810,1696,88006810,1536,0
113444,SMIM12,chr1,R,34850361,34859816,88016265,9455,88016265,1537,6
113451,AZIN2,chr1,F,33081109,33178892,88114048,97783,88114048,1538,18
113452,TMEM54,chr1,R,32894594,32901435,88120889,6841,88120889,1539,5
113802,HENMT1,chr1,R,108648287,108661526,88134128,13239,88134128,1540,9
114034,TOE1,chr1,F,45339669,45343978,88138437,4309,88138437,1541,7
114548,NLRP3,chr1,F,247415903,247449108,88171642,33205,88171642,1542,12
114625,ERMAP,chr1,F,42817104,42844989,88199527,27885,88199527,1543,12
114771,PGLYRP3,chr1,R,153297588,153312975,88214914,15387,88214914,1544,10
114784,CSMD2,chr1,R,33513998,34165842,88866758,651844,88866758,1545,72
114803,MYSM1,chr1,R,58654738,58700092,88912112,45354,88912112,1546,22
114814,GNRHR2,chr1,F,145919012,145925341,88918441,6329,88918441,1547,3
114819,CROCCP3,chr1,R,16467435,16492701,88943707,25266,88943707,1548,14
114827,FHAD1,chr1,F,15236601,15400283,89107389,163682,89107389,1549,42
114836,SLAMF6,chr1,R,160485029,160523262,89145622,38233,89145622,1550,7
114883,OSBPL9,chr1,F,51616873,51789219,89317968,172346,89317968,1551,27
115019,SLC26A9,chr1,R,205913047,205943472,89348393,30425,89348393,1552,20
115110,LOC115110,chr1,R,2549919,2557011,89355485,7092,89355485,1553,6
115209,OMA1,chr1,R,58480718,58546799,89421566,66081,89421566,1554,8
115273,RAB42,chr1,F,28592199,28594586,89423953,2387,89423953,1555,2
115350,FCRL1,chr1,R,157792248,157820150,89451855,27902,89451855,1556,11
115352,FCRL3,chr1,R,157676480,157700985,89476360,24505,89476360,1557,15
115353,LRRC42,chr1,F,53946325,53968168,89498203,21843,89498203,1558,10
115361,GBP4,chr1,R,89181147,89198950,89516006,17803,89516006,1559,10
115362,GBP5,chr1,R,89258949,89272861,89529918,13912,89529918,1560,11
115572,FAM46B,chr1,R,27005019,27012842,89537741,7823,89537741,1561,1
116123,FMO9P,chr1,F,166603915,166625238,89559064,21323,89559064,1562,6
116228,COX20,chr1,F,244835336,244845057,89568785,9721,89568785,1563,3
116362,RBP7,chr1,F,9997196,10016020,89587609,18824,89587609,1564,3
116461,TSEN15,chr1,F,184051650,184095846,89631805,44196,89631805,1565,7
116496,FAM129A,chr1,R,184791024,184975138,89815919,184114,89815919,1566,14
116841,SNAP47,chr1,F,227734995,227781231,89862155,46236,89862155,1567,6
116983,ACAP3,chr1,R,1292383,1307925,89877697,15542,89877697,1568,24
117143,TADA1,chr1,R,166856509,166876417,89897605,19908,89897605,1569,7
117145,THEM4,chr1,R,151870865,151909885,89936625,39020,89936625,1570,6
117157,SH2D1B,chr1,R,162395265,162412138,89953498,16873,89953498,1571,3
117178,SSX2IP,chr1,R,84643706,84690757,90000549,47051,90000549,1572,16
118424,UBE2J2,chr1,R,1253911,1273854,90020492,19943,90020492,1573,9
118427,OLFM3,chr1,R,101802566,101997234,90215160,194668,90215160,1574,9
126626,GABPB2,chr1,F,151070603,151129119,90273676,58516,90273676,1575,11
126637,TCHHL1,chr1,R,152084143,152089064,90278597,4921,90278597,1576,2
126638,RPTN,chr1,R,152153594,152159228,90284231,5634,90284231,1577,2
126661,CCDC163P,chr1,R,45493925,45500079,90290385,6154,90290385,1578,5
126668,TDRD10,chr1,F,154502218,154548147,90336314,45929,90336314,1579,18
126669,SHE,chr1,R,154469636,154502050,90368728,32414,90368728,1580,6
126695,KDF1,chr1,R,26949555,26960484,90379657,10929,90379657,1581,4
126731,CCSAP,chr1,R,229321004,229342941,90401594,21937,90401594,1582,4
126755,LRRC38,chr1,R,13474976,13513781,90440399,38805,90440399,1583,3
126767,AADACL3,chr1,F,12716114,12728759,90453044,12645,90453044,1584,3
126789,PUSL1,chr1,F,1308570,1311677,90456151,3107,90456151,1585,8
126792,B3GALT6,chr1,F,1232248,1235041,90458944,2793,90458944,1586,0
126820,WDR63,chr1,F,85062297,85133138,90529785,70841,90529785,1587,22
126823,KLHDC9,chr1,F,161098360,161100348,90531773,1988,90531773,1588,3
126859,AXDND1,chr1,F,179365717,179554735,90720791,189018,90720791,1589,32
126868,MAB21L3,chr1,F,116075791,116135240,90780240,59449,90780240,1590,10
126917,IFFO2,chr1,R,18904279,18956667,90832628,52388,90832628,1591,8
126961,HIST2H3C,chr1,R,149840686,149841193,90833135,507,90833135,1592,0
126969,SLC44A3,chr1,F,94820341,94895247,90908041,74906,90908041,1593,20
127002,ATXN7L2,chr1,F,109483910,109492804,90916935,8894,90916935,1594,12
127003,C1orf194,chr1,R,109105950,109113870,90924855,7920,90924855,1595,5
127018,LYPLAL1,chr1,F,219173830,219212865,90963890,39035,90963890,1596,6
127059,OR2M5,chr1,F,248145147,248146086,90964829,939,90964829,1597,0
127062,OR2M3,chr1,F,248203067,248204006,90965768,939,90965768,1598,0
127064,OR2T12,chr1,R,248294615,248295578,90966731,963,90966731,1599,0
127066,OR14C36,chr1,F,248348774,248349713,90967670,939,90967670,1600,0
127068,OR2T34,chr1,R,248573800,248574757,90968627,957,90968627,1601,0
127069,OR2T10,chr1,R,248592829,248593768,90969566,939,90969566,1602,0
127074,OR2T4,chr1,F,248361580,248362627,90970613,1047,90970613,1603,0
127077,OR2T11,chr1,R,248626177,248627128,90971564,951,90971564,1604,0
127124,ATP6V1G3,chr1,R,198523221,198540945,90989288,17724,90989288,1605,4
127247,ASB17,chr1,R,75918872,75932433,91002849,13561,91002849,1606,2
127253,TYW3,chr1,F,74733142,74766677,91036384,33535,91036384,1607,5
127254,ERICH3,chr1,R,74568110,74673738,91142012,105628,91142012,1608,20
127255,LRRIQ3,chr1,R,74026014,74198201,91314199,172187,91314199,1609,13
127262,TPRG1L,chr1,F,3624991,3630131,91319339,5140,91319339,1610,4
127281,FAM213B,chr1,F,2586459,2591469,91324349,5010,91324349,1611,7
127294,MYOM3,chr1,R,24056040,24112175,91380484,56135,91380484,1612,36
127343,DMBX1,chr1,F,46489836,46514226,91404874,24390,91404874,1613,6
127385,OR10J5,chr1,R,159535077,159536007,91405804,930,91405804,1614,0
127391,TMCO2,chr1,F,40247900,40251693,91409597,3793,91409597,1615,1
127396,ZNF684,chr1,F,40531154,40548169,91426612,17015,91426612,1616,8
127428,TCEANC2,chr1,F,54053571,54112519,91485560,58948,91485560,1617,5
127435,PODN,chr1,F,53062051,53085502,91509011,23451,91509011,1618,13
127495,LRRC39,chr1,R,100148447,100178273,91538837,29826,91538837,1619,11
127534,GJB4,chr1,F,34759740,34763724,91542821,3984,91542821,1620,2
127540,HMGB4,chr1,F,33860474,33864791,91547138,4317,91547138,1621,1
127544,RNF19B,chr1,R,32932497,32965266,91579907,32769,91579907,1622,9
127550,A3GALT2,chr1,R,33306765,33321098,91594240,14333,91594240,1623,4
127579,DCST2,chr1,R,155017447,155033781,91610574,16334,91610574,1624,15
127602,DNAH14,chr1,F,224929594,225399294,92080274,469700,92080274,1625,91
127623,OR2B11,chr1,R,247451028,247451982,92081228,954,92081228,1626,0
127665,ZNF648,chr1,R,182053765,182062505,92089968,8740,92089968,1627,2
127670,TEDDM1,chr1,R,182398116,182400616,92092468,2500,92092468,1628,0
127687,C1orf122,chr1,F,37807800,37809454,92094122,1654,92094122,1629,2
127700,OSCP1,chr1,R,36417905,36450485,92126702,32580,92126702,1630,12
127703,C1orf216,chr1,R,35713874,35719189,92132017,5315,92132017,1631,2
127707,KLHDC7A,chr1,F,18480929,18485999,92137087,5070,92137087,1632,0
127731,VWA5B1,chr1,F,20290906,20360221,92206402,69315,92206402,1633,31
127733,UBXN10,chr1,F,20183301,20196048,92219149,12747,92219149,1634,3
127795,C1orf87,chr1,R,59990393,60073770,92302526,83377,92302526,1635,11
127829,ARL8A,chr1,R,202133403,202144743,92313866,11340,92313866,1636,6
127833,SYT2,chr1,R,202587636,202710444,92436674,122808,92436674,1637,9
127841,LINC00628,chr1,R,204368429,204369719,92437964,1290,92437964,1638,0
127845,GOLT1A,chr1,R,204198159,204214092,92453897,15933,92453897,1639,4
127933,UHMK1,chr1,F,162497173,162529629,92486353,32456,92486353,1640,8
127943,FCRLB,chr1,F,161721543,161728143,92492953,6600,92492953,1641,8
128025,WDR64,chr1,F,241652277,241802745,92643421,150468,92643421,1642,33
128061,C1orf131,chr1,R,231223762,231241187,92660846,17425,92660846,1643,6
128077,LIX1L,chr1,R,145933423,145958019,92685442,24596,92685442,1644,5
128102,HSD3BP4,chr1,F,119563879,119572576,92694139,8697,92694139,1645,0
128153,SPATA17,chr1,F,217631323,217868151,92930967,236828,92930967,1646,11
128178,EDARADD,chr1,F,236394379,236484708,93021296,90329,93021296,1647,6
128209,KLF17,chr1,F,44043926,44135140,93112510,91214,93112510,1648,8
128218,TMEM125,chr1,F,43269950,43274002,93116562,4052,93116562,1649,4
128229,TSACC,chr1,F,156337313,156346995,93126244,9682,93126244,1650,5
128239,IQGAP3,chr1,R,156525404,156572604,93173444,47200,93173444,1651,40
128240,APOA1BP,chr1,F,156591765,156594299,93175978,2534,93175978,1652,5
128272,ARHGEF19,chr1,R,16197855,16212671,93190794,14816,93190794,1653,16
128308,MRPL55,chr1,R,228106678,228110953,93195069,4275,93195069,1654,5
128312,HIST3H2BB,chr1,F,228458106,228458558,93195521,452,93195521,1655,0
128338,DRAM2,chr1,R,111117331,111140216,93218406,22885,93218406,1656,10
128344,PIFO,chr1,F,111324514,111353017,93246909,28503,93246909,1657,7
128346,C1orf162,chr1,F,111467486,111478512,93257935,11026,93257935,1658,7
128360,OR10T2,chr1,R,158398521,158399466,93258880,945,93258880,1659,0
128366,OR6P1,chr1,R,158562650,158563604,93259834,954,93259834,1660,0
128367,OR10X1,chr1,R,158578918,158579899,93260815,981,93260815,1661,0
128368,OR10Z1,chr1,F,158606438,158607380,93261757,942,93261757,1662,0
128371,OR6K6,chr1,F,158754815,158755847,93262789,1032,93262789,1663,0
128372,OR6N1,chr1,R,158765743,158766682,93263728,939,93263728,1664,0
128387,TATDN3,chr1,F,212791827,212816825,93288726,24998,93288726,1665,9
140576,S100A16,chr1,R,153606885,153613038,93294879,6153,93294879,1666,4
140609,NEK7,chr1,F,198156977,198322420,93460322,165443,93460322,1667,9
140625,ACTRT2,chr1,F,3021481,3022903,93461744,1422,93461744,1668,0
142678,MIB2,chr1,F,1614974,1630610,93477380,15636,93477380,1669,22
142683,ITLN2,chr1,R,160945019,160957378,93489739,12359,93489739,1670,9
148281,SYT6,chr1,R,114089291,114153850,93554298,64559,93554298,1671,9
148304,C1orf74,chr1,R,209782316,209784545,93556527,2229,93556527,1672,1
148327,CREB3L4,chr1,F,153967838,153974364,93563053,6526,93563053,1673,10
148345,C1orf127,chr1,R,10946472,10982037,93598618,35565,93598618,1674,16
148362,BROX,chr1,F,222712552,222735196,93621262,22644,93621262,1675,15
148398,SAMD11,chr1,F,925740,944581,93640103,18841,93640103,1676,13
148413,LOC148413,chr1,F,1399529,1402046,93642620,2517,93642620,1677,2
148418,SAMD13,chr1,F,84274951,84350798,93718467,75847,93718467,1678,8
148423,C1orf52,chr1,R,85249952,85259672,93728187,9720,93728187,1679,3
148479,PHF13,chr1,F,6613695,6624033,93738525,10338,93738525,1680,4
148523,CIART,chr1,F,150282532,150287093,93743086,4561,93743086,1681,4
148534,TMEM56,chr1,F,95092516,95197607,93848177,105091,93848177,1682,7
148545,NBPF4,chr1,R,108222463,108244081,93869795,21618,93869795,1683,15
148581,UBE2U,chr1,F,64186827,64267368,93950336,80541,93950336,1684,17
148641,SLC35F3,chr1,F,233904711,234324518,94370143,419807,94370143,1685,8
148645,LINC00337,chr1,F,6236239,6239444,94373348,3205,94373348,1686,4
148696,LOC148696,chr1,F,207818378,207822596,94377566,4218,94377566,1687,0
148709,LOC148709,chr1,F,202861753,202875241,94391054,13488,94391054,1688,2
148713,PTPRVP,chr1,F,202168050,202189449,94412453,21399,94412453,1689,21
148738,HFE2,chr1,R,146017467,146021822,94416808,4355,94416808,1690,3
148741,ANKRD35,chr1,R,145866559,145885866,94436115,19307,94436115,1691,13
148753,FAM163A,chr1,F,179727762,179816198,94524551,88436,94524551,1692,12
148756,OVAAL,chr1,F,180558973,180566518,94532096,7545,94532096,1693,2
148789,B3GALNT2,chr1,R,235440659,235504481,94595918,63822,94595918,1694,14
148808,MFSD4,chr1,F,205568983,205602918,94629853,33935,94629853,1695,9
148811,PM20D1,chr1,R,205828021,205850148,94651980,22127,94651980,1696,12
148823,GCSAML,chr1,F,247507057,247577690,94722613,70633,94722613,1697,8
148824,GCSAML-AS1,chr1,R,247524678,247530804,94728739,6126,94728739,1698,3
148867,SLC30A7,chr1,F,100896072,100996913,94829580,100841,94829580,1699,13
148870,CCDC27,chr1,F,3752397,3771645,94848828,19248,94848828,1700,12
148898,ZNF436-AS1,chr1,F,23368970,23371839,94851697,2869,94851697,1701,0
148930,KNCN,chr1,R,46545637,46551657,94857717,6020,94857717,1702,3
148932,MOB3C,chr1,R,46607714,46616891,94866894,9177,94866894,1703,4
148979,GLIS1,chr1,R,53506232,53734204,95094866,227972,95094866,1704,10
149013,NBPF12,chr1,F,146938544,146996093,95152415,57549,95152415,1705,36
149018,LELP1,chr1,F,153203429,153205125,95154111,1696,95154111,1706,1
149041,RC3H1,chr1,R,173931083,173993072,95216100,61989,95216100,1707,18
149047,MGC27382,chr1,F,78229598,78369464,95355966,139866,95355966,1708,5
149069,DCDC2B,chr1,F,32209093,32216196,95363069,7103,95363069,1709,8
149076,ZNF362,chr1,F,33256306,33300720,95407483,44414,95407483,1710,10
149086,LINC01225,chr1,F,31500084,31508566,95415965,8482,95415965,1711,7
149095,DCST1,chr1,F,155033805,155050930,95433090,17125,95433090,1712,16
149111,CNIH3,chr1,F,224434789,224740567,95738868,305778,95738868,1713,15
149134,LINC01341,chr1,F,246789616,246791486,95740738,1870,95740738,1714,1
149175,MANEAL,chr1,F,37793819,37801606,95748525,7787,95748525,1715,3
149233,IL23R,chr1,F,67138639,67259979,95869865,121340,95869865,1716,13
149281,METTL11B,chr1,F,170146046,170168923,95892742,22877,95892742,1717,6
149297,FAM78B,chr1,R,166057425,166166755,96002072,109330,96002072,1718,2
149345,SHISA4,chr1,F,201888668,201892587,96005991,3919,96005991,1719,5
149371,EXOC8,chr1,R,231332730,231337872,96011133,5142,96011133,1720,0
149373,LOC149373,chr1,R,231184098,231187627,96014662,3529,96014662,1721,2
149420,PDIK1L,chr1,F,26111164,26125548,96029046,14384,96029046,1722,4
149428,BNIPL,chr1,F,151036552,151047600,96040094,11048,96040094,1723,10
149461,CLDN19,chr1,R,42733092,42740254,96047256,7162,96047256,1724,3
149465,CFAP57,chr1,F,43172329,43254358,96129285,82029,96129285,1725,27
149466,C1orf210,chr1,R,43281864,43285840,96133261,3976,96133261,1726,3
149473,CCDC24,chr1,F,43991607,43996528,96138182,4921,96138182,1727,8
149478,BTBD19,chr1,F,44807456,44814199,96144925,6743,96144925,1728,8
149483,CCDC17,chr1,R,45620043,45624787,96149669,4744,96149669,1729,8
149499,LRRC71,chr1,F,156920607,156942683,96171745,22076,96171745,1730,19
149563,C1orf64,chr1,F,16004235,16006695,96174205,2460,96174205,1731,1
149603,RNF187,chr1,F,228487366,228496188,96183027,8822,96183027,1732,3
149620,CHIAP2,chr1,F,111280523,111286108,96188612,5585,96188612,1733,7
149628,PYHIN1,chr1,F,158931546,158988872,96245938,57326,96245938,1734,11
149643,SPATA45,chr1,R,212830140,212847649,96263447,17509,96263447,1735,2
149647,FAM71A,chr1,F,212624446,212626778,96265779,2332,96265779,1736,0
155184,SLC2A7,chr1,R,8960852,9026384,96331311,65532,96331311,1737,14
163259,DENND2C,chr1,R,114584574,114670111,96416848,85537,96416848,1738,20
163351,GBP6,chr1,F,89363876,89388160,96441132,24284,96441132,1739,10
163404,LPPR5,chr1,R,98890244,99005809,96556697,115565,96556697,1740,7
163479,FNDC7,chr1,F,108712415,108743262,96587544,30847,96587544,1741,13
163486,DENND1B,chr1,R,197504747,197782175,96864972,277428,96864972,1742,29
163589,TDRD5,chr1,F,179591612,179691272,96964632,99660,96964632,1743,18
163590,TOR1AIP2,chr1,R,179839966,179877806,97002472,37840,97002472,1744,8
163688,CALML6,chr1,F,1913751,1917294,97006015,3543,97006015,1745,5
163702,IFNLR1,chr1,R,24154156,24187275,97039134,33119,97039134,1746,7
163720,CYP4Z2P,chr1,R,46843094,46900475,97096515,57381,97096515,1747,11
163732,CITED4,chr1,R,40861055,40862346,97097806,1291,97097806,1748,0
163742,SLC25A3P1,chr1,R,53438369,53440020,97099457,1651,97099457,1749,1
163747,C1orf177,chr1,F,54806062,54842264,97135659,36202,97135659,1750,12
163778,SPRR4,chr1,F,152970652,152972574,97137581,1922,97137581,1751,1
163782,KANK4,chr1,R,62236164,62319412,97220829,83248,97220829,1752,11
163786,SASS6,chr1,R,100083543,100133095,97270381,49552,97270381,1753,16
163859,SDE2,chr1,R,225982701,225999365,97287045,16664,97287045,1754,6
163882,CNST,chr1,F,246566336,246668587,97389296,102251,97389296,1755,13
163933,FAM43B,chr1,F,20552438,20555020,97391878,2582,97391878,1756,0
164045,HFM1,chr1,R,91260765,91408007,97539120,147242,97539120,1757,42
164091,PAQR7,chr1,R,25861483,25876707,97554344,15224,97554344,1758,4
164118,TTC24,chr1,F,156579726,156587797,97562415,8071,97562415,1759,10
164127,CCDC185,chr1,F,223393372,223395470,97564513,2098,97564513,1760,0
164153,UBL4B,chr1,F,110112439,110113947,97566021,1508,97566021,1761,0
170688,NUDT4P2,chr1,F,146297772,146301610,97569859,3838,97569859,1762,0
171423,PDIA3P1,chr1,F,147177850,147179949,97571958,2099,97571958,1763,0
192669,AGO3,chr1,F,35923402,36056747,97705303,133345,97705303,1764,23
192670,AGO4,chr1,F,35807629,35857890,97755564,50261,97755564,1765,19
199834,LCE4A,chr1,F,152709046,152709434,97755952,388,97755952,1766,0
199857,ALG14,chr1,R,94981564,95072964,97847352,91400,97847352,1767,5
199870,FAM76A,chr1,F,27725978,27762915,97884289,36937,97884289,1768,9
199882,LOC199882,chr1,R,143811356,143840630,97913563,29274,97913563,1769,10
199899,LINC00466,chr1,R,63159082,63317230,98071711,158148,98071711,1770,11
199920,C1orf168,chr1,R,56718803,56819696,98172604,100893,98172604,1771,25
199953,TMEM201,chr1,F,9588852,9614877,98198629,26025,98198629,1772,12
199964,TMEM61,chr1,F,54980594,54992293,98210328,11699,98210328,1773,3
199974,CYP4Z1,chr1,F,47067447,47118320,98261201,50873,98261201,1774,12
199990,C1orf86,chr1,R,2184459,2212720,98289462,28261,98289462,1775,17
200008,CDCP2,chr1,R,54138994,54153006,98303474,14012,98303474,1776,3
200010,SLC5A9,chr1,F,48222269,48248644,98329849,26375,98329849,1777,13
200014,CC2D1B,chr1,R,52350592,52366205,98345462,15613,98345462,1778,24
200030,NBPF11,chr1,R,148102045,148152190,98395607,50145,98395607,1779,24
200035,NUDT17,chr1,F,145844984,145848753,98399376,3769,98399376,1780,7
200058,FLJ23867,chr1,F,180198008,180200725,98402093,2717,98402093,1781,0
200081,TXLNA,chr1,F,32179694,32198285,98420684,18591,98420684,1782,10
200132,TCTEX1D1,chr1,F,66752456,66779047,98447275,26591,98447275,1783,5
200150,PLD5,chr1,R,242088386,242530544,98889433,442158,98889433,1784,19
200159,C1orf100,chr1,F,244352068,244389874,98927239,37806,98927239,1785,7
200162,SPAG17,chr1,R,117953664,118185225,99158800,231561,99158800,1786,55
200172,SLFNL1,chr1,R,41015596,41023444,99166648,7848,99166648,1787,5
200185,KRTCAP2,chr1,R,155169407,155173328,99170569,3921,99170569,1788,4
200186,CRTC2,chr1,R,153947671,153958656,99181554,10985,99181554,1789,14
200197,TMEM51-AS1,chr1,R,15111814,15152464,99222204,40650,99222204,1790,4
200205,IBA57,chr1,F,228165727,228197905,99254382,32178,99254382,1791,4
204851,HIPK1,chr1,F,113929196,113977869,99303055,48673,99303055,1792,23
204962,SLC44A5,chr1,R,75202130,75724322,99825247,522192,99825247,1793,33
219293,ATAD3C,chr1,F,1441300,1470158,99854105,28858,99854105,1794,13
246181,AKR7L,chr1,R,19265981,19274074,99862198,8093,99862198,1795,6
246182,AKR7A2P1,chr1,F,112923349,112924673,99863522,1324,99863522,1796,0
252839,TMEM9,chr1,R,201134770,201171582,99900334,36812,99900334,1797,6
252995,FNDC5,chr1,R,32862267,32872492,99910559,10225,99910559,1798,5
253152,EPHX4,chr1,F,92029975,92063536,99944120,33561,99944120,1799,6
254099,LINC01342,chr1,F,1137016,1144056,99951160,7040,99951160,1800,2
254173,TTLL10,chr1,F,1173897,1197935,99975198,24038,99975198,1801,18
254268,AKNAD1,chr1,R,108815897,108858242,100017543,42345,100017543,1802,16
254428,SLC41A1,chr1,R,205789092,205813759,100042210,24667,100042210,1803,11
254879,OR2T6,chr1,F,248387608,248388535,100043137,927,100043137,1804,0
254910,LCE5A,chr1,F,152510843,152512177,100044471,1334,100044471,1805,1
255104,TMCO4,chr1,R,19682212,19800353,100162612,118141,100162612,1806,21
255231,MCOLN2,chr1,R,84925582,84997122,100234152,71540,100234152,1807,17
255631,COL24A1,chr1,R,85729232,86156791,100661711,427559,100661711,1808,59
255654,LOC255654,chr1,R,246516038,246524287,100669960,8249,100669960,1809,2
255738,PCSK9,chr1,F,55039475,55064853,100695338,25378,100695338,1810,13
255928,SYT14,chr1,F,209938173,210164291,100921456,226118,100921456,1811,13
256435,ST6GALNAC3,chr1,F,76074703,76634601,101481354,559898,101481354,1812,6
257044,C1orf101,chr1,F,244452099,244640362,101669617,188263,101669617,1813,28
257101,ZNF683,chr1,R,26361631,26374533,101682519,12902,101682519,1814,9
257106,ARHGAP30,chr1,R,161046941,161069971,101705549,23030,101705549,1815,11
257177,CFAP126,chr1,R,161364730,161367883,101708702,3153,101708702,1816,4
257194,NEGR1,chr1,R,71402941,72282847,102588608,879906,102588608,1817,8
259266,ASPM,chr1,R,197084126,197146694,102651176,62568,102651176,1818,27
259283,MDS2,chr1,F,23627333,23640566,102664409,13233,102664409,1819,6
260293,CYP4X1,chr1,F,46961363,47050751,102753797,89388,102753797,1820,13
260425,MAGI3,chr1,F,113390473,113685923,103049247,295450,103049247,1821,21
261726,TIPRL,chr1,F,168178844,168202114,103072517,23270,103072517,1822,8
261734,NPHP4,chr1,R,5862807,5992505,103202215,129698,103202215,1823,35
266675,BEST4,chr1,R,44782044,44792828,103212999,10784,103212999,1824,13
267002,PGBD2,chr1,F,248872849,248919146,103259296,46297,103259296,1825,6
284467,FAM19A3,chr1,F,112718993,112727235,103267538,8242,103267538,1826,5
284485,RIIAD1,chr1,F,151721536,151729606,103275608,8070,103275608,1827,4
284486,THEM5,chr1,R,151847100,151853697,103282205,6597,103282205,1828,5
284498,C1orf167,chr1,F,11762182,11789585,103309608,27403,103309608,1829,26
284521,OR2L13,chr1,F,247937028,248100922,103473502,163894,103473502,1830,3
284525,SLC9C2,chr1,R,173500464,173603094,103576132,102630,103576132,1831,28
284532,OR14A16,chr1,R,247814799,247834858,103596191,20059,103596191,1832,3
284541,CYP4A22,chr1,F,47137434,47149738,103608495,12304,103608495,1833,11
284546,C1orf185,chr1,F,51102233,51148082,103654344,45849,103654344,1834,5
284551,LINC01226,chr1,F,31518434,31524245,103660155,5811,103660155,1835,2
284561,LOC284561,chr1,F,148279041,148291861,103672975,12820,103672975,1836,1
284565,NBPF15,chr1,R,144421385,144461667,103713257,40282,103713257,1837,23
284573,LINC00303,chr1,R,204032446,204041264,103722075,8818,103722075,1838,5
284576,LEMD1-AS1,chr1,F,205373251,205387440,103736264,14189,103736264,1839,3
284577,LOC284577,chr1,F,205455921,205469106,103749449,13185,103749449,1840,2
284578,LOC284578,chr1,R,205554272,205556635,103751812,2363,103751812,1841,0
284581,LOC284581,chr1,F,205862078,205896087,103785821,34009,103785821,1842,3
284593,FAM41C,chr1,R,868070,876802,103794553,8732,103794553,1843,2
284600,LOC284600,chr1,F,905114,920484,103809923,15370,103809923,1844,5
284611,FAM102B,chr1,F,108560348,108639327,103888902,78979,103888902,1845,10
284612,SYPL2,chr1,F,109466477,109482142,103904567,15665,103904567,1846,5
284613,CYB561D1,chr1,F,109494035,109500441,103910973,6406,103910973,1847,3
284615,ANKRD34A,chr1,R,145959440,145964591,103916124,5151,103916124,1848,2
284618,RUSC1-AS1,chr1,R,155320459,155324147,103919812,3688,103919812,1849,2
284632,LOC284632,chr1,F,24200239,24211690,103931263,11451,103931263,1850,2
284648,LOC284648,chr1,F,182615139,182616629,103932753,1490,103932753,1851,0
284649,SMG7-AS1,chr1,R,183460873,183471982,103943862,11109,103943862,1852,4
284654,RSPO1,chr1,R,37611349,37634923,103967436,23574,103967436,1853,7
284656,EPHA10,chr1,R,37713885,37765152,104018703,51267,104018703,1854,19
284661,LOC284661,chr1,F,4412050,4424684,104031337,12634,104031337,1855,5
284677,C1orf204,chr1,R,159834473,159855347,104052211,20874,104052211,1856,5
284680,C1orf111,chr1,R,162373724,162376925,104055412,3201,104055412,1857,3
284688,LINC01142,chr1,R,170271404,170284208,104068216,12804,104068216,1858,3
284695,ZNF326,chr1,F,89995118,90028538,104101636,33420,104101636,1859,11
284697,BTBD8,chr1,F,92080304,92147840,104169172,67536,104169172,1860,8
284702,HNRNPU-AS1,chr1,R,244840637,244846941,104175476,6304,104175476,1861,1
284716,RIMKLA,chr1,F,42380796,42424229,104218909,43433,104218909,1862,4
284723,SLC25A34,chr1,F,15735087,15741392,104225214,6305,104225214,1863,5
284729,ESPNP,chr1,R,16691217,16720157,104254154,28940,104254154,1864,10
286826,LIN9,chr1,R,226231148,226310099,104333105,78951,104333105,1865,17
317705,VN1R5,chr1,F,247256071,247257145,104334179,1074,104334179,1866,0
317772,HIST2H2AB,chr1,R,149887468,149887916,104334627,448,104334627,1867,0
333926,PPM1J,chr1,R,112709993,112715328,104339962,5335,104339962,1868,9
333932,HIST2H3A,chr1,F,149852618,149853125,104340469,507,104340469,1869,0
337873,HIST2H2BC,chr1,R,149850191,149850773,104341051,582,104341051,1870,0
337875,HIST2H2BA,chr1,R,121108440,121117251,104349862,8811,104349862,1871,1
338094,FAM151A,chr1,R,54609176,54623527,104364213,14351,104364213,1872,8
338324,S100A7A,chr1,F,153416523,153423225,104370915,6702,104370915,1873,2
338382,RAB7B,chr1,R,205976739,206003495,104397671,26756,104397671,1874,6
339398,LINGO4,chr1,R,151800263,151805442,104402850,5179,104402850,1875,1
339400,FLG-AS1,chr1,F,152313458,152366692,104456084,53234,104456084,1876,7
339403,RXFP4,chr1,F,155941688,155942834,104457230,1146,104457230,1877,0
339416,ANKRD45,chr1,R,173608335,173705267,104554162,96932,104554162,1878,13
339442,LINC01343,chr1,R,38209033,38214767,104559896,5734,104559896,1879,3
339448,C1orf174,chr1,R,3889132,3900293,104571057,11161,104571057,1880,5
339451,KLHL17,chr1,F,959951,965720,104576826,5769,104576826,1881,11
339453,TMEM240,chr1,R,1534777,1540360,104582409,5583,104582409,1882,3
339456,TMEM52,chr1,R,1917588,1919301,104584122,1713,104584122,1883,4
339468,LOC339468,chr1,F,72765015,72794882,104613989,29867,104613989,1884,7
339479,BRINP3,chr1,R,190097661,190478404,104994732,380743,104994732,1885,13
339483,MTMR9LP,chr1,R,32231659,32241710,105004783,10051,105004783,1886,6
339487,ZBTB8OS,chr1,R,32620819,32651013,105034977,30194,105034977,1887,7
339488,TFAP2E,chr1,F,35573369,35595328,105056936,21959,105056936,1888,6
339500,ZNF678,chr1,F,227563518,227677443,105170861,113925,105170861,1889,5
339501,PRSS38,chr1,F,227815691,227860439,105215609,44748,105215609,1890,6
339505,LINC01141,chr1,R,20359800,20428794,105284603,68994,105284603,1891,11
339512,C1orf110,chr1,R,162846565,162868900,105306938,22335,105306938,1892,5
339524,LINC01140,chr1,F,87129764,87169204,105346378,39440,105346378,1893,5
339529,LOC339529,chr1,F,243917401,244047317,105476294,129916,105476294,1894,11
339535,LINC01139,chr1,R,238480383,238486017,105481928,5634,105481928,1895,1
339539,LOC339539,chr1,F,42857621,42888792,105513099,31171,105513099,1896,3
339541,C1orf228,chr1,F,44674693,44725591,105563997,50898,105563997,1897,17
339559,ZFP69,chr1,F,40477219,40496343,105583121,19124,105583121,1898,5
343035,RD3,chr1,R,211476521,211492917,105599517,16396,105599517,1899,2
343052,LOC343052,chr1,F,153793946,153796302,105601873,2356,105601873,1900,2
343066,AADACL4,chr1,F,12644546,12667086,105624413,22540,105624413,1901,7
343068,PRAMEF5,chr1,F,13254197,13263435,105633651,9238,105633651,1902,3
343069,HNRNPCL1,chr1,R,12847376,12848756,105635031,1380,105635031,1903,1
343070,PRAMEF9,chr1,F,13175280,13179132,105638883,3852,105638883,1904,2
343071,PRAMEF10,chr1,R,12892895,12898270,105644258,5375,105644258,1905,3
343099,CCDC18,chr1,F,93180329,93279037,105742966,98708,105742966,1906,34
343169,OR6F1,chr1,R,247711828,247712755,105743893,927,105743893,1907,0
343171,OR2W3,chr1,F,247895586,247896531,105744838,945,105744838,1908,0
343172,OR2T8,chr1,F,247912252,247923152,105755738,10900,105755738,1909,3
343173,OR2T3,chr1,F,248473350,248474307,105756695,957,105756695,1910,0
343263,MYBPHL,chr1,R,109292364,109307041,105771372,14677,105771372,1911,8
343406,OR10R2,chr1,F,158479877,158480885,105772380,1008,105772380,1912,0
343413,FCRL6,chr1,F,159800510,159816257,105788127,15747,105788127,1913,10
343450,KCNT2,chr1,R,196225778,196608560,106170909,382782,106170909,1914,30
343472,BARHL2,chr1,R,90712021,90717237,106176125,5216,106176125,1915,2
343505,NBPF7,chr1,R,119833729,119844880,106187276,11151,106187276,1916,8
343521,TCTEX1D4,chr1,R,44805907,44807442,106188811,1535,106188811,1917,0
343563,OR2T29,chr1,R,248558543,248559491,106189759,948,106189759,1918,0
347735,SERINC2,chr1,F,31409564,31434680,106214875,25116,106214875,1919,13
348378,FAM159A,chr1,F,52631438,52669120,106252557,37682,106252557,1920,7
348487,FAM131C,chr1,R,16057768,16073632,106268421,15864,106268421,1921,8
353131,LCE1A,chr1,F,152827472,152828097,106269046,625,106269046,1922,0
353132,LCE1B,chr1,F,152811970,152813109,106270185,1139,106270185,1923,0
353133,LCE1C,chr1,R,152804834,152806631,106271982,1797,106271982,1924,1
353134,LCE1D,chr1,F,152796750,152798181,106273413,1431,106273413,1925,1
353135,LCE1E,chr1,F,152786276,152788426,106275563,2150,106275563,1926,1
353137,LCE1F,chr1,F,152776371,152776969,106276161,598,106276161,1927,0
353139,LCE2A,chr1,F,152698363,152699442,106277240,1079,106277240,1928,1
353140,LCE2C,chr1,F,152675314,152676574,106278500,1260,106278500,1929,1
353141,LCE2D,chr1,F,152663410,152664659,106279749,1249,106279749,1930,1
353142,LCE3A,chr1,R,152622833,152623103,106280019,270,106280019,1931,0
353143,LCE3B,chr1,F,152613810,152614098,106280307,288,106280307,1932,0
353144,LCE3C,chr1,F,152600661,152601086,106280732,425,106280732,1933,0
353145,LCE3E,chr1,R,152565653,152566770,106281849,1117,106281849,1934,1
353238,PADI6,chr1,F,17372195,17401699,106311353,29504,106311353,1935,15
353299,RGSL1,chr1,F,182449216,182560597,106422734,111381,106422734,1936,33
353500,BMP8A,chr1,F,39491633,39529869,106460970,38236,106460970,1937,9
359948,IRF2BP2,chr1,R,234604268,234609525,106466227,5257,106466227,1938,1
360023,ZBTB41,chr1,R,197153683,197200542,106513086,46859,106513086,1939,11
360155,CYCSP52,chr1,F,157128361,157128671,106513396,310,106513396,1940,0
374946,DRAXIN,chr1,F,11686646,11720612,106547362,33966,106547362,1941,9
374955,SPATA21,chr1,R,16387116,16437842,106598088,50726,106598088,1942,21
374969,CCDC23,chr1,R,42807051,42817388,106608425,10337,106608425,1943,2
374973,TEX38,chr1,F,46669345,46673594,106612674,4249,106612674,1944,2
374977,MROH7,chr1,F,54641739,54710267,106681202,68528,106681202,1945,23
374986,FAM73A,chr1,F,77779621,77879540,106781121,99919,106781121,1946,17
374987,NEXN-AS1,chr1,R,77881347,77889539,106789313,8192,106789313,1947,2
375033,PEAR1,chr1,F,156893691,156916434,106812056,22743,106812056,1948,24
375035,SFT2D2,chr1,F,168226016,168242850,106828890,16834,106828890,1949,7
375056,MIA3,chr1,F,222618101,222668012,106878801,49911,106878801,1950,30
375057,C1orf95,chr1,F,226548247,226609214,106939768,60967,106939768,1951,3
375061,FAM89A,chr1,R,231018957,231040249,106961060,21292,106961060,1952,1
375790,AGRN,chr1,F,1020100,1056119,106997079,36019,106997079,1953,39
376693,RPS10P7,chr1,F,201519903,201520602,106997778,699,106997778,1954,0
378708,APITD1,chr1,F,10430101,10442815,107010492,12714,107010492,1955,5
378807,CATSPER4,chr1,F,26190586,26202542,107022448,11956,107022448,1956,10
387338,NSUN4,chr1,F,46340176,46365152,107047424,24976,107047424,1957,6
387509,GPR153,chr1,R,6247345,6260990,107061069,13645,107061069,1958,5
387597,ILDR2,chr1,R,166913203,166989093,107136959,75890,107136959,1959,15
388581,FAM132A,chr1,R,1242445,1247218,107141732,4773,107141732,1960,8
388585,HES5,chr1,R,2528744,2530245,107143233,1501,107143233,1961,1
388588,SMIM1,chr1,F,3772760,3775982,107146455,3222,107146455,1962,3
388591,RNF207,chr1,F,6205774,6221299,107161980,15525,107161980,1963,18
388595,TMEM82,chr1,F,15742491,15747797,107167286,5306,107167286,1964,5
388610,TRNP1,chr1,F,26993666,27000886,107174506,7220,107174506,1965,1
388611,CD164L2,chr1,R,27379099,27383333,107178740,4234,107178740,1966,4
388630,TRABD2B,chr1,R,47760527,47997371,107415584,236844,107415584,1967,10
388633,LDLRAD1,chr1,R,54007297,54018186,107426473,10889,107426473,1968,5
388646,GBP7,chr1,R,89131750,89176040,107470763,44290,107470763,1969,10
388649,C1orf146,chr1,F,92217911,92245812,107498664,27901,107498664,1970,7
388650,FAM69A,chr1,R,92832728,92961522,107627458,128794,107627458,1971,6
388662,SLC6A17,chr1,F,110150509,110202202,107679151,51693,107679151,1972,12
388667,C1orf137,chr1,F,116694111,116706603,107691643,12492,107691643,1973,3
388677,NOTCH2NL,chr1,R,146151907,146229032,107768768,77125,107768768,1974,4
388685,LINC01138,chr1,R,148432958,148459920,107795730,26962,107795730,1975,4
388692,LOC388692,chr1,F,143792494,143797108,107800344,4614,107800344,1976,1
388695,LYSMD1,chr1,R,151156809,151165948,107809483,9139,107809483,1977,3
388697,HRNR,chr1,R,152212075,152224196,107821604,12121,107821604,1978,2
388698,FLG2,chr1,R,152348734,152360010,107832880,11276,107832880,1979,2
388699,LINC00302,chr1,F,152655428,152656805,107834257,1377,107834257,1980,2
388701,C1orf189,chr1,R,154199084,154206365,107841538,7281,107841538,1981,3
388714,FMO6P,chr1,F,171137739,171161563,107865362,23824,107865362,1982,6
388719,LINC00272,chr1,F,182407620,182414813,107872555,7193,107872555,1983,3
388722,C1orf53,chr1,F,197902551,197907367,107877371,4816,107877371,1984,2
388730,TMEM81,chr1,R,205083128,205084460,107878703,1332,107878703,1985,0
388743,CAPN8,chr1,R,223541608,223558167,107895262,16559,107895262,1986,8
388743,CAPN8,chr1,R,223609152,223665734,107951844,56582,107951844,1987,11
388753,COA6,chr1,F,234373436,234384049,107962457,10613,107962457,1988,2
388759,C1orf229,chr1,R,247110159,247112417,107964715,2258,107964715,1989,0
388762,OR2M1P,chr1,F,248122135,248122780,107965360,645,107965360,1990,0
390992,HES3,chr1,F,6244157,6245578,107966781,1421,107966781,1991,3
390999,PRAMEF12,chr1,F,12763222,12777906,107981465,14684,107981465,1992,4
391002,PRAMEF8,chr1,R,13281303,13285137,107985299,3834,107985299,1993,3
391003,LOC391003,chr1,R,13222694,13226154,107988759,3460,107988759,1994,2
391004,PRAMEF17,chr1,F,13389631,13392629,107991757,2998,107991757,1995,2
391013,PLA2G2C,chr1,R,20163990,20175194,108002961,11204,108002961,1996,2
391037,SKINTL,chr1,R,48101714,48182428,108083675,80714,108083675,1997,9
391051,UOX,chr1,R,84364957,84397893,108116611,32936,108116611,1998,8
391059,FRRS1,chr1,R,99708631,99766630,108174610,57999,108174610,1999,19
391104,VHLL,chr1,R,156298623,156299637,108175624,1014,108175624,2000,0
391107,OR10K2,chr1,R,158419927,158420866,108176563,939,108176563,2001,0
391109,OR10K1,chr1,F,158465561,158466503,108177505,942,108177505,2002,0
391112,OR6Y1,chr1,R,158547127,158548105,108178483,978,108178483,2003,0
391114,OR6K3,chr1,R,158717167,158718115,108179431,948,108179431,2004,0
391123,VSIG8,chr1,R,159854315,159862657,108187773,8342,108187773,2005,6
391189,OR11L1,chr1,R,247840927,247841896,108188742,969,108188742,2006,0
391190,OR2L8,chr1,F,247948857,247949796,108189681,939,108189681,2007,0
391191,OR2AK2,chr1,F,247965331,247966339,108190689,1008,108190689,2008,0
391192,OR2L3,chr1,F,248060681,248061620,108191628,939,108191628,2009,0
391194,OR2M2,chr1,F,248179985,248181029,108192672,1044,108192672,2010,0
391195,OR2T33,chr1,R,248272851,248273814,108193635,963,108193635,2011,0
391196,OR2M7,chr1,R,248323629,248324568,108194574,939,108194574,2012,0
391211,OR2G6,chr1,F,248521646,248522597,108195525,951,108195525,2013,0
399474,TMEM200B,chr1,R,29119424,29129134,108205235,9710,108205235,2014,3
400728,FAM87B,chr1,F,817370,819834,108207699,2464,108207699,2015,1
400735,PRAMEF4,chr1,R,12879211,12886201,108214689,6990,108214689,2016,3
400736,LOC400736,chr1,R,13196187,13201409,108219911,5222,108219911,2017,4
400745,SH2D5,chr1,R,20719730,20732640,108232821,12910,108232821,2018,11
400746,NCMAP,chr1,F,24556075,24609328,108286074,53253,108286074,2019,5
400748,LOC400748,chr1,F,30858157,30860254,108288171,2097,108288171,2020,1
400752,LINC01144,chr1,F,45303909,45305619,108289881,1710,108289881,2021,0
400757,C1orf141,chr1,R,67092175,67141645,108339351,49470,108339351,2022,14
400759,GBP1P1,chr1,F,89407678,89424934,108356607,17256,108356607,2023,4
400761,FLJ27354,chr1,R,89624848,89632894,108364653,8046,108364653,2024,2
400765,MIR137HG,chr1,R,97987999,98049693,108426347,61694,108426347,2025,4
400793,C1orf226,chr1,F,162378905,162386818,108434260,7913,108434260,2026,2
400794,LOC400794,chr1,R,165476841,165582104,108539523,105263,108539523,2027,6
400797,LINC00083,chr1,R,178478152,178499619,108560990,21467,108560990,2028,10
400798,C1orf220,chr1,F,178542795,178548889,108567084,6094,108567084,2029,2
400799,LINC01344,chr1,R,182203944,182314061,108677201,110117,108677201,2030,2
400800,LOC400800,chr1,F,199148597,199393307,108921911,244710,108921911,2031,3
400804,C1orf140,chr1,R,221329927,221336296,108928280,6369,108928280,2032,1
400818,NBPF9,chr1,R,149054032,149090861,108965109,36829,108965109,2033,25
400823,FAM177B,chr1,F,222737215,222753727,108981621,16512,108981621,2034,7
401934,RNF223,chr1,R,1071745,1074307,108984183,2562,108984183,2035,1
401944,LDLRAD2,chr1,F,21812264,21825221,108997140,12957,108997140,2036,3
401992,OR2T2,chr1,F,248449061,248548832,109096911,99771,109096911,2037,2
401993,OR2T5,chr1,F,248488588,248489536,109097859,948,109097859,2038,0
401994,OR14I1,chr1,R,248483421,248698899,109313337,215478,109313337,2039,7
402779,CSMD2-AS1,chr1,F,33868955,33885458,109329840,16503,109329840,2040,7
403239,OR2T27,chr1,R,248649930,248650884,109330794,954,109330794,2041,0
403244,OR2T35,chr1,R,248638286,248642735,109335243,4449,109335243,2042,1
403314,APOBEC4,chr1,R,183646274,183653313,109342282,7039,109342282,2043,1
406893,MIR101-1,chr1,R,65058433,65058508,109342357,75,109342357,2044,0
406928,MIR137,chr1,R,98046069,98046171,109342459,102,109342459,2045,0
406955,MIR181B1,chr1,R,198858872,198858982,109342569,110,109342569,2046,0
406962,MIR186,chr1,R,71067630,71067716,109342655,86,109342655,2047,0
406969,MIR194-1,chr1,R,220118156,220118241,109342740,85,109342740,2048,0
406974,MIR197,chr1,F,109598892,109598967,109342815,75,109342815,2049,0
406977,MIR199A2,chr1,R,172144534,172144644,109342925,110,109342925,2050,0
406983,MIR200A,chr1,F,1167862,1167952,109343015,90,109343015,2051,0
406984,MIR200B,chr1,F,1167103,1167198,109343110,95,109343110,2052,0
406988,MIR205,chr1,F,209432132,209432242,109343220,110,109343220,2053,0
406995,MIR181A1,chr1,R,198859043,198859153,109343330,110,109343330,2054,0
406996,MIR214,chr1,R,172138797,172138907,109343440,110,109343440,2055,0
406997,MIR215,chr1,R,220117852,220117962,109343550,110,109343550,2056,0
407025,MIR29B2,chr1,R,207802442,207802523,109343631,81,109343631,2057,0
407026,MIR29C,chr1,R,207801851,207801939,109343719,88,109343719,2058,0
407031,MIR30C1,chr1,F,40757283,40757372,109343808,89,109343808,2059,0
407034,MIR30E,chr1,F,40754354,40754446,109343900,92,109343900,2060,0
407040,MIR34A,chr1,R,9151667,9151777,109344010,110,109344010,2061,0
407046,MIR9-1,chr1,R,156420340,156420429,109344099,89,109344099,2062,0
414927,MGC34796,chr1,F,61654241,61656128,109345986,1887,109345986,2063,0
431704,RGS21,chr1,F,192316991,192367285,109396280,50294,109396280,2064,4
431707,LHX8,chr1,F,75128433,75161533,109429380,33100,109429380,2065,11
439927,LINC01555,chr1,R,84628229,84635020,109436171,6791,109436171,2066,2
440556,LINC00982,chr1,R,3059616,3067725,109444280,8109,109444280,2067,5
440560,PRAMEF11,chr1,R,12824379,12831410,109451311,7031,109451311,2068,3
440561,PRAMEF6,chr1,R,12938471,12947580,109460420,9109,109460420,2069,3
440563,HNRNPCL2,chr1,R,13115487,13116854,109461787,1367,109461787,2070,1
440567,UQCRHL,chr1,R,15807161,15807699,109462325,538,109462325,2071,0
440574,MINOS1,chr1,F,19596976,19629821,109495170,32845,109495170,2072,6
440584,SLC2A1-AS1,chr1,F,42959048,42983358,109519480,24310,109519480,2073,3
440585,FAM183A,chr1,F,43142978,43156396,109532898,13418,109532898,2074,4
440590,ZYG11A,chr1,F,52842510,52894575,109584963,52065,109584963,2075,14
440594,FLJ31662,chr1,F,95474736,95479356,109589583,4620,109589583,2076,3
440600,LOC440600,chr1,R,110286374,110339171,109642380,52797,109642380,2077,3
440602,LOC440602,chr1,R,110487679,110490258,109644959,2579,109644959,2078,1
440603,BCL2L15,chr1,R,113876813,113887547,109655693,10734,109655693,2079,3
440672,NUDT4P1,chr1,F,148748599,148752401,109659495,3802,109659495,2080,0
440689,HIST2H2BF,chr1,R,149755103,149813123,109717515,58020,109717515,2081,4
440695,ETV3L,chr1,R,157092042,157099808,109725281,7766,109725281,2082,4
440699,LRRC52,chr1,F,165544240,165563948,109744989,19708,109744989,2083,1
440700,LOC440700,chr1,F,165698749,165709968,109756208,11219,109756208,2084,3
440704,LOC440704,chr1,F,190624889,190801658,109932977,176769,109932977,2085,4
440712,C1orf186,chr1,F,206052722,206102701,109982956,49979,109982956,2086,6
440730,TRIM67,chr1,F,231162623,231221568,110041901,58945,110041901,2087,9
440738,MAP1LC3C,chr1,R,241995489,242001399,110047811,5910,110047811,2088,4
440742,LOC440742,chr1,F,244064613,244065102,110048300,489,110048300,2089,0
441124,LOC441124,chr1,R,223983031,223992644,110057913,9613,110057913,2090,6
441869,ANKRD65,chr1,R,1418419,1421820,110061314,3401,110061314,2091,2
441871,PRAMEF7,chr1,F,12916646,12920480,110065148,3834,110065148,2092,3
441873,PRAMEF25,chr1,F,13073677,13078038,110069509,4361,110069509,2093,2
441897,PGCP1,chr1,R,111384518,111389851,110074842,5333,110074842,2094,4
441908,NBPF18P,chr1,F,152018277,152022509,110079074,4232,110079074,2095,5
441911,OR10J3,chr1,R,159313669,159314659,110080064,990,110080064,2096,0
441925,BECN2,chr1,F,241957766,241959062,110081360,1296,110081360,2097,0
441932,OR2W5,chr1,F,247491067,247492409,110082702,1342,110082702,2098,0
441933,OR13G1,chr1,R,247672117,247673041,110083626,924,110083626,2099,0
442891,MIR135B,chr1,R,205448301,205448398,110083723,97,110083723,2100,0
448834,KPRP,chr1,F,152758029,152762053,110087747,4024,110087747,2101,2
448835,LCE6A,chr1,F,152842853,152843983,110088877,1130,110088877,2102,1
474338,SUMO1P3,chr1,F,160317264,160318474,110090087,1210,110090087,2103,0
492303,GEMIN8P4,chr1,R,89993264,89994966,110091789,1702,110091789,2104,0
494115,RBMXL1,chr1,R,88979455,88992960,110105294,13505,110105294,2105,13
541468,LURAP1,chr1,F,46203333,46221256,110123217,17923,110123217,2106,1
553115,PEF1,chr1,R,31629861,31645237,110138593,15376,110138593,2107,8
554210,MIR429,chr1,F,1169004,1169087,110138676,83,110138676,2108,0
554279,LINC00862,chr1,R,200342543,200373792,110169925,31249,110169925,2109,4
554282,FAM72C,chr1,R,143955363,143974205,110188767,18842,110188767,2110,6
554313,HIST2H4B,chr1,R,149860763,149861159,110189163,396,110189163,2111,0
574029,DUSP5P1,chr1,F,228644909,228652412,110196666,7503,110196666,2112,1
574036,SERTAD4-AS1,chr1,R,210231458,210234121,110199329,2663,110199329,2113,1
574406,ADAMTSL4-AS1,chr1,R,150560894,150574552,110212987,13658,110212987,2114,3
574407,C1orf145,chr1,R,228203505,228213664,110223146,10159,110223146,2115,4
574414,PRR9,chr1,F,153205161,153219317,110237302,14156,110237302,2116,5
574432,IBA57-AS1,chr1,R,228164085,228165512,110238729,1427,110238729,2117,2
574441,MIR488,chr1,R,177029362,177029445,110238812,83,110238812,2118,0
606495,CYB5RL,chr1,R,54172335,54200073,110266550,27738,110266550,2119,7
619498,SNORD74,chr1,R,173867673,173867745,110266622,72,110266622,2120,0
619518,SSBP3-AS1,chr1,F,54236442,54239063,110269243,2621,110269243,2121,0
641311,RPL31P11,chr1,R,161683694,161685252,110270801,1558,110270801,2122,0
641515,MGAT4EP,chr1,F,202820256,202827225,110277770,6969,110277770,2123,2
642587,MIR205HG,chr1,F,209428822,209432552,110281500,3730,110281500,2124,3
642864,SPATA42,chr1,F,108857216,108858524,110282808,1308,110282808,2125,2
642946,FLVCR1-AS1,chr1,R,212856603,212858138,110284343,1535,110284343,2126,1
643160,CYMP,chr1,F,110480765,110491269,110294847,10504,110294847,2127,8
643314,KIAA0754,chr1,F,39409503,39416482,110301826,6979,110301826,2128,0
643355,LOC643355,chr1,F,111989994,111998842,110310674,8848,110310674,2129,3
643441,LOC643441,chr1,R,113196780,113206253,110320147,9473,110320147,2130,2
643723,LYPLAL1-AS1,chr1,R,219080972,219173788,110412963,92816,110412963,2131,4
643837,LINC01128,chr1,F,827590,859446,110444819,31856,110444819,2132,7
643965,TMEM88B,chr1,F,1426127,1427787,110446479,1660,110446479,2133,1
643988,C1orf233,chr1,R,1598007,1600096,110448568,2089,110448568,2134,0
644068,RPS14P3,chr1,F,19607806,19608644,110449406,838,110449406,2135,0
644083,LOC644083,chr1,F,19399984,19400561,110449983,577,110449983,2136,0
644242,LINC00622,chr1,R,119597701,119599291,110451573,1590,110451573,2137,0
644591,PPIAL4G,chr1,R,148482547,148483285,110452311,738,110452311,2138,0
644634,FAM231D,chr1,F,149701424,149705717,110456604,4293,110456604,2139,1
644861,NBPF13P,chr1,R,147099481,147114346,110471469,14865,110471469,2140,5
644961,ACTG1P20,chr1,F,27323873,27326525,110474121,2652,110474121,2141,0
644997,PIK3CD-AS1,chr1,R,9652609,9654586,110476098,1977,110476098,2142,1
645030,NFIA-AS1,chr1,R,61248944,61253518,110480672,4574,110480672,2143,3
645142,PPIAL4D,chr1,R,145241414,145242199,110481457,785,110481457,2144,0
645166,LOC645166,chr1,F,144716078,144740806,110506185,24728,110506185,2145,5
645339,SNRPD2P2,chr1,R,231475761,231476525,110506949,764,110506949,2146,0
645354,LOC645354,chr1,F,13127068,13132274,110512155,5206,110512155,2147,3
645359,PRAMEF26,chr1,R,13148750,13153111,110516516,4361,110516516,2148,2
645382,LOC645382,chr1,F,13303515,13309027,110522028,5512,110522028,2149,3
645414,PRAMEF19,chr1,R,13368430,13371947,110525545,3517,110525545,2150,2
645425,PRAMEF20,chr1,F,13410449,13421354,110536450,10905,110536450,2151,3
645520,FAM138A,chr1,R,34610,36081,110537921,1471,110537921,2152,2
645676,ASH1L-AS1,chr1,F,155561980,155563944,110539885,1964,110539885,2153,0
645682,POU5F1P4,chr1,F,155433179,155434262,110540968,1083,110540968,2154,0
645745,MT1HL1,chr1,R,237004102,237004418,110541284,316,110541284,2155,0
645884,RPS7P5,chr1,F,240007523,240013260,110547021,5737,110547021,2156,1
645922,S100A7L2,chr1,R,153436994,153440027,110550054,3033,110550054,2157,2
646262,LACTBL1,chr1,R,22953042,22972316,110569328,19274,110569328,2158,6
646268,LOC646268,chr1,R,158132043,158140640,110577925,8597,110577925,2159,2
646471,LOC646471,chr1,R,25819953,25823606,110581578,3653,110581578,2160,0
646626,LOC646626,chr1,F,85276357,85278088,110583309,1731,110583309,2161,1
646627,LYPD8,chr1,R,248721229,248755792,110617872,34563,110617872,2162,9
646817,SETSIP,chr1,R,92074435,92075472,110618909,1037,110618909,2163,0
647070,LOC647070,chr1,R,182836004,182840325,110623230,4321,110623230,2164,5
647121,EMBP1,chr1,F,121519111,121571888,110676007,52777,110676007,2165,7
647135,SRGAP2B,chr1,R,144887190,145095328,110884145,208138,110884145,2166,11
647215,MROH3P,chr1,F,200916634,200966676,110934187,50042,110934187,2167,22
647219,ASCL5,chr1,R,201113952,201115372,110935607,1420,110935607,2168,0
648740,ACTG1P4,chr1,F,103569403,103571391,110937595,1988,110937595,2169,0
649324,LOC649324,chr1,R,13094514,13099717,110942798,5203,110942798,2170,3
649330,HNRNPCL3,chr1,F,13061231,13062237,110943804,1006,110943804,2171,0
653121,ZBTB8A,chr1,F,32539144,32605950,111010610,66806,111010610,2172,4
653149,NBPF6,chr1,F,108421488,108471903,111061025,50415,111061025,2173,21
653160,LOC653160,chr1,R,34975698,34978706,111064033,3008,111064033,2174,2
653464,SRGAP2C,chr1,F,121184966,121392824,111271891,207858,111271891,2175,12
653505,PPIAL4B,chr1,F,120889745,120890530,111272676,785,111272676,2176,0
653513,LOC653513,chr1,R,149197558,149201146,111276264,3588,111276264,2177,2
653519,GPR89A,chr1,F,145607959,145670977,111339282,63018,111339282,2178,16
653598,PPIAL4C,chr1,F,149583822,149584607,111340067,785,111340067,2179,0
653604,HIST2H3D,chr1,R,149813224,149813681,111340524,457,111340524,2180,0
653606,PRAMEF22,chr1,F,13005047,13005624,111341101,577,111341101,2181,0
653619,PRAMEF15,chr1,F,13315580,13322595,111348116,7015,111348116,2182,3
653635,WASH7P,chr1,R,14361,29370,111363125,15009,111363125,2183,10
653820,FAM72B,chr1,R,121167645,121186896,111382376,19251,111382376,2184,6
654790,PCP4L1,chr1,F,161258726,161285450,111409100,26724,111409100,2185,2
677679,SCARNA3,chr1,R,175968396,175968540,111409244,144,111409244,2186,0
677766,SCARNA2,chr1,F,109100192,109100612,111409664,420,111409664,2187,0
677771,SCARNA4,chr1,R,155925957,155926086,111409793,129,111409793,2188,0
677774,SCARNA1,chr1,F,27834400,27834566,111409959,166,111409959,2189,0
677802,SNORA14B,chr1,R,235127802,235127937,111410094,135,111410094,2190,0
677818,SNORA36B,chr1,R,220200545,220200676,111410225,131,111410225,2191,0
677823,SNORA80E,chr1,R,155919908,155920042,111410359,134,111410359,2192,0
677825,SNORA44,chr1,R,28580380,28580512,111410491,132,111410491,2193,0
677834,SNORA55,chr1,R,39567373,39567510,111410628,137,111410628,2194,0
677838,SNORA61,chr1,R,28579763,28579893,111410758,130,111410758,2195,0
677843,SNORA77,chr1,F,203729580,203729705,111410883,125,111410883,2196,0
677885,SNORA59A,chr1,F,12507245,12507397,111411035,152,111411035,2197,0
692073,SNORA16A,chr1,R,28580919,28581053,111411169,134,111411169,2198,0
692085,SNORD45C,chr1,F,75787071,75787149,111411247,78,111411247,2199,0
692157,SNORA16B,chr1,F,212352817,212352950,111411380,133,111411380,2200,0
692195,SNORD75,chr1,R,173866878,173866938,111411440,60,111411440,2201,0
692196,SNORD76,chr1,R,173866634,173866715,111411521,81,111411521,2202,0
692197,SNORD77,chr1,R,173866310,173866371,111411582,61,111411582,2203,0
692198,SNORD78,chr1,R,173865632,173865686,111411636,54,111411636,2204,0
692200,SNORD85,chr1,R,30968162,30968237,111411711,75,111411711,2205,0
692212,SNORD99,chr1,R,28578742,28578822,111411791,80,111411791,2206,0
692234,SNORD103A,chr1,R,30935688,30935776,111411879,88,111411879,2207,0
692235,SNORD103B,chr1,R,30949117,30949205,111411967,88,111411967,2208,0
693135,MIR551A,chr1,R,3560694,3560790,111412063,96,111412063,2209,0
693137,MIR552,chr1,R,34669598,34669694,111412159,96,111412159,2210,0
693138,MIR553,chr1,F,100281240,100281308,111412227,68,111412227,2211,0
693139,MIR554,chr1,F,151545795,151545891,111412323,96,111412323,2212,0
693140,MIR555,chr1,R,155346349,155346445,111412419,96,111412419,2213,0
693141,MIR556,chr1,F,162342545,162342640,111412514,95,111412514,2214,0
693142,MIR557,chr1,F,168375523,168375621,111412612,98,111412612,2215,0
693235,MIR92B,chr1,F,155195176,155195272,111412708,96,111412708,2216,0
723790,HIST2H2AA4,chr1,F,149851060,149851594,111413242,534,111413242,2217,0
727684,C1orf195,chr1,R,15164195,15171624,111420671,7429,111420671,2218,3
728116,ZBTB8B,chr1,F,32465056,32487859,111443474,22803,111443474,2219,3
728431,LINC01137,chr1,R,37454878,37474443,111463039,19565,111463039,2220,2
728448,PPIEL,chr1,R,39522279,39559698,111500458,37419,111500458,2221,8
728463,TGFB2-AS1,chr1,R,218344195,218345678,111501941,1483,111501941,2222,2
728621,CCDC30,chr1,F,42463317,42654664,111693288,191347,111693288,2223,23
728642,CDK11A,chr1,R,1702729,1724352,111714911,21623,111714911,2224,19
728661,SLC35E2B,chr1,R,1660024,1692804,111747691,32780,111747691,2225,10
728716,LINC01346,chr1,F,3940611,3952583,111759663,11972,111759663,2226,2
728833,FAM72D,chr1,F,145093797,145112692,111778558,18895,111778558,2227,6
728841,NBPF8,chr1,F,120416594,120467844,111829808,51250,111829808,2228,27
728855,LINC00623,chr1,F,120912237,120955811,111873382,43574,111873382,2229,2
728945,PPIAL4F,chr1,F,144592867,144593652,111874167,785,111874167,2230,0
728963,RPS15AP10,chr1,R,45645771,45646685,111875081,914,111875081,2231,0
728989,LOC728989,chr1,R,147019335,147043039,111898785,23704,111898785,2232,5
729041,FAAHP1,chr1,F,46433826,46445702,111910661,11876,111910661,2233,8
729059,C1orf234,chr1,R,23010833,23015850,111915678,5017,111915678,2234,2
729467,HSD52,chr1,R,59131935,59146807,111930550,14872,111930550,2235,2
729528,PRAMEF14,chr1,R,13341891,13347134,111935793,5243,111935793,2236,4
729533,FAM72A,chr1,R,206186181,206204919,111954531,18738,111954531,2237,6
729574,FAM231A,chr1,F,16673002,16673512,111955041,510,111955041,2238,0
729614,FLJ37453,chr1,R,15834214,15848147,111968974,13933,111968974,2239,1
729737,LOC729737,chr1,R,134772,140566,111974768,5794,111974768,2240,2
729759,OR4F29,chr1,R,450739,451678,111975707,939,111975707,2241,0
729867,LOC729867,chr1,R,160202198,160208869,111982378,6671,111982378,2242,4
729930,LOC729930,chr1,R,89289257,89290362,111983483,1105,111983483,2243,0
729970,LOC729970,chr1,F,94928027,94963270,112018726,35243,112018726,2244,3
729987,LOC729987,chr1,F,98210710,98272658,112080674,61948,112080674,2245,2
730102,LOC730102,chr1,R,178006135,178038007,112112546,31872,112112546,2246,9
730159,LOC730159,chr1,F,173603007,173637134,112146673,34127,112146673,2247,3
730227,LINC01136,chr1,R,203298757,203305325,112153241,6568,112153241,2248,3
730257,LOC730257,chr1,R,149176140,149177139,112154240,999,112154240,2249,0
730262,PPIAL4E,chr1,R,144372874,144373659,112155025,785,112155025,2250,0
731275,LINC01347,chr1,R,243056313,243101744,112200456,45431,112200456,2251,17
731656,LINC01348,chr1,R,235065473,235069818,112204801,4345,112204801,2252,3
767846,PFN1P2,chr1,R,120432203,120434109,112206707,1906,112206707,2253,0
768220,MIR765,chr1,R,156936130,156936244,112206821,114,112206821,2254,0
791226,TRN-GTT4-1,chr1,F,16889676,16889750,112206895,74,112206895,2255,0
791227,TRN-GTT6-1,chr1,R,143735919,143735993,112206969,74,112206969,2256,0
100034743,PDZK1P2,chr1,R,147993861,148014956,112228064,21095,112228064,2257,9
100126331,MIR942,chr1,F,117094642,117094728,112228150,86,112228150,2258,0
100126346,MIR190B,chr1,R,154193664,154193743,112228229,79,112228229,2259,0
100126348,MIR760,chr1,F,93846831,93846911,112228309,80,112228309,2260,0
100126349,MIR921,chr1,R,166154742,166154798,112228365,56,112228365,2261,0
100126488,TRNAV-CAC,chr1,F,145157156,145157229,112228438,73,112228438,2262,0
100126488,TRNAV-CAC,chr1,F,145161107,145161178,112228509,71,112228509,2263,0
100126488,TRNAV-CAC,chr1,R,121020728,121020801,112228582,73,112228582,2264,0
100126488,TRNAV-CAC,chr1,R,149708659,149708730,112228653,71,112228653,2265,0
100126510,TRNAQ-CUG,chr1,F,145459657,145459729,112228725,72,112228725,2266,0
100126512,TRNAN-GUU,chr1,F,145129238,145129312,112228799,74,112228799,2267,0
100126512,TRNAN-GUU,chr1,F,146370100,146370174,112228873,74,112228873,2268,0
100126512,TRNAN-GUU,chr1,R,16520584,16520658,112228947,74,112228947,2269,0
100126512,TRNAN-GUU,chr1,R,121048431,121048505,112229021,74,112229021,2270,0
100126512,TRNAN-GUU,chr1,R,145475380,145475454,112229095,74,112229095,2271,0
100126512,TRNAN-GUU,chr1,R,149558418,149558493,112229170,75,112229170,2272,0
100126514,TRNAK-CUU,chr1,R,54957868,54957941,112229243,73,112229243,2273,0
100126517,TRNAE-UUC,chr1,R,16535278,16535350,112229315,72,112229315,2274,0
100126520,TRNAC-GCA,chr1,R,93516276,93516349,112229388,73,112229388,2275,0
100126533,TRNAG-CCC,chr1,R,16678270,16678341,112229459,71,112229459,2276,0
100126533,TRNAG-CCC,chr1,R,121016844,121016915,112229530,71,112229530,2277,0
100128071,FAM229A,chr1,R,32361269,32362243,112230504,974,112230504,2278,2
100128537,C1orf132,chr1,R,207761718,207869072,112337858,107354,112337858,2279,7
100128787,LINC01349,chr1,R,100627048,100647004,112357814,19956,112357814,2280,4
100129046,LOC100129046,chr1,F,93591967,93600030,112365877,8063,112365877,2281,3
100129094,BTNL10,chr1,R,228508026,228514017,112371868,5991,112371868,2282,3
100129138,LOC100129138,chr1,F,104073022,104077086,112375932,4064,112375932,2283,1
100129196,MATN1-AS1,chr1,F,30718771,30726746,112383907,7975,112383907,2284,3
100129269,LINC01160,chr1,R,111599006,111608318,112393219,9312,112393219,2285,4
100129271,C1orf68,chr1,F,152719521,152720429,112394127,908,112394127,2286,0
100129405,MSTO2P,chr1,F,155745767,155750688,112399048,4921,112399048,2287,12
100129476,LOC100129476,chr1,R,7049846,7051869,112401071,2023,112401071,2288,1
100129534,LOC100129534,chr1,R,2350413,2352661,112403319,2248,112403319,2289,0
100129620,LOC100129620,chr1,F,99004275,99148852,112547896,144577,112547896,2290,2
100129924,LOC100129924,chr1,F,42787989,42798230,112558137,10241,112558137,2291,6
100130093,LOC100130093,chr1,F,227728538,227734377,112563976,5839,112563976,2292,2
100130097,KIF28P,chr1,R,246770906,246839587,112632657,68681,112632657,2293,22
100130197,EFCAB14-AS1,chr1,F,46674035,46692098,112650720,18063,112650720,2294,3
100130249,PP2672,chr1,R,234757618,234760374,112653476,2756,112653476,2295,0
100130331,LOC100130331,chr1,F,237862174,237928321,112719623,66147,112719623,2296,11
100130417,LOC100130417,chr1,R,916817,919692,112722498,2875,112722498,2297,3
100130557,NFYC-AS1,chr1,R,40689079,40692261,112725680,3182,112725680,2298,0
100131060,LINC01135,chr1,F,58785150,58899712,112840242,114562,112840242,2299,3
100131107,LOC100131107,chr1,R,152079412,152080924,112841754,1512,112841754,2300,0
100131187,TSTD1,chr1,R,161037630,161038984,112843108,1354,112843108,2301,2
100131205,RPL21P28,chr1,R,212051485,212052051,112843674,566,112843674,2302,0
100131234,MIR181A1HG,chr1,R,198808002,198937429,112973101,129427,112973101,2303,2
100131564,LOC100131564,chr1,R,93310108,93345811,113008804,35703,113008804,2304,8
100131825,CADM3-AS1,chr1,R,159195984,159202422,113015242,6438,113015242,2305,3
100132057,LOC100132057,chr1,F,148402482,148432545,113045305,30063,113045305,2306,8
100132074,FOXO6,chr1,F,41361930,41383591,113066966,21661,113066966,2307,1
100132111,LOC100132111,chr1,F,151838468,151844165,113072663,5697,113072663,2308,3
100132287,LOC100132287,chr1,R,490755,495445,113077353,4690,113077353,2309,2
100132406,NBPF10,chr1,R,146066317,146144804,113155840,78487,113155840,2310,89
100132417,FCGR1C,chr1,F,143874742,143883733,113164831,8991,113164831,2311,5
100132618,ZRANB2-AS1,chr1,F,71046505,71067184,113185510,20679,113185510,2312,2
100132774,KDM4A-AS1,chr1,R,43699723,43707341,113193128,7618,113193128,2313,4
100133301,FAM231B,chr1,F,16538723,16540035,113194440,1312,113194440,2314,0
100133331,LOC100133331,chr1,R,725758,730351,113199033,4593,113199033,2315,2
100133612,LINC01134,chr1,F,3900403,3915447,113214077,15044,113214077,2316,3
100134822,LOC100134822,chr1,R,497258,532779,113249598,35521,113249598,2317,20
100147773,LOC100147773,chr1,F,165768928,165775449,113256119,6521,113256119,2318,2
100169751,RNA5S1,chr1,R,228610265,228610386,113256240,121,113256240,2319,0
100169753,RNA5S2,chr1,R,228612506,228612627,113256361,121,113256361,2320,0
100169754,RNA5S3,chr1,R,228614747,228614868,113256482,121,113256482,2321,0
100169755,RNA5S4,chr1,R,228616988,228617109,113256603,121,113256603,2322,0
100169756,RNA5S5,chr1,R,228619229,228619350,113256724,121,113256724,2323,0
100169757,RNA5S6,chr1,R,228621444,228621565,113256845,121,113256845,2324,0
100169758,RNA5S7,chr1,R,228623664,228623785,113256966,121,113256966,2325,0
100169759,RNA5S8,chr1,R,228625906,228626027,113257087,121,113257087,2326,0
100169760,RNA5S9,chr1,R,228628145,228628266,113257208,121,113257208,2327,0
100169761,RNA5S10,chr1,R,228630387,228630508,113257329,121,113257329,2328,0
100169762,RNA5S11,chr1,R,228632628,228632749,113257450,121,113257450,2329,0
100169763,RNA5S12,chr1,R,228634868,228634989,113257571,121,113257571,2330,0
100169764,RNA5S13,chr1,R,228637093,228637214,113257692,121,113257692,2331,0
100169765,RNA5S14,chr1,R,228639334,228639455,113257813,121,113257813,2332,0
100169766,RNA5S15,chr1,R,228641565,228641686,113257934,121,113257934,2333,0
100169767,RNA5S16,chr1,R,228643806,228643927,113258055,121,113258055,2334,0
100169768,RNA5S17,chr1,R,228646037,228646158,113258176,121,113258176,2335,0
100188991,TRH-GTG1-1,chr1,F,146038043,146038115,113258248,72,113258248,2336,0
100188997,TRG-TCC4-1,chr1,R,161440170,161440242,113258320,72,113258320,2337,0
100188998,TRQ-CTG7-1,chr1,F,148328811,148328883,113258392,72,113258392,2338,0
100189003,TRL-CAA6-1,chr1,R,161611945,161612029,113258476,84,113258476,2339,0
100189005,TRN-GTT7-1,chr1,F,148529256,148529330,113258550,74,113258550,2340,0
100189005,TRN-GTT7-1,chr1,R,120844261,120844335,113258624,74,113258624,2341,0
100189009,TRL-CAG1-2,chr1,F,161448950,161449033,113258707,83,113258707,2342,0
100189011,TRG-TCC2-6,chr1,F,161531112,161531184,113258779,72,113258779,2343,0
100189015,TRX-CAT1-1,chr1,F,153671249,153671321,113258851,72,113258851,2344,0
100189017,TRE-CTC1-5,chr1,R,161469398,161469470,113258923,72,113258923,2345,0
100189018,TRL-CAG1-6,chr1,R,161530341,161530424,113259006,83,113259006,2346,0
100189019,TRP-AGG2-1,chr1,R,167715487,167715559,113259078,72,113259078,2347,0
100189039,TRG-TCC2-5,chr1,R,161469756,161469828,113259150,72,113259150,2348,0
100189045,TRG-CCC5-1,chr1,F,16727284,16727355,113259221,71,113259221,2349,0
100189056,TRQ-CTG4-1,chr1,R,148265107,148265179,113259293,72,113259293,2350,0
100189059,TRN-GTT8-1,chr1,R,149740247,149740321,113259367,74,113259367,2351,0
100189064,TRG-TCC2-1,chr1,F,146037060,146037132,113259439,72,113259439,2352,0
100189091,TRE-CTC1-2,chr1,R,161447227,161447299,113259511,72,113259511,2353,0
100189098,TRK-TTT8-1,chr1,F,205474142,205474215,113259584,73,113259584,2354,0
100189120,TRD-GTC2-5,chr1,R,161470414,161470486,113259656,72,113259656,2355,0
100189122,TRK-TTT3-1,chr1,F,204506526,204506599,113259729,73,113259729,2356,0
100189126,TRN-GTT1-1,chr1,F,161540240,161540314,113259803,74,113259803,2357,0
100189127,TRN-GTT3-2,chr1,R,144567514,144567588,113259877,74,113259877,2358,0
100189133,TRR-TCT1-1,chr1,F,93847572,93847657,113259962,85,113259962,2359,1
100189134,TRD-GTC2-4,chr1,R,161463033,161463105,113260034,72,113260034,2360,0
100189139,TRL-CAG1-5,chr1,F,161471122,161471205,113260117,83,113260117,2361,0
100189140,TRQ-CTG3-2,chr1,F,148032789,148032861,113260189,72,113260189,2362,0
100189141,TRG-TCC2-3,chr1,R,161454965,161455037,113260261,72,113260261,2363,0
100189142,TRV-CAC8-1,chr1,R,143800040,143800111,113260332,71,113260332,2364,0
100189160,TRG-GCC1-4,chr1,F,161465467,161465538,113260403,71,113260403,2365,0
100189166,TRR-TCT4-1,chr1,R,159141610,159141684,113260477,74,113260477,2366,0
100189174,TRH-GTG1-4,chr1,R,148302733,148302805,113260549,72,113260549,2367,0
100189188,TRG-TCC2-4,chr1,R,161462375,161462447,113260621,72,113260621,2368,0
100189193,TRN-GTT9-2,chr1,R,148048515,148048589,113260695,74,113260695,2369,0
100189198,TRK-CTT2-1,chr1,F,146039400,146039473,113260768,73,113260768,2370,0
100189199,TRL-CAA4-1,chr1,F,248873854,248873960,113260874,106,113260874,2371,1
100189211,TRP-CGG1-1,chr1,F,167714724,167714796,113260946,72,113260946,2372,0
100189228,TRV-CAC5-1,chr1,R,149712551,149712624,113261019,73,113261019,2373,0
100189230,TRG-GCC1-3,chr1,F,161458107,161458178,113261090,71,113261090,2374,0
100189235,TRD-GTC2-2,chr1,R,161448242,161448314,113261162,72,113261162,2375,0
100189252,TRG-GCC1-2,chr1,F,161450676,161450747,113261233,71,113261233,2376,0
100189257,TRN-GTT11-2,chr1,R,120952290,120952364,113261307,74,113261307,2377,0
100189257,TRN-GTT11-2,chr1,R,149646450,149646524,113261381,74,113261381,2378,0
100189259,TRE-CTC1-4,chr1,R,161462018,161462090,113261453,72,113261453,2379,0
100189260,TRG-TCC2-2,chr1,R,161447584,161447656,113261525,72,113261525,2380,0
100189261,TRQ-CTG4-2,chr1,F,143691473,143691545,113261597,72,113261597,2381,0
100189274,TRG-GCC4-1,chr1,F,161480565,161480636,113261668,71,113261668,2382,0
100189290,TRD-GTC2-3,chr1,R,161455623,161455695,113261740,72,113261740,2383,0
100189298,TRG-CCC1-2,chr1,F,16861920,16861991,113261811,71,113261811,2384,0
100189307,TRH-GTG1-3,chr1,F,148281364,148281436,113261883,72,113261883,2385,0
100189316,TRL-CAG1-3,chr1,F,161456331,161456414,113261966,83,113261966,2386,0
100189323,TRN-GTT3-1,chr1,F,144419266,144419340,113262040,74,113262040,2387,0
100189326,TRV-CAC4-1,chr1,R,143803993,143804066,113262113,73,113262113,2388,0
100189334,TRH-GTG1-2,chr1,F,147073224,147073296,113262185,72,113262185,2389,0
100189356,TRN-GTT12-1,chr1,R,143831707,143831781,113262259,74,113262259,2390,0
100189364,TRL-CAG1-4,chr1,F,161463741,161463824,113262342,83,113262342,2391,0
100189366,TRG-GCC1-1,chr1,F,161443303,161443374,113262413,71,113262413,2392,0
100189373,TRV-CAC1-1,chr1,R,161399699,161399772,113262486,73,113262486,2393,0
100189378,TRT-TGT2-1,chr1,F,222465004,222465077,113262559,73,113262559,2394,0
100189380,TRG-GCC2-1,chr1,R,161523846,161523917,113262630,71,113262630,2395,0
100189384,TRE-CTC1-1,chr1,F,146035691,146035763,113262702,72,113262702,2396,0
100189385,TRE-CTC1-3,chr1,R,161454607,161454679,113262774,72,113262774,2397,0
100189394,TRL-CAG1-1,chr1,F,161441532,161441615,113262857,83,113262857,2398,0
100189402,TRN-GTT2-2,chr1,R,161428076,161428150,113262931,74,113262931,2399,0
100189407,TRE-TTC4-2,chr1,R,161422092,161422164,113263003,72,113263003,2400,0
100189409,TRE-CTC2-1,chr1,F,248874247,248874319,113263075,72,113263075,2401,0
100189412,TRD-GTC2-1,chr1,R,161440824,161440896,113263147,72,113263147,2402,0
100189425,TRK-TTT3-2,chr1,R,204507029,204507102,113263220,73,113263220,2403,0
100191040,C2CD4D,chr1,R,151837817,151845329,113270732,7512,113270732,2404,3
100287102,DDX11L1,chr1,F,11873,14409,113273268,2536,113273268,2405,2
100287497,LOC100287497,chr1,F,224008589,224009969,113274648,1380,113274648,2406,0
100287722,AP4B1-AS1,chr1,F,113812611,113901237,113363274,88626,113363274,2407,7
100287814,LINC00582,chr1,R,231591291,231612090,113384073,20799,113384073,2408,1
100287877,LOC100287877,chr1,R,5705567,5713772,113392278,8205,113392278,2409,2
100287898,TTC34,chr1,R,2636987,2789665,113544956,152678,113544956,2410,7
100287902,LGALS8-AS1,chr1,R,236523068,236524508,113546396,1440,113546396,2411,0
100287934,LOC100287934,chr1,F,785939,787186,113547643,1247,113547643,2412,0
100287948,GM140,chr1,F,181236387,181238604,113549860,2217,113549860,2413,2
100288069,LOC100288069,chr1,R,764864,778688,113563684,13824,113563684,2414,6
100288079,GS1-279B7.1,chr1,R,185323845,185335039,113574878,11194,113574878,2415,3
100288142,NBPF20,chr1,R,145289899,145405778,113690757,115879,113690757,2416,137
100288175,LOC100288175,chr1,F,1059712,1061058,113692103,1346,113692103,2417,2
100288805,HYDIN2,chr1,F,146547488,146822034,113966649,274546,113966649,2418,45
100289061,LOC100289061,chr1,R,150548448,150557938,113976139,9490,113976139,2419,6
100289178,GNG12-AS1,chr1,F,67832287,68202987,114346839,370700,114346839,2420,9
100289211,LINC00624,chr1,R,147382191,147517875,114482523,135684,114482523,2421,3
100302117,MIR320B1,chr1,F,116671748,116671827,114482602,79,114482602,2422,0
100302132,MIR1182,chr1,R,231019827,231019924,114482699,97,114482699,2423,0
100302139,MIR1537,chr1,R,235852999,235853060,114482760,61,114482760,2424,0
100302155,MIR1256,chr1,R,20988313,20988432,114482879,119,114482879,2425,0
100302158,MIR1231,chr1,F,201808610,201808702,114482971,92,114482971,2426,0
100302163,MIR1278,chr1,F,193136502,193136583,114483052,81,114483052,2427,0
100302178,MIR1295A,chr1,R,171101727,171101806,114483131,79,114483131,2428,0
100302190,MIR1976,chr1,F,26554541,26554593,114483183,52,114483183,2429,0
100302234,MIR664A,chr1,R,220200537,220200619,114483265,82,114483265,2430,0
100302276,MIR1290,chr1,R,18897070,18897148,114483343,78,114483343,2431,0
100302278,MIR1302-2,chr1,F,30365,30503,114483481,138,114483481,2432,0
100302279,MIR1262,chr1,R,68183517,68183610,114483574,93,114483574,2433,0
100302401,RASAL2-AS1,chr1,R,178091507,178093993,114486060,2486,114486060,2434,1
100302691,LINC00184,chr1,F,234629310,234634780,114491530,5470,114491530,2435,1
100303453,TSNAX-DISC1,chr1,F,231528652,232041272,115004150,512620,115004150,2436,18
100313769,MIR320B2,chr1,R,224257003,224257141,115004288,138,115004288,2437,0
100313835,MIR1255B2,chr1,F,167998659,167998726,115004355,67,115004355,2438,0
100313892,MIR761,chr1,R,51836343,51836402,115004414,59,115004414,2439,0
100379251,NPPA-AS1,chr1,F,11840318,11847616,115011712,7298,115011712,2440,3
100381270,ZBED6,chr1,F,203797522,203800462,115014652,2940,115014652,2441,0
100422212,LOC100422212,chr1,R,163421069,163423191,115016774,2122,115016774,2442,0
100422839,MIR3119-1,chr1,R,170151377,170151462,115016859,85,115016859,2443,0
100422852,MIR4259,chr1,R,159899978,159900079,115016960,101,115016960,2444,0
100422856,MIR3123,chr1,F,241132271,241132346,115017035,75,115017035,2445,0
100422866,MIR3115,chr1,F,23044304,23044372,115017103,68,115017103,2446,0
100422871,MIR3117,chr1,F,66628439,66628517,115017181,78,115017181,2447,0
100422879,MIR3124,chr1,F,248826376,248826443,115017248,67,115017248,2448,0
100422882,MIR3120,chr1,F,172138807,172138888,115017329,81,115017329,2449,0
100422894,MIR4260,chr1,R,209623443,209623510,115017396,67,115017396,2450,0
100422898,MIR4255,chr1,F,37161562,37161634,115017468,72,115017468,2451,0
100422902,MIR3116-1,chr1,F,62078785,62078859,115017542,74,115017542,2452,0
100422914,MIR4253,chr1,R,22863158,22863226,115017610,68,115017610,2453,0
100422946,MIR3116-2,chr1,R,62078788,62078856,115017678,68,115017678,2454,0
100422947,MIR3122,chr1,F,212077612,212077685,115017751,73,115017751,2455,0
100422968,MIR4251,chr1,F,3127974,3128035,115017812,61,115017812,2456,0
100422970,MIR1273D,chr1,F,10227717,10227803,115017898,86,115017898,2457,0
100422975,MIR4252,chr1,R,6429833,6429896,115017961,63,115017961,2458,0
100422976,MIR4256,chr1,R,112461769,112461833,115018025,64,115018025,2459,0
100422997,MIR4257,chr1,F,150551928,150552014,115018111,86,115018111,2460,0
100423010,MIR3119-2,chr1,F,170151377,170151462,115018196,85,115018196,2461,0
100423020,MIR4258,chr1,F,154975692,154975783,115018287,91,115018287,2462,0
100423028,MIR4254,chr1,R,31758659,31758735,115018363,76,115018363,2463,0
100423032,MIR3121,chr1,R,180438313,180438390,115018440,77,115018440,2464,0
100500801,MIR3659,chr1,F,38089230,38089329,115018539,99,115018539,2465,0
100500808,MIR3917,chr1,R,25906361,25906454,115018632,93,115018632,2466,0
100500810,MIR3620,chr1,F,228097262,228097341,115018711,79,115018711,2467,0
100500832,MIR3658,chr1,F,165907920,165907976,115018767,56,115018767,2468,0
100500849,MIR3916,chr1,R,247201966,247202060,115018861,94,115018861,2469,0
100500853,MIR3605,chr1,R,33332392,33332492,115018961,100,115018961,2470,0
100500854,MIR3671,chr1,R,65057754,65057842,115019049,88,115019049,2471,0
100500876,MIR3675,chr1,R,16858948,16859021,115019122,73,115019122,2472,0
100505633,LINC01133,chr1,F,159961223,159979086,115036985,17863,115036985,2473,2
100505666,LOC100505666,chr1,R,155045190,155063991,115055786,18801,115055786,2474,4
100505728,LOC100505728,chr1,R,155745111,155748218,115058893,3107,115058893,2475,2
100505741,SPATA1,chr1,F,84506300,84556495,115109088,50195,115109088,2476,15
100505768,LINC01364,chr1,R,87353523,87371655,115127220,18132,115127220,2477,3
100505795,LOC100505795,chr1,R,164769115,164774641,115132746,5526,115132746,2478,3
100505824,LOC100505824,chr1,F,148162737,148163413,115133422,676,115133422,2479,1
100505832,PROX1-AS1,chr1,R,213819640,213986153,115299935,166513,115299935,2480,5
100505887,LOC100505887,chr1,F,6724744,6730012,115305203,5268,115305203,2481,2
100505918,LOC100505918,chr1,R,168400187,168422656,115327672,22469,115327672,2482,3
100505975,ENO1-AS1,chr1,F,8878834,8879885,115328723,1051,115328723,2483,1
100506007,RTCA-AS1,chr1,R,100264741,100266174,115330156,1433,115330156,2484,2
100506022,LOC100506022,chr1,R,9425093,9428996,115334059,3903,115334059,2485,2
100506023,LOC100506023,chr1,R,173235059,173477155,115576155,242096,115576155,2486,2
100506046,GAS5-AS1,chr1,F,173863247,173863941,115576849,694,115576849,2487,0
100506144,ZMYM6NB,chr1,R,34981525,34985347,115580671,3822,115580671,2488,2
100506161,TAF1A-AS1,chr1,F,222589919,222592633,115583385,2714,115583385,2489,1
100506343,FAM212B-AS1,chr1,F,111739840,111747798,115591343,7958,115591343,2490,2
100506376,TTLL10-AS1,chr1,R,1173054,1179555,115597844,6501,115597844,2491,2
100506392,SLC16A1-AS1,chr1,F,112956414,112964072,115605502,7658,115605502,2492,2
100506443,ITPKB-IT1,chr1,R,226656079,226675068,115624491,18989,115624491,2493,1
100506504,LOC100506504,chr1,R,2181810,2184360,115627041,2550,115627041,2494,1
100506571,LOC100506571,chr1,R,228073908,228078006,115631139,4098,115631139,2495,0
100506696,PCAT6,chr1,F,202810945,202811913,115632107,968,115632107,2496,1
100506730,LOC100506730,chr1,R,19293246,19295736,115634597,2490,115634597,2497,0
100506747,LOC100506747,chr1,R,202986451,203007265,115655411,20814,115655411,2498,4
100506775,LINC01353,chr1,F,203287151,203288798,115657058,1647,115657058,2499,3
100506795,LINC01354,chr1,R,234527890,234531779,115660947,3889,115660947,2500,2
100506801,LOC100506801,chr1,F,21293289,21299869,115667527,6580,115667527,2501,2
100506810,LINC01132,chr1,F,234724041,234731643,115675129,7602,115675129,2502,2
100506915,CHRM3-AS2,chr1,R,239707125,239719119,115687123,11994,115687123,2503,2
100506929,LOC100506929,chr1,R,240739141,240743679,115691661,4538,115691661,2504,1
100506963,TCEB3-AS1,chr1,R,23760381,23778297,115709577,17916,115709577,2505,3
100506985,LOC100506985,chr1,R,24539273,24556024,115726328,16751,115726328,2506,2
100507178,SLFNL1-AS1,chr1,F,41014589,41043890,115755629,29301,115755629,2507,3
100507423,MKNK1-AS1,chr1,F,46538695,46570255,115787189,31560,115787189,2508,7
100507564,LOC100507564,chr1,F,53238609,53242783,115791363,4174,115791363,2509,2
100507634,LOC100507634,chr1,F,55215407,55217455,115793411,2048,115793411,2510,0
100507670,LOC100507670,chr1,R,151279895,151281929,115795445,2034,115795445,2511,1
100509303,LOC100509303,chr1,R,209147266,209154609,115802788,7343,115802788,2512,3
100526739,APITD1-CORT,chr1,F,10430101,10452003,115824690,21902,115824690,2513,1
100526835,FPGT-TNNI3K,chr1,F,74198211,74544432,116170911,346221,116170911,2514,24
100527950,GJA9-MYCBP,chr1,R,38862489,38881626,116190048,19137,116190048,2515,1
100527960,MROH7-TTC4,chr1,F,54641739,54742657,116290966,100918,116290966,2516,33
100527963,PMF1-BGLAP,chr1,F,156212987,156243332,116321311,30345,116321311,2517,6
100527964,LHX4-AS1,chr1,R,180269662,180274681,116326330,5019,116326330,2518,4
100527978,TMEM56-RWDD3,chr1,F,95117922,95244955,116453363,127033,116453363,2519,7
100532736,MINOS1-NBL1,chr1,F,19596976,19658456,116514843,61480,116514843,2520,9
100533111,ZNF670-ZNF695,chr1,R,246945546,247078813,116648110,133267,116648110,2521,6
100534012,TNFAIP8L2-SCNM1,chr1,F,151156628,151170297,116661779,13669,116661779,2522,6
100616120,MIR4695,chr1,R,18883201,18883275,116661853,74,116661853,2523,0
100616141,MIR4428,chr1,F,237471118,237471191,116661926,73,116661926,2524,0
100616145,MIR1273G,chr1,F,52940313,52940413,116662026,100,116662026,2525,0
100616156,MIR1273F,chr1,F,52928673,52928772,116662125,99,116662125,2526,0
100616164,MIR4420,chr1,R,30739155,30739232,116662202,77,116662202,2527,0
100616177,MIR4419A,chr1,R,23057857,23057934,116662279,77,116662279,2528,0
100616188,MIR3972,chr1,F,17277888,17277975,116662366,87,116662366,2529,0
100616189,MIR4421,chr1,F,51059836,51059905,116662435,69,116662435,2530,0
100616224,MIR4753,chr1,R,235190033,235190116,116662518,83,116662518,2531,0
100616272,MIR4422,chr1,F,55225640,55225723,116662601,83,116662601,2532,0
100616308,MIR4666A,chr1,F,228462073,228462152,116662680,79,116662680,2533,0
100616315,MIR4781,chr1,F,54054078,54054154,116662756,76,116662756,2534,0
100616321,MIR378G,chr1,R,94745859,94745900,116662797,41,116662797,2535,0
100616328,MIR4424,chr1,F,178677748,178677834,116662883,86,116662883,2536,0
100616338,MIR4794,chr1,F,64579846,64579923,116662960,77,116662960,2537,0
100616343,MIR4677,chr1,F,243346175,243346255,116663040,80,116663040,2538,0
100616345,MIR4426,chr1,F,192716327,192716390,116663103,63,116663103,2539,0
100616363,MIR4735,chr1,R,196582412,196582481,116663172,69,116663172,2540,0
100616365,MIR4425,chr1,F,25023502,25023586,116663256,84,116663256,2541,0
100616380,MIR4671,chr1,F,234306466,234306539,116663329,73,116663329,2542,0
100616384,MIR548AC,chr1,R,116560023,116560111,116663417,88,116663417,2543,0
100616386,MIR4654,chr1,F,162157106,162157182,116663493,76,116663493,2544,0
100616390,MIR4427,chr1,F,233624151,233624219,116663561,68,116663561,2545,0
100616391,MIR4684,chr1,F,22719516,22719598,116663643,82,116663643,2546,0
100616409,MIR4711,chr1,R,59733226,59733296,116663713,70,116663713,2547,0
100616421,MIR4689,chr1,R,5862671,5862741,116663783,70,116663783,2548,0
100616433,MIR4418,chr1,F,22266238,22266300,116663845,62,116663845,2549,0
100616438,MIR4632,chr1,F,12191712,12191773,116663906,61,116663906,2550,0
100616452,MIR2682,chr1,R,98045241,98045351,116664016,110,116664016,2551,0
100616458,MIR5095,chr1,F,52934929,52935017,116664104,88,116664104,2552,0
100616468,MIR4742,chr1,R,224398226,224398311,116664189,85,116664189,2553,0
100616481,MIR4423,chr1,F,85133793,85133873,116664269,80,116664269,2554,0
100616489,MIR4417,chr1,F,5564070,5564143,116664342,73,116664342,2555,0
100616492,MIR378F,chr1,F,23929069,23929147,116664420,78,116664420,2556,0
100628315,DNM3OS,chr1,R,172136878,172144835,116672377,7957,116672377,2557,0
100750325,RCAN3AS,chr1,R,24496332,24502360,116678405,6028,116678405,2558,2
100847009,MIR1295B,chr1,F,171101738,171101798,116678465,60,116678465,2559,0
100847010,MIR5581,chr1,R,37500934,37500994,116678525,60,116678525,2560,0
100847018,MIR5585,chr1,F,32086948,32087007,116678584,59,116678584,2561,0
100847024,MIR5698,chr1,R,154104520,154104592,116678656,72,116678656,2562,0
100847044,MIR5087,chr1,R,148334478,148334554,116678732,76,116678732,2563,0
100847050,MIR5191,chr1,F,201719507,201719627,116678852,120,116678852,2564,0
100847055,MIR5697,chr1,F,9967380,9967458,116678930,78,116678930,2565,0
100847072,MIR5008,chr1,R,227941589,227941683,116679024,94,116679024,2566,0
100847089,MIR5584,chr1,F,44545492,44545552,116679084,60,116679084,2567,0
100847090,MIR5187,chr1,F,161227185,161227261,116679160,76,116679160,2568,0
100852409,NEGR1-IT1,chr1,R,71794231,71837012,116721941,42781,116721941,2569,2
100852410,ZRANB2-AS2,chr1,F,71081323,71237723,116878341,156400,116878341,2570,3
100861504,LINC00538,chr1,F,213924748,213926654,116880247,1906,116880247,2571,0
100861548,PINK1-AS,chr1,R,20642656,20652193,116889784,9537,116889784,2572,2
100873165,SRGAP2-AS1,chr1,R,121360155,121397905,116927534,37750,116927534,2573,3
100873924,HLX-AS1,chr1,R,220832762,220880140,116974912,47378,116974912,2574,2
100873932,DPYD-AS1,chr1,F,97095922,97322955,117201945,227033,117201945,2575,4
100873933,DPYD-AS2,chr1,F,97796920,97798051,117203076,1131,117203076,2576,2
100873935,MTOR-AS1,chr1,F,11143897,11149538,117208717,5641,117208717,2577,3
100873946,VAV3-AS1,chr1,F,107964442,107994607,117238882,30165,117238882,2578,2
100873949,IPO9-AS1,chr1,R,201688255,201829559,117380186,141304,117380186,2579,2
100873974,KCNC4-AS1,chr1,R,110208449,110209987,117381724,1538,117381724,2580,1
100873984,CHRM3-AS1,chr1,R,239898018,239899872,117383578,1854,117383578,2581,1
100873995,KCND3-AS1,chr1,F,111909656,111910930,117384852,1274,117384852,2582,3
100874054,FALEC,chr1,F,150515756,150518032,117387128,2276,117387128,2583,1
100874097,UBE2Q1-AS1,chr1,F,154553608,154555028,117388548,1420,117388548,2584,1
100874253,LINC00853,chr1,F,47179249,47180339,117389638,1090,117389638,2585,1
100874270,HAO2-IT1,chr1,F,119368945,119370331,117391024,1386,117391024,2586,1
100874278,ERI3-IT1,chr1,R,44222594,44244283,117412713,21689,117412713,2587,4
100874284,DNM3-IT1,chr1,F,171864191,171864687,117413209,496,117413209,2588,1
100874295,KCND3-IT1,chr1,R,111853761,111856905,117416353,3144,117416353,2589,1
100874313,AGBL4-IT1,chr1,R,49374200,49472085,117514238,97885,117514238,2590,3
100874340,CAMTA1-IT1,chr1,F,7368789,7370263,117515712,1474,117515712,2591,1
100885798,LINC00210,chr1,F,217892899,217920804,117543617,27905,117543617,2592,3
100887744,RNU6-48P,chr1,F,27325218,27325325,117543724,107,117543724,2593,0
100996251,LOC100996251,chr1,R,113011686,113073102,117605140,61416,117605140,2594,2
100996263,LOC100996263,chr1,R,117596831,117605770,117614079,8939,117614079,2595,2
100996301,FOXD3-AS1,chr1,R,63320883,63324441,117617637,3558,117617637,2596,5
100996318,LOC100996318,chr1,R,121097141,121098265,117618761,1124,117618761,2597,2
100996442,LOC100996442,chr1,R,141933,174394,117651222,32461,117651222,2598,17
100996511,LINC01355,chr1,R,23281308,23285518,117655432,4210,117655432,2599,1
100996517,LOC100996517,chr1,R,148767752,148791814,117679494,24062,117679494,2600,5
100996521,LOC100996521,chr1,F,150887252,150912512,117704754,25260,117704754,2601,1
100996570,NFIA-AS2,chr1,R,60940243,60970776,117735287,30533,117735287,2602,7
100996583,LOC100996583,chr1,F,2566534,2584534,117753287,18000,117753287,2603,3
100996630,LOC100996630,chr1,R,95310927,95318282,117760642,7355,117760642,2604,1
100996635,LOC100996635,chr1,F,95510115,95515464,117765991,5349,117765991,2605,2
100996702,LINC01356,chr1,R,112820168,112850643,117796466,30475,117796466,2606,6
100996712,SRGAP2D,chr1,F,143972638,144069704,117893532,97066,117893532,2607,7
100996713,LOC100996713,chr1,R,143883903,143885954,117895583,2051,117895583,2608,1
100996716,LOC100996716,chr1,F,149338437,149362499,117919645,24062,117919645,2609,5
100996717,LOC100996717,chr1,F,149390592,149414468,117943521,23876,117943521,2610,2
100996721,LOC100996721,chr1,F,121012215,121013923,117945229,1708,117945229,2611,0
100996724,LOC100996724,chr1,R,120488843,120701360,118157746,212517,118157746,2612,43
100996732,LOC100996732,chr1,R,144208088,144250332,118199990,42244,118199990,2613,11
100996740,LOC100996740,chr1,F,145214737,145215769,118201022,1032,118201022,2614,0
100996741,LOC100996741,chr1,R,145164098,145207256,118244180,43158,118244180,2615,2
100996756,LOC100996756,chr1,F,146387140,146388091,118245131,951,118245131,2616,1
100996761,LOC100996761,chr1,R,149245803,149322070,118321398,76267,118321398,2617,3
100996763,LOC100996763,chr1,R,148595856,148712520,118438062,116664,118438062,2618,11
101060022,LOC101060022,chr1,F,227969792,227971378,118439648,1586,118439648,2619,0
101060170,LOC101060170,chr1,F,145282606,145289041,118446083,6435,118446083,2620,2
101060226,NBPF19,chr1,F,149463736,149556256,118538603,92520,118538603,2621,15
101060254,LOC101060254,chr1,F,145507429,145539922,118571096,32493,118571096,2622,10
101060301,HNRNPCL4,chr1,R,13164554,13165482,118572024,928,118572024,2623,0
101060398,LOC101060398,chr1,R,149090900,149104180,118585304,13280,118585304,2624,6
101060524,LOC101060524,chr1,R,144274533,144276762,118587533,2229,118587533,2625,0
101060684,NBPF26,chr1,F,120805276,120842217,118624474,36941,118624474,2626,28
101410535,LAMTOR5-AS1,chr1,F,110407808,110416274,118632940,8466,118632940,2627,2
101447996,RNVU1-8,chr1,R,147084615,147084756,118633081,141,118633081,2628,0
101669762,BLACAT1,chr1,R,205434885,205456086,118654282,21201,118654282,2629,1
101926890,DAB1-AS1,chr1,F,57860542,57863114,118656854,2572,118656854,2630,1
101926901,LOC101926901,chr1,R,222510531,222519974,118666297,9443,118666297,2631,6
101926907,LOC101926907,chr1,F,58805295,58816042,118677044,10747,118677044,2632,1
101926925,LINC01358,chr1,F,59020475,59088247,118744816,67772,118744816,2633,2
101926944,LOC101926944,chr1,F,59772794,59788832,118760854,16038,118760854,2634,2
101926964,LOC101926964,chr1,R,60659630,60825584,118926808,165954,118926808,2635,5
101926980,LOC101926980,chr1,F,223992708,224004864,118938964,12156,118938964,2636,2
101927034,ROR1-AS1,chr1,R,64094441,64113791,118958314,19350,118958314,2637,7
101927084,LINC01359,chr1,R,64979576,65002476,118981214,22900,118981214,2638,6
101927139,LOC101927139,chr1,R,66042499,66050718,118989433,8219,118989433,2639,2
101927143,LOC101927143,chr1,R,224208746,224213279,118993966,4533,118993966,2640,1
101927164,LOC101927164,chr1,F,224219612,224228043,119002397,8431,119002397,2641,2
101927220,DEPDC1-AS1,chr1,F,68496675,68538627,119044349,41952,119044349,2642,2
101927244,LOC101927244,chr1,F,70706452,70786468,119124365,80016,119124365,2643,6
101927247,LOC101927247,chr1,F,226186809,226213192,119150748,26383,119150748,2644,4
101927295,LINC01360,chr1,F,73306169,73338877,119183456,32708,119183456,2645,3
101927320,ERICH3-AS1,chr1,F,74577429,74626098,119232125,48669,119232125,2646,3
101927333,LOC101927333,chr1,F,144324092,144340912,119248945,16820,119248945,2647,8
101927342,LOC101927342,chr1,F,76011323,76019356,119256978,8033,119256978,2648,2
101927401,LOC101927401,chr1,R,228360909,228368332,119264401,7423,119264401,2649,8
101927412,LOC101927412,chr1,F,80535754,80646788,119375435,111034,119375435,2650,4
101927417,LOC101927417,chr1,R,15328742,15343980,119390673,15238,119390673,2651,3
101927429,LOC101927429,chr1,F,144663792,144676283,119403164,12491,119403164,2652,6
101927434,LOC101927434,chr1,R,81513879,81557702,119446987,43823,119446987,2653,3
101927441,LOC101927441,chr1,R,15403770,15415522,119458739,11752,119458739,2654,6
101927452,LOC101927452,chr1,F,143498953,143515940,119475726,16987,119475726,2655,5
101927468,LOC101927468,chr1,R,148208092,148247071,119514705,38979,119514705,2656,4
101927478,LOC101927478,chr1,F,229508429,229514087,119520363,5658,119520363,2657,2
101927479,LOC101927479,chr1,F,16155000,16168216,119533579,13216,119533579,2658,5
101927498,LINC01361,chr1,R,82973881,82986208,119545906,12327,119545906,2659,3
101927504,LOC101927504,chr1,R,229870018,229894066,119569954,24048,119569954,2660,11
101927532,LOC101927532,chr1,F,230002716,230007162,119574400,4446,119574400,2661,2
101927542,LOC101927542,chr1,F,83445875,83483441,119611966,37566,119611966,2662,7
101927546,ANO7P1,chr1,R,16215906,16227036,119623096,11130,119623096,2663,8
101927553,LOC101927553,chr1,R,230592659,230595583,119626020,2924,119626020,2664,1
101927560,LOC101927560,chr1,R,83801515,83860546,119685051,59031,119685051,2665,2
101927587,LOC101927587,chr1,R,83575786,83860996,119970261,285210,119970261,2666,2
101927604,LOC101927604,chr1,F,230874845,230879015,119974431,4170,119974431,2667,2
101927660,LOC101927660,chr1,R,232174934,232180113,119979610,5179,119979610,2668,1
101927663,LOC101927663,chr1,R,16633330,16644733,119991013,11403,119991013,2669,3
101927683,LOC101927683,chr1,R,232727253,232742715,120006475,15462,120006475,2670,3
101927711,LOC101927711,chr1,F,232815544,232907461,120098392,91917,120098392,2671,8
101927736,LOC101927736,chr1,F,233200427,233206506,120104471,6079,120104471,2672,1
101927765,LOC101927765,chr1,R,234372806,234373593,120105258,787,120105258,2673,1
101927767,LOC101927767,chr1,R,149792522,149793847,120106583,1325,120106583,2674,0
101927787,LOC101927787,chr1,F,234646288,234660924,120121219,14636,120121219,2675,3
101927806,LOC101927806,chr1,F,16871823,16874037,120123433,2214,120123433,2676,1
101927844,LOC101927844,chr1,F,87212668,87251331,120162096,38663,120162096,2677,3
101927851,LOC101927851,chr1,R,234957341,234963999,120168754,6658,120168754,2678,3
101927871,LOC101927871,chr1,F,87959419,87976899,120186234,17480,120186234,2679,3
101927876,LOC101927876,chr1,F,18065656,18074412,120194990,8756,120194990,2680,2
101927886,LOC101927886,chr1,F,151346955,151347891,120195926,936,120195926,2681,1
101927891,PKN2-AS1,chr1,R,88537512,88685204,120343618,147692,120343618,2682,3
101927895,LOC101927895,chr1,F,19210364,19240704,120373958,30340,120373958,2683,1
101927906,LOC101927906,chr1,F,235641993,235643820,120375785,1827,120375785,2684,3
101927949,LOC101927949,chr1,R,152047295,152049878,120378368,2583,120378368,2685,3
101927952,LOC101927952,chr1,R,89737970,89764523,120404921,26553,120404921,2686,5
101927975,LOC101927975,chr1,F,89786312,89790492,120409101,4180,120409101,2687,3
101927988,LINC01527,chr1,R,152930039,152949249,120428311,19210,120428311,2688,1
101928009,LOC101928009,chr1,F,153174517,153191676,120445470,17159,120445470,2689,2
101928017,UBXN10-AS1,chr1,R,20184241,20186486,120447715,2245,120447715,2690,1
101928034,LOC101928034,chr1,F,153545741,153551769,120453743,6028,120453743,2691,2
101928043,LOC101928043,chr1,R,22023993,22026048,120455798,2055,120455798,2692,2
101928059,LOC101928059,chr1,F,153923346,153934964,120467416,11618,120467416,2693,4
101928068,LOC101928068,chr1,R,244965203,244970869,120473082,5666,120473082,2694,1
101928079,LINC01057,chr1,R,94657532,94820281,120635831,162749,120635831,2695,4
101928089,LOC101928089,chr1,F,246108298,246113869,120641402,5571,120641402,2696,3
101928098,LOC101928098,chr1,F,95061549,95067545,120647398,5996,120647398,2697,1
101928101,LOC101928101,chr1,R,154402320,154408834,120653912,6514,120653912,2698,1
101928118,LOC101928118,chr1,R,95163218,95233982,120724676,70764,120724676,2699,4
101928120,LOC101928120,chr1,F,154961559,154962625,120725742,1066,120725742,2700,0
101928163,LOC101928163,chr1,F,23521929,23528419,120732232,6490,120732232,2701,2
101928169,LOC101928169,chr1,R,95351250,95352653,120733635,1403,120733635,2702,1
101928177,LOC101928177,chr1,R,156614741,156621928,120740822,7187,120740822,2703,1
101928189,LOC101928189,chr1,R,25302734,25338221,120776309,35487,120776309,2704,6
101928202,LOC101928202,chr1,R,157284341,157311377,120803345,27036,120803345,2705,6
101928216,LOC101928216,chr1,R,26006533,26036470,120833282,29937,120833282,2706,8
101928219,LOC101928219,chr1,F,95625449,95815917,121023750,190468,121023750,2707,7
101928226,LOC101928226,chr1,F,248697061,248699110,121025799,2049,121025799,2708,1
101928241,LOC101928241,chr1,R,96254068,96374125,121145856,120057,121145856,2709,5
101928264,LOC101928264,chr1,R,159776471,159780820,121150205,4349,121150205,2710,2
101928270,LOC101928270,chr1,R,99472419,99487804,121165590,15385,121165590,2711,2
101928303,LOC101928303,chr1,F,26225319,26229840,121170111,4521,121170111,2712,3
101928324,LOC101928324,chr1,R,26462755,26467537,121174893,4782,121174893,2713,3
101928334,LOC101928334,chr1,F,101150514,101176555,121200934,26041,121200934,2714,6
101928370,LOC101928370,chr1,R,101234872,101236528,121202590,1656,121202590,2715,1
101928372,LOC101928372,chr1,F,160932464,160949922,121220048,17458,121220048,2716,5
101928391,LOC101928391,chr1,F,27031756,27063997,121252289,32241,121252289,2717,8
101928404,LOC101928404,chr1,F,163161674,163213023,121303638,51349,121303638,2718,3
101928436,LOC101928436,chr1,R,103418078,103525483,121411043,107405,121411043,2719,3
101928459,LOC101928459,chr1,R,166883678,166888855,121416220,5177,121416220,2720,1
101928460,LOC101928460,chr1,R,29329619,29350114,121436715,20495,121436715,2721,2
101928476,LOC101928476,chr1,R,105589693,105618935,121465957,29242,121465957,2722,4
101928484,LINC01363,chr1,R,167175361,167195805,121486401,20444,121486401,2723,3
101928512,LOC101928512,chr1,F,167455053,167501062,121532410,46009,121532410,2724,6
101928531,LOC101928531,chr1,F,15948507,15954649,121538552,6142,121538552,2725,2
101928560,LOC101928560,chr1,R,109546609,109548538,121540481,1929,121540481,2726,1
101928565,LOC101928565,chr1,R,168464113,168495644,121572012,31531,121572012,2727,4
101928566,TBC1D3P6,chr1,F,15976130,15997206,121593088,21076,121593088,2728,8
101928596,LOC101928596,chr1,F,169103699,169106473,121595862,2774,121595862,2729,1
101928626,LOC101928626,chr1,R,627379,629009,121597492,1630,121597492,2730,2
101928628,LOC101928628,chr1,R,169762913,169764740,121599319,1827,121599319,2731,1
101928650,LOC101928650,chr1,R,170461316,170532609,121670612,71293,121670612,2732,2
101928673,LOC101928673,chr1,R,173417788,173461362,121714186,43574,121714186,2733,1
101928696,LOC101928696,chr1,R,174934946,174954261,121733501,19315,121733501,2734,5
101928718,LOC101928718,chr1,R,111745316,111755509,121743694,10193,121743694,2735,2
101928727,LOC101928727,chr1,F,175556987,175568248,121754955,11261,121754955,2736,1
101928728,LOC101928728,chr1,R,26692062,26696405,121759298,4343,121759298,2737,1
101928751,LOC101928751,chr1,F,175877342,175880464,121762420,3122,121762420,2738,2
101928778,LOC101928778,chr1,F,177700523,177710330,121772227,9807,121772227,2739,3
101928811,LOC101928811,chr1,R,7616945,7620622,121775904,3677,121775904,2740,2
101928836,LOC101928836,chr1,R,7440566,7441592,121776930,1026,121776930,2741,2
101928846,HIPK1-AS1,chr1,R,113924000,113929525,121782455,5525,121782455,2742,5
101928866,LOC101928866,chr1,R,178506135,178513028,121789348,6893,121789348,2743,4
101928890,LOC101928890,chr1,F,114401442,114411092,121798998,9650,121798998,2744,2
101928895,LOC101928895,chr1,F,1274001,1279447,121804444,5446,121804444,2745,2
101928933,LOC101928933,chr1,R,179926389,179954671,121832726,28282,121832726,2746,3
101928973,LOC101928973,chr1,F,181174483,181182208,121840451,7725,121840451,2747,2
101928977,LOC101928977,chr1,R,115922572,115977276,121895155,54704,121895155,2748,4
101928979,LOC101928979,chr1,F,146052595,146058799,121901359,6204,121901359,2749,3
101928995,LOC101928995,chr1,F,115919375,115925908,121907892,6533,121907892,2750,2
101929023,LOC101929023,chr1,R,116423723,116478826,121962995,55103,121962995,2751,6
101929069,LOC101929069,chr1,F,185001526,185008678,121970147,7152,121970147,2752,1
101929074,PIK3CD-AS2,chr1,R,9672425,9687574,121985296,15149,121985296,2753,2
101929093,LINC01350,chr1,R,185558378,185628488,122055406,70110,122055406,2754,3
101929099,LOC101929099,chr1,R,117025481,117059490,122089415,34009,122089415,2755,3
101929120,LINC01351,chr1,F,190478259,190481394,122092550,3135,122092550,2756,3
101929147,LOC101929147,chr1,F,119140395,119275973,122228128,135578,122228128,2757,10
101929160,LOC101929160,chr1,R,193122337,193130659,122236450,8322,122236450,2758,2
101929178,LOC101929178,chr1,F,120069836,120077091,122243705,7255,122243705,2759,1
101929181,LOC101929181,chr1,F,11609530,11613355,122247530,3825,122247530,2760,2
101929184,LINC01031,chr1,F,193304744,193365953,122308739,61209,122308739,2761,3
101929224,LOC101929224,chr1,F,200669506,200694250,122333483,24744,122333483,2762,2
101929305,LOC101929305,chr1,F,201023935,201043069,122352617,19134,122352617,2763,9
101929325,LOC101929325,chr1,F,148293277,148297556,122356896,4279,122356896,2764,1
101929326,LOC101929326,chr1,R,201355225,201356658,122358329,1433,122358329,2765,2
101929343,LOC101929343,chr1,F,201399632,201401564,122360261,1932,122360261,2766,1
101929363,LOC101929363,chr1,R,207401102,207416234,122375393,15132,122375393,2767,2
101929367,LOC101929367,chr1,R,201429194,201430233,122376432,1039,122376432,2768,3
101929388,LOC101929388,chr1,R,202227317,202238957,122388072,11640,122388072,2769,8
101929406,LOC101929406,chr1,R,30013951,30037612,122411733,23661,122411733,2770,6
101929441,LOC101929441,chr1,F,204141407,204143009,122413335,1602,122413335,2771,2
101929444,LOC101929444,chr1,F,31669810,31671067,122414592,1257,122414592,2772,1
101929459,LOC101929459,chr1,R,205233776,205237316,122418132,3540,122418132,2773,3
101929464,LOC101929464,chr1,F,33350351,33363245,122431026,12894,122431026,2774,2
101929476,LOC101929476,chr1,F,209372041,209379690,122438675,7649,122438675,2775,3
101929516,LOC101929516,chr1,F,39565069,39573203,122446809,8134,122446809,2776,3
101929536,LOC101929536,chr1,F,39788981,39790171,122447999,1190,122447999,2777,0
101929541,LOC101929541,chr1,R,212213001,212285021,122520019,72020,122520019,2778,6
101929565,LOC101929565,chr1,F,212545693,212556066,122530392,10373,122530392,2779,2
101929592,LOC101929592,chr1,R,43709391,43727343,122548344,17952,122548344,2780,3
101929609,LOC101929609,chr1,R,43944369,43946757,122550732,2388,122550732,2781,1
101929612,LOC101929612,chr1,F,215481829,215499834,122568737,18005,122568737,2782,3
101929626,LOC101929626,chr1,F,46133370,46139081,122574448,5711,122574448,2783,2
101929631,LOC101929631,chr1,F,218043504,218059140,122590084,15636,122590084,2784,3
101929651,LINC01398,chr1,R,46446672,46449704,122593116,3032,122593116,2785,2
101929713,LOC101929713,chr1,F,219218523,219445121,122819714,226598,122819714,2786,10
101929721,LOC101929721,chr1,F,49257410,49269294,122831598,11884,122831598,2787,3
101929730,LINC01352,chr1,F,220829254,220832429,122834773,3175,122834773,2788,3
101929750,LOC101929750,chr1,F,221073717,221143011,122904067,69294,122904067,2789,8
101929766,LOC101929766,chr1,R,189266080,189335533,122973520,69453,122973520,2790,1
101929771,LOC101929771,chr1,R,221827665,221840666,122986521,13001,122986521,2791,3
101929780,NBPF25P,chr1,R,145572344,145607858,123022035,35514,123022035,2792,19
101929787,LOC101929787,chr1,R,148865453,148871271,123027853,5818,123027853,2793,2
101929788,LOC101929788,chr1,F,120393544,120411356,123045665,17812,123045665,2794,5
101929790,LOC101929790,chr1,R,149107222,149124744,123063187,17522,123063187,2795,6
101929796,LOC101929796,chr1,F,120723954,120805451,123144684,81497,123144684,2796,5
101929798,LOC101929798,chr1,R,121028074,121053518,123170128,25444,123170128,2797,9
101929805,LOC101929805,chr1,F,145135058,145149891,123184961,14833,123184961,2798,7
101929814,LOC101929814,chr1,R,143300729,143308909,123193141,8180,123193141,2799,4
101929815,LOC101929815,chr1,R,143450184,143479561,123222518,29377,123222518,2800,11
101929826,LOC101929826,chr1,R,144625605,144642375,123239288,16770,123239288,2801,7
101929901,LOC101929901,chr1,R,41375003,41380923,123245208,5920,123245208,2802,2
101929929,LOC101929929,chr1,R,56477808,56483448,123250848,5640,123250848,2803,2
101929935,LOC101929935,chr1,R,56627761,56645313,123268400,17552,123268400,2804,3
101929983,LOC101929983,chr1,R,13049807,13053659,123272252,3852,123272252,2805,2
101930114,LOC101930114,chr1,R,209661358,209757599,123368493,96241,123368493,2806,9
101930120,LOC101930120,chr1,R,99913196,100037998,123493295,124802,123493295,2807,8
101954264,RNVU1-4,chr1,F,120942599,120942763,123493459,164,123493459,2808,0
101954266,RNVU1-14,chr1,F,145281115,145281279,123493623,164,123493623,2809,0
101954267,RNVU1-15,chr1,F,144412575,144412740,123493788,165,123493788,2810,0
101954269,RNVU1-17,chr1,R,143699455,143699619,123493952,164,123493952,2811,0
101954272,RNVU1-3,chr1,F,148402714,148402875,123494113,161,123494113,2812,0
101954273,RNVU1-10,chr1,R,148362369,148362533,123494277,164,123494277,2813,0
101954276,RNVU1-6,chr1,R,146052080,146052244,123494441,164,123494441,2814,0
101954277,RNVU1-19,chr1,R,120850818,120850985,123494608,167,123494608,2815,0
101978719,LINC00970,chr1,R,168903904,169087005,123677709,183101,123677709,2816,4
102464823,MIR6068,chr1,R,63326924,63326984,123677769,60,123677769,2817,0
102464830,MIR6079,chr1,F,43838621,43838683,123677831,62,123677831,2818,0
102464833,MIR6084,chr1,F,20633678,20633788,123677941,110,123677941,2819,0
102465432,MIR6723,chr1,R,632324,632413,123678030,89,123678030,2820,0
102465434,MIR6726,chr1,R,1296109,1296170,123678091,61,123678091,2821,0
102465435,MIR6727,chr1,R,1312501,1312566,123678156,65,123678156,2822,0
102465436,MIR6728,chr1,R,8866501,8866590,123678245,89,123678245,2823,0
102465437,MIR6731,chr1,R,24919344,24919416,123678317,72,123678317,2824,0
102465438,MIR6732,chr1,F,37480229,37480289,123678377,60,123678377,2825,0
102465439,MIR6733,chr1,R,43171651,43171712,123678438,61,123678438,2826,0
102465440,MIR6735,chr1,F,43448538,43448611,123678511,73,123678511,2827,0
102465441,MIR6737,chr1,R,153962350,153962420,123678581,70,123678581,2828,0
102465442,MIR6738,chr1,R,155951272,155951336,123678645,64,123678645,2829,0
102465443,MIR6740,chr1,F,202003123,202003236,123678758,113,123678758,2830,0
102465444,MIR6742,chr1,R,228397047,228397109,123678820,62,123678820,2831,0
102465529,MIR6878,chr1,F,150492344,150492410,123678886,66,123678886,2832,0
102465836,MIR7846,chr1,F,12166942,12167038,123678982,96,123678982,2833,0
102465839,MIR7852,chr1,F,107897222,107897304,123679064,82,123679064,2834,0
102465842,MIR7856,chr1,R,86357631,86357687,123679120,56,123679120,2835,0
102465909,MIR6859-2,chr1,R,187890,187958,123679188,68,123679188,2836,0
102466191,MIR6736,chr1,R,145850586,145850645,123679247,59,123679247,2837,0
102466202,MIR6769B,chr1,F,206474802,206474864,123679309,62,123679309,2838,0
102466225,MIR6077,chr1,F,148388281,148388363,123679391,82,123679391,2839,0
102466270,MIR6741,chr1,R,225922079,225922142,123679454,63,123679454,2840,0
102466615,MIR6127,chr1,R,22633257,22633366,123679563,109,123679563,2841,0
102466656,MIR6500,chr1,F,51060017,51060103,123679649,86,123679649,2842,0
102466722,MIR6730,chr1,R,12578956,12579023,123679716,67,123679716,2843,0
102466723,MIR6734,chr1,R,43364647,43364715,123679784,68,123679784,2844,0
102466724,MIR6739,chr1,F,201863372,201863447,123679859,75,123679859,2845,0
102466740,MIR6808,chr1,R,1339649,1339708,123679918,59,123679918,2846,0
102466751,MIR6859-1,chr1,R,17368,17436,123679986,68,123679986,2847,0
102466879,MIR8083,chr1,R,153689704,153689793,123680075,89,123680075,2848,0
102466982,MIR6729,chr1,F,12029157,12029222,123680140,65,123680140,2849,0
102466995,MIR7156,chr1,F,77060142,77060202,123680200,60,123680200,2850,0
102606465,LOC102606465,chr1,F,101025845,101087379,123741734,61534,123741734,2851,4
102723321,LOC102723321,chr1,F,147700375,147810024,123851383,109649,123851383,2852,4
102723348,LOC102723348,chr1,F,149127871,149153274,123876786,25403,123876786,2853,4
102723383,LOC102723383,chr1,R,16733806,16734539,123877519,733,123877519,2854,0
102723436,LOC102723436,chr1,R,91518636,91569826,123928709,51190,123928709,2855,5
102723465,LOC102723465,chr1,R,202000094,202010046,123938661,9952,123938661,2856,1
102723480,LOC102723480,chr1,F,93693195,93699548,123945014,6353,123945014,2857,4
102723529,LOC102723529,chr1,F,203372930,203398513,123970597,25583,123970597,2858,9
102723543,LOC102723543,chr1,R,203737200,203744286,123977683,7086,123977683,2859,1
102723661,LOC102723661,chr1,F,95992067,96022880,124008496,30813,124008496,2860,4
102723727,LOC102723727,chr1,F,211829717,211852415,124031194,22698,124031194,2861,7
102723760,LOC102723760,chr1,F,27157555,27160453,124034092,2898,124034092,2862,2
102723761,LOC102723761,chr1,R,212632368,212665649,124067373,33281,124067373,2863,4
102723784,LOC102723784,chr1,R,101296752,101309187,124079808,12435,124079808,2864,5
102723802,LOC102723802,chr1,R,214256635,214279385,124102558,22750,124102558,2865,3
102723817,LOC102723817,chr1,R,224610607,224616279,124108230,5672,124108230,2866,3
102723832,LOC102723832,chr1,F,30860589,30862399,124110040,1810,124110040,2867,2
102723833,LOC102723833,chr1,F,216072464,216086917,124124493,14453,124124493,2868,2
102723834,LOC102723834,chr1,F,225700692,225716434,124140235,15742,124140235,2869,2
102723870,LOC102723870,chr1,R,32609297,32619941,124150879,10644,124150879,2870,3
102723886,LOC102723886,chr1,R,219409458,219557280,124298701,147822,124298701,2871,8
102723897,LOC102723897,chr1,R,184915,200470,124314256,15555,124314256,2872,10
102723917,LOC102723917,chr1,R,268132,297530,124343654,29398,124343654,2873,3
102723919,LOC102723919,chr1,F,113131185,113132260,124344729,1075,124344729,2874,1
102723924,LOC102723924,chr1,F,41242334,41334558,124436953,92224,124436953,2875,11
102723935,LOC102723935,chr1,R,229242987,229256698,124450664,13711,124450664,2876,3
102723955,LOC102723955,chr1,R,149719895,149749184,124479953,29289,124479953,2877,10
102724012,LOC102724012,chr1,F,150629699,150643018,124493272,13319,124493272,2878,4
102724041,LOC102724041,chr1,R,231461476,231520998,124552794,59522,124552794,2879,4
102724046,LOC102724046,chr1,R,223092927,223103308,124563175,10381,124563175,2880,6
102724077,LINC01389,chr1,R,47380795,47437317,124619697,56522,124619697,2881,4
102724097,TTC39A-AS1,chr1,F,51329653,51331281,124621325,1628,124621325,2882,2
102724100,LOC102724100,chr1,R,234270402,234273025,124623948,2623,124623948,2883,1
102724125,LOC102724125,chr1,R,53413150,53428069,124638867,14919,124638867,2884,3
102724140,LOC102724140,chr1,F,56436680,56445707,124647894,9027,124647894,2885,3
102724174,LOC102724174,chr1,F,239127260,239208303,124728937,81043,124728937,2886,2
102724180,LOC102724180,chr1,F,156511683,156512509,124729763,826,124729763,2887,1
102724222,LOC102724222,chr1,R,157050051,157051683,124731395,1632,124731395,2888,2
102724235,LOC102724235,chr1,R,145164644,145166132,124732883,1488,124732883,2889,0
102724281,LOC102724281,chr1,F,61096800,61133282,124769365,36482,124769365,2890,3
102724282,LOC102724282,chr1,F,120724447,120746675,124791593,22228,124791593,2891,4
102724312,LOC102724312,chr1,R,1430156,1434573,124796010,4417,124796010,2892,1
102724319,LOC102724319,chr1,F,63487785,63517794,124826019,30009,124826019,2893,2
102724329,LOC102724329,chr1,R,161764119,161766227,124828127,2108,124828127,2894,2
102724358,LOC102724358,chr1,R,162552150,162561489,124837466,9339,124837466,2895,2
102724364,LOC102724364,chr1,R,146316890,146376833,124897409,59943,124897409,2896,6
102724382,LOC102724382,chr1,F,246682070,246692537,124907876,10467,124907876,2897,2
102724416,LOC102724416,chr1,R,65277546,65309457,124939787,31911,124939787,2898,7
102724429,LOC102724429,chr1,F,4998036,5016708,124958459,18672,124958459,2899,5
102724446,LOC102724446,chr1,R,247565638,247641191,125034012,75553,125034012,2900,2
102724450,LOC102724450,chr1,R,6204839,6205780,125034953,941,125034953,2901,2
102724481,LOC102724481,chr1,F,67522310,67532308,125044951,9998,125044951,2902,4
102724528,LOC102724528,chr1,R,172393132,172456471,125108290,63339,125108290,2903,6
102724539,LOC102724539,chr1,F,8208671,8215210,125114829,6539,125114829,2904,3
102724541,LOC102724541,chr1,R,172369727,172384910,125130012,15183,125130012,2905,2
102724548,LOC102724548,chr1,R,70355884,70361007,125135135,5123,125135135,2906,2
102724552,LOC102724552,chr1,F,8424644,8435016,125145507,10372,125145507,2907,3
102724558,LOC102724558,chr1,F,146486331,146525289,125184465,38958,125184465,2908,4
102724571,LOC102724571,chr1,F,9181421,9192086,125195130,10665,125195130,2909,4
102724572,LOC102724572,chr1,F,70812547,70855460,125238043,42913,125238043,2910,6
102724601,LOC102724601,chr1,R,174121637,174159287,125275693,37650,125275693,2911,3
102724649,LOC102724649,chr1,R,176521215,176552695,125307173,31480,125307173,2912,3
102724659,LOC102724659,chr1,R,11777076,11779619,125309716,2543,125309716,2913,2
102724661,LOC102724661,chr1,F,177351585,177366458,125324589,14873,125324589,2914,3
102724742,LOC102724742,chr1,F,13030808,13032199,125325980,1391,125325980,2915,1
102724754,LOC102724754,chr1,R,178936756,178938904,125328128,2148,125328128,2916,2
102724830,LOC102724830,chr1,F,184112569,184122538,125338097,9969,125338097,2917,3
102724846,LOC102724846,chr1,R,184208210,184213972,125343859,5762,125343859,2918,1
102724856,LOC102724856,chr1,F,13487576,13493138,125349421,5562,125349421,2919,3
102724857,LOC102724857,chr1,F,184538780,184542649,125353290,3869,125353290,2920,2
102724892,LOC102724892,chr1,R,84781005,84797644,125369929,16639,125369929,2921,2
102724897,LOC102724897,chr1,F,185370665,185375028,125374292,4363,125374292,2922,2
102724919,LOC102724919,chr1,F,186435160,186470291,125409423,35131,125409423,2923,4
102724954,LINC01032,chr1,R,192935743,192948257,125421937,12514,125421937,2924,2
102724970,LOC102724970,chr1,F,16535772,16536956,125423121,1184,125423121,2925,1
102725121,LOC102725121,chr1,F,181044,184254,125426331,3210,125426331,2926,3
102725140,LOC102725140,chr1,F,165215854,165219047,125429524,3193,125429524,2927,2
102725193,LOC102725193,chr1,R,7388182,7389923,125431265,1741,125431265,2928,2
102800316,LINC01222,chr1,R,198992588,199018964,125457641,26376,125457641,2929,2
103021295,LOC103021295,chr1,F,205957924,205958388,125458105,464,125458105,2930,0
103021296,LOC103021296,chr1,F,205934912,205978095,125501288,43183,125501288,2931,4
103091866,LOC103091866,chr1,R,145168404,145216071,125548955,47667,125548955,2932,4
103283057,LINC01362,chr1,F,82903182,82997583,125643356,94401,125643356,2933,4
103611157,TGFB2-OT1,chr1,F,218442625,218443995,125644726,1370,125644726,2934,0
103695366,LINC01461,chr1,R,84597963,84621031,125667794,23068,125667794,2935,2
103752555,SPATA17-AS1,chr1,R,217781197,217785120,125671717,3923,125671717,2936,2
103752588,PACERR,chr1,F,186680653,186681446,125672510,793,125672510,2937,0
104169671,LINC01036,chr1,F,187290055,187360244,125742699,70189,125742699,2938,4
104266961,LINC01221,chr1,F,199016132,199076735,125803302,60603,125803302,2939,2
104355139,LINC01397,chr1,F,110082687,110109719,125830334,27032,125830334,2940,3
104355143,TXNDC12-AS1,chr1,F,52050917,52052683,125832100,1766,125832100,2941,2
104355286,LINC01307,chr1,F,101323836,101377313,125885577,53477,125885577,2942,4
104355292,LINC01525,chr1,F,117295465,117321336,125911448,25871,125911448,2943,2
104472714,DISC1-IT1,chr1,F,231925833,231945205,125930820,19372,125930820,2944,3
104472716,WARS2-IT1,chr1,F,119047404,119063287,125946703,15883,125946703,2945,1
105369140,LOC105369140,chr1,F,143744879,143785882,125987706,41003,125987706,2946,9
105369141,LOC105369141,chr1,R,161002284,161021003,126006425,18719,126006425,2947,3
105369174,LOC105369174,chr1,F,1061206,1066390,126011609,5184,126011609,2948,3
105369175,LOC105369175,chr1,R,53641739,53739323,126109193,97584,126109193,2949,2
105369195,LOC105369195,chr1,R,223951265,223983034,126140962,31769,126140962,2950,22
105369199,LOC105369199,chr1,F,120963237,121002782,126180507,39545,126180507,2951,9
105371172,LOC105371172,chr1,R,143323046,143327030,126184491,3984,126184491,2952,2
105371175,LOC105371175,chr1,F,143327630,143345549,126202410,17919,126202410,2953,3
105371206,LOC105371206,chr1,F,144153168,144171251,126220493,18083,126220493,2954,3
105371207,LOC105371207,chr1,R,144148426,144152410,126224477,3984,126224477,2955,2
105371208,LOC105371208,chr1,R,143976737,143982381,126230121,5644,126230121,2956,1
105371209,LOC105371209,chr1,F,143907387,143934791,126257525,27404,126257525,2957,1
105371210,LOC105371210,chr1,F,143825904,143831979,126263600,6075,126263600,2958,3
105371211,LOC105371211,chr1,R,144472374,144485779,126277005,13405,126277005,2959,5
105371212,LOC105371212,chr1,R,144501112,144503718,126279611,2606,126279611,2960,2
105371213,LOC105371213,chr1,F,144512465,144532363,126299509,19898,126299509,2961,3
105371215,LOC105371215,chr1,F,144652205,144654427,126301731,2222,126301731,2962,1
105371216,LOC105371216,chr1,R,144795132,144813218,126319817,18086,126319817,2963,3
105371217,LOC105371217,chr1,F,144814152,144818136,126323801,3984,126323801,2964,2
105371218,LOC105371218,chr1,F,145085612,145091250,126329439,5638,126329439,2965,1
105371219,LOC105371219,chr1,R,145128365,145135724,126336798,7359,126336798,2966,5
105371220,LOC105371220,chr1,F,149047908,149051273,126340163,3365,126340163,2967,1
105371221,LOC105371221,chr1,R,148949650,148952093,126342606,2443,126342606,2968,1
105371222,LOC105371222,chr1,R,148733394,148735995,126345207,2601,126345207,2969,2
105371223,LOC105371223,chr1,F,148680045,148686764,126351926,6719,126351926,2970,1
105371225,LOC105371225,chr1,R,148290890,148296853,126357889,5963,126357889,2971,2
105371226,LOC105371226,chr1,R,148271895,148281363,126367357,9468,126367357,2972,2
105371227,LOC105371227,chr1,F,148155576,148158546,126370327,2970,126370327,2973,1
105371228,LOC105371228,chr1,F,148009530,148027696,126388493,18166,126388493,2974,6
105371229,LOC105371229,chr1,R,147908672,147928673,126408494,20001,126408494,2975,6
105371230,LOC105371230,chr1,R,147700807,147738850,126446537,38043,126446537,2976,2
105371231,LOC105371231,chr1,R,147053868,147073065,126465734,19197,126465734,2977,6
105371232,LOC105371232,chr1,F,146954395,146956851,126468190,2456,126468190,2978,1
105371233,LOC105371233,chr1,F,146448454,146452348,126472084,3894,126472084,2979,3
105371234,LOC105371234,chr1,F,146430420,146433108,126474772,2688,126474772,2980,2
105371235,LOC105371235,chr1,R,146410594,146443993,126508171,33399,126508171,2981,5
105371242,LOC105371242,chr1,R,146343118,146344870,126509923,1752,126509923,2982,0
105371249,LOC105371249,chr1,R,146282611,146285212,126512524,2601,126512524,2983,2
105371254,LOC105371254,chr1,F,146229322,146236689,126519891,7367,126519891,2984,1
105371260,LOC105371260,chr1,F,145927556,145949052,126541387,21496,126541387,2985,3
105371288,LOC105371288,chr1,F,145432149,145443352,126552590,11203,126552590,2986,5
105371303,LOC105371303,chr1,R,145423356,145425966,126555200,2610,126555200,2987,2
105371312,LOC105371312,chr1,R,145412896,145422886,126565190,9990,126565190,2988,3
105371324,LOC105371324,chr1,R,145411770,145412825,126566245,1055,126566245,2989,1
105371330,LOC105371330,chr1,R,145408579,145410723,126568389,2144,126568389,2990,1
105371364,LOC105371364,chr1,R,149140044,149142712,126571057,2668,126571057,2991,2
105371403,LOC105371403,chr1,R,149383615,149390590,126578032,6975,126578032,2992,1
105371405,LOC105371405,chr1,F,149833132,149840737,126585637,7605,126585637,2993,4
105371406,LOC105371406,chr1,F,149734939,149740512,126591210,5573,126591210,2994,2
105371415,LOC105371415,chr1,R,149665714,149669149,126594645,3435,126594645,2995,1
105371420,LOC105371420,chr1,F,149615927,149625411,126604129,9484,126604129,2996,1
105371424,LOC105371424,chr1,R,149853543,149860683,126611269,7140,126611269,2997,3
105371427,LOC105371427,chr1,R,150048512,150067605,126630362,19093,126630362,2998,2
105371431,LOC105371431,chr1,F,150012434,150058301,126676229,45867,126676229,2999,2
105371433,LOC105371433,chr1,F,150160727,150181331,126696833,20604,126696833,3000,10
105371434,LOC105371434,chr1,R,150293301,150293722,126697254,421,126697254,3001,1
105371435,LOC105371435,chr1,R,150507604,150510869,126700519,3265,126700519,3002,1
105371436,LOC105371436,chr1,F,150521057,150535829,126715291,14772,126715291,3003,3
105371437,LOC105371437,chr1,F,150550282,150551350,126716359,1068,126716359,3004,0
105371438,LOC105371438,chr1,R,150979826,150981661,126718194,1835,126718194,3005,2
105371439,LOC105371439,chr1,R,151273220,151278047,126723021,4827,126723021,3006,2
105371440,LOC105371440,chr1,F,151735537,151759648,126747132,24111,126747132,3007,4
105371441,LOC105371441,chr1,F,151987234,152010601,126770499,23367,126770499,3008,5
105371442,LOC105371442,chr1,R,152018877,152027518,126779140,8641,126779140,3009,2
105371444,LOC105371444,chr1,R,152861508,152868176,126785808,6668,126785808,3010,2
105371445,LOC105371445,chr1,R,152869329,152872495,126788974,3166,126788974,3011,3
105371446,LOC105371446,chr1,F,153011131,153024583,126802426,13452,126802426,3012,3
105371447,LOC105371447,chr1,R,153164350,153203313,126841389,38963,126841389,3013,7
105371448,LOC105371448,chr1,F,153800480,153804151,126845060,3671,126845060,3014,1
105371449,LOC105371449,chr1,R,154919505,154924183,126849738,4678,126849738,3015,3
105371450,LOC105371450,chr1,F,155195288,155201949,126856399,6661,126856399,3016,7
105371451,LOC105371451,chr1,R,155313707,155317353,126860045,3646,126860045,3017,1
105371452,LOC105371452,chr1,R,155609608,155612837,126863274,3229,126863274,3018,1
105371453,LOC105371453,chr1,R,156645724,156661441,126878991,15717,126878991,3019,1
105371454,LOC105371454,chr1,R,156706328,156713174,126885837,6846,126885837,3020,1
105371455,LOC105371455,chr1,F,157275008,157283617,126894446,8609,126894446,3021,2
105371456,LOC105371456,chr1,R,157225412,157279272,126948306,53860,126948306,3022,3
105371457,LOC105371457,chr1,R,157653128,157660145,126955323,7017,126955323,3023,2
105371458,LOC105371458,chr1,F,157948475,157950921,126957769,2446,126957769,3024,2
105371459,LOC105371459,chr1,F,157979310,157986183,126964642,6873,126964642,3025,2
105371460,LOC105371460,chr1,F,158140724,158170029,126993947,29305,126993947,3026,4
105371461,LOC105371461,chr1,R,159056126,159057750,126995571,1624,126995571,3027,1
105371462,LOC105371462,chr1,F,159466103,159490491,127019959,24388,127019959,3028,4
105371463,LOC105371463,chr1,F,159509918,159534693,127044734,24775,127044734,3029,3
105371464,LOC105371464,chr1,R,159800480,159806589,127050843,6109,127050843,3030,2
105371465,LOC105371465,chr1,F,160057211,160079682,127073314,22471,127073314,3031,5
105371466,LOC105371466,chr1,R,160375505,160408444,127106253,32939,127106253,3032,2
105371467,LOC105371467,chr1,R,160432864,160438177,127111566,5313,127111566,3033,2
105371468,LOC105371468,chr1,F,160536576,160571133,127146123,34557,127146123,3034,1
105371470,LOC105371470,chr1,R,160773527,160789878,127162474,16351,127162474,3035,1
105371471,LOC105371471,chr1,F,161083825,161087575,127166224,3750,127166224,3036,2
105371472,LOC105371472,chr1,R,161279464,161281773,127168533,2309,127168533,3037,4
105371473,LOC105371473,chr1,F,161489309,161495515,127174739,6206,127174739,3038,2
105371474,LOC105371474,chr1,R,162288048,162292930,127179621,4882,127179621,3039,2
105371475,LOC105371475,chr1,R,162105453,162175134,127249302,69681,127249302,3040,9
105371497,LOC105371497,chr1,R,162467314,162497713,127279701,30399,127279701,3041,2
105371503,LOC105371503,chr1,F,162534827,162549066,127293940,14239,127293940,3042,2
105371515,LOC105371515,chr1,R,162990521,163006645,127310064,16124,127310064,3043,2
105371521,LOC105371521,chr1,R,163769384,163842492,127383172,73108,127383172,3044,2
105371527,LOC105371527,chr1,R,164428762,164431745,127386155,2983,127386155,3045,2
105371542,LOC105371542,chr1,F,165267630,165287477,127406002,19847,127406002,3046,2
105371546,LOC105371546,chr1,F,165247304,165258654,127417352,11350,127417352,3047,2
105371561,LOC105371561,chr1,F,165204046,165213091,127426397,9045,127426397,3048,5
105371565,LOC105371565,chr1,F,165535530,165535915,127426782,385,127426782,3049,1
105371575,LOC105371575,chr1,F,165598379,165606862,127435265,8483,127435265,3050,2
105371581,LOC105371581,chr1,R,165707130,165709500,127437635,2370,127437635,3051,1
105371586,LOC105371586,chr1,F,166080841,166091335,127448129,10494,127448129,3052,2
105371590,LOC105371590,chr1,R,166475843,166490223,127462509,14380,127462509,3053,2
105371593,LOC105371593,chr1,R,166894905,166908107,127475711,13202,127475711,3054,3
105371594,LOC105371594,chr1,F,166947754,166973184,127501141,25430,127501141,3055,4
105371596,LOC105371596,chr1,F,166927193,166935289,127509237,8096,127509237,3056,3
105371598,LOC105371598,chr1,F,167088520,167091370,127512087,2850,127512087,3057,2
105371599,LOC105371599,chr1,R,167079855,167088513,127520745,8658,127520745,3058,2
105371600,LOC105371600,chr1,F,167051132,167067149,127536762,16017,127536762,3059,4
105371601,LOC105371601,chr1,F,167166957,167172159,127541964,5202,127541964,3060,2
105371602,LOC105371602,chr1,F,167639711,167643235,127545488,3524,127545488,3061,2
105371603,LOC105371603,chr1,F,168317511,168417970,127645947,100459,127645947,3062,2
105371604,LOC105371604,chr1,R,168638019,168666637,127674565,28618,127674565,3063,2
105371605,LOC105371605,chr1,R,169371460,169373946,127677051,2486,127677051,3064,1
105371606,LOC105371606,chr1,F,168803947,168870199,127743303,66252,127743303,3065,2
105371607,LOC105371607,chr1,F,169854970,169862649,127750982,7679,127750982,3066,2
105371608,LOC105371608,chr1,F,170041475,170046229,127755736,4754,127755736,3067,1
105371609,LOC105371609,chr1,F,170173927,170241844,127823653,67917,127823653,3068,8
105371610,LOC105371610,chr1,F,170655405,170660691,127828939,5286,127828939,3069,2
105371611,LOC105371611,chr1,R,171120401,171251882,127960420,131481,127960420,3070,4
105371612,LOC105371612,chr1,F,171601080,171626916,127986256,25836,127986256,3071,4
105371613,LOC105371613,chr1,R,171655657,171663109,127993708,7452,127993708,3072,2
105371614,LOC105371614,chr1,F,171773105,171779610,128000213,6505,128000213,3073,2
105371615,LOC105371615,chr1,F,171849287,171860154,128011080,10867,128011080,3074,4
105371616,LOC105371616,chr1,R,172515144,172532473,128028409,17329,128028409,3075,3
105371617,LOC105371617,chr1,F,172679676,172789878,128138611,110202,128138611,3076,2
105371618,LOC105371618,chr1,R,172831140,172836075,128143546,4935,128143546,3077,2
105371619,LOC105371619,chr1,F,173637716,173681710,128187540,43994,128187540,3078,3
105371620,LOC105371620,chr1,F,174022471,174022985,128188054,514,128188054,3079,1
105371621,LOC105371621,chr1,F,174056887,174109993,128241160,53106,128241160,3080,3
105371622,LOC105371622,chr1,R,174992544,174999352,128247968,6808,128247968,3081,1
105371623,LOC105371623,chr1,F,175330253,175335704,128253419,5451,128253419,3082,2
105371624,LOC105371624,chr1,F,175287552,175321717,128287584,34165,128287584,3083,1
105371625,LOC105371625,chr1,R,177243735,177255930,128299779,12195,128299779,3084,2
105371626,LOC105371626,chr1,R,177556498,177576949,128320230,20451,128320230,3085,2
105371627,LOC105371627,chr1,F,177819477,177825572,128326325,6095,128326325,3086,2
105371628,LOC105371628,chr1,F,178058471,178076755,128344609,18284,128344609,3087,2
105371629,LOC105371629,chr1,R,178323657,178341380,128362332,17723,128362332,3088,2
105371630,LOC105371630,chr1,F,178125462,178135525,128372395,10063,128372395,3089,1
105371631,LOC105371631,chr1,R,178526179,178532732,128378948,6553,128378948,3090,6
105371632,LOC105371632,chr1,R,178554389,178580176,128404735,25787,128404735,3091,4
105371633,LOC105371633,chr1,R,178796955,178809783,128417563,12828,128417563,3092,2
105371634,LOC105371634,chr1,R,179814300,179819418,128422681,5118,128422681,3093,3
105371635,LOC105371635,chr1,R,179690333,179730060,128462408,39727,128462408,3094,3
105371636,LOC105371636,chr1,R,180152607,180154439,128464240,1832,128464240,3095,1
105371637,LOC105371637,chr1,R,180415817,180424253,128472676,8436,128472676,3096,1
105371638,LOC105371638,chr1,F,180906902,180909621,128475395,2719,128475395,3097,2
105371639,LOC105371639,chr1,R,181447663,181482521,128510253,34858,128510253,3098,2
105371640,LOC105371640,chr1,R,182002836,182004330,128511747,1494,128511747,3099,2
105371641,LOC105371641,chr1,R,182064294,182244444,128691897,180150,128691897,3100,7
105371642,LOC105371642,chr1,F,182109968,182117815,128699744,7847,128699744,3101,2
105371643,LOC105371643,chr1,F,182393829,182405940,128711855,12111,128711855,3102,2
105371644,LOC105371644,chr1,F,182712675,182714544,128713724,1869,128713724,3103,1
105371645,LOC105371645,chr1,R,182792370,182794349,128715703,1979,128715703,3104,1
105371646,LOC105371646,chr1,F,183433889,183462082,128743896,28193,128743896,3105,4
105371647,LOC105371647,chr1,F,183621937,183626939,128748898,5002,128748898,3106,1
105371648,LOC105371648,chr1,F,184663180,184672035,128757753,8855,128757753,3107,2
105371649,LOC105371649,chr1,F,184754972,184776029,128778810,21057,128778810,3108,1
105371650,LOC105371650,chr1,R,184943243,184946879,128782446,3636,128782446,3109,1
105371651,LOC105371651,chr1,R,185267685,185283809,128798570,16124,128798570,3110,2
105371652,LOC105371652,chr1,R,185354271,185370571,128814870,16300,128814870,3111,2
105371653,LOC105371653,chr1,F,185646565,185657168,128825473,10603,128825473,3112,3
105371654,LOC105371654,chr1,R,186182361,186222715,128865827,40354,128865827,3113,1
105371655,LOC105371655,chr1,F,187254010,187255104,128866921,1094,128866921,3114,3
105371656,LOC105371656,chr1,R,187485455,187547684,128929150,62229,128929150,3115,2
105371658,LOC105371658,chr1,F,190264958,190362234,129026426,97276,129026426,3116,6
105371659,LOC105371659,chr1,F,190228929,190264964,129062461,36035,129062461,3117,3
105371660,LOC105371660,chr1,R,191221158,191228512,129069815,7354,129069815,3118,2
105371661,LOC105371661,chr1,F,192106282,192139550,129103083,33268,129103083,3119,3
105371662,LOC105371662,chr1,R,192235840,192239786,129107029,3946,129107029,3120,3
105371663,LOC105371663,chr1,R,192343560,192381698,129145167,38138,129145167,3121,2
105371664,LOC105371664,chr1,R,192491750,192629012,129282429,137262,129282429,3122,4
105371665,LOC105371665,chr1,R,192763828,192792523,129311124,28695,129311124,3123,3
105371666,LOC105371666,chr1,R,192863898,192873200,129320426,9302,129320426,3124,3
105371667,LOC105371667,chr1,R,192836181,192853029,129337274,16848,129337274,3125,2
105371668,LOC105371668,chr1,F,192831862,192864092,129369504,32230,129369504,3126,2
105371669,LOC105371669,chr1,R,192951393,192955456,129373567,4063,129373567,3127,1
105371670,LOC105371670,chr1,R,194291216,194299946,129382297,8730,129382297,3128,2
105371671,LOC105371671,chr1,R,195574399,195721899,129529797,147500,129529797,3129,2
105371672,LOC105371672,chr1,R,195753457,195763506,129539846,10049,129539846,3130,3
105371673,LOC105371673,chr1,R,196044961,196086021,129580906,41060,129580906,3131,3
105371674,LOC105371674,chr1,R,196181893,196186140,129585153,4247,129585153,3132,2
105371675,LOC105371675,chr1,R,196912091,196933716,129606778,21625,129606778,3133,2
105371676,LOC105371676,chr1,R,197273012,197288046,129621812,15034,129621812,3134,2
105371677,LOC105371677,chr1,R,198452363,198520229,129689678,67866,129689678,3135,1
105371678,LOC105371678,chr1,R,198642948,198657564,129704294,14616,129704294,3136,2
105371679,LOC105371679,chr1,F,198976177,198983925,129712042,7748,129712042,3137,3
105371680,LOC105371680,chr1,F,199448985,199460401,129723458,11416,129723458,3138,4
105371681,LOC105371681,chr1,F,199775674,199783747,129731531,8073,129731531,3139,2
105371682,LOC105371682,chr1,R,199947646,199959459,129743344,11813,129743344,3140,2
105371683,LOC105371683,chr1,R,202123599,202125637,129745382,2038,129745382,3141,2
105371684,LOC105371684,chr1,R,202087726,202119949,129777605,32223,129777605,3142,2
105371685,LOC105371685,chr1,F,202602016,202604010,129779599,1994,129779599,3143,1
105371686,LOC105371686,chr1,F,202596976,202602000,129784623,5024,129784623,3144,4
105371687,LOC105371687,chr1,R,203067326,203067688,129784985,362,129784985,3145,1
105371688,LOC105371688,chr1,R,203510492,203513771,129788264,3279,129788264,3146,2
105371689,LOC105371689,chr1,F,203996804,204008534,129799994,11730,129799994,3147,2
105371690,LOC105371690,chr1,R,204170175,204174118,129803937,3943,129803937,3148,2
105371691,LOC105371691,chr1,F,204659289,204678290,129822938,19001,129822938,3149,4
105371692,LOC105371692,chr1,F,204594402,204629711,129858247,35309,129858247,3150,11
105371693,LOC105371693,chr1,R,204708807,204715114,129864554,6307,129864554,3151,1
105371694,LOC105371694,chr1,F,204726228,204733988,129872314,7760,129872314,3152,2
105371695,LOC105371695,chr1,R,204716383,204726206,129882137,9823,129882137,3153,3
105371696,LOC105371696,chr1,R,205282416,205298122,129897843,15706,129897843,3154,2
105371697,LOC105371697,chr1,F,205441392,205452029,129908480,10637,129908480,3155,3
105371698,LOC105371698,chr1,R,205376981,205378597,129910096,1616,129910096,3156,2
105371699,LOC105371699,chr1,R,205558261,205569217,129921052,10956,129921052,3157,5
105371700,LOC105371700,chr1,R,205539954,205543560,129924658,3606,129924658,3158,3
105371701,LOC105371701,chr1,F,205680414,205690644,129934888,10230,129934888,3159,2
105371702,LOC105371702,chr1,F,205775570,205783623,129942941,8053,129942941,3160,1
105371729,LOC105371729,chr1,F,156001152,156033225,129975014,32073,129975014,3161,4
105372857,LOC105372857,chr1,R,206057446,206072340,129989908,14894,129989908,3162,2
105372869,LOC105372869,chr1,R,206126027,206134117,129997998,8090,129997998,3163,2
105372873,LOC105372873,chr1,F,206147198,206165682,130016482,18484,130016482,3164,1
105372874,LOC105372874,chr1,R,206207622,206213266,130022126,5644,130022126,3165,1
105372875,LOC105372875,chr1,F,206680456,206682988,130024658,2532,130024658,3166,2
105372876,LOC105372876,chr1,R,206634195,206635780,130026243,1585,130026243,3167,1
105372877,LOC105372877,chr1,R,206748330,206751594,130029507,3264,130029507,3168,1
105372878,LOC105372878,chr1,R,206841100,206842821,130031228,1721,130031228,3169,2
105372879,LOC105372879,chr1,R,206885308,206896495,130042415,11187,130042415,3170,2
105372880,LOC105372880,chr1,F,207416344,207425700,130051771,9356,130051771,3171,2
105372881,LOC105372881,chr1,F,207368579,207373246,130056438,4667,130056438,3172,1
105372882,LOC105372882,chr1,R,207873448,207880102,130063092,6654,130063092,3173,5
105372883,LOC105372883,chr1,F,207962872,207967460,130067680,4588,130067680,3174,2
105372884,LOC105372884,chr1,F,208207259,208243294,130103715,36035,130103715,3175,3
105372885,LOC105372885,chr1,F,208122607,208128688,130109796,6081,130109796,3176,2
105372886,LOC105372886,chr1,F,208112151,208121442,130119087,9291,130119087,3177,4
105372887,LOC105372887,chr1,F,208094565,208110988,130135510,16423,130135510,3178,3
105372889,LOC105372889,chr1,F,208252743,208254596,130137363,1853,130137363,3179,2
105372890,LOC105372890,chr1,R,208266201,208270568,130141730,4367,130141730,3180,2
105372891,LOC105372891,chr1,R,208626740,208636018,130151008,9278,130151008,3181,2
105372892,LOC105372892,chr1,R,208671328,208728604,130208284,57276,130208284,3182,7
105372893,LOC105372893,chr1,F,208728667,208736774,130216391,8107,130216391,3183,5
105372894,LOC105372894,chr1,F,208972452,208975307,130219246,2855,130219246,3184,1
105372895,LOC105372895,chr1,F,209105591,209114464,130228119,8873,130228119,3185,2
105372896,LOC105372896,chr1,R,209211768,209266726,130283077,54958,130283077,3186,4
105372897,LOC105372897,chr1,F,209325437,209328532,130286172,3095,130286172,3187,3
105372898,LOC105372898,chr1,R,209515968,209542918,130313122,26950,130313122,3188,6
105372899,LOC105372899,chr1,R,209566947,209567802,130313977,855,130313977,3189,2
105372900,LOC105372900,chr1,R,209680923,209690613,130323667,9690,130323667,3190,3
105372901,LOC105372901,chr1,F,210708590,210753925,130369002,45335,130369002,3191,4
105372902,LOC105372902,chr1,R,211257806,211259191,130370387,1385,130370387,3192,1
105372903,LOC105372903,chr1,R,211604319,211609562,130375630,5243,130375630,3193,2
105372904,LOC105372904,chr1,R,211713175,211715994,130378449,2819,130378449,3194,2
105372905,LOC105372905,chr1,R,212180145,212182456,130380760,2311,130380760,3195,1
105372906,LOC105372906,chr1,R,212429961,212432791,130383590,2830,130383590,3196,2
105372907,LOC105372907,chr1,R,212466815,212472865,130389640,6050,130389640,3197,2
105372908,LOC105372908,chr1,R,212506401,212514782,130398021,8381,130398021,3198,1
105372909,LOC105372909,chr1,R,212634180,212638538,130402379,4358,130402379,3199,2
105372910,LOC105372910,chr1,F,213492205,213578880,130489054,86675,130489054,3200,3
105372911,LOC105372911,chr1,R,214019268,214112021,130581807,92753,130581807,3201,6
105372912,LOC105372912,chr1,F,213731422,213863908,130714293,132486,130714293,3202,3
105372913,LOC105372913,chr1,F,214430946,214438403,130721750,7457,130721750,3203,2
105372914,LOC105372914,chr1,F,214416630,214419468,130724588,2838,130724588,3204,3
105372915,LOC105372915,chr1,F,214900600,214905479,130729467,4879,130729467,3205,1
105372916,LOC105372916,chr1,F,214823525,214833280,130739222,9755,130739222,3206,2
105372917,LOC105372917,chr1,R,215186276,215195022,130747968,8746,130747968,3207,3
105372918,LOC105372918,chr1,F,216194058,216238039,130791949,43981,130791949,3208,5
105372919,LOC105372919,chr1,R,215566641,215567357,130792665,716,130792665,3209,1
105372920,LOC105372920,chr1,R,217163168,217190918,130820415,27750,130820415,3210,4
105372922,LOC105372922,chr1,R,217921581,217944812,130843646,23231,130843646,3211,4
105372923,LOC105372923,chr1,F,218165055,218198611,130877202,33556,130877202,3212,4
105372924,LOC105372924,chr1,R,218698586,218720622,130899238,22036,130899238,3213,3
105372925,LOC105372925,chr1,R,218912756,218918358,130904840,5602,130904840,3214,3
105372926,LOC105372926,chr1,R,219795447,219822603,130931996,27156,130931996,3215,3
105372927,LOC105372927,chr1,F,220289207,220299259,130942048,10052,130942048,3216,2
105372928,LOC105372928,chr1,F,220487737,220494506,130948817,6769,130948817,3217,3
105372929,LOC105372929,chr1,R,220483164,220487584,130953237,4420,130953237,3218,1
105372930,LOC105372930,chr1,F,220974372,220982379,130961244,8007,130961244,3219,2
105372931,LOC105372931,chr1,R,221298512,221302539,130965271,4027,130965271,3220,1
105372932,LOC105372932,chr1,F,221304187,221379923,131041007,75736,131041007,3221,2
105372934,LOC105372934,chr1,R,221492287,221504181,131052901,11894,131052901,3222,2
105372937,LOC105372937,chr1,R,221556150,221563633,131060384,7483,131060384,3223,2
105372945,LOC105372945,chr1,F,221708839,221714412,131065957,5573,131065957,3224,2
105372950,LOC105372950,chr1,R,221913761,221916141,131068337,2380,131068337,3225,2
105372953,LOC105372953,chr1,R,222385640,222387728,131070425,2088,131070425,3226,1
105372956,LOC105372956,chr1,R,222479517,222499064,131089972,19547,131089972,3227,5
105372970,LOC105372970,chr1,R,222501468,222510315,131098819,8847,131098819,3228,4
105372984,LOC105372984,chr1,R,222751250,222773179,131120748,21929,131120748,3229,4
105373025,LOC105373025,chr1,R,223372810,223393209,131141147,20399,131141147,3230,5
105373034,LOC105373034,chr1,F,223506300,223508625,131143472,2325,131143472,3231,2
105373041,LOC105373041,chr1,R,223772710,223774827,131145589,2117,131145589,3232,1
105373046,LOC105373046,chr1,R,223738469,223740411,131147531,1942,131147531,3233,1
105373056,LOC105373056,chr1,R,224095981,224105904,131157454,9923,131157454,3234,2
105373061,LOC105373061,chr1,F,224058865,224073200,131171789,14335,131171789,3235,3
105373106,LOC105373106,chr1,R,224701683,224719087,131189193,17404,131189193,3236,4
105373107,LOC105373107,chr1,R,224434718,224437949,131192424,3231,131192424,3237,2
105373109,LOC105373109,chr1,R,224883787,224929574,131238211,45787,131238211,3238,2
105373110,LOC105373110,chr1,R,225447822,225462489,131252878,14667,131252878,3239,2
105373111,LOC105373111,chr1,R,225914989,225917992,131255881,3003,131255881,3240,1
105373112,LOC105373112,chr1,R,226067713,226070276,131258444,2563,131258444,3241,1
105373113,LOC105373113,chr1,F,226083575,226090312,131265181,6737,131265181,3242,2
105373114,LOC105373114,chr1,F,226233493,226265748,131297436,32255,131297436,3243,4
105373115,LOC105373115,chr1,R,226516082,226520800,131302154,4718,131302154,3244,4
105373116,LOC105373116,chr1,R,226535550,226543273,131309877,7723,131309877,3245,2
105373117,LOC105373117,chr1,R,226691110,226699896,131318663,8786,131318663,3246,3
105373118,LOC105373118,chr1,F,226847143,226857766,131329286,10623,131329286,3247,2
105373119,LOC105373119,chr1,R,226860171,226870519,131339634,10348,131339634,3248,2
105373120,LOC105373120,chr1,F,226896887,226909737,131352484,12850,131352484,3249,5
105373121,LOC105373121,chr1,F,227060257,227089636,131381863,29379,131381863,3250,2
105373122,LOC105373122,chr1,R,227510328,227520380,131391915,10052,131391915,3251,2
105373124,LOC105373124,chr1,F,228508046,228510103,131393972,2057,131393972,3252,2
105373132,LOC105373132,chr1,F,228647613,228650007,131396366,2394,131396366,3253,0
105373143,LOC105373143,chr1,F,228948711,228965297,131412952,16586,131412952,3254,2
105373158,LOC105373158,chr1,R,229087099,229184277,131510130,97178,131510130,3255,8
105373159,LOC105373159,chr1,R,229257839,229271044,131523335,13205,131523335,3256,2
105373160,LOC105373160,chr1,R,229452750,229456753,131527338,4003,131527338,3257,1
105373161,LOC105373161,chr1,R,229778613,229807848,131556573,29235,131556573,3258,4
105373162,LOC105373162,chr1,R,229814066,229866962,131609469,52896,131609469,3259,6
105373163,LOC105373163,chr1,R,229896719,229900680,131613430,3961,131613430,3260,1
105373164,LOC105373164,chr1,F,230496122,230499024,131616332,2902,131616332,3261,2
105373165,LOC105373165,chr1,R,230549801,230551176,131617707,1375,131617707,3262,1
105373166,LOC105373166,chr1,R,230716764,230745608,131646551,28844,131646551,3263,3
105373167,LOC105373167,chr1,F,230889556,230899570,131656565,10014,131656565,3264,3
105373168,LOC105373168,chr1,R,230879003,230890459,131668021,11456,131668021,3265,2
105373169,LOC105373169,chr1,F,231268888,231270660,131669793,1772,131669793,3266,1
105373170,LOC105373170,chr1,R,231811487,231848787,131707093,37300,131707093,3267,3
105373171,LOC105373171,chr1,F,232061403,232092497,131738187,31094,131738187,3268,2
105373172,LOC105373172,chr1,F,232043917,232057638,131751908,13721,131751908,3269,5
105373196,LOC105373196,chr1,F,232361501,232370410,131760817,8909,131760817,3270,2
105373198,LOC105373198,chr1,R,232374408,232376900,131763309,2492,131763309,3271,3
105373199,LOC105373199,chr1,F,232718051,232762405,131807663,44354,131807663,3272,7
105373201,LOC105373201,chr1,F,232910500,232918421,131815584,7921,131815584,3273,2
105373206,LOC105373206,chr1,F,234273127,234275220,131817677,2093,131817677,3274,1
105373207,LOC105373207,chr1,F,234646899,234649404,131820182,2505,131820182,3275,2
105373208,LOC105373208,chr1,R,234678677,234688831,131830336,10154,131830336,3276,2
105373209,LOC105373209,chr1,F,234676027,234683176,131837485,7149,131837485,3277,3
105373210,LOC105373210,chr1,R,234745769,234748723,131840439,2954,131840439,3278,3
105373211,LOC105373211,chr1,F,234953869,234957397,131843967,3528,131843967,3279,1
105373212,LOC105373212,chr1,R,235906133,235972738,131910572,66605,131910572,3280,3
105373215,LOC105373215,chr1,F,235892283,235957995,131976284,65712,131976284,3281,9
105373218,LOC105373218,chr1,F,236906693,236921553,131991144,14860,131991144,3282,3
105373219,LOC105373219,chr1,F,238116366,238125255,132000033,8889,132000033,3283,2
105373220,LOC105373220,chr1,F,238323087,238445519,132122465,122432,132122465,3284,6
105373222,LOC105373222,chr1,F,238836445,238848059,132134079,11614,132134079,3285,2
105373223,LOC105373223,chr1,R,239248068,239254929,132140940,6861,132140940,3286,4
105373224,LOC105373224,chr1,R,239909478,239952987,132184449,43509,132184449,3287,2
105373225,LOC105373225,chr1,R,239587931,239633648,132230166,45717,132230166,3288,6
105373226,LOC105373226,chr1,F,239386517,239387227,132230876,710,132230876,3289,0
105373227,LOC105373227,chr1,F,240553783,240572211,132249304,18428,132249304,3290,2
105373228,LOC105373228,chr1,R,240685682,240710019,132273641,24337,132273641,3291,3
105373229,LOC105373229,chr1,F,240823571,240852725,132302795,29154,132302795,3292,3
105373230,LOC105373230,chr1,F,241424220,241433741,132312316,9521,132312316,3293,1
105373231,LOC105373231,chr1,F,241817792,241818765,132313289,973,132313289,3294,2
105373232,LOC105373232,chr1,R,241723365,241742111,132332035,18746,132332035,3295,2
105373233,LOC105373233,chr1,R,241585024,241588836,132335847,3812,132335847,3296,2
105373234,LOC105373234,chr1,R,242489552,242500055,132346350,10503,132346350,3297,3
105373235,LOC105373235,chr1,F,242266625,242269632,132349357,3007,132349357,3298,2
105373236,LOC105373236,chr1,F,242178294,242210406,132381469,32112,132381469,3299,6
105373238,LOC105373238,chr1,R,242700941,242773796,132454324,72855,132454324,3300,5
105373255,LOC105373255,chr1,R,243494788,243497823,132457359,3035,132457359,3301,1
105373257,LOC105373257,chr1,F,243163273,243169614,132463700,6341,132463700,3302,2
105373258,LOC105373258,chr1,R,243960034,243979514,132483180,19480,132483180,3303,2
105373259,LOC105373259,chr1,R,244066409,244068711,132485482,2302,132485482,3304,1
105373260,LOC105373260,chr1,F,244117989,244126166,132493659,8177,132493659,3305,4
105373261,LOC105373261,chr1,R,244108415,244118489,132503733,10074,132503733,3306,2
105373262,LOC105373262,chr1,R,244230513,244325151,132598371,94638,132598371,3307,3
105373263,LOC105373263,chr1,R,244363904,244376806,132611273,12902,132611273,3308,2
105373264,LOC105373264,chr1,R,244431546,244432532,132612259,986,132612259,3309,1
105373265,LOC105373265,chr1,R,245693822,245698908,132617345,5086,132617345,3310,2
105373266,LOC105373266,chr1,R,245448828,245450551,132619068,1723,132619068,3311,1
105373267,LOC105373267,chr1,F,245367477,245371488,132623079,4011,132623079,3312,2
105373268,LOC105373268,chr1,R,246194291,246201730,132630518,7439,132630518,3313,0
105373269,LOC105373269,chr1,F,245895208,245931560,132666870,36352,132666870,3314,4
105373270,LOC105373270,chr1,F,245812589,245813854,132668135,1265,132668135,3315,2
105373271,LOC105373271,chr1,R,246582935,246609340,132694540,26405,132694540,3316,5
105373272,LOC105373272,chr1,F,247172042,247174480,132696978,2438,132696978,3317,2
105373273,LOC105373273,chr1,F,247273428,247288212,132711762,14784,132711762,3318,2
105373274,LOC105373274,chr1,R,247700078,247749120,132760804,49042,132760804,3319,4
105373275,LOC105373275,chr1,R,248046933,248095544,132809415,48611,132809415,3320,4
105373279,LOC105373279,chr1,R,248468552,248482053,132822916,13501,132822916,3321,2
105373280,LOC105373280,chr1,R,220875192,220879330,132827054,4138,132827054,3322,3
105373281,LOC105373281,chr1,R,223677817,223708362,132857599,30545,132857599,3323,4
105373289,LOC105373289,chr1,F,227786480,227790651,132861770,4171,132861770,3324,4
105373317,LOC105373317,chr1,F,248859163,248865047,132867654,5884,132867654,3325,2
105373318,LOC105373318,chr1,F,248931412,248937105,132873347,5693,132873347,3326,1
105373467,LOC105373467,chr1,F,144412508,144414069,132874908,1561,132874908,3327,1
105373468,LOC105373468,chr1,F,146938327,146960004,132896585,21677,132896585,3328,6
105373469,LOC105373469,chr1,F,145281215,145282608,132897978,1393,132897978,3329,1
105373470,LOC105373470,chr1,R,151922277,151953555,132929256,31278,132929256,3330,2
105373471,LOC105373471,chr1,F,162420081,162447346,132956521,27265,132956521,3331,4
105373472,LOC105373472,chr1,R,178538472,178542606,132960655,4134,132960655,3332,1
105373473,LOC105373473,chr1,F,183869124,183872705,132964236,3581,132964236,3333,1
105373474,LOC105373474,chr1,F,210293122,210321710,132992824,28588,132992824,3334,1
105373475,LOC105373475,chr1,R,220111576,220112602,132993850,1026,132993850,3335,1
105373476,LOC105373476,chr1,F,222500736,222501556,132994670,820,132994670,3336,1
105373477,LOC105373477,chr1,R,149983140,149990952,133002482,7812,133002482,3337,2
105376672,LOC105376672,chr1,R,3944539,3949012,133006955,4473,133006955,3338,4
105376673,LOC105376673,chr1,F,3995103,3998855,133010707,3752,133010707,3339,3
105376674,LOC105376674,chr1,F,4432145,4443683,133022245,11538,133022245,3340,3
105376679,LOC105376679,chr1,F,4571513,4594998,133045730,23485,133045730,3341,3
105376680,LOC105376680,chr1,F,4973390,4983958,133056298,10568,133056298,3342,5
105376681,LOC105376681,chr1,R,5088250,5098548,133066596,10298,133066596,3343,4
105376682,LOC105376682,chr1,F,5131855,5135373,133070114,3518,133070114,3344,2
105376686,LOC105376686,chr1,R,5490841,5494629,133073902,3788,133073902,3345,2
105376687,LOC105376687,chr1,F,6131762,6132692,133074832,930,133074832,3346,1
105376688,LOC105376688,chr1,F,6385582,6387249,133076499,1667,133076499,3347,2
105376689,LOC105376689,chr1,R,7701685,7704034,133078848,2349,133078848,3348,2
105376690,LOC105376690,chr1,R,7700703,7701651,133079796,948,133079796,3349,1
105376691,LOC105376691,chr1,F,7503176,7509205,133085825,6029,133085825,3350,2
105376692,LOC105376692,chr1,R,7236684,7240058,133089199,3374,133089199,3351,2
105376693,LOC105376693,chr1,R,7773793,7783107,133098513,9314,133098513,3352,1
105376694,LOC105376694,chr1,R,8003180,8007029,133102362,3849,133102362,3353,1
105376695,LOC105376695,chr1,F,8240089,8248643,133110916,8554,133110916,3354,2
105376696,LOC105376696,chr1,R,8905611,8926858,133132163,21247,133132163,3355,3
105376697,LOC105376697,chr1,R,9241962,9242942,133133143,980,133133143,3356,1
105376706,LOC105376706,chr1,R,9500751,9503503,133135895,2752,133135895,3357,1
105376712,LOC105376712,chr1,R,9628446,9629428,133136877,982,133136877,3358,1
105376717,LOC105376717,chr1,F,9850783,9855490,133141584,4707,133141584,3359,1
105376719,LOC105376719,chr1,R,9996422,9998089,133143251,1667,133143251,3360,1
105376725,LOC105376725,chr1,R,10358000,10366735,133151986,8735,133151986,3361,2
105376733,LOC105376733,chr1,R,10809017,10815658,133158627,6641,133158627,3362,3
105376736,LOC105376736,chr1,F,11099720,11102100,133161007,2380,133161007,3363,2
105376737,LOC105376737,chr1,R,11311497,11316839,133166349,5342,133166349,3364,2
105376739,LOC105376739,chr1,F,11357967,11364461,133172843,6494,133172843,3365,3
105376740,LOC105376740,chr1,F,11371743,11377509,133178609,5766,133178609,3366,3
105376741,LOC105376741,chr1,R,11485875,11499470,133192204,13595,133192204,3367,2
105376742,LOC105376742,chr1,F,11908120,11914327,133198411,6207,133198411,3368,2
105376743,LOC105376743,chr1,R,12471979,12497047,133223479,25068,133223479,3369,2
105376744,LOC105376744,chr1,F,12525279,12528868,133227068,3589,133227068,3370,2
105376745,LOC105376745,chr1,R,12822723,12823223,133227568,500,133227568,3371,1
105376756,LOC105376756,chr1,R,13687117,13691876,133232327,4759,133232327,3372,2
105376757,LOC105376757,chr1,R,14922089,14923846,133234084,1757,133234084,3373,2
105376758,LOC105376758,chr1,R,14816221,14826229,133244092,10008,133244092,3374,4
105376759,LOC105376759,chr1,R,14801037,14814936,133257991,13899,133257991,3375,4
105376762,LOC105376762,chr1,R,14388170,14419973,133289794,31803,133289794,3376,2
105376764,LOC105376764,chr1,R,14278126,14304452,133316120,26326,133316120,3377,2
105376765,LOC105376765,chr1,R,15289696,15305562,133331986,15866,133331986,3378,2
105376767,LOC105376767,chr1,R,15461664,15464159,133334481,2495,133334481,3379,2
105376796,LOC105376796,chr1,F,16516223,16521801,133340059,5578,133340059,3380,2
105376805,LOC105376805,chr1,R,16888537,16889686,133341208,1149,133341208,3381,2
105376806,LOC105376806,chr1,F,16976196,16977795,133342807,1599,133342807,3382,1
105376807,LOC105376807,chr1,F,17111775,17119273,133350305,7498,133350305,3383,2
105376808,LOC105376808,chr1,F,17135703,17138955,133353557,3252,133353557,3384,2
105376809,LOC105376809,chr1,R,18000421,18010510,133363646,10089,133363646,3385,4
105376812,LOC105376812,chr1,F,18044181,18052715,133372180,8534,133372180,3386,2
105376813,LOC105376813,chr1,R,18262234,18264921,133374867,2687,133374867,3387,2
105376814,LOC105376814,chr1,R,18159985,18176677,133391559,16692,133391559,3388,9
105376815,LOC105376815,chr1,R,18971112,19050967,133471414,79855,133471414,3389,3
105376816,LOC105376816,chr1,R,19052479,19055855,133474790,3376,133474790,3390,2
105376817,LOC105376817,chr1,R,19512539,19529924,133492175,17385,133492175,3391,3
105376818,LOC105376818,chr1,R,19509889,19512483,133494769,2594,133494769,3392,2
105376819,LOC105376819,chr1,F,19500220,19531778,133526327,31558,133526327,3393,4
105376820,LOC105376820,chr1,F,19408708,19416641,133534260,7933,133534260,3394,3
105376822,LOC105376822,chr1,R,19566743,19582847,133550364,16104,133550364,3395,2
105376823,LOC105376823,chr1,R,19860165,19889388,133579587,29223,133579587,3396,3
105376824,LOC105376824,chr1,R,20163075,20163980,133580492,905,133580492,3397,1
105376825,LOC105376825,chr1,F,20198995,20202827,133584324,3832,133584324,3398,1
105376826,LOC105376826,chr1,R,20210719,20213372,133586977,2653,133586977,3399,2
105376827,LOC105376827,chr1,F,20243100,20244622,133588499,1522,133588499,3400,2
105376828,LOC105376828,chr1,F,20271640,20274919,133591778,3279,133591778,3401,3
105376829,LOC105376829,chr1,F,20919270,20936232,133608740,16962,133608740,3402,5
105376830,LOC105376830,chr1,F,20903704,20919273,133624309,15569,133624309,3403,5
105376832,LOC105376832,chr1,R,21412678,21416543,133628174,3865,133628174,3404,3
105376833,LOC105376833,chr1,R,21543559,21551254,133635869,7695,133635869,3405,2
105376834,LOC105376834,chr1,F,21585688,21591187,133641368,5499,133641368,3406,1
105376835,LOC105376835,chr1,F,21732235,21780475,133689608,48240,133689608,3407,2
105376841,LOC105376841,chr1,R,22031027,22052869,133711450,21842,133711450,3408,1
105376845,LOC105376845,chr1,F,22140952,22157385,133727883,16433,133727883,3409,7
105376850,LOC105376850,chr1,F,22163383,22172505,133737005,9122,133737005,3410,1
105376856,LOC105376856,chr1,R,22416330,22418938,133739613,2608,133739613,3411,2
105376857,LOC105376857,chr1,R,22883329,22889663,133745947,6334,133745947,3412,2
105376858,LOC105376858,chr1,F,23424834,23429733,133750846,4899,133750846,3413,2
105376859,LOC105376859,chr1,R,23548516,23557350,133759680,8834,133759680,3414,7
105376860,LOC105376860,chr1,R,23790623,23793698,133762755,3075,133762755,3415,1
105376861,LOC105376861,chr1,R,23825544,23838629,133775840,13085,133775840,3416,2
105376862,LOC105376862,chr1,R,23949006,23959141,133785975,10135,133785975,3417,1
105376863,LOC105376863,chr1,F,24010504,24028914,133804385,18410,133804385,3418,5
105376864,LOC105376864,chr1,F,24098668,24104537,133810254,5869,133810254,3419,3
105376865,LOC105376865,chr1,F,24096052,24097921,133812123,1869,133812123,3420,2
105376867,LOC105376867,chr1,F,24112495,24129813,133829441,17318,133829441,3421,2
105376871,LOC105376871,chr1,R,24305927,24321888,133845402,15961,133845402,3422,2
105376876,LOC105376876,chr1,F,24857342,24865338,133853398,7996,133853398,3423,2
105376878,LOC105376878,chr1,F,24932511,24964506,133885393,31995,133885393,3424,8
105376879,LOC105376879,chr1,F,25041171,25047346,133891568,6175,133891568,3425,3
105376880,LOC105376880,chr1,R,25131180,25132913,133893301,1733,133893301,3426,2
105376881,LOC105376881,chr1,R,25290740,25338211,133940772,47471,133940772,3427,2
105376882,LOC105376882,chr1,R,25269461,25274764,133946075,5303,133946075,3428,1
105376883,LOC105376883,chr1,F,25753602,25756063,133948536,2461,133948536,3429,1
105376884,LOC105376884,chr1,R,25887967,25897101,133957670,9134,133957670,3430,2
105376885,LOC105376885,chr1,F,25906549,25908243,133959364,1694,133959364,3431,1
105376886,LOC105376886,chr1,R,26118277,26127752,133968839,9475,133968839,3432,2
105376887,LOC105376887,chr1,R,26165312,26169802,133973329,4490,133973329,3433,2
105376888,LOC105376888,chr1,F,26682573,26690812,133981568,8239,133981568,3434,4
105376889,LOC105376889,chr1,R,27207819,27208690,133982439,871,133982439,3435,1
105376890,LOC105376890,chr1,R,27229400,27234494,133987533,5094,133987533,3436,2
105376892,LOC105376892,chr1,F,27522505,27530506,133995534,8001,133995534,3437,1
105376893,LOC105376893,chr1,R,27849815,27850118,133995837,303,133995837,3438,1
105376894,LOC105376894,chr1,R,27828450,27831528,133998915,3078,133998915,3439,2
105376895,LOC105376895,chr1,R,28240973,28241376,133999318,403,133999318,3440,1
105376896,LOC105376896,chr1,R,28239510,28247324,134007132,7814,134007132,3441,1
105376897,LOC105376897,chr1,R,28927221,28942792,134022703,15571,134022703,3442,2
105376898,LOC105376898,chr1,R,28870481,28886843,134039065,16362,134039065,3443,3
105376910,LOC105376910,chr1,F,26045894,26049057,134042228,3163,134042228,3444,1
105376911,LOC105376911,chr1,R,28677906,28681528,134045850,3622,134045850,3445,4
105378580,LOC105378580,chr1,F,803397,805130,134047583,1733,134047583,3446,1
105378581,LOC105378581,chr1,F,778797,784251,134053037,5454,134053037,3447,1
105378582,LOC105378582,chr1,R,688824,732141,134096354,43317,134096354,3448,4
105378583,LOC105378583,chr1,F,982072,989979,134104261,7907,134104261,3449,2
105378584,LOC105378584,chr1,F,1093332,1094038,134104967,706,134104967,3450,1
105378585,LOC105378585,chr1,F,1420244,1423287,134108010,3043,134108010,3451,1
105378586,LOC105378586,chr1,F,1600287,1607378,134115101,7091,134115101,3452,4
105378587,LOC105378587,chr1,R,1625284,1626651,134116468,1367,134116468,3453,2
105378588,LOC105378588,chr1,F,1745724,1751773,134122517,6049,134122517,3454,1
105378589,LOC105378589,chr1,R,2013221,2016584,134125880,3363,134125880,3455,2
105378590,LOC105378590,chr1,R,2034985,2047444,134138339,12459,134138339,3456,4
105378591,LOC105378591,chr1,R,2049200,2050143,134139282,943,134139282,3457,1
105378592,LOC105378592,chr1,R,2208941,2215211,134145552,6270,134145552,3458,3
105378593,LOC105378593,chr1,F,2207012,2208854,134147394,1842,134147394,3459,2
105378594,LOC105378594,chr1,F,2280382,2284676,134151688,4294,134151688,3460,0
105378595,LOC105378595,chr1,F,2314979,2319268,134155977,4289,134155977,3461,4
105378596,LOC105378596,chr1,F,2567829,2570106,134158254,2277,134158254,3462,1
105378597,LOC105378597,chr1,F,2633110,2636620,134161764,3510,134161764,3463,3
105378598,LOC105378598,chr1,F,2763418,2784733,134183079,21315,134183079,3464,15
105378599,LOC105378599,chr1,F,2773494,2774394,134183979,900,134183979,3465,2
105378600,LOC105378600,chr1,F,2766072,2766810,134184717,738,134184717,3466,2
105378601,LOC105378601,chr1,F,2762487,2763382,134185612,895,134185612,3467,2
105378602,LOC105378602,chr1,F,2701551,2702276,134186337,725,134186337,3468,2
105378603,LOC105378603,chr1,R,2700559,2702756,134188534,2197,134188534,3469,2
105378604,LOC105378604,chr1,R,3306635,3323585,134205484,16950,134205484,3470,3
105378605,LOC105378605,chr1,R,3210735,3213909,134208658,3174,134208658,3471,1
105378606,LOC105378606,chr1,R,3161278,3167573,134214953,6295,134214953,3472,3
105378607,LOC105378607,chr1,F,3602892,3607681,134219742,4789,134219742,3473,1
105378608,LOC105378608,chr1,F,3546960,3550526,134223308,3566,134223308,3474,2
105378609,LOC105378609,chr1,R,3674734,3677526,134226100,2792,134226100,3475,2
105378610,LOC105378610,chr1,R,3658648,3665313,134232765,6665,134232765,3476,2
105378611,LOC105378611,chr1,F,4582292,4587722,134238195,5430,134238195,3477,2
105378612,LOC105378612,chr1,F,13670247,13674725,134242673,4478,134242673,3478,2
105378613,LOC105378613,chr1,F,19438075,19447290,134251888,9215,134251888,3479,3
105378614,LOC105378614,chr1,R,19591801,19596872,134256959,5071,134256959,3480,1
105378615,LOC105378615,chr1,R,23987407,23987788,134257340,381,134257340,3481,1
105378616,LOC105378616,chr1,F,28643432,28648731,134262639,5299,134262639,3482,1
105378617,LOC105378617,chr1,R,30160481,30199957,134302115,39476,134302115,3483,4
105378618,LOC105378618,chr1,F,30253429,30261152,134309838,7723,134309838,3484,3
105378619,LOC105378619,chr1,R,30410929,30412521,134311430,1592,134311430,3485,2
105378620,LOC105378620,chr1,R,30749248,30752871,134315053,3623,134315053,3486,1
105378621,LOC105378621,chr1,R,30775106,30782380,134322327,7274,134322327,3487,2
105378622,LOC105378622,chr1,F,30824138,30834282,134332471,10144,134332471,3488,4
105378623,LOC105378623,chr1,R,31383331,31389830,134338970,6499,134338970,3489,2
105378624,LOC105378624,chr1,R,31459329,31471520,134351161,12191,134351161,3490,2
105378625,LOC105378625,chr1,F,31448373,31449586,134352374,1213,134352374,3491,2
105378626,LOC105378626,chr1,R,31568235,31577922,134362061,9687,134362061,3492,3
105378627,LOC105378627,chr1,F,31549576,31568204,134380689,18628,134380689,3493,4
105378628,LOC105378628,chr1,R,31650456,31651485,134381718,1029,134381718,3494,1
105378629,LOC105378629,chr1,R,32343135,32351795,134390378,8660,134390378,3495,3
105378630,LOC105378630,chr1,F,32394512,32395663,134391529,1151,134391529,3496,2
105378631,LOC105378631,chr1,F,32876026,32882505,134398008,6479,134398008,3497,2
105378632,LOC105378632,chr1,R,32901659,32903203,134399552,1544,134399552,3498,2
105378634,LOC105378634,chr1,F,32927452,32934354,134406454,6902,134406454,3499,1
105378635,LOC105378635,chr1,R,33077883,33081102,134409673,3219,134409673,3500,2
105378636,LOC105378636,chr1,R,33120351,33140802,134430124,20451,134430124,3501,4
105378637,LOC105378637,chr1,F,33790990,33804803,134443937,13813,134443937,3502,2
105378638,LOC105378638,chr1,F,33605001,33610152,134449088,5151,134449088,3503,2
105378639,LOC105378639,chr1,F,34279847,34295942,134465183,16095,134465183,3504,3
105378640,LOC105378640,chr1,F,34364821,34366065,134466427,1244,134466427,3505,1
105378641,LOC105378641,chr1,R,34457858,34686927,134695496,229069,134695496,3506,9
105378642,LOC105378642,chr1,R,34710021,34724238,134709713,14217,134709713,3507,4
105378643,LOC105378643,chr1,R,34742407,34799371,134766677,56964,134766677,3508,2
105378644,LOC105378644,chr1,R,35141438,35146825,134772064,5387,134772064,3509,2
105378645,LOC105378645,chr1,R,35569814,35578330,134780580,8516,134780580,3510,2
105378646,LOC105378646,chr1,F,35665307,35685441,134800714,20134,134800714,3511,5
105378647,LOC105378647,chr1,R,36009603,36019780,134810891,10177,134810891,3512,2
105378648,LOC105378648,chr1,R,36686700,36694967,134819158,8267,134819158,3513,3
105378649,LOC105378649,chr1,F,37531455,37540213,134827916,8758,134827916,3514,3
105378650,LOC105378650,chr1,R,37765728,37767313,134829501,1585,134829501,3515,2
105378651,LOC105378651,chr1,F,37932060,37945314,134842755,13254,134842755,3516,6
105378652,LOC105378652,chr1,F,37910156,37918656,134851255,8500,134851255,3517,1
105378653,LOC105378653,chr1,F,38047139,38119530,134923646,72391,134923646,3518,5
105378654,LOC105378654,chr1,F,38141653,38213095,134995088,71442,134995088,3519,7
105378655,LOC105378655,chr1,R,38129479,38141542,135007151,12063,135007151,3520,6
105378656,LOC105378656,chr1,F,38475195,38476255,135008211,1060,135008211,3521,1
105378657,LOC105378657,chr1,R,38300261,38503454,135211404,203193,135211404,3522,3
105378658,LOC105378658,chr1,F,38518245,38532800,135225959,14555,135225959,3523,2
105378659,LOC105378659,chr1,F,38553524,38558188,135230623,4664,135230623,3524,2
105378660,LOC105378660,chr1,R,38692951,38728533,135266205,35582,135266205,3525,2
105378661,LOC105378661,chr1,F,38923072,38926507,135269640,3435,135269640,3526,1
105378662,LOC105378662,chr1,F,38915224,38919471,135273887,4247,135273887,3527,1
105378663,LOC105378663,chr1,F,38859917,38876226,135290196,16309,135290196,3528,2
105378664,LOC105378664,chr1,F,39651175,39655326,135294347,4151,135294347,3529,1
105378665,LOC105378665,chr1,F,39808158,39817442,135303631,9284,135303631,3530,2
105378666,LOC105378666,chr1,F,39779983,39781424,135305072,1441,135305072,3531,1
105378667,LOC105378667,chr1,F,39824054,39838083,135319101,14029,135319101,3532,4
105378668,LOC105378668,chr1,F,39897740,39899098,135320459,1358,135320459,3533,1
105378669,LOC105378669,chr1,R,40014566,40040153,135346046,25587,135346046,3534,4
105378670,LOC105378670,chr1,F,40023511,40039121,135361656,15610,135361656,3535,1
105378671,LOC105378671,chr1,R,40147700,40161312,135375268,13612,135375268,3536,2
105378672,LOC105378672,chr1,R,40487268,40508671,135396671,21403,135396671,3537,2
105378673,LOC105378673,chr1,F,40563484,40568562,135401749,5078,135401749,3538,2
105378674,LOC105378674,chr1,R,40668539,40673849,135407059,5310,135407059,3539,2
105378675,LOC105378675,chr1,F,40658045,40666746,135415760,8701,135415760,3540,1
105378676,LOC105378676,chr1,R,40847980,40857494,135425274,9514,135425274,3541,2
105378677,LOC105378677,chr1,F,41427200,41429394,135427468,2194,135427468,3542,1
105378678,LOC105378678,chr1,F,41433050,41464911,135459329,31861,135459329,3543,4
105378679,LOC105378679,chr1,F,41905343,41907112,135461098,1769,135461098,3544,2
105378680,LOC105378680,chr1,F,42311266,42323675,135473507,12409,135473507,3545,3
105378681,LOC105378681,chr1,R,42680157,42681381,135474731,1224,135474731,3546,1
105378682,LOC105378682,chr1,R,42841894,42843443,135476280,1549,135476280,3547,1
105378683,LOC105378683,chr1,R,42775876,42784890,135485294,9014,135485294,3548,3
105378684,LOC105378684,chr1,F,42979697,42985699,135491296,6002,135491296,3549,2
105378685,LOC105378685,chr1,R,43181691,43250544,135560149,68853,135560149,3550,10
105378686,LOC105378686,chr1,R,43172775,43175257,135562631,2482,135562631,3551,2
105378687,LOC105378687,chr1,R,43354257,43358630,135567004,4373,135567004,3552,2
105378688,LOC105378688,chr1,R,43937891,43940543,135569656,2652,135569656,3553,1
105378689,LOC105378689,chr1,R,44172745,44174548,135571459,1803,135571459,3554,1
105378690,LOC105378690,chr1,R,44688340,44724114,135607233,35774,135607233,3555,4
105378691,LOC105378691,chr1,R,45296583,45303663,135614313,7080,135614313,3556,2
105378692,LOC105378692,chr1,R,45503888,45504329,135614754,441,135614754,3557,1
105378693,LOC105378693,chr1,F,45750895,45760837,135624696,9942,135624696,3558,2
105378694,LOC105378694,chr1,R,45867799,45907053,135663950,39254,135663950,3559,5
105378695,LOC105378695,chr1,R,46171282,46175408,135668076,4126,135668076,3560,2
105378696,LOC105378696,chr1,R,46533461,46535497,135670112,2036,135670112,3561,2
105378697,LOC105378697,chr1,R,46621694,46624879,135673297,3185,135673297,3562,2
105378698,LOC105378698,chr1,R,46685082,46686665,135674880,1583,135674880,3563,1
105378699,LOC105378699,chr1,F,46765056,46767638,135677462,2582,135677462,3564,2
105378700,LOC105378700,chr1,R,47018310,47021786,135680938,3476,135680938,3565,2
105378701,LOC105378701,chr1,R,47172850,47177065,135685153,4215,135685153,3566,2
105378702,LOC105378702,chr1,F,47815879,47819491,135688765,3612,135688765,3567,2
105378703,LOC105378703,chr1,F,48175646,48181628,135694747,5982,135694747,3568,2
105378704,LOC105378704,chr1,F,48100474,48161444,135755717,60970,135755717,3569,3
105378705,LOC105378705,chr1,R,48073564,48074361,135756514,797,135756514,3570,1
105378706,LOC105378706,chr1,F,49025594,49140831,135871751,115237,135871751,3571,4
105378707,LOC105378707,chr1,R,48956661,48962775,135877865,6114,135877865,3572,2
105378708,LOC105378708,chr1,F,50024020,50042404,135896249,18384,135896249,3573,2
105378709,LOC105378709,chr1,R,50061017,50063659,135898891,2642,135898891,3574,4
105378710,LOC105378710,chr1,F,50257639,50258202,135899454,563,135899454,3575,1
105378711,LOC105378711,chr1,R,50206083,50258259,135951630,52176,135951630,3576,9
105378712,LOC105378712,chr1,R,50265198,50321162,136007594,55964,136007594,3577,9
105378713,LOC105378713,chr1,F,50298643,50307609,136016560,8966,136016560,3578,2
105378714,LOC105378714,chr1,F,50423504,50425355,136018411,1851,136018411,3579,2
105378715,LOC105378715,chr1,F,50447415,50480014,136051010,32599,136051010,3580,8
105378716,LOC105378716,chr1,R,51218411,51236237,136068836,17826,136068836,3581,4
105378717,LOC105378717,chr1,F,51326752,51328589,136070673,1837,136070673,3582,1
105378718,LOC105378718,chr1,F,51669531,51674021,136075163,4490,136075163,3583,2
105378719,LOC105378719,chr1,R,51610691,51623937,136088409,13246,136088409,3584,2
105378720,LOC105378720,chr1,F,51516612,51600488,136172285,83876,136172285,3585,6
105378721,LOC105378721,chr1,F,51793989,51798131,136176427,4142,136176427,3586,1
105378722,LOC105378722,chr1,F,52552933,52565732,136189226,12799,136189226,3587,1
105378723,LOC105378723,chr1,F,52530966,52552709,136210969,21743,136210969,3588,3
105378724,LOC105378724,chr1,F,53180460,53191428,136221937,10968,136221937,3589,4
105378725,LOC105378725,chr1,R,53311982,53321441,136231396,9459,136231396,3590,3
105378726,LOC105378726,chr1,F,53289569,53311174,136253001,21605,136253001,3591,5
105378727,LOC105378727,chr1,F,53286495,53289558,136256064,3063,136256064,3592,2
105378728,LOC105378728,chr1,F,53255173,53269366,136270257,14193,136270257,3593,3
105378729,LOC105378729,chr1,R,53348295,53350340,136272302,2045,136272302,3594,2
105378730,LOC105378730,chr1,F,53337192,53339291,136274401,2099,136274401,3595,1
105378731,LOC105378731,chr1,R,53329814,53346230,136290817,16416,136290817,3596,4
105378732,LOC105378732,chr1,F,53328229,53337109,136299697,8880,136299697,3597,3
105378733,LOC105378733,chr1,F,53439780,53457782,136317699,18002,136317699,3598,3
105378734,LOC105378734,chr1,R,54516411,54528746,136330034,12335,136330034,3599,2
105378735,LOC105378735,chr1,F,54514232,54517129,136332931,2897,136332931,3600,3
105378736,LOC105378736,chr1,R,54975156,54980460,136338235,5304,136338235,3601,2
105378737,LOC105378737,chr1,F,55953136,55975733,136360832,22597,136360832,3602,3
105378738,LOC105378738,chr1,F,55945034,55950119,136365917,5085,136365917,3603,1
105378739,LOC105378739,chr1,R,55915608,55944973,136395282,29365,136395282,3604,1
105378740,LOC105378740,chr1,R,55783680,55854984,136466586,71304,136466586,3605,2
105378741,LOC105378741,chr1,R,56045840,56060859,136481605,15019,136481605,3606,5
105378742,LOC105378742,chr1,R,56154654,56194042,136520993,39388,136520993,3607,8
105378743,LOC105378743,chr1,F,56194210,56227331,136554114,33121,136554114,3608,3
105378744,LOC105378744,chr1,F,56414578,56417085,136556621,2507,136556621,3609,3
105378745,LOC105378745,chr1,F,56967535,56987463,136576549,19928,136576549,3610,2
105378746,LOC105378746,chr1,F,57953812,57991232,136613969,37420,136613969,3611,7
105378747,LOC105378747,chr1,F,57172261,57186219,136627927,13958,136627927,3612,3
105378748,LOC105378748,chr1,F,57017404,57049117,136659640,31713,136659640,3613,6
105378749,LOC105378749,chr1,F,56998057,57014700,136676283,16643,136676283,3614,4
105378750,LOC105378750,chr1,R,58739510,58745474,136682247,5964,136682247,3615,3
105378751,LOC105378751,chr1,F,58761007,58770704,136691944,9697,136691944,3616,2
105378752,LOC105378752,chr1,R,59011496,59029907,136710355,18411,136710355,3617,2
105378753,LOC105378753,chr1,R,58882875,58912038,136739518,29163,136739518,3618,8
105378754,LOC105378754,chr1,F,59184276,59201435,136756677,17159,136756677,3619,2
105378755,LOC105378755,chr1,R,59491605,59501173,136766245,9568,136766245,3620,2
105378756,LOC105378756,chr1,R,59289280,59296460,136773425,7180,136773425,3621,3
105378757,LOC105378757,chr1,R,59766770,59807539,136814194,40769,136814194,3622,4
105378758,LOC105378758,chr1,R,59807591,59815740,136822343,8149,136822343,3623,4
105378759,LOC105378759,chr1,F,59913791,59918682,136827234,4891,136827234,3624,1
105378760,LOC105378760,chr1,F,60242822,60258619,136843031,15797,136843031,3625,2
105378761,LOC105378761,chr1,R,60183011,60276791,136936811,93780,136936811,3626,2
105378762,LOC105378762,chr1,R,60522926,60529035,136942920,6109,136942920,3627,2
105378763,LOC105378763,chr1,R,60529213,60622546,137036253,93333,137036253,3628,10
105378764,LOC105378764,chr1,R,60893265,60925000,137067988,31735,137067988,3629,3
105378765,LOC105378765,chr1,R,61211941,61230708,137086755,18767,137086755,3630,2
105378766,LOC105378766,chr1,R,61551256,61567847,137103346,16591,137103346,3631,3
105378767,LOC105378767,chr1,R,62356545,62395506,137142307,38961,137142307,3632,3
105378768,LOC105378768,chr1,F,62423975,62432921,137151253,8946,137151253,3633,2
105378769,LOC105378769,chr1,R,62975973,63022126,137197406,46153,137197406,3634,5
105378770,LOC105378770,chr1,F,63173147,63198709,137222968,25562,137222968,3635,3
105378771,LOC105378771,chr1,F,63669658,63728051,137281361,58393,137281361,3636,3
105378772,LOC105378772,chr1,R,64033934,64035179,137282606,1245,137282606,3637,1
105378773,LOC105378773,chr1,R,64191520,64196045,137287131,4525,137287131,3638,3
105378774,LOC105378774,chr1,F,64369687,64383571,137301015,13884,137301015,3639,2
105378775,LOC105378775,chr1,R,65048335,65069390,137322070,21055,137322070,3640,2
105378776,LOC105378776,chr1,F,66416558,66439650,137345162,23092,137345162,3641,2
105378777,LOC105378777,chr1,R,66611191,66619849,137353820,8658,137353820,3642,2
105378778,LOC105378778,chr1,F,67044309,67049008,137358519,4699,137358519,3643,2
105378779,LOC105378779,chr1,R,67398497,67399826,137359848,1329,137359848,3644,1
105378780,LOC105378780,chr1,F,67562056,67590379,137388171,28323,137388171,3645,3
105378781,LOC105378781,chr1,F,67753930,67783501,137417742,29571,137417742,3646,3
105378782,LOC105378782,chr1,F,68293381,68303696,137428057,10315,137428057,3647,2
105378783,LOC105378783,chr1,R,68892376,68904648,137440329,12272,137440329,3648,3
105378784,LOC105378784,chr1,R,69020352,69054436,137474413,34084,137474413,3649,2
105378785,LOC105378785,chr1,F,69055863,69192476,137611026,136613,137611026,3650,4
105378786,LOC105378786,chr1,R,69215514,69249487,137644999,33973,137644999,3651,4
105378787,LOC105378787,chr1,F,69197085,69229641,137677555,32556,137677555,3652,6
105378788,LOC105378788,chr1,F,69431250,69435400,137681705,4150,137681705,3653,2
105378789,LOC105378789,chr1,F,69453675,69557821,137785851,104146,137785851,3654,11
105378790,LOC105378790,chr1,F,69557831,69564068,137792088,6237,137792088,3655,2
105378791,LOC105378791,chr1,R,70038661,70043126,137796553,4465,137796553,3656,2
105378792,LOC105378792,chr1,R,70020822,70036600,137812331,15778,137812331,3657,8
105378793,LOC105378793,chr1,F,70449090,70461596,137824837,12506,137824837,3658,2
105378794,LOC105378794,chr1,R,70640359,70648909,137833387,8550,137833387,3659,4
105378795,LOC105378795,chr1,R,71083810,71088902,137838479,5092,137838479,3660,3
105378796,LOC105378796,chr1,R,72409643,72466359,137895195,56716,137895195,3661,3
105378797,LOC105378797,chr1,F,72283095,72670716,138282816,387621,138282816,3662,7
105378798,LOC105378798,chr1,R,72697397,72766696,138352115,69299,138352115,3663,8
105378799,LOC105378799,chr1,F,72848335,72854302,138358082,5967,138358082,3664,5
105378800,LOC105378800,chr1,R,73129095,73342515,138571502,213420,138571502,3665,2
105378801,LOC105378801,chr1,R,73451087,73472982,138593397,21895,138593397,3666,2
105378802,LOC105378802,chr1,R,73583281,73607277,138617393,23996,138617393,3667,3
105378803,LOC105378803,chr1,R,74479954,74537447,138674886,57493,138674886,3668,2
105378804,LOC105378804,chr1,R,74469616,74476533,138681803,6917,138681803,3669,1
105378805,LOC105378805,chr1,F,74465836,74469124,138685091,3288,138685091,3670,1
105378806,LOC105378806,chr1,R,75964916,76002941,138723116,38025,138723116,3671,2
105378807,LOC105378807,chr1,R,76587062,76675311,138811365,88249,138811365,3672,5
105378808,LOC105378808,chr1,F,77219566,77231670,138823469,12104,138823469,3673,2
105378809,LOC105378809,chr1,R,77432954,77437946,138828461,4992,138828461,3674,1
105378810,LOC105378810,chr1,F,79270403,79405420,138963478,135017,138963478,3675,8
105378811,LOC105378811,chr1,R,79309583,79323851,138977746,14268,138977746,3676,4
105378812,LOC105378812,chr1,R,79278361,79286728,138986113,8367,138986113,3677,2
105378813,LOC105378813,chr1,R,81158403,81177845,139005555,19442,139005555,3678,1
105378814,LOC105378814,chr1,F,82621529,82656278,139040304,34749,139040304,3679,4
105378815,LOC105378815,chr1,R,82814122,82853644,139079826,39522,139079826,3680,2
105378816,LOC105378816,chr1,F,83287470,83315236,139107592,27766,139107592,3681,4
105378817,LOC105378817,chr1,F,83065927,83086308,139127973,20381,139127973,3682,2
105378818,LOC105378818,chr1,R,84076330,84078014,139129657,1684,139129657,3683,1
105378819,LOC105378819,chr1,F,84578090,84583620,139135187,5530,139135187,3684,1
105378820,LOC105378820,chr1,F,84630542,84637724,139142369,7182,139142369,3685,4
105378821,LOC105378821,chr1,F,85225578,85245412,139162203,19834,139162203,3686,2
105378822,LOC105378822,chr1,F,85624202,85628292,139166293,4090,139166293,3687,2
105378823,LOC105378823,chr1,F,85717694,85728232,139176831,10538,139176831,3688,3
105378824,LOC105378824,chr1,R,86265374,86320225,139231682,54851,139231682,3689,5
105378825,LOC105378825,chr1,R,86328445,86330110,139233347,1665,139233347,3690,2
105378826,LOC105378826,chr1,F,86520362,86523557,139236542,3195,139236542,3691,2
105378827,LOC105378827,chr1,R,86500096,86503813,139240259,3717,139240259,3692,1
105378828,LOC105378828,chr1,R,86703497,86704754,139241516,1257,139241516,3693,0
105378829,LOC105378829,chr1,R,86618448,86623132,139246200,4684,139246200,3694,2
105378830,LOC105378830,chr1,R,86571248,86698263,139373215,127015,139373215,3695,5
105378831,LOC105378831,chr1,R,86821596,86825909,139377528,4313,139377528,3696,2
105378832,LOC105378832,chr1,F,87219917,87261689,139419300,41772,139419300,3697,2
105378833,LOC105378833,chr1,F,87394491,87430418,139455227,35927,139455227,3698,3
105378834,LOC105378834,chr1,F,87446490,87451804,139460541,5314,139460541,3699,2
105378835,LOC105378835,chr1,R,87526333,87528656,139462864,2323,139462864,3700,3
105378836,LOC105378836,chr1,R,87965170,87987040,139484734,21870,139484734,3701,2
105378837,LOC105378837,chr1,R,88175238,88271652,139581148,96414,139581148,3702,2
105378838,LOC105378838,chr1,F,88615286,88648319,139614181,33033,139614181,3703,3
105378839,LOC105378839,chr1,F,88462887,88465805,139617099,2918,139617099,3704,1
105378840,LOC105378840,chr1,F,88945081,88947495,139619513,2414,139619513,3705,1
105378841,LOC105378841,chr1,F,89034790,89102691,139687414,67901,139687414,3706,7
105378842,LOC105378842,chr1,F,89128416,89179775,139738773,51359,139738773,3707,3
105378843,LOC105378843,chr1,R,89217043,89218034,139739764,991,139739764,3708,1
105378844,LOC105378844,chr1,R,89471600,89479972,139748136,8372,139748136,3709,2
105378845,LOC105378845,chr1,R,89544056,89555164,139759244,11108,139759244,3710,2
105378846,LOC105378846,chr1,R,89900425,89906621,139765440,6196,139765440,3711,2
105378847,LOC105378847,chr1,F,89967190,89986800,139785050,19610,139785050,3712,3
105378848,LOC105378848,chr1,F,90115180,90118603,139788473,3423,139788473,3713,2
105378849,LOC105378849,chr1,F,90219802,90285806,139854477,66004,139854477,3714,4
105378850,LOC105378850,chr1,R,90390186,90401055,139865346,10869,139865346,3715,2
105378851,LOC105378851,chr1,R,90475856,90488088,139877578,12232,139877578,3716,2
105378852,LOC105378852,chr1,R,90504684,90547930,139920824,43246,139920824,3717,6
105378853,LOC105378853,chr1,R,90782983,90789487,139927328,6504,139927328,3718,1
105378854,LOC105378854,chr1,F,90851125,90854899,139931102,3774,139931102,3719,1
105378855,LOC105378855,chr1,F,90844355,90851026,139937773,6671,139937773,3720,2
105378856,LOC105378856,chr1,R,91488865,91499054,139947962,10189,139947962,3721,2
105378857,LOC105378857,chr1,R,92214630,92229004,139962336,14374,139962336,3722,2
105378858,LOC105378858,chr1,R,94144808,94161728,139979256,16920,139979256,3723,3
105378859,LOC105378859,chr1,R,94311300,94330050,139998006,18750,139998006,3724,3
105378860,LOC105378860,chr1,F,94683471,94688112,140002647,4641,140002647,3725,2
105378861,LOC105378861,chr1,F,94599329,94636984,140040302,37655,140040302,3726,2
105378862,LOC105378862,chr1,F,94925900,94931255,140045657,5355,140045657,3727,1
105378863,LOC105378863,chr1,F,95028779,95031531,140048409,2752,140048409,3728,1
105378864,LOC105378864,chr1,R,95315794,95317984,140050599,2190,140050599,3729,2
105378865,LOC105378865,chr1,F,96268860,96359189,140140928,90329,140140928,3730,2
105378866,LOC105378866,chr1,F,96482427,96524341,140182842,41914,140182842,3731,2
105378867,LOC105378867,chr1,F,97340751,97389919,140232010,49168,140232010,3732,6
105378868,LOC105378868,chr1,R,97108137,97116436,140240309,8299,140240309,3733,2
105378869,LOC105378869,chr1,F,98143770,98144838,140241377,1068,140241377,3734,2
105378870,LOC105378870,chr1,F,98188470,98209472,140262379,21002,140262379,3735,4
105378871,LOC105378871,chr1,F,98709898,98711484,140263965,1586,140263965,3736,1
105378872,LOC105378872,chr1,F,101639559,101785719,140410125,146160,140410125,3737,9
105378873,LOC105378873,chr1,R,102387210,102388621,140411536,1411,140411536,3738,2
105378874,LOC105378874,chr1,R,102647853,102660714,140424397,12861,140424397,3739,2
105378875,LOC105378875,chr1,F,102676777,102680950,140428570,4173,140428570,3740,3
105378876,LOC105378876,chr1,F,103650531,103651378,140429417,847,140429417,3741,2
105378877,LOC105378877,chr1,R,103669002,103681271,140441686,12269,140441686,3742,1
105378878,LOC105378878,chr1,R,103700591,103701430,140442525,839,140442525,3743,2
105378879,LOC105378879,chr1,F,104132204,104150706,140461027,18502,140461027,3744,2
105378880,LOC105378880,chr1,R,105001025,105025102,140485104,24077,140485104,3745,2
105378881,LOC105378881,chr1,R,105473601,105489957,140501460,16356,140501460,3746,3
105378882,LOC105378882,chr1,R,105668855,105673290,140505895,4435,140505895,3747,2
105378883,LOC105378883,chr1,F,105830358,105859474,140535011,29116,140535011,3748,3
105378884,LOC105378884,chr1,R,105927623,106028371,140635759,100748,140635759,3749,11
105378885,LOC105378885,chr1,R,106047107,106073162,140661814,26055,140661814,3750,3
105378886,LOC105378886,chr1,F,106041858,106047677,140667633,5819,140667633,3751,2
105378887,LOC105378887,chr1,F,106448065,106485680,140705248,37615,140705248,3752,6
105378888,LOC105378888,chr1,R,106831266,106843817,140717799,12551,140717799,3753,2
105378889,LOC105378889,chr1,F,106818187,106878302,140777914,60115,140777914,3754,6
105378890,LOC105378890,chr1,F,108661625,108667195,140783484,5570,140783484,3755,3
105378891,LOC105378891,chr1,F,108833762,108837003,140786725,3241,140786725,3756,2
105378892,LOC105378892,chr1,R,109078319,109090726,140799132,12407,140799132,3757,2
105378893,LOC105378893,chr1,R,109510612,109522443,140810963,11831,140810963,3758,2
105378894,LOC105378894,chr1,R,109720029,109728731,140819665,8702,140819665,3759,2
105378895,LOC105378895,chr1,R,110031959,110035511,140823217,3552,140823217,3760,3
105378896,LOC105378896,chr1,F,110135494,110138778,140826501,3284,140826501,3761,2
105378897,LOC105378897,chr1,R,110165858,110168717,140829360,2859,140829360,3762,2
105378898,LOC105378898,chr1,F,110472970,110474980,140831370,2010,140831370,3763,4
105378899,LOC105378899,chr1,R,110472524,110473646,140832492,1122,140832492,3764,1
105378900,LOC105378900,chr1,R,110522233,110525306,140835565,3073,140835565,3765,1
105378901,LOC105378901,chr1,R,110749203,110753073,140839435,3870,140839435,3766,2
105378902,LOC105378902,chr1,R,110877152,110929157,140891440,52005,140891440,3767,2
105378903,LOC105378903,chr1,R,111323839,111324572,140892173,733,140892173,3768,2
105378904,LOC105378904,chr1,R,111361573,111371692,140902292,10119,140902292,3769,3
105378905,LOC105378905,chr1,F,111788774,111795743,140909261,6969,140909261,3770,2
105378906,LOC105378906,chr1,F,112005932,112008270,140911599,2338,140911599,3771,2
105378907,LOC105378907,chr1,R,112077067,112080078,140914610,3011,140914610,3772,2
105378908,LOC105378908,chr1,R,112269861,112273735,140918484,3874,140918484,3773,2
105378909,LOC105378909,chr1,R,112229672,112360633,141049445,130961,141049445,3774,4
105378910,LOC105378910,chr1,F,112715356,112717794,141051883,2438,141051883,3775,1
105378911,LOC105378911,chr1,R,112857299,112871382,141065966,14083,141065966,3776,3
105378912,LOC105378912,chr1,F,112850343,112877871,141093494,27528,141093494,3777,2
105378913,LOC105378913,chr1,R,114545317,114548202,141096379,2885,141096379,3778,2
105378914,LOC105378914,chr1,F,114581738,114586880,141101521,5142,141101521,3779,2
105378915,LOC105378915,chr1,R,114899373,114902463,141104611,3090,141104611,3780,3
105378916,LOC105378916,chr1,F,115099559,115102681,141107733,3122,141107733,3781,1
105378917,LOC105378917,chr1,F,115222473,115282555,141167815,60082,141167815,3782,5
105378918,LOC105378918,chr1,R,116121319,116124054,141170550,2735,141170550,3783,2
105378919,LOC105378919,chr1,R,116240963,116242077,141171664,1114,141171664,3784,2
105378920,LOC105378920,chr1,R,116289247,116336339,141218756,47092,141218756,3785,6
105378921,LOC105378921,chr1,F,116407201,116410261,141221816,3060,141221816,3786,1
105378922,LOC105378922,chr1,R,116493015,116505088,141233889,12073,141233889,3787,1
105378923,LOC105378923,chr1,F,116487139,116502637,141249387,15498,141249387,3788,1
105378924,LOC105378924,chr1,F,116591469,116595796,141253714,4327,141253714,3789,3
105378925,LOC105378925,chr1,F,116544614,116550578,141259678,5964,141259678,3790,2
105378926,LOC105378926,chr1,R,116706438,116710580,141263820,4142,141263820,3791,2
105378927,LOC105378927,chr1,F,116882383,116885828,141267265,3445,141267265,3792,2
105378928,LOC105378928,chr1,F,117759855,117796481,141303891,36626,141303891,3793,2
105378929,LOC105378929,chr1,R,117815460,117821182,141309613,5722,141309613,3794,2
105378930,LOC105378930,chr1,F,118185255,118206679,141331037,21424,141331037,3795,3
105378931,LOC105378931,chr1,F,118136179,118148481,141343339,12302,141343339,3796,2
105378932,LOC105378932,chr1,R,118555567,118564265,141352037,8698,141352037,3797,2
105378933,LOC105378933,chr1,R,119000343,119001461,141353155,1118,141353155,3798,1
105378934,LOC105378934,chr1,F,119327414,119362420,141388161,35006,141388161,3799,5
105378935,LOC105378935,chr1,R,119483337,119490108,141394932,6771,141394932,3800,2
105378936,LOC105378936,chr1,F,119727786,119732090,141399236,4304,141399236,3801,1
105378937,LOC105378937,chr1,R,119681347,119711815,141429704,30468,141429704,3802,2
105378938,LOC105378938,chr1,F,119829293,119846812,141447223,17519,141447223,3803,4
105378939,LOC105378939,chr1,R,120093630,120100787,141454380,7157,141454380,3804,2
105378940,LOC105378940,chr1,F,120120476,120136719,141470623,16243,141470623,3805,2
105378941,LOC105378941,chr1,F,120323844,120328644,141475423,4800,141475423,3806,1
105378942,LOC105378942,chr1,F,120375274,120377885,141478034,2611,141478034,3807,2
105378943,LOC105378943,chr1,F,120718088,120723566,141483512,5478,141483512,3808,2
105378944,LOC105378944,chr1,R,120716938,120723764,141490338,6826,141490338,3809,1
105378945,LOC105378945,chr1,F,120873851,120911049,141527536,37198,141527536,3810,2
105378946,LOC105378946,chr1,R,121492343,121499740,141534933,7397,141534933,3811,1
105378947,LOC105378947,chr1,R,586286,611297,141559944,25011,141559944,3812,5
105378948,LOC105378948,chr1,R,1065634,1069326,141563636,3692,141563636,3813,4
105378949,LOC105378949,chr1,F,1885959,1893010,141570687,7051,141570687,3814,5
105378950,LOC105378950,chr1,R,39488833,39491993,141573847,3160,141573847,3815,2
105378951,LOC105378951,chr1,F,39784635,39808042,141597254,23407,141597254,3816,9
105378952,LOC105378952,chr1,R,44137795,44141631,141601090,3836,141601090,3817,1
105378954,LOC105378954,chr1,F,120339115,120341679,141603654,2564,141603654,3818,2
105379212,LOC105379212,chr1,F,51942,53959,141605671,2017,141605671,3819,1
105379213,LOC105379213,chr1,F,96599,107727,141616799,11128,141616799,3820,2
105379214,LOC105379214,chr1,R,176544,180102,141620357,3558,141620357,3821,1
105379248,LOC105379248,chr1,F,360086,366034,141626305,5948,141626305,3822,1
105379282,LOC105379282,chr1,F,226971536,226977442,141632211,5906,141632211,3823,1
105379283,LOC105379283,chr1,R,235126918,235128187,141633480,1269,141633480,3824,1
105379284,LOC105379284,chr1,R,245671230,245678589,141640839,7359,141640839,3825,2
105379285,LOC105379285,chr1,F,248445606,248548838,141744071,103232,141744071,3826,2
105379431,LOC105379431,chr1,F,271647,284291,141756715,12644,141756715,3827,1
36,ACADSB,chr10,F,123008912,123058290,49378,49378,141806093,3828,10
59,ACTA2,chr10,R,88935073,88991390,105695,56317,141862410,3829,9
101,ADAM8,chr10,R,133262415,133276903,120183,14488,141876898,3830,24
105,ADARB2,chr10,R,1177312,1737498,680369,560186,142437084,3831,9
120,ADD3,chr10,F,109996364,110135565,819570,139201,142576285,3832,22
132,ADK,chr10,F,74151184,74709303,1377689,558119,143134404,3833,12
150,ADRA2A,chr10,F,111077031,111080907,1381565,3876,143138280,3834,0
153,ADRB1,chr10,F,114044046,114046908,1384427,2862,143141142,3835,0
240,ALOX5,chr10,F,45374175,45446121,1456373,71946,143213088,3836,13
288,ANK3,chr10,R,60026297,60733526,2163602,707229,143920317,3837,59
305,ANXA2P3,chr10,F,64825527,64826877,2164952,1350,143921667,3838,0
310,ANXA7,chr10,R,73375430,73414083,2203605,38653,143960320,3839,13
311,ANXA11,chr10,R,80152609,80205677,2256673,53068,144013388,3840,20
355,FAS,chr10,F,88969800,89017059,2303932,47259,144060647,3841,13
403,ARL3,chr10,R,102673726,102714433,2344639,40707,144101354,3842,5
509,ATP5C1,chr10,F,7788129,7807801,2364311,19672,144121026,3843,9
648,BMI1,chr10,F,22321209,22331485,2374587,10276,144131302,3844,13
657,BMPR1A,chr10,F,86755785,86925188,2543990,169403,144300705,3845,14
664,BNIP3,chr10,R,131967682,131982013,2558321,14331,144315036,3846,5
783,CACNB2,chr10,F,18140676,18541759,2959404,401083,144716119,3847,19
810,CALML3,chr10,F,5524888,5526268,2960784,1380,144717499,3848,0
818,CAMK2G,chr10,R,73812500,73874591,3022875,62091,144779590,3849,25
840,CASP7,chr10,F,113679161,113730909,3074623,51748,144831338,3850,11
953,ENTPD1,chr10,F,95710905,95877266,3240984,166361,144997699,3851,15
983,CDK1,chr10,F,60778330,60794852,3257506,16522,145014221,3852,7
1103,CHAT,chr10,F,49609094,49665104,3313516,56010,145070231,3853,17
1109,AKR1C4,chr10,F,5196808,5220633,3337341,23825,145094056,3854,8
1147,CHUK,chr10,R,100186112,100229610,3380839,43498,145137554,3855,22
1244,ABCC2,chr10,F,99782597,99852576,3450818,69979,145207533,3856,33
1305,COL13A1,chr10,F,69801862,69959148,3608104,157286,145364819,3857,41
1308,COL17A1,chr10,R,104031287,104085880,3662697,54593,145419412,3858,55
1316,KLF6,chr10,R,3775995,3785281,3671983,9286,145428698,3859,3
1326,MAP3K8,chr10,F,30434002,30461833,3699814,27831,145456529,3860,11
1355,COX15,chr10,R,99696128,99732666,3736352,36538,145493067,3861,9
1369,CPN1,chr10,R,100042307,100081901,3775946,39594,145532661,3862,8
1390,CREM,chr10,F,35126840,35212958,3862064,86118,145618779,3863,17
1488,CTBP2,chr10,R,124987848,125161055,4035271,173207,145791986,3864,20
1517,CTSLP2,chr10,R,47580670,47583419,4038020,2749,145794735,3865,3
1557,CYP2C19,chr10,F,94762680,94853205,4128545,90525,145885260,3866,8
1558,CYP2C8,chr10,R,95036771,95069498,4161272,32727,145917987,3867,10
1559,CYP2C9,chr10,F,94938657,94989391,4212006,50734,145968721,3868,8
1562,CYP2C18,chr10,F,94683493,94736190,4264703,52697,146021418,3869,8
1571,CYP2E1,chr10,F,133527362,133539116,4276457,11754,146033172,3870,8
1586,CYP17A1,chr10,R,102830530,102837533,4283460,7003,146040175,3871,7
1592,CYP26A1,chr10,F,93073474,93077884,4287870,4410,146044585,3872,7
1645,AKR1C1,chr10,F,4963261,4977966,4302575,14705,146059290,3873,8
1646,AKR1C2,chr10,R,4987774,5018033,4332834,30259,146089549,3874,11
1755,DMBT1,chr10,F,122560664,122643736,4415906,83072,146172621,3875,55
1763,DNA2,chr10,R,68414063,68472516,4474359,58453,146231074,3876,22
1787,TRDMT1,chr10,R,17137801,17202071,4538629,64270,146295344,3877,15
1791,DNTT,chr10,F,96304327,96338564,4572866,34237,146329581,3878,10
1793,DOCK1,chr10,F,126905408,127452517,5119975,547109,146876690,3879,56
1847,DUSP5,chr10,F,110497866,110511544,5133653,13678,146890368,3880,3
1892,ECHS1,chr10,R,133362482,133373404,5144575,10922,146901290,3881,7
1959,EGR2,chr10,R,62811995,62919895,5252475,107900,147009190,3882,9
1979,EIF4EBP2,chr10,F,70404104,70428618,5276989,24514,147033704,3883,2
2018,EMX2,chr10,F,117542444,117549546,5284091,7102,147040806,3884,2
2074,ERCC6,chr10,R,49454479,49539123,5368735,84644,147125450,3885,20
2253,FGF8,chr10,R,101770129,101780369,5378975,10240,147135690,3886,7
2263,FGFR2,chr10,R,121478329,121598656,5499302,120327,147256017,3887,22
2572,GAD2,chr10,F,26216306,26304562,5587558,88256,147344273,3888,16
2625,GATA3,chr10,F,8045427,8075201,5617332,29774,147374047,3889,7
2658,GDF2,chr10,F,47322489,47327594,5622437,5105,147379152,3890,2
2662,GDF10,chr10,F,47300223,47313583,5635797,13360,147392512,3891,2
2665,GDI2,chr10,R,5765222,5813549,5684124,48327,147440839,3892,10
2674,GFRA1,chr10,R,116056924,116273614,5900814,216690,147657529,3893,12
2746,GLUD1,chr10,R,87050201,87095019,5945632,44818,147702347,3894,16
2749,GLUD1P3,chr10,F,73731540,73735609,5949701,4069,147706416,3895,0
2805,GOT1,chr10,R,99396869,99430773,5983605,33904,147740320,3896,8
2834,PRLHR,chr10,R,118591924,118599895,5991576,7971,147748291,3897,2
2849,GPR26,chr10,F,123666354,123697399,6022621,31045,147779336,3898,2
2869,GRK5,chr10,F,119207684,119455619,6270556,247935,148027271,3899,16
2894,GRID1,chr10,R,85599554,86366493,7037495,766939,148794210,3900,16
3026,HABP2,chr10,F,113550830,113589602,7076267,38772,148832982,3901,13
3070,HELLS,chr10,F,94545766,94602099,7132600,56333,148889315,3902,24
3087,HHEX,chr10,F,92689923,92695651,7138328,5728,148895043,3903,3
3098,HK1,chr10,F,69269983,69401882,7270227,131899,149026942,3904,27
3167,HMX2,chr10,F,123142420,123150672,7278479,8252,149035194,3905,2
3185,HNRNPF,chr10,R,43385616,43409248,7302111,23632,149058826,3906,6
3189,HNRNPH3,chr10,F,68332010,68343196,7313297,11186,149070012,3907,10
3195,TLX1,chr10,F,101130779,101137789,7320307,7010,149077022,3908,2
3257,HPS1,chr10,R,98416197,98446963,7351073,30766,149107788,3909,20
3363,HTR7,chr10,R,90740817,90857914,7468170,117097,149224885,3910,3
3416,IDE,chr10,R,92451683,92574095,7590582,122412,149347297,3911,27
3422,IDI1,chr10,R,1040022,1056699,7607259,16677,149363974,3912,6
3433,IFIT2,chr10,F,89301948,89309276,7614587,7328,149371302,3913,1
3434,IFIT1,chr10,F,89392545,89406487,7628529,13942,149385244,3914,3
3437,IFIT3,chr10,F,89327818,89340968,7641679,13150,149398394,3915,3
3559,IL2RA,chr10,R,6010693,6062370,7693356,51677,149450071,3916,7
3601,IL15RA,chr10,R,5948899,5978634,7723091,29735,149479806,3917,10
3632,INPP5A,chr10,F,132537783,132783480,7968788,245697,149725503,3918,19
3688,ITGB1,chr10,R,32900317,32958365,8026836,58048,149783551,3919,17
3698,ITIH2,chr10,F,7703272,7749520,8073084,46248,149829799,3920,20
3778,KCNMA1,chr10,R,76869600,77637819,8841303,768219,150598018,3921,36
3799,KIF5B,chr10,R,32009009,32056443,8888737,47434,150645452,3922,25
3832,KIF11,chr10,F,92593067,92655395,8951065,62328,150707780,3923,21
3983,ABLIM1,chr10,R,114431109,114821643,9341599,390534,151098314,3924,33
3988,LIPA,chr10,R,89213568,89252039,9380070,38471,151136785,3925,9
4143,MAT1A,chr10,R,80271819,80289979,9398230,18160,151154945,3926,9
4153,MBL2,chr10,R,52765379,52772841,9405692,7462,151162407,3927,4
4255,MGMT,chr10,F,129467189,129768042,9706545,300853,151463260,3928,5
4288,MKI67,chr10,R,128096658,128126363,9736250,29705,151492965,3929,15
4360,MRC1,chr10,F,17809342,17911162,9838070,101820,151594785,3930,29
4477,MSMB,chr10,R,46033304,46046269,9851035,12965,151607750,3931,3
4601,MXI1,chr10,F,110207604,110287365,9930796,79761,151687511,3932,7
4714,NDUFB8,chr10,R,100523728,100529923,9936991,6195,151693706,3933,4
4791,NFKB2,chr10,F,102394109,102402529,9945411,8420,151702126,3934,22
4838,NODAL,chr10,R,70431935,70441709,9955185,9774,151711900,3935,2
4892,NRAP,chr10,R,113588823,113664070,10030432,75247,151787147,3936,41
4942,OAT,chr10,R,124397302,124418976,10052106,21674,151808821,3937,11
5033,P4HA1,chr10,R,73007216,73096974,10141864,89758,151898579,3938,16
5076,PAX2,chr10,F,100735708,100829941,10236097,94233,151992812,3939,12
5092,PCBD1,chr10,R,70882279,70888786,10242604,6507,151999319,3940,5
5146,PDE6C,chr10,F,93612587,93665673,10295690,53086,152052405,3941,21
5209,PFKFB3,chr10,F,6144879,6235545,10386356,90666,152143071,3942,17
5214,PFKP,chr10,F,3067473,3136805,10455688,69332,152212403,3943,25
5223,PGAM1,chr10,F,97426269,97433441,10462860,7172,152219575,3944,3
5264,PHYH,chr10,R,13277795,13300138,10485203,22343,152241918,3945,9
5305,PIP4K2A,chr10,R,22534836,22714574,10664941,179738,152421656,3946,13
5309,PITX3,chr10,R,102230188,102241474,10676227,11286,152432942,3947,4
5328,PLAU,chr10,F,73909181,73917501,10684547,8320,152441262,3948,11
5406,PNLIP,chr10,F,116545915,116567855,10706487,21940,152463202,3949,12
5407,PNLIPRP1,chr10,F,116590414,116609175,10725248,18761,152481963,3950,14
5408,PNLIPRP2,chr10,F,116620952,116645143,10749439,24191,152506154,3951,12
5464,PPA1,chr10,R,70202829,70233434,10780044,30605,152536759,3952,10
5507,PPP1R3C,chr10,R,91628439,91633101,10784706,4662,152541421,3953,1
5532,PPP3CB,chr10,R,73436427,73496024,10844303,59597,152601018,3954,16
5540,NPY4R,chr10,R,46458550,46470647,10856400,12097,152613115,3955,7
5551,PRF1,chr10,R,70597347,70602775,10861828,5428,152618543,3956,2
5552,SRGN,chr10,F,69088071,69104811,10878568,16740,152635283,3957,2
5588,PRKCQ,chr10,R,6393594,6580646,11065620,187052,152822335,3958,21
5592,PRKG1,chr10,F,50991150,52298350,12372820,1307200,154129535,3959,20
5599,MAPK8,chr10,F,48306638,48439360,12505542,132722,154262257,3960,14
5654,HTRA1,chr10,F,122461524,122514908,12558926,53384,154315641,3961,8
5660,PSAP,chr10,R,71816297,71851325,12593954,35028,154350669,3962,14
5662,PSD,chr10,R,102402616,102420161,12611499,17545,154368214,3963,20
5728,PTEN,chr10,F,87863437,87971930,12719992,108493,154476707,3964,15
5791,PTPRE,chr10,F,127907060,128085916,12898848,178856,154655563,3965,26
5832,ALDH18A1,chr10,R,95605928,95656810,12949730,50882,154706445,3966,17
5949,RBP3,chr10,F,47348370,47357875,12959235,9505,154715950,3967,3
5950,RBP4,chr10,R,93591835,93601236,12968636,9401,154725351,3968,5
5979,RET,chr10,F,43077026,43130351,13021961,53325,154778676,3969,19
5995,RGR,chr10,F,84237082,84259347,13044226,22265,154800941,3970,8
6001,RGS10,chr10,R,119499826,119542710,13087110,42884,154843825,3971,5
6229,RPS24,chr10,F,78033759,78056813,13110164,23054,154866879,3972,9
6251,RSU1,chr10,R,16590615,16817454,13337003,226839,155093718,3973,9
6319,SCD,chr10,F,100347014,100364831,13354820,17817,155111535,3974,5
6387,CXCL12,chr10,R,44370152,44385097,13369765,14945,155126480,3975,4
6425,SFRP5,chr10,R,97766750,97771999,13375014,5249,155131729,3976,2
6441,SFTPD,chr10,R,79937739,79982236,13419511,44497,155176226,3977,8
6468,FBXW4,chr10,R,101610663,101695037,13503885,84374,155260600,3978,9
6571,SLC18A2,chr10,F,117241072,117279430,13542243,38358,155298958,3979,15
6572,SLC18A3,chr10,F,49610300,49612720,13544663,2420,155301378,3980,0
6585,SLIT1,chr10,R,96998037,97185926,13732552,187889,155489267,3981,36
6623,SNCG,chr10,F,86958530,86963260,13737282,4730,155493997,3982,4
6832,SUPV3L1,chr10,F,69180203,69209098,13766177,28895,155522892,3983,15
6840,SVIL,chr10,R,29457337,29736935,14045775,279598,155802490,3984,46
6865,TACR2,chr10,R,69404201,69416918,14058492,12717,155815207,3985,4
6877,TAF5,chr10,F,103367952,103389065,14079605,21113,155836320,3986,10
6934,TCF7L2,chr10,F,112950218,113167678,14297065,217460,156053780,3987,20
6935,ZEB1,chr10,F,31318782,31529814,14508097,211032,156264812,3988,16
6975,TECTB,chr10,F,112283344,112305035,14529788,21691,156286503,3989,10
7019,TFAM,chr10,F,58385142,58399230,14543876,14088,156300591,3990,8
7073,TIAL1,chr10,R,119573464,119597029,14567441,23565,156324156,3991,12
7093,TLL2,chr10,R,96364605,96513926,14716762,149321,156473477,3992,20
7321,UBE2D1,chr10,F,58334978,58370753,14752537,35775,156509252,3993,6
7390,UROS,chr10,R,125784979,125823268,14790826,38289,156547541,3994,17
7414,VCL,chr10,F,73998077,74120160,14912909,122083,156669624,3995,21
7417,VDAC2,chr10,F,75210153,75231448,14934204,21295,156690919,3996,12
7431,VIM,chr10,F,17227934,17237593,14943863,9659,156700578,3997,8
7479,WNT8B,chr10,F,100463054,100483642,14964451,20588,156721166,3998,5
7511,XPNPEP1,chr10,R,109864765,109923553,15023239,58788,156779954,3999,22
7570,ZNF22,chr10,F,45000824,45005329,15027744,4505,156784459,4000,1
7580,ZNF32,chr10,R,43643858,43648878,15032764,5020,156789479,4001,3
7581,ZNF33A,chr10,F,38010482,38060067,15082349,49585,156839064,4002,9
7582,ZNF33B,chr10,R,42589106,42638836,15132079,49730,156888794,4003,6
7587,ZNF37A,chr10,F,38094335,38123352,15161096,29017,156917811,4004,8
8027,STAM,chr10,F,17644124,17716824,15233796,72700,156990511,4005,15
8028,MLLT10,chr10,F,21533822,21743633,15443607,209811,157200322,4006,33
8029,CUBN,chr10,R,16823965,17130249,15749891,306284,157506606,4007,70
8030,CCDC6,chr10,R,59788746,59906656,15867801,117910,157624516,4008,8
8031,NCOA4,chr10,R,46005087,46030714,15893428,25627,157650143,4009,13
8034,SLC25A16,chr10,R,68473386,68527523,15947565,54137,157704280,4010,12
8036,SHOC2,chr10,F,110919542,111013667,16041690,94125,157798405,4011,8
8038,ADAM12,chr10,R,126012384,126388558,16417864,376174,158174579,4012,23
8187,ZNF239,chr10,R,43556343,43574618,16436139,18275,158192854,4013,8
8325,FZD8,chr10,R,35638248,35641434,16439325,3186,158196040,4014,0
8433,UTF1,chr10,F,133230273,133231558,16440610,1285,158197325,4015,1
8453,CUL2,chr10,R,35008550,35126899,16558959,118349,158315674,4016,27
8505,PARG,chr10,R,49818274,49942027,16682712,123753,158439427,4017,19
8509,NDST2,chr10,R,73801910,73811831,16692633,9921,158449348,4018,15
8512,MBL1P,chr10,F,79920177,79923119,16695575,2942,158452290,4019,2
8513,LIPF,chr10,F,88664388,88678815,16710002,14427,158466717,4020,10
8516,ITGA8,chr10,R,15513948,15720335,16916389,206387,158673104,4021,30
8559,PRPF18,chr10,F,13586938,13630868,16960319,43930,158717034,4022,11
8644,AKR1C3,chr10,F,5048765,5107686,17019240,58921,158775955,4023,9
8661,EIF3A,chr10,R,119035028,119080822,17065034,45794,158821749,4024,21
8729,GBF1,chr10,F,102245497,102382899,17202436,137402,158959151,4025,40
8829,NRP1,chr10,R,33177490,33334905,17359851,157415,159116566,4026,17
8861,LDB1,chr10,R,102106557,102120453,17373747,13896,159130462,4027,11
8872,CDC123,chr10,F,12195961,12250590,17428376,54629,159185091,4028,12
8879,SGPL1,chr10,F,70815947,70881189,17493618,65242,159250333,4029,16
8945,BTRC,chr10,F,101354032,101557321,17696907,203289,159453622,4030,15
9023,CH25H,chr10,R,89205936,89207314,17698285,1378,159455000,4031,0
9033,PKD2L1,chr10,R,100288144,100346524,17756665,58380,159513380,4032,19
9044,BTAF1,chr10,F,91923768,92030998,17863895,107230,159620610,4033,40
9060,PAPSS2,chr10,F,87659718,87747705,17951882,87987,159708597,4034,12
9118,INA,chr10,F,103277162,103290351,17965071,13189,159721786,4035,2
9124,PDLIM1,chr10,R,95237567,95291148,18018652,53581,159775367,4036,6
9126,SMC3,chr10,F,110567690,110604634,18055596,36944,159812311,4037,28
9148,NEURL1,chr10,F,103493889,103592552,18154259,98663,159910974,4038,11
9184,BUB3,chr10,F,123154243,123165370,18165386,11127,159922101,4039,7
9188,DDX21,chr10,F,68956122,68985069,18194333,28947,159951048,4040,15
9200,HACD1,chr10,R,17589958,17617390,18221765,27432,159978480,4041,6
9211,LGI1,chr10,F,93757808,93798159,18262116,40351,160018831,4042,7
9221,NOLC1,chr10,F,102152175,102163871,18273812,11696,160030527,4043,12
9231,DLG5,chr10,R,77790786,77926590,18409616,135804,160166331,4044,39
9317,PTER,chr10,F,16436942,16513745,18486419,76803,160243134,4045,6
9397,NMT2,chr10,R,15105699,15168705,18549425,63006,160306140,4046,12
9446,GSTO1,chr10,F,104254193,104267464,18562696,13271,160319411,4047,6
9469,CHST3,chr10,F,71964361,72013564,18611899,49203,160368614,4048,4
9531,BAG3,chr10,F,119651346,119677819,18638372,26473,160395087,4049,3
9559,VPS26A,chr10,F,69124151,69172861,18687082,48710,160443797,4050,8
9562,MINPP1,chr10,F,87502791,87553461,18737752,50670,160494467,4051,5
9576,SPAG6,chr10,F,22345415,22417610,18809947,72195,160566662,4052,13
9585,KIF20B,chr10,F,89701589,89774943,18883301,73354,160640016,4053,32
9632,SEC24C,chr10,F,73744280,73772175,18911196,27895,160667911,4054,25
9644,SH3PXD2A,chr10,R,103594026,103855482,19172652,261456,160929367,4055,18
9679,FAM53B,chr10,R,124619293,124744361,19297720,125068,161054435,4056,4
9712,USP6NL,chr10,R,11460509,11611789,19449000,151280,161205715,4057,21
9721,GPRIN2,chr10,R,46543962,46556947,19461985,12985,161218700,4058,8
9748,SLK,chr10,F,103967181,104029233,19524037,62052,161280752,4059,18
9790,BMS1,chr10,F,42782505,42834937,19576469,52432,161333184,4060,23
9806,SPOCK2,chr10,R,72059033,72089032,19606468,29999,161363183,4061,12
9849,ZNF518A,chr10,F,96129199,96163793,19641062,34594,161397777,4062,9
9886,RHOBTB1,chr10,R,60869437,61001468,19773093,132031,161529808,4063,18
9937,DCLRE1A,chr10,R,113834723,113854404,19792774,19681,161549489,4064,9
10006,ABI1,chr10,R,26746595,26861087,19907266,114492,161663981,4065,13
10023,FRAT1,chr10,F,97319264,97321915,19909917,2651,161666632,4066,0
10105,PPIF,chr10,F,79347463,79355334,19917788,7871,161674503,4067,5
10121,ACTR1A,chr10,R,102479228,102502755,19941315,23527,161698030,4068,10
10133,OPTN,chr10,F,13100074,13138291,19979532,38217,161736247,4069,15
10151,HNRNPA3P1,chr10,R,43787411,43790417,19982538,3006,161739253,4070,0
10276,NET1,chr10,F,5412550,5459056,20029044,46506,161785759,4071,12
10285,SMNDC1,chr10,R,110293039,110304949,20040954,11910,161797669,4072,6
10360,NPM3,chr10,R,101781324,101783413,20043043,2089,161799758,4073,5
10367,MICU1,chr10,R,72367325,72626191,20301909,258866,162058624,4074,16
10529,NEBL,chr10,R,20779970,21174187,20696126,394217,162452841,4075,36
10531,PITRM1,chr10,R,3137726,3172841,20731241,35115,162487956,4076,27
10539,GLRX3,chr10,F,130136374,130180382,20775249,44008,162531964,4077,12
10556,RPP30,chr10,F,90871951,90908558,20811856,36607,162568571,4078,13
10557,RPP38,chr10,F,15097179,15104257,20818934,7078,162575649,4079,2
10570,DPYSL4,chr10,F,132184986,132205776,20839724,20790,162596439,4080,15
10579,TACC2,chr10,F,121989173,122254545,21105096,265372,162861811,4081,29
10580,SORBS1,chr10,R,95311772,95561420,21354744,249648,163111459,4082,40
10613,ERLIN1,chr10,R,100150089,100186057,21390712,35968,163147427,4083,11
10659,CELF2,chr10,F,11004640,11336675,21722747,332035,163479462,4084,16
10660,LBX1,chr10,R,101226211,101230327,21726863,4116,163483578,4085,2
10718,NRG3,chr10,F,81875308,82987179,22838734,1111871,164595449,4086,14
10724,MGEA5,chr10,R,101784442,101818709,22873001,34267,164629716,4087,17
10730,YME1L1,chr10,R,27110110,27155278,22918169,45168,164674884,4088,19
10771,ZMYND11,chr10,F,134464,254637,23038342,120173,164795057,4089,17
10844,TUBGCP2,chr10,R,133278629,133312337,23072050,33708,164828765,4090,19
10935,PRDX3,chr10,R,119167698,119178865,23083217,11167,164839932,4091,6
10974,ADIRF,chr10,F,86968430,86970909,23085696,2479,164842411,4092,2
11023,VAX1,chr10,R,117128520,117138301,23095477,9781,164852192,4093,4
11067,C10orf10,chr10,R,44976260,44978882,23098099,2622,164854814,4094,1
11101,ATE1,chr10,R,121740420,121928801,23286480,188381,165043195,4095,13
11128,POLR3A,chr10,R,77975148,78029540,23340872,54392,165097587,4096,30
11130,ZWINT,chr10,R,56357437,56361302,23344737,3865,165101452,4097,7
11155,LDB3,chr10,F,86666716,86736072,23414093,69356,165170808,4098,18
11164,NUDT5,chr10,R,12165329,12196144,23444908,30815,165201623,4099,10
11196,SEC23IP,chr10,F,119892572,119944658,23496994,52086,165253709,4100,18
11319,ECD,chr10,R,73134523,73168095,23530566,33572,165287281,4101,14
22841,RAB11FIP2,chr10,R,118004915,118046877,23572528,41962,165329243,4102,6
22849,CPEB3,chr10,R,92048637,92291118,23815009,242481,165571724,4103,13
22852,ANKRD26,chr10,R,26966583,27100498,23948924,133915,165705639,4104,50
22876,INPP5F,chr10,F,119704394,119829278,24073808,124884,165830523,4105,24
22884,WDR37,chr10,F,1056835,1132297,24149270,75462,165905985,4106,13
22891,ZNF365,chr10,F,62374156,62672011,24447125,297855,166203840,4107,17
22921,MSRB2,chr10,F,23095497,23122013,24473641,26516,166230356,4108,5
22929,SEPHS1,chr10,R,13317427,13348298,24504512,30871,166261227,4109,8
22931,RAB18,chr10,F,27504173,27542237,24542576,38064,166299291,4110,7
22943,DKK1,chr10,F,52314280,52317657,24545953,3377,166302668,4111,3
22944,KIN,chr10,R,7750961,7788027,24583019,37066,166339734,4112,12
22978,NT5C2,chr10,R,103088016,103193306,24688309,105290,166445024,4113,25
22982,DIP2C,chr10,R,274189,689689,25103809,415500,166860524,4114,42
22984,PDCD11,chr10,F,103396623,103446295,25153481,49672,166910196,4115,36
22986,SORCS3,chr10,F,104640836,105265250,25777895,624414,167534610,4116,28
23053,ZSWIM8,chr10,F,73785576,73801798,25794117,16222,167550832,4117,27
23063,WAPAL,chr10,R,86435255,86521816,25880678,86561,167637393,4118,18
23082,PPRC1,chr10,F,102132993,102150333,25898018,17340,167654733,4119,13
23172,FAM175B,chr10,F,124801784,124836670,25932904,34886,167689619,4120,8
23185,LARP4B,chr10,R,806913,988323,26114314,181410,167871029,4121,25
23223,RRP12,chr10,R,97356700,97401370,26158984,44670,167915699,4122,33
23232,TBC1D12,chr10,F,94402428,94536332,26292888,133904,168049603,4123,14
23234,DNAJC9,chr10,R,73241953,73247331,26298266,5378,168054981,4124,4
23268,DNMBP,chr10,R,99875575,100009948,26432639,134373,168189354,4125,18
23283,CSTF2T,chr10,R,51695485,51699595,26436749,4110,168193464,4126,0
23401,FRAT2,chr10,R,97332496,97334701,26438954,2205,168195669,4127,0
23411,SIRT1,chr10,F,67884661,67918390,26472683,33729,168229398,4128,10
23412,COMMD3,chr10,F,22316382,22320317,26476618,3935,168233333,4129,7
23522,KAT6B,chr10,F,74824926,75032623,26684315,207697,168441030,4130,18
23555,TSPAN15,chr10,F,69425217,69507669,26766767,82452,168523482,4131,10
23560,GTPBP4,chr10,F,988408,1017768,26796127,29360,168552842,4132,16
23590,PDSS1,chr10,F,26697423,26748564,26847268,51141,168603983,4133,13
24138,IFIT5,chr10,F,89414567,89421002,26853703,6435,168610418,4134,1
25805,BAMBI,chr10,F,28677494,28682939,26859148,5445,168615863,4135,2
25911,DPCD,chr10,F,101588331,101609653,26880470,21322,168637185,4136,5
25956,SEC31B,chr10,R,100486645,100519838,26913663,33193,168670378,4137,25
25961,NUDT13,chr10,F,73110374,73131828,26935117,21454,168691832,4138,9
26019,UPF2,chr10,R,11920021,12043172,27058268,123151,168814983,4139,23
26033,ATRNL1,chr10,F,115093364,115948999,27913903,855635,169670618,4140,34
26091,HERC4,chr10,R,67921898,68075348,28067353,153450,169824068,4141,30
26095,PTPN20,chr10,F,46911412,47031830,28187771,120418,169944486,4142,19
26098,EDRF1,chr10,F,125719514,125764143,28232400,44629,169989115,4143,26
26103,LRIT1,chr10,R,84231519,84246493,28247374,14974,170004089,4144,5
26123,TCTN3,chr10,R,95663395,95694143,28278122,30748,170034837,4145,13
26128,KIAA1279,chr10,F,68988720,69016983,28306385,28263,170063100,4146,6
26148,C10orf12,chr10,F,96981283,96985828,28310930,4545,170067645,4147,0
26287,ANKRD2,chr10,F,97572440,97583884,28322374,11444,170079089,4148,8
26507,CNNM1,chr10,F,99329098,99394330,28387606,65232,170144321,4149,11
26509,MYOF,chr10,R,93306428,93482486,28563664,176058,170320379,4150,56
26985,AP3M1,chr10,R,74120256,74151068,28594476,30812,170351191,4151,11
27063,ANKRD1,chr10,R,90912099,90921275,28603652,9176,170360367,4152,8
27069,GHITM,chr10,F,84139428,84153555,28617779,14127,170374494,4153,8
27143,PALD1,chr10,F,70458544,70568450,28727685,109906,170484400,4154,23
27250,PDCD4,chr10,F,110871794,110900006,28755897,28212,170512612,4155,12
27287,VENTX,chr10,F,133237903,133241930,28759924,4027,170516639,4156,2
27291,R3HCC1L,chr10,F,98134623,98244897,28870198,110274,170626913,4157,13
27343,POLL,chr10,R,101578881,101588270,28879587,9389,170636302,4158,8
29119,CTNNA3,chr10,R,65912517,67763610,30730680,1851093,172487395,4159,22
29760,BLNK,chr10,R,96191698,96271576,30810558,79878,172567273,4160,17
29974,A1CF,chr10,R,50799408,50885675,30896825,86267,172653540,4161,14
29982,NRBF2,chr10,F,63133246,63155031,30918610,21785,172675325,4162,4
30819,KCNIP2,chr10,R,101825973,101843920,30936557,17947,172693272,4163,10
50624,CUZD1,chr10,R,122832154,122846175,30950578,14021,172707293,4164,8
50632,CALY,chr10,R,133324071,133336971,30963478,12900,172720193,4165,8
50674,NEUROG3,chr10,R,69572034,69573454,30964898,1420,172721613,4166,1
51008,ASCC1,chr10,R,72096031,72217134,31086001,121103,172842716,4167,14
51013,EXOSC1,chr10,R,97435908,97446011,31096104,10103,172852819,4168,9
51021,MRPS16,chr10,R,73248842,73252693,31099955,3851,172856670,4169,2
51063,CALHM2,chr10,R,103446784,103452405,31105576,5621,172862291,4170,3
51076,CUTC,chr10,F,99732200,99756137,31129513,23937,172886228,4171,8
51182,HSPA14,chr10,F,14838159,14871741,31163095,33582,172919810,4172,15
51196,PLCE1,chr10,F,93993988,94328392,31497499,334404,173254214,4173,38
51207,DUSP13,chr10,R,75094431,75109221,31512289,14790,173269004,4174,8
51322,WAC,chr10,F,28532587,28623112,31602814,90525,173359529,4175,15
51363,CHST15,chr10,R,123954350,124093684,31742148,139334,173498863,4176,16
51684,SUFU,chr10,F,102502873,102633457,31872732,130584,173629447,4177,15
51703,ACSL5,chr10,F,112374157,112428380,31926955,54223,173683670,4178,22
51806,CALML5,chr10,R,5498694,5499570,31927831,876,173684546,4179,0
53354,PANK1,chr10,R,89579496,89645572,31993907,66076,173750622,4180,7
53828,FXYD4,chr10,F,43371643,43376335,31998599,4692,173755314,4181,8
53904,MYO3A,chr10,F,25934072,26212536,32277063,278464,174033778,4182,45
54462,CCSER2,chr10,F,84328585,84518521,32466999,189936,174223714,4183,16
54518,APBB1IP,chr10,F,26438202,26567879,32596676,129677,174353391,4184,15
54522,ANKRD16,chr10,R,5861725,5889897,32624848,28172,174381563,4185,7
54536,EXOC6,chr10,F,92834712,93059494,32849630,224782,174606345,4186,23
54537,FAM35A,chr10,F,87095195,87191469,32945904,96274,174702619,4187,14
54541,DDIT4,chr10,F,72273918,72276039,32948025,2121,174704740,4188,2
54619,CCNJ,chr10,F,96041773,96060870,32967122,19097,174723837,4189,6
54708,MARCH5,chr10,F,92291162,92353964,33029924,62802,174786639,4190,6
54764,ZRANB1,chr10,F,124916898,124988059,33101085,71161,174857800,4191,11
54777,CFAP46,chr10,R,132808391,132943163,33235857,134772,174992572,4192,66
54780,NSMCE4A,chr10,R,121957087,121975228,33253998,18141,175010713,4193,13
54788,DNAJB12,chr10,R,72332829,72355149,33276318,22320,175033033,4194,7
54805,CNNM2,chr10,F,102918292,103078587,33436613,160295,175193328,4195,13
54838,WBP1L,chr10,F,102739282,102816265,33513596,76983,175270311,4196,7
54906,FAM208B,chr10,F,5684771,5765779,33594604,81008,175351319,4197,26
55088,CCDC186,chr10,R,114120855,114174605,33648354,53750,175405069,4198,18
55118,CRTAC1,chr10,R,97854710,98030828,33824472,176118,175581187,4199,17
55130,ARMC4,chr10,R,27812163,27999067,34011376,186904,175768091,4200,29
55149,MTPAP,chr10,R,30309800,30349338,34050914,39538,175807629,4201,8
55165,CEP55,chr10,F,93496611,93529094,34083397,32483,175840112,4202,8
55176,SEC61A2,chr10,F,12129640,12169958,34123715,40318,175880430,4203,14
55222,LRRC20,chr10,R,70298969,70382650,34207396,83681,175964111,4204,6
55280,CWF19L1,chr10,R,100232295,100267681,34242782,35386,175999497,4205,13
55301,OLAH,chr10,F,15043895,15073852,34272739,29957,176029454,4206,9
55315,SLC29A3,chr10,F,71319252,71363396,34316883,44144,176073598,4207,5
55328,RNLS,chr10,R,88180642,88583854,34720095,403212,176476810,4208,12
55361,PI4K2A,chr10,F,97640685,97676434,34755844,35749,176512559,4209,8
55388,MCM10,chr10,F,13161553,13211104,34805395,49551,176562110,4210,20
55454,CSGALNACT2,chr10,F,43138444,43185308,34852259,46864,176608974,4211,9
55506,H2AFY2,chr10,F,70052600,70112284,34911943,59684,176668658,4212,8
55526,DHTKD1,chr10,F,12068916,12123228,34966255,54312,176722970,4213,16
55662,HIF1AN,chr10,F,100535883,100553924,34984296,18041,176741011,4214,7
55680,RUFY2,chr10,R,68341106,68407294,35050484,66188,176807199,4215,21
55691,FRMD4A,chr10,R,13643705,14330867,35737646,687162,177494361,4216,35
55717,WDR11,chr10,F,120851174,120909526,35795998,58352,177552713,4217,29
55719,FAM178A,chr10,F,100912568,100965134,35848564,52566,177605279,4218,20
55749,CCAR1,chr10,F,68721143,68792377,35919798,71234,177676513,4219,24
55753,OGDHL,chr10,R,49734640,49762379,35947537,27739,177704252,4220,24
55760,DHX32,chr10,R,125836339,125881315,35992513,44976,177749228,4221,10
55844,PPP2R2D,chr10,F,131900643,131969980,36061850,69337,177818565,4222,14
55847,CISD1,chr10,F,58269101,58289259,36082008,20158,177838723,4223,2
55853,IDI2-AS1,chr10,F,1022636,1044201,36103573,21565,177860288,4224,4
56165,TDRD1,chr10,F,114174441,114232669,36161801,58228,177918516,4225,29
56243,KIAA1217,chr10,F,23694745,24547848,37014904,853103,178771619,4226,28
56288,PARD3,chr10,R,34109559,34815325,37720670,705766,179477385,4227,29
56521,DNAJC12,chr10,R,67796664,67838191,37762197,41527,179518912,4228,5
56624,ASAH2,chr10,R,50182777,50251577,37830997,68800,179587712,4229,21
56647,BCCIP,chr10,F,125823534,125853695,37861158,30161,179617873,4230,8
56652,C10orf2,chr10,F,100987377,100994403,37868184,7026,179624899,4231,4
56681,SAR1A,chr10,R,70150203,70170529,37888510,20326,179645225,4232,7
56889,TM9SF3,chr10,R,96518109,96587052,37957453,68943,179714168,4233,15
56952,PRTFDC1,chr10,R,24812956,24953751,38098248,140795,179854963,4234,13
57089,ENTPD7,chr10,F,99659505,99711245,38149988,51740,179906703,4235,12
57118,CAMK1D,chr10,F,12349516,12835545,38636017,486029,180392732,4236,16
57178,ZMIZ1,chr10,F,79068963,79316528,38883582,247565,180640297,4237,27
57209,ZNF248,chr10,R,37744362,37860851,39000071,116489,180756786,4238,10
57412,AS3MT,chr10,F,102869452,102901899,39032518,32447,180789233,4239,14
57512,GPR158,chr10,F,25174736,25602233,39460015,427497,181216730,4240,10
57559,STAMBPL1,chr10,F,88879367,88923502,39504150,44135,181260865,4241,16
57584,ARHGAP21,chr10,R,24583608,24723668,39644210,140060,181400925,4242,30
57608,KIAA1462,chr10,R,30012799,30115486,39746897,102687,181503612,4243,6
57678,GPAM,chr10,R,112149863,112215395,39812429,65532,181569144,4244,22
57698,KIAA1598,chr10,R,116883376,117126586,40055639,243210,181812354,4245,20
57700,FAM160B1,chr10,F,114821743,114899827,40133723,78084,181890438,4246,17
57705,WDFY4,chr10,F,48684829,48982956,40431850,298127,182188565,4247,68
57713,SFMBT2,chr10,R,7158623,7411486,40684713,252863,182441428,4248,23
57715,SEMA4G,chr10,F,100969481,100985616,40700848,16135,182457563,4249,15
58504,ARHGAP22,chr10,R,48430317,48656265,40926796,225948,182683511,4250,19
58529,MYOZ1,chr10,R,73631611,73641757,40936942,10146,182693657,4251,5
59338,PLEKHA1,chr10,F,122374577,122432355,40994720,57778,182751435,4252,18
60370,AVPI1,chr10,R,97677423,97687258,41004555,9835,182761270,4253,2
60495,HPSE2,chr10,R,98457076,99235875,41783354,778799,183540069,4254,15
63877,FAM204A,chr10,R,118305888,118342327,41819793,36439,183576508,4255,10
64072,CDH23,chr10,F,71396933,71815947,42238807,419014,183995522,4256,78
64077,LHPP,chr10,F,124461771,124614141,42391177,152370,184147892,4257,14
64081,PBLD,chr10,R,68282659,68332928,42441446,50269,184198161,4258,9
64106,NPFFR1,chr10,R,70254956,70283694,42470184,28738,184226899,4259,3
64115,C10orf54,chr10,R,71747555,71773580,42496209,26025,184252924,4260,6
64210,MMS19,chr10,R,97458323,97498794,42536680,40471,184293395,4261,31
64215,DNAJC1,chr10,R,21756547,22003768,42783901,247221,184540616,4262,14
64318,NOC3L,chr10,R,94314906,94362976,42831971,48070,184588686,4263,21
64376,IKZF5,chr10,R,122990805,123008850,42850016,18045,184606731,4264,6
64421,DCLRE1C,chr10,R,14904610,14954432,42899838,49822,184656553,4265,18
64429,ZDHHC6,chr10,R,112425438,112447234,42921634,21796,184678349,4266,14
65217,PCDH15,chr10,R,53802770,54801291,43920155,998521,185676870,4267,39
79004,CUEDC2,chr10,R,102423244,102432666,43929577,9422,185686292,4268,8
79009,DDX50,chr10,F,68898971,68946847,43977453,47876,185734168,4269,15
79176,FBXL15,chr10,F,102419060,102423138,43981531,4078,185738246,4270,4
79290,OR13A1,chr10,R,45302293,45315608,43994846,13315,185751561,4271,4
79591,C10orf76,chr10,R,101845598,102056232,44205480,210634,185962195,4272,30
79723,SUV39H2,chr10,F,14878782,14904315,44231013,25533,185987728,4273,7
79741,CCDC7,chr10,F,32446081,32882864,44667796,436783,186424511,4274,53
79746,ECHDC3,chr10,F,11742356,11764070,44689510,21714,186446225,4275,4
79754,ASB13,chr10,R,5638856,5666595,44717249,27739,186473964,4276,6
79803,HPS6,chr10,F,102065366,102068038,44719921,2672,186476636,4277,0
79812,MMRN2,chr10,R,86935539,86969953,44754335,34414,186511050,4278,7
79847,TMEM180,chr10,F,102461380,102480118,44773073,18738,186529788,4279,12
79861,TUBAL3,chr10,R,5393097,5404830,44784806,11733,186541521,4280,3
79892,MCMBP,chr10,R,119829403,119873628,44829031,44225,186585746,4281,16
79896,THNSL1,chr10,F,25016578,25026664,44839117,10086,186595832,4282,2
79933,SYNPO2L,chr10,R,73644880,73656105,44850342,11225,186607057,4283,6
79946,C10orf95,chr10,R,102449836,102451543,44852049,1707,186608764,4284,1
79949,PLEKHS1,chr10,F,113751261,113782433,44883221,31172,186639936,4285,14
79955,PDZD7,chr10,R,101007682,101031157,44906696,23475,186663411,4286,17
79991,OBFC1,chr10,R,103870257,103918287,44954726,48030,186711441,4287,11
80007,C10orf88,chr10,R,122930902,122954403,44978227,23501,186734942,4288,5
80013,FAM188A,chr10,R,15778168,15860520,45060579,82352,186817294,4289,18
80019,UBTD1,chr10,F,97498881,97571210,45132908,72329,186889623,4290,2
80114,BICC1,chr10,F,58512915,58831437,45451430,318522,187208145,4291,27
80195,TMEM254,chr10,F,80078645,80092557,45465342,13912,187222057,4292,8
80201,HKDC1,chr10,F,69220302,69267559,45512599,47257,187269314,4293,19
80217,CFAP43,chr10,R,104129887,104232366,45615078,102479,187371793,4294,38
80312,TET1,chr10,F,68560359,68694487,45749206,134128,187505921,4295,15
80313,LRRC27,chr10,F,132330062,132381506,45800650,51444,187557365,4296,17
80314,EPC1,chr10,R,32267715,32378798,45911733,111083,187668448,4297,17
80351,TNKS2,chr10,F,91798393,91865475,45978815,67082,187735530,4298,29
80760,ITIH5,chr10,R,7559269,7666998,46086544,107729,187843259,4299,16
81603,TRIM8,chr10,F,102642902,102658319,46101961,15417,187858676,4300,5
81619,TSPAN14,chr10,F,80454277,80522635,46170319,68358,187927034,4301,13
81621,KAZALD1,chr10,F,101061140,101068131,46177310,6991,187934025,4302,5
81855,SFXN3,chr10,F,101031228,101041241,46187323,10013,187944038,4303,10
81894,SLC25A28,chr10,R,99610517,99659339,46236145,48822,187992860,4304,8
83401,ELOVL3,chr10,F,102225357,102229589,46240377,4232,187997092,4305,4
83592,AKR1E2,chr10,F,4824559,4854131,46269949,29572,188026664,4306,13
83641,FAM107B,chr10,R,14518556,14774897,46526290,256341,188283005,4307,17
83643,CCDC3,chr10,R,12896624,13099773,46729439,203149,188486154,4308,7
83742,MARVELD1,chr10,F,97713707,97718152,46733884,4445,188490599,4309,1
83849,SYT15,chr10,F,46578433,46595194,46750645,16761,188507360,4310,9
83860,TAF3,chr10,F,7818476,8016631,46948800,198155,188705515,4311,6
83937,RASSF4,chr10,F,44959749,44994724,46983775,34975,188740490,4312,10
83938,C10orf11,chr10,F,75431457,76557375,48109693,1125918,189866408,4313,10
84108,PCGF6,chr10,R,103302795,103351134,48158032,48339,189914747,4314,9
84159,ARID5B,chr10,F,61901253,62096948,48353727,195695,190110442,4315,10
84171,LOXL4,chr10,R,98247685,98268250,48374292,20565,190131007,4316,15
84287,ZDHHC16,chr10,F,97446130,97457370,48385532,11240,190142247,4317,11
84293,FAM213A,chr10,F,80407828,80432997,48410701,25169,190167416,4318,10
84332,DYDC2,chr10,F,80344744,80368118,48434075,23374,190190790,4319,9
84333,PCGF5,chr10,F,91163011,91284331,48555395,121320,190312110,4320,13
84435,ADGRA1,chr10,F,133070928,133131675,48616142,60747,190372857,4321,18
84445,LZTS2,chr10,F,100997106,101007836,48626872,10730,190383587,4322,7
84457,PHYHIPL,chr10,F,59173370,59247774,48701276,74404,190457991,4323,7
84458,LCOR,chr10,F,96832259,96964441,48833458,132182,190590173,4324,8
84504,NKX6-2,chr10,R,132784815,132786033,48834676,1218,190591391,4325,2
84545,MRPL43,chr10,R,100977821,100987515,48844370,9694,190601085,4326,6
84569,LYZL1,chr10,F,29289050,29318328,48873648,29278,190630363,4327,6
84632,AFAP1L2,chr10,R,114280729,114405143,48998062,124414,190754777,4328,23
84647,PLA2G12B,chr10,R,72935179,72954883,49017766,19704,190774481,4329,3
84665,MYPN,chr10,F,68106116,68212017,49123667,105901,190880382,4330,25
84795,PYROXD2,chr10,R,98383564,98415221,49155324,31657,190912039,4331,18
84833,USMG5,chr10,R,103389049,103396513,49162788,7464,190919503,4332,5
84856,LINC00839,chr10,F,42475490,42495337,49182635,19847,190939350,4333,4
84858,ZNF503,chr10,R,75279725,75401894,49304804,122169,191061519,4334,4
84883,AIFM2,chr10,R,70112266,70132934,49325472,20668,191082187,4335,8
84890,ADO,chr10,F,62804755,62808479,49329196,3724,191085911,4336,0
84893,FBXO18,chr10,F,5889571,5937595,49377220,48024,191133935,4337,25
84896,ATAD1,chr10,R,87751850,87841349,49466719,89499,191223434,4338,15
84898,PLXDC2,chr10,F,19816226,20289856,49940349,473630,191697064,4339,14
84930,MASTL,chr10,F,27154823,27186920,49972446,32097,191729161,4340,13
84986,ARHGAP19,chr10,R,97222172,97292673,50042947,70501,191799662,4341,12
84989,JMJD1C-AS1,chr10,F,63465228,63466563,50044282,1335,191800997,4342,0
84991,RBM17,chr10,F,6088985,6117459,50072756,28474,191829471,4343,12
85442,KNDC1,chr10,F,133160466,133226412,50138702,65946,191895417,4344,29
85450,ITPRIP,chr10,R,104309695,104338493,50167500,28798,191924215,4345,5
90271,OLMALINC,chr10,F,100373575,100388354,50182279,14779,191938994,4346,2
90550,MCU,chr10,F,72692130,72887694,50377843,195564,192134558,4347,11
91074,ANKRD30A,chr10,F,37125741,37235831,50487933,110090,192244648,4348,45
91452,ACBD5,chr10,R,27195213,27242139,50534859,46926,192291574,4349,13
91734,IDI2,chr10,R,1018906,1025859,50541812,6953,192298527,4350,4
92170,MTG1,chr10,F,133394116,133420670,50568366,26554,192325081,4351,10
92211,CDHR1,chr10,F,84194634,84219621,50593353,24987,192350068,4352,18
92482,BBIP1,chr10,R,110898729,110919366,50613990,20637,192370705,4353,5
92565,FANK1,chr10,F,125896223,126009592,50727359,113369,192484074,4354,20
93377,OPALIN,chr10,R,96343215,96359365,50743509,16150,192500224,4355,7
93426,SYCE1,chr10,R,133553899,133568291,50757901,14392,192514616,4356,14
93550,ZFAND4,chr10,R,45614566,45672962,50816297,58396,192573012,4357,16
94134,ARHGAP12,chr10,R,31805397,31928876,50939776,123479,192696491,4358,19
94233,OPN4,chr10,F,86654556,86666460,50951680,11904,192708395,4359,10
112817,HOGA1,chr10,F,97584344,97612802,50980138,28458,192736853,4360,6
114131,UCN3,chr10,F,5365012,5374206,50989332,9194,192746047,4361,1
114815,SORCS1,chr10,R,106573662,107181126,51596796,607464,193353511,4362,32
118461,C10orf71,chr10,F,49297055,49327492,51627233,30437,193383948,4363,4
118471,PRAP1,chr10,F,133347339,133352683,51632577,5344,193389292,4364,4
118472,ZNF511,chr10,F,133308888,133313162,51636851,4274,193393566,4365,5
118487,CHCHD1,chr10,F,73782049,73783648,51638450,1599,193395165,4366,2
118490,MSS51,chr10,R,73423578,73433561,51648433,9983,193405148,4367,6
118491,CFAP70,chr10,R,73253757,73361064,51755740,107307,193512455,4368,29
118611,C10orf90,chr10,R,126424996,126671038,52001782,246042,193758497,4369,26
118663,BTBD16,chr10,F,122270827,122338161,52069116,67334,193825831,4370,16
118670,FAM24A,chr10,F,122910700,122913111,52071527,2411,193828242,4371,2
118672,PSTK,chr10,F,122954234,122997519,52114812,43285,193871527,4372,8
118738,ZNF488,chr10,R,47365495,47384333,52133650,18838,193890365,4373,7
118788,PIK3AP1,chr10,R,96593311,96720522,52260861,127211,194017576,4374,18
118812,MORN4,chr10,R,97614552,97634156,52280465,19604,194037180,4375,6
118813,ZFYVE27,chr10,F,97737120,97760907,52304252,23787,194060967,4376,14
118856,MMP21,chr10,R,125764938,125785224,52324538,20286,194081253,4377,7
118881,COMTD1,chr10,R,75233970,75236057,52326625,2087,194083340,4378,6
118924,FRA10AC1,chr10,R,93667882,93702572,52361315,34690,194118030,4379,16
118932,ANKRD22,chr10,R,88819898,88851975,52393392,32077,194150107,4380,5
118980,SFXN2,chr10,F,102714507,102739189,52418074,24682,194174789,4381,16
118987,PDZD8,chr10,R,117280488,117375467,52513053,94979,194269768,4382,7
119016,AGAP4,chr10,R,45825591,45853877,52541339,28286,194298054,4383,12
119032,C10orf32,chr10,F,102854209,102864961,52552091,10752,194308806,4384,4
119180,LYZL2,chr10,R,30606231,30629762,52575622,23531,194332337,4385,7
119369,NUDT9P1,chr10,R,91151994,91153083,52576711,1089,194333426,4386,0
119385,AGAP11,chr10,F,86970740,87010203,52616174,39463,194372889,4387,11
119391,GSTO2,chr10,F,104268415,104304948,52652707,36533,194409422,4388,8
119392,SFR1,chr10,F,104122057,104126385,52657035,4328,194413750,4389,4
119395,CALHM3,chr10,R,103472803,103479240,52663472,6437,194420187,4390,2
119437,CTAGE7P,chr10,F,130106008,130108838,52666302,2830,194423017,4391,0
119467,CLRN3,chr10,R,127877840,127892947,52681409,15107,194438124,4392,2
119504,ANAPC16,chr10,F,72215999,72235860,52701270,19861,194457985,4393,4
119548,PNLIPRP3,chr10,F,116427878,116477961,52751353,50083,194508068,4394,14
119559,SFXN4,chr10,R,119140912,119165709,52776150,24797,194532865,4395,14
119587,CPXM2,chr10,R,123722290,123891984,52945844,169694,194702559,4396,18
140766,ADAMTS14,chr10,F,70672538,70762441,53035747,89903,194792462,4397,24
142827,ACSM6,chr10,F,95194199,95228929,53070477,34730,194827192,4398,11
142891,SAMD8,chr10,F,75099591,75182123,53153009,82532,194909724,4399,5
142910,LIPJ,chr10,F,88583276,88606976,53176709,23700,194933424,4400,14
142913,CFL1P1,chr10,F,87818312,87845612,53204009,27300,194960724,4401,3
142940,TRUB1,chr10,F,114938192,114977680,53243497,39488,195000212,4402,8
143098,MPP7,chr10,R,28050992,28303061,53495566,252069,195252281,4403,25
143162,FRMPD2,chr10,R,48150000,48274898,53620464,124898,195377179,4404,32
143187,VTI1A,chr10,F,112446997,112855364,54028831,408367,195785546,4405,14
143241,DYDC1,chr10,R,80336101,80356787,54049517,20686,195806232,4406,7
143244,EIF5AL1,chr10,F,79512600,79516440,54053357,3840,195810072,4407,0
143279,HECTD2,chr10,F,91409279,91514829,54158907,105550,195915622,4408,24
143282,FGFBP3,chr10,R,91906587,91909501,54161821,2914,195918536,4409,1
143379,C10orf82,chr10,R,116662210,116670269,54169880,8059,195926595,4410,8
143384,CACUL1,chr10,R,118672992,118755246,54252134,82254,196008849,4411,10
158160,HSD17B7P2,chr10,F,38356379,38378505,54274260,22126,196030975,4412,7
159195,USP54,chr10,R,73497537,73591342,54368065,93805,196124780,4413,23
159296,NKX2-3,chr10,F,99532932,99536524,54371657,3592,196128372,4414,2
159371,SLC35G1,chr10,F,93893972,93914255,54391940,20283,196148655,4415,6
159686,CFAP58,chr10,F,104338557,104455090,54508473,116533,196265188,4416,21
170370,FAM170B,chr10,R,49131153,49134020,54511340,2867,196268055,4417,1
170371,C10orf128,chr10,R,49154723,49188585,54545202,33862,196301917,4418,7
170384,FUT11,chr10,F,73772174,73779075,54552103,6901,196308818,4419,3
170392,OIT3,chr10,F,72893555,72933036,54591584,39481,196348299,4420,8
170393,C10orf91,chr10,F,132445209,132448321,54594696,3112,196351411,4421,2
170394,PWWP2B,chr10,F,132397196,132417863,54615363,20667,196372078,4422,4
170425,LINC00858,chr10,F,84279979,84294659,54630043,14680,196386758,4423,5
195977,ANTXRL,chr10,F,46286996,46330419,54673466,43423,196430181,4424,27
196047,EMX2OS,chr10,R,117484292,117545068,54734242,60776,196490957,4425,3
196051,PPAPDC1A,chr10,F,120456953,120589855,54867144,132902,196623859,4426,10
196740,VSTM4,chr10,R,49014244,49129144,54982044,114900,196738759,4427,12
196743,PAOX,chr10,F,133379236,133391696,54994504,12460,196751219,4428,7
196792,FAM24B,chr10,R,122849093,122879641,55025052,30548,196781767,4429,3
207107,SFTA1P,chr10,R,10784438,10794914,55035528,10476,196792243,4430,3
219347,TMEM254-AS1,chr10,R,80046232,80079193,55068489,32961,196825204,4431,5
219348,PLAC9,chr10,F,80132501,80145028,55081016,12527,196837731,4432,3
219621,C10orf107,chr10,F,61662951,61766766,55184831,103815,196941546,4433,9
219623,TMEM26,chr10,R,61406641,61453450,55231640,46809,196988355,4434,7
219654,ZCCHC24,chr10,R,79382324,79445627,55294943,63303,197051658,4435,4
219670,ENKUR,chr10,R,24981978,25062279,55375244,80301,197131959,4436,8
219681,ARMC3,chr10,F,22928023,23038523,55485744,110500,197242459,4437,21
219699,UNC5B,chr10,F,71212534,71302879,55576089,90345,197332804,4438,18
219731,PROSER2-AS1,chr10,R,11849607,11894710,55621192,45103,197377907,4439,5
219736,STOX1,chr10,F,68827536,68895453,55689109,67917,197445824,4440,5
219738,C10orf35,chr10,F,69630242,69633599,55692466,3357,197449181,4441,4
219743,TYSND1,chr10,R,70137980,70146740,55701226,8760,197457941,4442,4
219749,ZNF25,chr10,R,37949571,37976980,55728635,27409,197485350,4443,9
219770,GJD4,chr10,F,35605409,35608935,55732161,3526,197488876,4444,1
219771,CCNY,chr10,F,35246980,35572670,56057851,325690,197814566,4445,22
219790,RTKN2,chr10,R,62183034,62268863,56143680,85829,197900395,4446,16
219793,TBATA,chr10,R,70771237,70785401,56157844,14164,197914559,4447,16
220202,ATOH7,chr10,R,68230594,68232113,56159363,1519,197916078,4448,0
220213,OTUD1,chr10,F,23439268,23442381,56162476,3113,197919191,4449,0
220906,WAC-AS1,chr10,R,28519916,28532354,56174914,12438,197931629,4450,2
220929,ZNF438,chr10,R,30844633,31032407,56362688,187774,198119403,4451,14
220930,ZEB1-AS1,chr10,R,31316527,31319095,56365256,2568,198121971,4452,1
220963,SLC16A9,chr10,R,59650763,59709891,56424384,59128,198181099,4453,6
220965,FAM13C,chr10,R,59246128,59363181,56541437,117053,198298152,4454,16
220972,MARCH8,chr10,R,45454584,45594906,56681759,140322,198438474,4455,14
220979,C10orf25,chr10,R,44993931,45000910,56688738,6979,198445453,4456,2
220980,TMEM72-AS1,chr10,R,44811023,44959689,56837404,148666,198594119,4457,7
220992,ZNF485,chr10,F,43606406,43617904,56848902,11498,198605617,4458,4
221002,RASGEF1A,chr10,R,43194532,43266919,56921289,72387,198678004,4459,15
221035,REEP3,chr10,F,63521352,63625123,57025060,103771,198781775,4460,8
221037,JMJD1C,chr10,R,63167220,63466001,57323841,298781,199080556,4461,27
221044,UCMA,chr10,R,13221765,13234328,57336404,12563,199093119,4462,4
221060,C10orf111,chr10,R,15095384,15097319,57338339,1935,199095054,4463,1
221061,FAM171A1,chr10,R,15211642,15371059,57497756,159417,199254471,4464,8
221074,SLC39A12,chr10,F,17951838,18043292,57589210,91454,199345925,4465,12
221078,NSUN6,chr10,R,18545206,18659309,57703313,114103,199460028,4466,14
221079,ARL5B,chr10,F,18659334,18681639,57725618,22305,199482333,4467,6
222389,BEND7,chr10,R,13438483,13528597,57815732,90114,199572447,4468,12
253264,ZNF503-AS1,chr10,F,75296382,75361678,57881028,65296,199637743,4469,3
253430,IPMK,chr10,R,58191516,58267937,57957449,76421,199714164,4470,5
253725,FAM21C,chr10,F,45727199,45792964,58023214,65765,199779929,4471,31
253738,EBF3,chr10,R,129835231,129964281,58152264,129050,199908979,4472,19
254312,LINC00710,chr10,R,10934939,10952163,58169488,17224,199926203,4473,5
254427,PROSER2,chr10,F,11823348,11872277,58218417,48929,199975132,4474,5
255022,CALHM1,chr10,R,103453386,103458891,58223922,5505,199980637,4475,1
255082,CASC2,chr10,F,118046820,118210153,58387255,163333,200143970,4476,5
256297,PTF1A,chr10,F,23192530,23194252,58388977,1722,200145692,4477,1
256536,TCERG1L,chr10,R,131092390,131311721,58608308,219331,200365023,4478,13
256815,C10orf67,chr10,R,23202850,23345216,58750674,142366,200507389,4479,23
259217,HSPA12A,chr10,R,116671191,116850814,58930297,179623,200687012,4480,16
259230,SGMS1,chr10,R,50305584,50623977,59248690,318393,201005405,4481,14
266971,PIPSL,chr10,R,93958139,93961915,59252466,3776,201009181,4482,0
267004,PGBD3,chr10,R,49515104,49524281,59261643,9177,201018358,4483,1
282966,C10orf53,chr10,F,49679637,49708910,59290916,29273,201047631,4484,3
282969,FUOM,chr10,R,133352774,133358025,59296167,5251,201052882,4485,6
282973,JAKMIP3,chr10,F,132036106,132184809,59444870,148703,201201585,4486,27
282974,STK32C,chr10,R,132207488,132332256,59569638,124768,201326353,4487,17
282980,LINC00700,chr10,R,2005472,2014348,59578514,8876,201335229,4488,2
282991,BLOC1S2,chr10,R,100273277,100286712,59591949,13435,201348664,4489,5
282996,RBM20,chr10,F,110644396,110839471,59787024,195075,201543739,4490,14
282997,PDCD4-AS1,chr10,R,110868889,110870904,59789039,2015,201545754,4491,0
283011,FLJ37201,chr10,R,89691299,89697928,59795668,6629,201552383,4492,1
283025,LINC01553,chr10,R,59958216,59960913,59798365,2697,201555080,4493,1
283028,LOC283028,chr10,R,42752907,42755383,59800841,2476,201557556,4494,1
283033,LINC00841,chr10,F,43909303,43969907,59861445,60604,201618160,4495,7
283038,LOC283038,chr10,F,125683242,125709677,59887880,26435,201644595,4496,4
283045,LOC283045,chr10,R,62339587,62375127,59923420,35540,201680135,4497,3
283050,ZMIZ1-AS1,chr10,R,78943325,79067448,60047543,124123,201804258,4498,9
283078,MKX,chr10,R,27672873,27745849,60120519,72976,201877234,4499,8
283080,C10orf126,chr10,F,28846407,28881898,60156010,35491,201912725,4500,6
283089,WDR11-AS1,chr10,R,120761811,120851179,60245378,89368,202002093,4501,2
285961,SEPT7P9,chr10,R,38383068,38402852,60265162,19784,202021877,4502,3
317662,FAM149B1,chr10,F,73168094,73242181,60339249,74087,202095964,4503,15
338557,FFAR4,chr10,F,93566203,93590072,60363118,23869,202119833,4504,3
338567,KCNK18,chr10,F,117197488,117210299,60375929,12811,202132644,4505,2
338579,ANKRD30BP3,chr10,F,45154661,45186041,60407309,31380,202164024,4506,7
338588,LINC00705,chr10,F,4656155,4662419,60413573,6264,202170288,4507,2
338596,ST8SIA6,chr10,R,17315413,17455510,60553670,140097,202310385,4508,9
338599,DUPD1,chr10,R,75037471,75073632,60589831,36161,202346546,4509,4
340654,LIPM,chr10,F,88802729,88822022,60609124,19293,202365839,4510,10
340665,CYP26C1,chr10,F,93061263,93068697,60616558,7434,202373273,4511,5
340706,VWA2,chr10,F,114239136,114294500,60671922,55364,202428637,4512,20
340719,NANOS1,chr10,F,119029715,119034342,60676549,4627,202433264,4513,0
340745,LRIT2,chr10,R,84220484,84225589,60681654,5105,202438369,4514,3
340784,HMX3,chr10,F,123136050,123137731,60683335,1681,202440050,4515,1
340811,AKR1C8P,chr10,R,5154459,5185187,60714063,30728,202470778,4516,7
340895,MALRD1,chr10,F,19046930,19734478,61401611,687548,203158326,4517,41
340900,EBLN1,chr10,R,22208813,22209983,61402781,1170,203159496,4518,0
347688,TUBB8,chr10,R,46637,76455,61432599,29818,203189314,4519,7
347731,LRRTM3,chr10,F,66926033,67101551,61608117,175518,203364832,4520,4
374308,PTCHD3,chr10,R,27398187,27414368,61624298,16181,203381013,4521,3
374354,NHLRC2,chr10,F,113854631,113912506,61682173,57875,203438888,4522,11
374355,CCDC172,chr10,F,116324103,116380029,61738099,55926,203494814,4523,11
375940,DMBT1P1,chr10,F,122756693,122797645,61779051,40952,203535766,4524,27
387638,C10orf113,chr10,R,21125762,21146559,61799848,20797,203556563,4525,3
387640,SKIDA1,chr10,R,21510753,21527188,61816283,16435,203572998,4526,8
387642,LINC01552,chr10,R,23203815,23239792,61852260,35977,203608975,4527,3
387644,LINC00202-1,chr10,R,26931205,26942001,61863056,10796,203619771,4528,4
387646,LRRC37A6P,chr10,R,27245852,27252306,61869510,6454,203626225,4529,0
387680,FAM21A,chr10,F,50067887,50133509,61935132,65622,203691847,4530,31
387694,SH2D4B,chr10,F,80537901,80646560,62043791,108659,203800506,4531,7
387695,C10orf99,chr10,F,84173763,84185294,62055322,11531,203812037,4532,2
387700,SLC16A12,chr10,R,89430293,89535556,62160585,105263,203917300,4533,7
387707,CC2D2B,chr10,F,95974028,96035750,62222307,61722,203979022,4534,20
387712,ENO4,chr10,F,116849211,116943974,62317070,94763,204073785,4535,17
387715,ARMS2,chr10,F,122454662,122457352,62319760,2690,204076475,4536,1
387718,TEX36,chr10,R,125576512,125683154,62426402,106642,204183117,4537,7
387720,LOC387720,chr10,R,127734609,127737275,62429068,2666,204185783,4538,0
387723,LINC00959,chr10,R,130063895,130110817,62475990,46922,204232705,4539,7
389932,AKR1C6P,chr10,R,4871666,4916273,62520597,44607,204277312,4540,10
389941,C1QL3,chr10,R,16513742,16522005,62528860,8263,204285575,4541,1
390003,GUCY2GP,chr10,R,112308177,112356595,62577278,48418,204333993,4542,18
390010,NKX1-2,chr10,R,124447428,124449981,62579831,2553,204336546,4543,1
399706,LINC00200,chr10,F,1159767,1164672,62584736,4905,204341451,4544,2
399708,LINC00701,chr10,R,2300318,2315074,62599492,14756,204356207,4545,2
399715,LOC399715,chr10,F,6326543,6335982,62608931,9439,204365646,4546,5
399716,LOC399716,chr10,F,6347182,6352762,62614511,5580,204371226,4547,1
399717,GATA3-AS1,chr10,R,8050449,8053484,62617546,3035,204374261,4548,1
399726,CASC10,chr10,R,21494491,21497284,62620339,2793,204377054,4549,1
399744,LINC00999,chr10,F,38428145,38452153,62644347,24008,204401062,4550,7
399746,ACTR3BP5,chr10,F,38696595,38698241,62645993,1646,204402708,4551,0
399761,BMS1P5,chr10,F,46786732,46811989,62671250,25257,204427965,4552,8
399806,LBX1-AS1,chr10,F,101229593,101238859,62680516,9266,204437231,4553,2
399814,C10orf120,chr10,R,122697708,122699822,62682630,2114,204439345,4554,2
399815,LOC399815,chr10,F,122879632,122898714,62701712,19082,204458427,4555,5
399818,METTL10,chr10,R,124757830,124791941,62735823,34111,204492538,4556,6
399821,FLJ37035,chr10,R,125705289,125719493,62750027,14204,204506742,4557,4
399823,FOXI2,chr10,F,127737273,127741186,62753940,3913,204510655,4558,1
399827,LINC01164,chr10,R,131772397,131790199,62771742,17802,204528457,4559,4
399829,LINC01168,chr10,F,132965533,132976497,62782706,10964,204539421,4560,2
399833,SPRNP1,chr10,R,133566933,133569958,62785731,3025,204542446,4561,1
401647,GOLGA7B,chr10,F,97850237,97871578,62807072,21341,204563787,4562,4
404216,LINC01561,chr10,F,120597948,120600123,62809247,2175,204565962,4563,0
404636,FAM45A,chr10,F,119104064,119137984,62843167,33920,204599882,4564,10
406901,MIR107,chr10,R,89592746,89592827,62843248,81,204599963,4565,0
414149,ACBD7,chr10,R,15075474,15088776,62856550,13302,204613265,4566,3
414152,C10orf105,chr10,R,71711700,71737824,62882674,26124,204639389,4567,5
414157,C10orf62,chr10,F,97589692,97590934,62883916,1242,204640631,4568,0
414189,AGAP6,chr10,F,49973059,50010499,62921356,37440,204678071,4569,12
414194,CCNYL2,chr10,R,42408173,42472240,62985423,64067,204742138,4570,8
414196,CELF2-AS1,chr10,R,11316832,11344674,63013265,27842,204769980,4571,2
414197,ZNF32-AS1,chr10,F,43643871,43645047,63014441,1176,204771156,4572,1
414201,ZNF32-AS3,chr10,F,43628816,43674699,63060324,45883,204817039,4573,4
414208,ZNF32-AS2,chr10,F,43645941,43648019,63062402,2078,204819117,4574,2
414212,GLUD1P7,chr10,R,46759022,46786770,63090150,27748,204846865,4575,5
414224,CTGLF12P,chr10,R,48010131,48031640,63111659,21509,204868374,4576,7
414235,PRR26,chr10,F,649947,665169,63126881,15222,204883596,4577,3
414236,C10orf55,chr10,R,73909968,73922777,63139690,12809,204896405,4578,4
414241,FAM35BP,chr10,R,46610471,46651976,63181195,41505,204937910,4579,6
414243,LINC00595,chr10,F,78267327,78280213,63194081,12886,204950796,4580,2
414245,DNAJC9-AS1,chr10,F,73247366,73276984,63223699,29618,204980414,4581,3
414260,LINC00619,chr10,F,43845305,43850622,63229016,5317,204985731,4582,2
439949,PRKCQ-AS1,chr10,F,6580424,6585361,63233953,4937,204990668,4583,2
439950,CELF2-AS2,chr10,R,11071540,11105488,63267901,33948,205024616,4584,6
439965,FAM35DP,chr10,F,47689699,47731218,63309420,41519,205066135,4585,6
439990,LINC00857,chr10,F,80207709,80219657,63321368,11948,205078083,4586,1
439994,LOC439994,chr10,F,87342410,87343574,63322532,1164,205079247,4587,0
439996,IFIT1B,chr10,F,89378055,89385205,63329682,7150,205086397,4588,1
441549,CDNF,chr10,R,14819244,14838098,63348536,18854,205105251,4589,3
441581,FRG2B,chr10,R,133624795,133627886,63351627,3091,205108342,4590,4
441666,LOC441666,chr10,R,42331865,42368045,63387807,36180,205144522,4591,2
442911,MIR346,chr10,R,86264693,86264788,63387902,95,205144617,4592,0
474354,LRRC18,chr10,R,48883695,48940126,63444333,56431,205201048,4593,8
503542,SPRN,chr10,R,133420665,133424617,63448285,3952,205205000,4594,1
574445,MIR511,chr10,F,17845106,17845193,63448372,87,205205087,4595,0
574447,MIR146B,chr10,F,102436511,102436584,63448445,73,205205160,4596,0
574448,MIR202,chr10,R,133247510,133247620,63448555,110,205205270,4597,0
594857,NPS,chr10,F,127549348,127552671,63451878,3323,205208593,4598,2
619207,SCART1,chr10,F,133453927,133468445,63466396,14518,205223111,4599,9
641451,SNORA19,chr10,R,119060010,119060138,63466524,128,205223239,4600,0
642361,LOC642361,chr10,F,79825901,79827602,63468225,1701,205224940,4601,0
642394,ADARB2-AS1,chr10,F,1526629,1556984,63498580,30355,205255295,4602,1
642422,LOC642422,chr10,R,1339879,1341755,63500456,1876,205257171,4603,0
642517,AGAP9,chr10,R,47501853,47523638,63522241,21785,205278956,4604,7
642819,ZNF487,chr10,F,43437125,43482559,63567675,45434,205324390,4605,3
642826,BMS1P6,chr10,R,47535573,47553523,63585625,17950,205342340,4606,8
642934,LOC642934,chr10,R,84167227,84172188,63590586,4961,205347301,4607,1
642938,FAM196A,chr10,R,127135425,127196216,63651377,60791,205408092,4608,6
643161,FAM25A,chr10,F,87020288,87024730,63655819,4442,205412534,4609,2
643236,TMEM72,chr10,F,44911307,44937010,63681522,25703,205438237,4610,6
643414,LIPK,chr10,F,88706233,88753092,63728381,46859,205485096,4611,15
643418,LIPN,chr10,F,88757225,88778891,63750047,21666,205506762,4612,11
643529,LINC00865,chr10,F,89829492,89840861,63761416,11369,205518131,4613,3
643650,LINC00842,chr10,F,46398361,46453306,63816361,54945,205573076,4614,3
644054,FAM25C,chr10,R,47995321,47999791,63820831,4470,205577546,4615,2
644168,DRGX,chr10,R,49364065,49396016,63852782,31951,205609497,4616,8
644215,LOC644215,chr10,R,97401236,97426151,63877697,24915,205634412,4617,6
644511,RPL13AP6,chr10,R,110936602,110937255,63878350,653,205635065,4618,0
644890,MEIG1,chr10,F,14954227,14972857,63896980,18630,205653695,4619,3
645528,LINC00264,chr10,F,26589864,26594324,63901440,4460,205658155,4620,3
645954,SVILP1,chr10,F,30692273,30717013,63926180,24740,205682895,4621,9
646034,LOC646034,chr10,F,31602569,31607714,63931325,5145,205688040,4622,4
650623,BEND3P3,chr10,F,79682974,79688897,63937248,5923,205693963,4623,0
653145,ANXA8,chr10,R,47467992,47993768,64463024,525776,206219739,4624,20
653268,AGAP7P,chr10,F,46109494,46131678,64485208,22184,206241923,4625,6
653308,ASAH2B,chr10,F,50739898,50757188,64502498,17290,206259213,4626,5
653509,SFTPA1,chr10,F,79610938,79615443,64507003,4505,206263718,4627,7
653567,TMEM236,chr10,F,17752209,17800887,64555681,48678,206312396,4628,7
677800,SNORA12,chr10,R,100237155,100237302,64555828,147,206312543,4629,0
692211,SNORD98,chr10,F,68755171,68755238,64555895,67,206312610,4630,0
693188,MIR603,chr10,F,24275684,24275781,64555992,97,206312707,4631,0
693189,MIR604,chr10,R,29545003,29545097,64556086,94,206312801,4632,0
693190,MIR605,chr10,F,51299572,51299655,64556169,83,206312884,4633,0
693191,MIR606,chr10,F,75552457,75552553,64556265,96,206312980,4634,0
693192,MIR607,chr10,R,96828668,96828764,64556361,96,206313076,4635,0
693193,MIR608,chr10,F,100974984,100975084,64556461,100,206313176,4636,0
693194,MIR609,chr10,R,104218788,104218883,64556556,95,206313271,4637,0
728113,ANXA8L1,chr10,F,46375589,46391784,64572751,16195,206329466,4638,11
728118,NUTM2A,chr10,F,87223040,87235907,64585618,12867,206342333,4639,7
728130,NUTM2D,chr10,F,87357719,87370695,64598594,12976,206355309,4640,6
728158,LOC728158,chr10,F,126423111,126433986,64609469,10875,206366184,4641,1
728190,NUTM2A-AS1,chr10,R,87238666,87342558,64713361,103892,206470076,4642,5
728218,LINC00864,chr10,R,87396573,87407700,64724488,11127,206481203,4643,2
728327,LOC728327,chr10,F,128912829,128916286,64727945,3457,206484660,4644,2
728407,PARGP1,chr10,R,45854834,45972428,64845539,117594,206602254,4645,12
728558,ENTPD1-AS1,chr10,R,95753205,96090235,65182569,337030,206939284,4646,5
728640,FAM133CP,chr10,F,58715014,58717534,65185089,2520,206941804,4647,0
728643,HNRNPA1P33,chr10,F,46415914,46416456,65185631,542,206942346,4648,0
728658,RPL13AP5,chr10,F,96750265,96750923,65186289,658,206943004,4649,0
728798,FRMPD2B,chr10,F,46876673,46895326,65204942,18653,206961657,4650,5
728978,UNC5B-AS1,chr10,R,71217223,71218228,65205947,1005,206962662,4651,1
729020,RPEL1,chr10,F,103245886,103248016,65208077,2130,206964792,4652,0
729047,LOC729047,chr10,R,50737566,50740317,65210828,2751,206967543,4653,0
729092,AGAP5,chr10,R,73674274,73697796,65234350,23522,206991065,4654,7
729096,BMS1P4,chr10,R,73699150,73730514,65265714,31364,207022429,4655,11
729238,SFTPA2,chr10,R,79555851,79560459,65270322,4608,207027037,4656,5
729262,NUTM2B,chr10,F,79699699,79715486,65286109,15787,207042824,4657,8
729668,GOLGA2P6,chr10,R,30364326,30371907,65293690,7581,207050405,4658,11
729815,LOC729815,chr10,R,79503399,79512577,65302868,9178,207059583,4659,2
731789,LINC00202-2,chr10,F,26643107,26653454,65313215,10347,207069930,4660,4
100038246,TLX1NB,chr10,R,101089320,101141266,65365161,51946,207121876,4661,4
100126326,MIR936,chr10,R,104048088,104048186,65365259,98,207121974,4662,0
100126327,MIR938,chr10,R,29602263,29602346,65365342,83,207122057,4663,0
100127889,C10orf131,chr10,F,95907964,95938658,65396036,30694,207152751,4664,7
100128054,PLCE1-AS1,chr10,R,94279289,94287070,65403817,7781,207160532,4665,3
100128098,ST8SIA6-AS1,chr10,F,17386935,17408286,65425168,21351,207181883,4666,2
100128127,ADGRA1-AS1,chr10,R,133085243,133086697,65426622,1454,207183337,4667,2
100128292,DLG5-AS1,chr10,F,77926811,77929825,65429636,3014,207186351,4668,0
100128511,NEBL-AS1,chr10,F,21173989,21174923,65430570,934,207187285,4669,2
100128811,GPR158-AS1,chr10,R,25158071,25176276,65448775,18205,207205490,4670,1
100129055,LOC100129055,chr10,F,38175670,38214345,65487450,38675,207244165,4671,6
100129213,SLC39A12-AS1,chr10,R,18001785,18010562,65496227,8777,207252942,4672,4
100129482,ZNF37BP,chr10,R,42513509,42552870,65535588,39361,207292303,4673,7
100130539,LOC100130539,chr10,F,44292749,44294649,65537488,1900,207294203,4674,2
100130698,LOC100130698,chr10,F,80247750,80255408,65545146,7658,207301861,4675,2
100130887,ATE1-AS1,chr10,F,121928311,121951965,65568800,23654,207325515,4676,1
100130992,LOC100130992,chr10,F,22252071,22258548,65575277,6477,207331992,4677,0
100131132,LOC100131132,chr10,F,77866901,77871535,65579911,4634,207336626,4678,2
100131213,ZNF503-AS2,chr10,F,75401527,75408982,65587366,7455,207344081,4679,4
100132116,ACTA2-AS1,chr10,F,88932683,88939974,65594657,7291,207351372,4680,4
100132159,CALML3-AS1,chr10,R,5514243,5526246,65606660,12003,207363375,4681,3
100132929,FAM25BP,chr10,F,46369086,46373563,65611137,4477,207367852,4682,2
100132987,LINC00856,chr10,F,78248624,78252645,65615158,4021,207371873,4683,1
100133093,FAM25G,chr10,R,47487235,47491700,65619623,4465,207376338,4684,2
100133308,RSU1P2,chr10,R,45099475,45154596,65674744,55121,207431459,4685,8
100144748,KLLN,chr10,R,87859160,87863437,65679021,4277,207435736,4686,0
100169752,TEX36-AS1,chr10,F,125574370,125578445,65683096,4075,207439811,4687,4
100188947,HECTD2-AS1,chr10,R,91306961,91611460,65987595,304499,207744310,4688,4
100188954,DNMBP-AS1,chr10,F,99927208,99958998,66019385,31790,207776100,4689,4
100189083,TRN-GTT2-3,chr10,R,22229508,22229582,66019459,74,207776174,4690,0
100189279,TRS-TGA1-1,chr10,F,67764502,67764584,66019541,82,207776256,4691,0
100189342,TRV-TAC3-1,chr10,R,5853710,5853783,66019614,73,207776329,4692,0
100192204,PPIAP30,chr10,R,15154721,15155347,66020240,626,207776955,4693,0
100216001,LINC00704,chr10,R,4650184,4678070,66048126,27886,207804841,4694,3
100287932,TIMM23,chr10,F,45972452,46003742,66079416,31290,207836131,4695,9
100288485,MTRNR2L7,chr10,R,37601437,37602931,66080910,1494,207837625,4696,0
100288974,LOC100288974,chr10,F,79904897,79931801,66107814,26904,207864529,4697,5
100289509,KCNIP2-AS1,chr10,F,101819067,101828889,66117636,9822,207874351,4698,2
100302116,MIR1265,chr10,F,14436575,14436661,66117722,86,207874437,4699,0
100302129,MIR1915,chr10,R,21496561,21496641,66117802,80,207874517,4700,0
100302133,MIR1287,chr10,R,98395217,98395307,66117892,90,207874607,4701,0
100302150,MIR1296,chr10,R,63372956,63373048,66117984,92,207874699,4702,0
100302174,MIR1307,chr10,R,103394252,103394401,66118133,149,207874848,4703,0
100302192,MIR548F1,chr10,R,54607873,54607957,66118217,84,207874932,4704,0
100302224,MIR2110,chr10,R,114174104,114174179,66118292,75,207875007,4705,0
100302273,MIR1254-1,chr10,F,68759317,68759414,66118389,97,207875104,4706,0
100302740,FAS-AS1,chr10,R,88991421,88992975,66119943,1554,207876658,4707,0
100302741,RNU6-15P,chr10,F,21321960,21322067,66120050,107,207876765,4708,0
100313841,MIR548Q,chr10,R,12725253,12725353,66120150,100,207876865,4709,0
100313921,MIR548E,chr10,F,110988925,110989013,66120238,88,207876953,4710,0
100419868,ZNF33BP1,chr10,R,37793937,37795175,66121476,1238,207878191,4711,0
100421577,FAM21EP,chr10,R,50021181,50067803,66168098,46622,207924813,4712,6
100422843,MIR4293,chr10,R,14383199,14383277,66168176,78,207924891,4713,0
100422867,MIR378C,chr10,R,130962587,130962668,66168257,81,207924972,4714,0
100422873,MIR4297,chr10,R,129843298,129843374,66168333,76,207925048,4715,0
100422892,MIR3157,chr10,R,96064314,96064399,66168418,85,207925133,4716,0
100422895,MIR4294,chr10,R,48985511,48985587,66168494,76,207925209,4717,0
100422900,MIR3158-1,chr10,F,101601416,101601497,66168575,81,207925290,4718,0
100422909,MIR4295,chr10,F,112634169,112634254,66168660,85,207925375,4719,0
100422988,MIR3156-1,chr10,F,45164013,45164088,66168735,75,207925450,4720,0
100422989,MIR3155A,chr10,F,6152195,6152277,66168817,82,207925532,4721,0
100423033,MIR3158-2,chr10,R,101601416,101601497,66168898,81,207925613,4722,0
100423041,MIR4296,chr10,R,125032782,125032870,66168986,88,207925701,4723,0
100463289,MTRNR2L5,chr10,F,55598989,55600728,66170725,1739,207927440,4724,0
100499489,LOC100499489,chr10,R,22435424,22437929,66173230,2505,207929945,4725,0
100500834,MIR3924,chr10,R,57304478,57304559,66173311,81,207930026,4726,0
100500866,MIR3941,chr10,F,122416964,122417067,66173414,103,207930129,4727,0
100500890,MIR3611,chr10,R,35079597,35079680,66173497,83,207930212,4728,0
100500893,MIR3663,chr10,R,117167677,117167774,66173594,97,207930309,4729,0
100500911,MIR3944,chr10,R,133371555,133371663,66173702,108,207930417,4730,0
100505502,LOC100505502,chr10,R,31362777,31364077,66175002,1300,207931717,4731,0
100505540,SLIT1-AS1,chr10,F,97102755,97103747,66175994,992,207932709,4732,2
100505561,LINC00866,chr10,R,97828477,97849798,66197315,21321,207954030,4733,2
100505583,LINC00838,chr10,R,33759712,33772680,66210283,12968,207966998,4734,2
100505601,PARD3-AS1,chr10,F,34815767,34816422,66210938,655,207967653,4735,1
100505761,RPARP-AS1,chr10,F,102449816,102456293,66217415,6477,207974130,4736,4
100505839,SH3PXD2A-AS1,chr10,F,103746778,103755409,66226046,8631,207982761,4737,2
100505869,CFAP58-AS1,chr10,R,104351300,104353575,66228321,2275,207985036,4738,1
100505890,SORCS3-AS1,chr10,R,104664607,104666216,66229930,1609,207986645,4739,1
100505933,ADD3-AS1,chr10,R,109945558,110008381,66292753,62823,208049468,4740,4
100506126,LINC00867,chr10,F,118357107,118359203,66294849,2096,208051564,4741,2
100506733,FAM170B-AS1,chr10,F,49121838,49151547,66324558,29709,208081273,4742,5
100506769,C10orf71-AS1,chr10,R,49296282,49298893,66327169,2611,208083884,4743,1
100506835,LINC00840,chr10,F,43859410,43895433,66363192,36023,208119907,4744,4
100506939,PRKG1-AS1,chr10,R,52296847,52314128,66380473,17281,208137188,4745,5
100507008,LINC00844,chr10,F,58999517,59001617,66382573,2100,208139288,4746,1
100507027,MRLN,chr10,R,59736989,59753471,66399055,16482,208155770,4747,3
100507034,PITRM1-AS1,chr10,F,3141600,3148629,66406084,7029,208162799,4748,3
100507058,LINC00845,chr10,F,61016274,61026417,66416227,10143,208172942,4749,1
100507059,LINC00703,chr10,F,4384245,4410612,66442594,26367,208199309,4750,3
100507127,LINC00707,chr10,F,6779597,6842906,66505903,63309,208262618,4751,4
100507143,LINC00708,chr10,R,8259330,8268305,66514878,8975,208271593,4752,4
100507163,LINC00709,chr10,F,9275612,9287057,66526323,11445,208283038,4753,1
100507331,ZSWIM8-AS1,chr10,R,73796513,73801399,66531209,4886,208287924,4754,3
100507347,VIM-AS1,chr10,R,17214238,17229985,66546956,15747,208303671,4755,4
100507470,GRID1-AS1,chr10,F,85577730,85607215,66576441,29485,208333156,4756,2
100507605,LINC00837,chr10,R,28789310,28796050,66583181,6740,208339896,4757,2
100507633,TNKS2-AS1,chr10,R,91782838,91798291,66598634,15453,208355349,4758,2
100507674,MARK2P9,chr10,F,92418660,92419606,66599580,946,208356295,4759,0
100528007,C10orf32-ASMT,chr10,F,102854209,102901899,66647270,47690,208403985,4760,14
100532731,COMMD3-BMI1,chr10,F,22316382,22331485,66662373,15103,208419088,4761,13
100533184,ARHGAP19-SLIT1,chr10,R,97153041,97292673,66802005,139632,208558720,4762,12
100533195,FAM24B-CUZD1,chr10,R,122832154,122879641,66849492,47487,208606207,4763,3
100616113,MIR4680,chr10,F,110898089,110898155,66849558,66,208606273,4764,0
100616128,MIR4679-1,chr10,F,89063335,89063410,66849633,75,208606348,4765,0
100616151,MIR4480,chr10,F,12578752,12578823,66849704,71,208606419,4766,0
100616162,MIR4483,chr10,R,113777992,113778054,66849766,62,208606481,4767,0
100616192,MIR4679-2,chr10,R,89063334,89063411,66849843,77,208606558,4768,0
100616217,MIR1254-2,chr10,F,23393404,23393467,66849906,63,208606621,4769,0
100616286,MIR4676,chr10,F,72721028,72721100,66849978,72,208606693,4770,0
100616296,MIR4678,chr10,F,87503880,87503954,66850052,74,208606767,4771,0
100616320,MIR4481,chr10,R,12653137,12653197,66850112,60,208606827,4772,0
100616322,MIR4682,chr10,F,119958512,119958592,66850192,80,208606907,4773,0
100616323,MIR4482,chr10,R,104268335,104268405,66850262,70,208606977,4774,0
100616327,MIR4484,chr10,F,125819739,125819822,66850345,83,208607060,4775,0
100616383,MIR4675,chr10,F,20551969,20552046,66850422,77,208607137,4776,0
100616398,MIR4681,chr10,F,119377971,119378043,66850494,72,208607209,4777,0
100616482,MIR4685,chr10,R,98431291,98431360,66850563,69,208607278,4778,0
100616488,MIR548AK,chr10,R,12130759,12130816,66850620,57,208607335,4779,0
100616500,MIR4683,chr10,R,35641171,35641252,66850701,81,208607416,4780,0
100628560,MIR3155B,chr10,R,6152206,6152262,66850757,56,208607472,4781,0
100652748,TIMM23B,chr10,F,49942032,49988839,66897564,46807,208654279,4782,12
100652988,LINC00702,chr10,R,4206875,4243912,66934601,37037,208691316,4783,2
100652997,LINC00706,chr10,R,6774302,6779180,66939479,4878,208696194,4784,1
100847014,MIR5100,chr10,F,42997562,42997681,66939598,119,208696313,4785,0
100847086,MIR5699,chr10,R,641688,641778,66939688,90,208696403,4786,0
100874184,LINC00502,chr10,F,91045807,91062159,66956040,16352,208712755,4787,3
100996567,ANTXRLP1,chr10,R,46219024,46269608,67006624,50584,208763339,4788,4
100996758,LOC100996758,chr10,F,47914011,47926069,67018682,12058,208775397,4789,6
101060171,ARMC4P1,chr10,F,27280761,27329145,67067066,48384,208823781,4790,4
101060691,NUTM2B-AS1,chr10,R,79691499,79826594,67202161,135095,208958876,4791,7
101101772,LINC00601,chr10,R,126413868,126421879,67210172,8011,208966887,4792,3
101243544,ERCC6-PGBD3,chr10,R,49515104,49539538,67234606,24434,208991321,4793,6
101410540,FANK1-AS1,chr10,R,125972187,125973273,67235692,1086,208992407,4794,3
101926887,LOC101926887,chr10,R,89332106,89342706,67246292,10600,209003007,4795,3
101926906,SLC16A12-AS1,chr10,F,89455990,89468151,67258453,12161,209015168,4796,2
101926924,LINC01375,chr10,R,89915488,89957373,67300338,41885,209057053,4797,3
101926942,LOC101926942,chr10,R,90402520,90540805,67438623,138285,209195338,4798,6
101927013,LOC101927013,chr10,R,93746022,93757715,67450316,11693,209207031,4799,2
101927032,LOC101927032,chr10,F,93762165,93771976,67460127,9811,209216842,4800,1
101927049,PLCE1-AS2,chr10,R,94081949,94108794,67486972,26845,209243687,4801,8
101927278,LOC101927278,chr10,F,98446646,98453716,67494042,7070,209250757,4802,3
101927300,LOC101927300,chr10,F,99433224,99461216,67522034,27992,209278749,4803,3
101927324,LINC01475,chr10,R,99526349,99531177,67526862,4828,209283577,4804,4
101927381,LINC01163,chr10,F,128285949,128317726,67558639,31777,209315354,4805,5
101927396,LINC01514,chr10,F,101176321,101194147,67576465,17826,209333180,4806,5
101927419,LOC101927419,chr10,R,101252820,101263550,67587195,10730,209343910,4807,2
101927435,LOC101927435,chr10,F,130205331,130496873,67878737,291542,209635452,4808,19
101927445,LOC101927445,chr10,F,101839948,101910450,67949239,70502,209705954,4809,10
101927461,LOC101927461,chr10,F,131312171,131315690,67952758,3519,209709473,4810,2
101927472,LOC101927472,chr10,F,104323363,104326745,67956140,3382,209712855,4811,2
101927489,TCERG1L-AS1,chr10,F,131095217,131095777,67956700,560,209713415,4812,1
101927523,LOC101927523,chr10,R,104474938,104480275,67962037,5337,209718752,4813,2
101927549,LOC101927549,chr10,R,105673609,105820333,68108761,146724,209865476,4814,3
101927573,LOC101927573,chr10,F,107689568,107713406,68132599,23838,209889314,4815,7
101927584,LOC101927584,chr10,F,46717520,46719561,68134640,2041,209891355,4816,3
101927590,LINC01166,chr10,R,132943966,132965289,68155963,21323,209912678,4817,2
101927600,LOC101927600,chr10,R,112216881,112227697,68166779,10816,209923494,4818,2
101927671,MIR202HG,chr10,R,133246478,133247885,68168186,1407,209924901,4819,2
101927692,LOC101927692,chr10,F,114764787,114779903,68183302,15116,209940017,4820,2
101927699,LOC101927699,chr10,R,46582162,46598145,68199285,15983,209956000,4821,1
101927704,MIR3663HG,chr10,R,117153520,117169055,68214820,15535,209971535,4822,2
101927760,LOC101927760,chr10,F,118241500,118247881,68221201,6381,209977916,4823,4
101927762,LOC101927762,chr10,F,933025,942743,68230919,9718,209987634,4824,2
101927824,LOC101927824,chr10,R,3052509,3069273,68247683,16764,210004398,4825,6
101927868,GRK5-IT1,chr10,F,119208068,119212704,68252319,4636,210009034,4826,1
101927880,LOC101927880,chr10,R,3433734,3502860,68321445,69126,210078160,4827,9
101927889,LINC01153,chr10,F,121178288,121185966,68329123,7678,210085838,4828,1
101927904,LOC101927904,chr10,F,3911510,3936479,68354092,24969,210110807,4829,4
101927944,FAM53B-AS1,chr10,F,124704027,124714774,68364839,10747,210121554,4830,2
101927964,LOC101927964,chr10,F,4051725,4089013,68402127,37288,210158842,4831,3
101927983,EDRF1-AS1,chr10,R,125744726,125752060,68409461,7334,210166176,4832,4
101928051,LOC101928051,chr10,F,4995490,4997777,68411748,2287,210168463,4833,1
101928080,LOC101928080,chr10,R,6121797,6141157,68431108,19360,210187823,4834,2
101928125,LOC101928125,chr10,F,122672891,122679470,68437687,6579,210194402,4835,3
101928150,LOC101928150,chr10,F,6618715,6639781,68458753,21066,210215468,4836,5
101928272,LOC101928272,chr10,R,9197365,9295593,68556981,98228,210313696,4837,4
101928298,LOC101928298,chr10,F,10058721,10063502,68561762,4781,210318477,4838,3
101928322,LOC101928322,chr10,R,10419537,10462349,68604574,42812,210361289,4839,3
101928453,LOC101928453,chr10,F,14074283,14087881,68618172,13598,210374887,4840,2
101928524,LOC101928524,chr10,F,13632290,13655929,68641811,23639,210398526,4841,4
101928678,LOC101928678,chr10,F,15737772,15850013,68754052,112241,210510767,4842,5
101928687,LINC01468,chr10,R,52450876,52470533,68773709,19657,210530424,4843,4
101928701,LOC101928701,chr10,F,16524829,16539768,68788648,14939,210545363,4844,2
101928781,TMEM26-AS1,chr10,F,61452638,61493433,68829443,40795,210586158,4845,8
101928834,LOC101928834,chr10,R,19710334,19728550,68847659,18216,210604374,4846,4
101928859,LOC101928859,chr10,R,63859645,63887311,68875325,27666,210632040,4847,4
101928887,LOC101928887,chr10,R,64901135,64924518,68898708,23383,210655423,4848,1
101928913,LINC01515,chr10,F,65571424,65766541,69093825,195117,210850540,4849,5
101928961,LOC101928961,chr10,R,66894109,67012153,69211869,118044,210968584,4850,6
101928994,LOC101928994,chr10,R,69215332,69232490,69229027,17158,210985742,4851,4
101929021,LOC101929021,chr10,F,69572979,69577099,69233147,4120,210989862,4852,3
101929025,LINC01516,chr10,F,25113057,25161233,69281323,48176,211038038,4853,7
101929052,LINC00836,chr10,F,25651711,25732935,69362547,81224,211119262,4854,6
101929073,LOC101929073,chr10,R,25924377,25933710,69371880,9333,211128595,4855,3
101929085,LOC101929085,chr10,R,71564885,71597654,69404649,32769,211161364,4856,3
101929112,LOC101929112,chr10,F,73251621,73254343,69407371,2722,211164086,4857,4
101929117,LOC101929117,chr10,R,26577375,26579402,69409398,2027,211166113,4858,2
101929145,PPP3CB-AS1,chr10,F,73495751,73507295,69420942,11544,211177657,4859,4
101929165,LOC101929165,chr10,F,74912671,74944808,69453079,32137,211209794,4860,2
101929180,LOC101929180,chr10,F,27343435,27344917,69454561,1482,211211276,4861,1
101929202,MKX-AS1,chr10,F,27744614,27767799,69477746,23185,211234461,4862,1
101929216,LOC101929216,chr10,F,47210952,47231647,69498441,20695,211255156,4863,3
101929218,LINC01517,chr10,F,28743649,28808219,69563011,64570,211319726,4864,3
101929234,LOC101929234,chr10,F,75409156,75411324,69565179,2168,211321894,4865,2
101929236,LOC101929236,chr10,F,28897901,28934486,69601764,36585,211358479,4866,7
101929256,LOC101929256,chr10,F,30049322,30111844,69664286,62522,211421001,4867,4
101929279,LOC101929279,chr10,F,30211851,30232690,69685125,20839,211441840,4868,2
101929286,KCNMA1-AS3,chr10,F,77350871,77376613,69710867,25742,211467582,4869,5
101929287,LOC101929287,chr10,F,46756444,46759740,69714163,3296,211470878,4870,3
101929310,KCNMA1-AS2,chr10,F,77140830,77150100,69723433,9270,211480148,4871,2
101929328,KCNMA1-AS1,chr10,F,76888043,76978593,69813983,90550,211570698,4872,3
101929347,LOC101929347,chr10,F,77889598,77900567,69824952,10969,211581667,4873,5
101929352,LOC101929352,chr10,F,31187709,31261552,69898795,73843,211655510,4874,1
101929373,LOC101929373,chr10,F,42242498,42277067,69933364,34569,211690079,4875,2
101929397,LINC01518,chr10,R,42673012,42691759,69952111,18747,211708826,4876,5
101929431,LOC101929431,chr10,R,32434353,32446056,69963814,11703,211720529,4877,2
101929445,LOC101929445,chr10,F,42871520,42874060,69966354,2540,211723069,4878,1
101929447,LOC101929447,chr10,R,33073728,33116806,70009432,43078,211766147,4879,3
101929465,LOC101929465,chr10,R,44292087,44293360,70010705,1273,211767420,4880,1
101929475,LOC101929475,chr10,F,32982456,33082102,70110351,99646,211867066,4881,3
101929498,LOC101929498,chr10,R,37297754,37306964,70119561,9210,211876276,4882,2
101929506,LOC101929506,chr10,F,79669473,79679237,70129325,9764,211886040,4883,3
101929520,LINC00993,chr10,F,37309185,37347029,70167169,37844,211923884,4884,4
101929540,LOC101929540,chr10,F,38403165,38435338,70199342,32173,211956057,4885,14
101929574,LOC101929574,chr10,R,80529596,80535942,70205688,6346,211962403,4886,1
101929590,NRG3-AS1,chr10,R,82229013,82232920,70209595,3907,211966310,4887,3
101929624,LINC01519,chr10,R,85193420,85198938,70215113,5518,211971828,4888,4
101929646,LOC101929646,chr10,R,85431942,85432772,70215943,830,211972658,4889,1
101929662,LOC101929662,chr10,F,85432862,85448956,70232037,16094,211988752,4890,2
101929684,LINC01520,chr10,F,85449591,85492001,70274447,42410,212031162,4891,5
101929727,LOC101929727,chr10,F,88113381,88380366,70541432,266985,212298147,4892,5
101929806,LOC101929806,chr10,R,131884017,131889796,70547211,5779,212303926,4893,5
101929846,LOC101929846,chr10,F,63630676,63654745,70571280,24069,212327995,4894,3
101929946,LOC101929946,chr10,R,31307718,31320696,70584258,12978,212340973,4895,2
101929951,LOC101929951,chr10,R,31693081,31707630,70598807,14549,212355522,4896,1
101930421,LOC101930421,chr10,F,624990,631255,70605072,6265,212361787,4897,1
102031319,LOC102031319,chr10,F,32347363,32374488,70632197,27125,212388912,4898,1
102464829,MIR6078,chr10,F,3991159,3991259,70632297,100,212389012,4899,0
102465253,MIR6507,chr10,R,98924498,98924568,70632367,70,212389082,4900,0
102465427,MIR6715B,chr10,R,112299611,112299688,70632444,77,212389159,4901,0
102465689,MIR7152,chr10,F,71790746,71790800,70632498,54,212389213,4902,0
102465880,MIR8086,chr10,R,28289257,28289350,70632591,93,212389306,4903,0
102465944,MIR6072,chr10,R,2076018,2076089,70632662,71,212389377,4904,0
102466189,MIR6715A,chr10,F,112299611,112299690,70632741,79,212389456,4905,0
102466227,MIR7162,chr10,R,30368596,30368665,70632810,69,212389525,4906,0
102466814,MIR7151,chr10,R,67403350,67403410,70632870,60,212389585,4907,0
102578074,LINC01452,chr10,F,35778301,35800920,70655489,22619,212412204,4908,2
102723166,STAM-AS1,chr10,R,17641283,17643918,70658124,2635,212414839,4909,0
102723337,LOC102723337,chr10,F,133011763,133015765,70662126,4002,212418841,4910,1
102723350,LOC102723350,chr10,R,69993789,70019525,70687862,25736,212444577,4911,5
102723376,LOC102723376,chr10,F,11720,15576,70691718,3856,212448433,4912,2
102723377,LOC102723377,chr10,R,71508152,71511920,70695486,3768,212452201,4913,2
102723422,LOC102723422,chr10,F,1038453,1040858,70697891,2405,212454606,4914,1
102723439,LOC102723439,chr10,R,74506497,74529324,70720718,22827,212477433,4915,4
102723629,LOC102723629,chr10,R,5616617,5632478,70736579,15861,212493294,4916,3
102723665,LOC102723665,chr10,R,96830631,96832393,70738341,1762,212495056,4917,0
102723703,LOC102723703,chr10,F,80531249,80533123,70740215,1874,212496930,4918,1
102723721,LOC102723721,chr10,F,6736970,6738943,70742188,1973,212498903,4919,1
102723782,LOC102723782,chr10,R,87168766,87172649,70746071,3883,212502786,4920,2
102723794,LOC102723794,chr10,F,87430291,87499379,70815159,69088,212571874,4921,3
102723864,LOC102723864,chr10,R,89634145,89636340,70817354,2195,212574069,4922,1
102724039,LOC102724039,chr10,F,16276916,16295772,70836210,18856,212592925,4923,4
102724082,LOC102724082,chr10,R,19439492,19457598,70854316,18106,212611031,4924,3
102724202,LOC102724202,chr10,R,26635870,26637719,70856165,1849,212612880,4925,2
102724225,LOC102724225,chr10,F,100729561,100732024,70858628,2463,212615343,4926,1
102724245,LOC102724245,chr10,R,27297806,27307419,70868241,9613,212624956,4927,2
102724264,LOC102724264,chr10,R,43777561,43778862,70869542,1301,212626257,4928,1
102724307,CYP17A1-AS1,chr10,F,102832666,102834512,70871388,1846,212628103,4929,1
102724316,SVIL-AS1,chr10,F,29409533,29487856,70949711,78323,212706426,4930,7
102724323,LOC102724323,chr10,R,45444567,45453121,70958265,8554,212714980,4931,2
102724333,LOC102724333,chr10,F,29838721,29839746,70959290,1025,212716005,4932,1
102724341,NEURL1-AS1,chr10,R,103479602,103517442,70997130,37840,212753845,4933,4
102724350,LOC102724350,chr10,F,46629290,46633159,71000999,3869,212757714,4934,2
102724351,LOC102724351,chr10,R,103937112,103967053,71030940,29941,212787655,4935,6
102724418,LOC102724418,chr10,R,105489341,105642760,71184359,153419,212941074,4936,5
102724439,LOC102724439,chr10,F,106285467,106310945,71209837,25478,212966552,4937,3
102724455,LOC102724455,chr10,R,48036674,48042170,71215333,5496,212972048,4938,1
102724471,LOC102724471,chr10,F,110667335,110670836,71218834,3501,212975549,4939,2
102724488,LOC102724488,chr10,R,47746652,47763592,71235774,16940,212992489,4940,10
102724509,LOC102724509,chr10,F,37235995,37251719,71251498,15724,213008213,4941,7
102724589,LOC102724589,chr10,F,114994656,114996593,71253435,1937,213010150,4942,2
102724593,LOC102724593,chr10,F,47743698,47759023,71268760,15325,213025475,4943,1
102724603,LOC102724603,chr10,R,47708507,47712375,71272628,3868,213029343,4944,2
102724627,LOC102724627,chr10,F,117734933,117753377,71291072,18444,213047787,4945,4
102724643,LOC102724643,chr10,F,46720952,46753190,71323310,32238,213080025,4946,3
102724643,LOC102724643,chr10,R,47589050,47619453,71353713,30403,213110428,4947,4
102724719,LOC102724719,chr10,R,51062578,51068552,71359687,5974,213116402,4948,1
102724746,LOC102724746,chr10,R,121996344,121998491,71361834,2147,213118549,4949,2
102724768,LOC102724768,chr10,F,59013679,59065845,71414000,52166,213170715,4950,3
102724778,LOC102724778,chr10,F,59322134,59332607,71424473,10473,213181188,4951,1
102724793,LOC102724793,chr10,F,125584485,125603252,71443240,18767,213199955,4952,2
102724863,LOC102724863,chr10,F,64933243,64938712,71448709,5469,213205424,4953,2
102724883,LOC102724883,chr10,F,130111218,130120721,71458212,9503,213214927,4954,1
102725043,LOC102725043,chr10,F,133770223,133778345,71466334,8122,213223049,4955,1
102725112,LOC102725112,chr10,F,20845374,20884942,71505902,39568,213262617,4956,6
103344931,LOC103344931,chr10,F,112823495,112827732,71510139,4237,213266854,4957,0
103695365,LINC01435,chr10,R,107871575,108069293,71707857,197718,213464572,4958,4
103695432,LINC01167,chr10,R,132961339,132962237,71708755,898,213465470,4959,1
104266963,LINC01264,chr10,R,42979016,42981507,71711246,2491,213467961,4960,2
104355295,SGMS1-AS1,chr10,F,50624950,50631636,71717932,6686,213474647,4961,3
105369217,LOC105369217,chr10,R,45700183,45704983,71722732,4800,213479447,4962,1
105376338,LOC105376338,chr10,F,44695,46683,71724720,1988,213481435,4963,2
105376339,LOC105376339,chr10,F,665958,666681,71725443,723,213482158,4964,1
105376340,LOC105376340,chr10,F,353609,362481,71734315,8872,213491030,4965,3
105376341,LOC105376341,chr10,R,951570,956386,71739131,4816,213495846,4966,1
105376342,LOC105376342,chr10,F,1359589,1361951,71741493,2362,213498208,4967,1
105376343,LOC105376343,chr10,R,1319331,1328781,71750943,9450,213507658,4968,2
105376344,LOC105376344,chr10,R,1152309,1159347,71757981,7038,213514696,4969,3
105376345,LOC105376345,chr10,R,1742273,1772289,71787997,30016,213544712,4970,5
105376346,LOC105376346,chr10,F,1971812,1990380,71806565,18568,213563280,4971,3
105376347,LOC105376347,chr10,F,2071797,2072729,71807497,932,213564212,4972,1
105376348,LOC105376348,chr10,R,2169163,2189505,71827839,20342,213584554,4973,6
105376349,LOC105376349,chr10,F,2318425,2325108,71834522,6683,213591237,4974,3
105376350,LOC105376350,chr10,F,2501907,2618724,71951339,116817,213708054,4975,6
105376351,LOC105376351,chr10,R,2422113,2501968,72031194,79855,213787909,4976,7
105376352,LOC105376352,chr10,R,2984141,2986444,72033497,2303,213790212,4977,2
105376353,LOC105376353,chr10,F,3243058,3253291,72043730,10233,213800445,4978,3
105376354,LOC105376354,chr10,R,3238086,3258678,72064322,20592,213821037,4979,4
105376355,LOC105376355,chr10,R,3270279,3277073,72071116,6794,213827831,4980,1
105376356,LOC105376356,chr10,R,3305131,3313998,72079983,8867,213836698,4981,2
105376357,LOC105376357,chr10,F,3397446,3398434,72080971,988,213837686,4982,1
105376358,LOC105376358,chr10,R,3394078,3397455,72084348,3377,213841063,4983,2
105376359,LOC105376359,chr10,F,3485182,3486998,72086164,1816,213842879,4984,2
105376360,LOC105376360,chr10,F,3748504,3750764,72088424,2260,213845139,4985,1
105376361,LOC105376361,chr10,R,3750851,3756540,72094113,5689,213850828,4986,2
105376362,LOC105376362,chr10,R,3756545,3758096,72095664,1551,213852379,4987,2
105376363,LOC105376363,chr10,F,3759189,3769321,72105796,10132,213862511,4988,5
105376364,LOC105376364,chr10,F,3806413,3808517,72107900,2104,213864615,4989,1
105376365,LOC105376365,chr10,F,3834007,3834728,72108621,721,213865336,4990,1
105376366,LOC105376366,chr10,R,3892820,3905657,72121458,12837,213878173,4991,2
105376367,LOC105376367,chr10,F,3942328,3949354,72128484,7026,213885199,4992,2
105376368,LOC105376368,chr10,F,4150238,4174518,72152764,24280,213909479,4993,2
105376369,LOC105376369,chr10,F,4247272,4256851,72162343,9579,213919058,4994,1
105376370,LOC105376370,chr10,F,4334395,4336838,72164786,2443,213921501,4995,2
105376371,LOC105376371,chr10,R,4369183,4370565,72166168,1382,213922883,4996,1
105376372,LOC105376372,chr10,R,4384421,4406350,72188097,21929,213944812,4997,4
105376373,LOC105376373,chr10,F,4669903,4679654,72197848,9751,213954563,4998,2
105376374,LOC105376374,chr10,R,4757069,4764045,72204824,6976,213961539,4999,2
105376375,LOC105376375,chr10,R,4706028,4766552,72265348,60524,214022063,5000,2
105376376,LOC105376376,chr10,R,5065262,5069616,72269702,4354,214026417,5001,2
105376377,LOC105376377,chr10,R,5120190,5123956,72273468,3766,214030183,5002,3
105376378,LOC105376378,chr10,R,5429189,5446520,72290799,17331,214047514,5003,2
105376379,LOC105376379,chr10,R,5483488,5493864,72301175,10376,214057890,5004,2
105376380,LOC105376380,chr10,R,5549598,5552069,72303646,2471,214060361,5005,3
105376381,LOC105376381,chr10,R,5564941,5566713,72305418,1772,214062133,5006,2
105376382,LOC105376382,chr10,R,5594983,5596094,72306529,1111,214063244,5007,1
105376383,LOC105376383,chr10,R,5607993,5610439,72308975,2446,214065690,5008,2
105376384,LOC105376384,chr10,R,5934266,5946581,72321290,12315,214078005,5009,3
105376385,LOC105376385,chr10,R,6745783,6755414,72330921,9631,214087636,5010,2
105376386,LOC105376386,chr10,F,7096284,7097675,72332312,1391,214089027,5011,2
105376387,LOC105376387,chr10,R,6837770,7119802,72614344,282032,214371059,5012,11
105376388,LOC105376388,chr10,R,7465660,7472896,72621580,7236,214378295,5013,4
105376389,LOC105376389,chr10,F,7485461,7491755,72627874,6294,214384589,5014,2
105376390,LOC105376390,chr10,F,7533206,7536418,72631086,3212,214387801,5015,2
105376391,LOC105376391,chr10,F,7541398,7548704,72638392,7306,214395107,5016,1
105376392,LOC105376392,chr10,R,7799195,7807724,72646921,8529,214403636,5017,1
105376393,LOC105376393,chr10,R,8015793,8018607,72649735,2814,214406450,5018,1
105376394,LOC105376394,chr10,F,8035580,8042845,72657000,7265,214413715,5019,2
105376395,LOC105376395,chr10,F,8094294,8097227,72659933,2933,214416648,5020,2
105376396,LOC105376396,chr10,F,8382524,8401504,72678913,18980,214435628,5021,2
105376397,LOC105376397,chr10,R,8435739,8454127,72697301,18388,214454016,5022,1
105376398,LOC105376398,chr10,R,8572746,8594412,72718967,21666,214475682,5023,1
105376399,LOC105376399,chr10,F,8532213,8594352,72781106,62139,214537821,5024,3
105376400,LOC105376400,chr10,R,8658695,9065394,73187805,406699,214944520,5025,3
105376401,LOC105376401,chr10,R,9296073,9312349,73204081,16276,214960796,5026,3
105376402,LOC105376402,chr10,R,9443280,9878080,73638881,434800,215395596,5027,11
105376403,LOC105376403,chr10,R,9926725,9940724,73652880,13999,215409595,5028,1
105376404,LOC105376404,chr10,R,11008015,11012745,73657610,4730,215414325,5029,1
105376405,LOC105376405,chr10,R,10922308,10929660,73664962,7352,215421677,5030,2
105376406,LOC105376406,chr10,F,10798186,10846839,73713615,48653,215470330,5031,2
105376407,LOC105376407,chr10,F,10796844,10922316,73839087,125472,215595802,5032,2
105376408,LOC105376408,chr10,R,10775620,10783760,73847227,8140,215603942,5033,4
105376409,LOC105376409,chr10,R,11350574,11355466,73852119,4892,215608834,5034,2
105376410,LOC105376410,chr10,F,11497421,11517354,73872052,19933,215628767,5035,4
105376411,LOC105376411,chr10,F,11463782,11467204,73875474,3422,215632189,5036,1
105376412,LOC105376412,chr10,F,11672956,11679646,73882164,6690,215638879,5037,4
105376413,LOC105376413,chr10,R,11636398,11682029,73927795,45631,215684510,5038,4
105376414,LOC105376414,chr10,R,11765937,11783605,73945463,17668,215702178,5039,1
105376415,LOC105376415,chr10,F,11784285,11785332,73946510,1047,215703225,5040,2
105376416,LOC105376416,chr10,R,12043672,12046077,73948915,2405,215705630,5041,2
105376417,LOC105376417,chr10,F,12399733,12403717,73952899,3984,215709614,5042,2
105376418,LOC105376418,chr10,F,12907635,12965475,74010739,57840,215767454,5043,4
105376419,LOC105376419,chr10,F,13383048,13409240,74036931,26192,215793646,5044,2
105376420,LOC105376420,chr10,F,13413775,13423758,74046914,9983,215803629,5045,2
105376421,LOC105376421,chr10,F,13528603,13530264,74048575,1661,215805290,5046,1
105376422,LOC105376422,chr10,F,13548235,13557170,74057510,8935,215814225,5047,2
105376423,LOC105376423,chr10,F,14182889,14185567,74060188,2678,215816903,5048,1
105376424,LOC105376424,chr10,R,14082946,14089294,74066536,6348,215823251,5049,2
105376425,LOC105376425,chr10,F,13990375,14008040,74084201,17665,215840916,5050,5
105376426,LOC105376426,chr10,F,13710017,13730725,74104909,20708,215861624,5051,5
105376427,LOC105376427,chr10,R,13694807,13699088,74109190,4281,215865905,5052,2
105376428,LOC105376428,chr10,F,14655126,14660616,74114680,5490,215871395,5053,2
105376429,LOC105376429,chr10,F,14652717,14655065,74117028,2348,215873743,5054,2
105376430,LOC105376430,chr10,F,14986794,14988047,74118281,1253,215874996,5055,1
105376431,LOC105376431,chr10,F,15104510,15140192,74153963,35682,215910678,5056,4
105376432,LOC105376432,chr10,R,15016255,15073080,74210788,56825,215967503,5057,11
105376433,LOC105376433,chr10,F,15207897,15237848,74240739,29951,215997454,5058,2
105376434,LOC105376434,chr10,R,15172896,15211298,74279141,38402,216035856,5059,6
105376435,LOC105376435,chr10,F,16817711,16821245,74282675,3534,216039390,5060,2
105376436,LOC105376436,chr10,F,17437289,17453546,74298932,16257,216055647,5061,3
105376437,LOC105376437,chr10,R,17471638,17472987,74300281,1349,216056996,5062,3
105376438,LOC105376438,chr10,R,17695891,17696768,74301158,877,216057873,5063,1
105376439,LOC105376439,chr10,R,18512581,18539265,74327842,26684,216084557,5064,3
105376440,LOC105376440,chr10,F,18710293,18836471,74454020,126178,216210735,5065,7
105376441,LOC105376441,chr10,F,19156570,19160232,74457682,3662,216214397,5066,2
105376442,LOC105376442,chr10,F,20597129,20610771,74471324,13642,216228039,5067,4
105376443,LOC105376443,chr10,R,21054238,21101141,74518227,46903,216274942,5068,3
105376444,LOC105376444,chr10,R,21368478,21372943,74522692,4465,216279407,5069,2
105376445,LOC105376445,chr10,F,21414786,21418654,74526560,3868,216283275,5070,2
105376446,LOC105376446,chr10,R,22225993,22246083,74546650,20090,216303365,5071,2
105376447,LOC105376447,chr10,R,22247419,22258542,74557773,11123,216314488,5072,1
105376448,LOC105376448,chr10,R,22426821,22428526,74559478,1705,216316193,5073,1
105376449,LOC105376449,chr10,F,22447137,22462623,74574964,15486,216331679,5074,3
105376450,LOC105376450,chr10,F,22471450,22472577,74576091,1127,216332806,5075,2
105376451,LOC105376451,chr10,F,22854083,22868246,74590254,14163,216346969,5076,2
105376452,LOC105376452,chr10,R,22964734,22995934,74621454,31200,216378169,5077,2
105376453,LOC105376453,chr10,F,23342232,23359066,74638288,16834,216395003,5078,3
105376454,LOC105376454,chr10,F,23543919,23586268,74680637,42349,216437352,5079,10
105376455,LOC105376455,chr10,R,24457007,24466437,74690067,9430,216446782,5080,2
105376456,LOC105376456,chr10,R,24753407,24778075,74714735,24668,216471450,5081,2
105376457,LOC105376457,chr10,F,25813119,25882732,74784348,69613,216541063,5082,2
105376458,LOC105376458,chr10,R,26192000,26194622,74786970,2622,216543685,5083,2
105376459,LOC105376459,chr10,R,26147587,26168658,74808041,21071,216564756,5084,2
105376460,LOC105376460,chr10,F,25905896,25912012,74814157,6116,216570872,5085,2
105376461,LOC105376461,chr10,F,26637821,26642958,74819294,5137,216576009,5086,2
105376462,LOC105376462,chr10,R,26663174,26675736,74831856,12562,216588571,5087,2
105376463,LOC105376463,chr10,F,27566804,27584417,74849469,17613,216606184,5088,3
105376464,LOC105376464,chr10,R,27774953,27796423,74870939,21470,216627654,5089,2
105376465,LOC105376465,chr10,F,27983171,27995151,74882919,11980,216639634,5090,2
105376466,LOC105376466,chr10,F,28303161,28306271,74886029,3110,216642744,5091,2
105376467,LOC105376467,chr10,R,28326011,28335354,74895372,9343,216652087,5092,3
105376468,LOC105376468,chr10,R,28433007,28436221,74898586,3214,216655301,5093,1
105376469,LOC105376469,chr10,R,28485010,28488022,74901598,3012,216658313,5094,2
105376470,LOC105376470,chr10,F,28708103,28712450,74905945,4347,216662660,5095,4
105376471,LOC105376471,chr10,F,29108193,29133234,74930986,25041,216687701,5096,1
105376472,LOC105376472,chr10,F,29229432,29235506,74937060,6074,216693775,5097,2
105376473,LOC105376473,chr10,R,29373025,29374919,74938954,1894,216695669,5098,2
105376474,LOC105376474,chr10,R,29405880,29408473,74941547,2593,216698262,5099,2
105376475,LOC105376475,chr10,R,29782396,29784039,74943190,1643,216699905,5100,2
105376476,LOC105376476,chr10,F,29821313,29829111,74950988,7798,216707703,5101,2
105376477,LOC105376477,chr10,F,30197080,30206208,74960116,9128,216716831,5102,2
105376478,LOC105376478,chr10,F,30529556,30533734,74964294,4178,216721009,5103,2
105376479,LOC105376479,chr10,F,30587716,30590045,74966623,2329,216723338,5104,3
105376480,LOC105376480,chr10,F,30723218,30723740,74967145,522,216723860,5105,1
105376481,LOC105376481,chr10,F,31033022,31113399,75047522,80377,216804237,5106,2
105376482,LOC105376482,chr10,R,31129938,31134228,75051812,4290,216808527,5107,3
105376483,LOC105376483,chr10,F,31134264,31139329,75056877,5065,216813592,5108,3
105376484,LOC105376484,chr10,R,31609271,31620873,75068479,11602,216825194,5109,3
105376485,LOC105376485,chr10,R,31980787,31992578,75080270,11791,216836985,5110,2
105376486,LOC105376486,chr10,R,32887258,32895979,75088991,8721,216845706,5111,1
105376487,LOC105376487,chr10,R,33249081,33251099,75091009,2018,216847724,5112,1
105376488,LOC105376488,chr10,F,33336754,33384153,75138408,47399,216895123,5113,2
105376489,LOC105376489,chr10,F,33530767,33537149,75144790,6382,216901505,5114,3
105376490,LOC105376490,chr10,R,33579035,33594205,75159960,15170,216916675,5115,2
105376491,LOC105376491,chr10,F,34973017,34975578,75162521,2561,216919236,5116,1
105376492,LOC105376492,chr10,R,34993656,35007596,75176461,13940,216933176,5117,2
105376493,LOC105376493,chr10,R,35219802,35244679,75201338,24877,216958053,5118,3
105376494,LOC105376494,chr10,F,35643801,35647824,75205361,4023,216962076,5119,1
105376495,LOC105376495,chr10,R,35897205,35898849,75207005,1644,216963720,5120,1
105376496,LOC105376496,chr10,R,36917275,36943132,75232862,25857,216989577,5121,3
105376497,LOC105376497,chr10,F,37437592,37438734,75234004,1142,216990719,5122,1
105376498,LOC105376498,chr10,R,37677096,37680351,75237259,3255,216993974,5123,3
105376499,LOC105376499,chr10,F,37992379,38004541,75249421,12162,217006136,5124,3
105376500,LOC105376500,chr10,R,38157045,38169066,75261442,12021,217018157,5125,3
105376501,LOC105376501,chr10,R,3532039,3556794,75286197,24755,217042912,5126,4
105376502,LOC105376502,chr10,F,8046826,8050862,75290233,4036,217046948,5127,5
105378267,LOC105378267,chr10,R,42192463,42242291,75340061,49828,217096776,5128,4
105378268,LOC105378268,chr10,F,42638463,42645542,75347140,7079,217103855,5129,1
105378269,LOC105378269,chr10,F,42755141,42769621,75361620,14480,217118335,5130,1
105378270,LOC105378270,chr10,F,43323016,43327938,75366542,4922,217123257,5131,1
105378271,LOC105378271,chr10,F,43318487,43350340,75398395,31853,217155110,5132,2
105378272,LOC105378272,chr10,F,43420737,43422148,75399806,1411,217156521,5133,1
105378273,LOC105378273,chr10,F,43598611,43604486,75405681,5875,217162396,5134,1
105378274,LOC105378274,chr10,F,43649509,43649790,75405962,281,217162677,5135,1
105378275,LOC105378275,chr10,F,43778960,43818803,75445805,39843,217202520,5136,3
105378276,LOC105378276,chr10,F,43912404,43914496,75447897,2092,217204612,5137,1
105378277,LOC105378277,chr10,R,43901364,43912343,75458876,10979,217215591,5138,2
105378278,LOC105378278,chr10,R,44293482,44349067,75514461,55585,217271176,5139,3
105378279,LOC105378279,chr10,F,44402732,44459911,75571640,57179,217328355,5140,3
105378280,LOC105378280,chr10,F,44945059,44954748,75581329,9689,217338044,5141,2
105378281,LOC105378281,chr10,R,44969110,44970174,75582393,1064,217339108,5142,1
105378282,LOC105378282,chr10,R,45215737,45224468,75591124,8731,217347839,5143,2
105378283,LOC105378283,chr10,R,45180355,45194262,75605031,13907,217361746,5144,4
105378284,LOC105378284,chr10,F,45071704,45074924,75608251,3220,217364966,5145,2
105378285,LOC105378285,chr10,F,45046939,45064542,75625854,17603,217382569,5146,2
105378286,LOC105378286,chr10,F,45464274,45511565,75673145,47291,217429860,5147,4
105378287,LOC105378287,chr10,F,46030740,46038059,75680464,7319,217437179,5148,2
105378288,LOC105378288,chr10,F,46090396,46103699,75693767,13303,217450482,5149,2
105378289,LOC105378289,chr10,F,46607750,46612020,75698037,4270,217454752,5150,2
105378290,LOC105378290,chr10,R,46906749,46911302,75702590,4553,217459305,5151,2
105378291,LOC105378291,chr10,F,47203530,47210958,75710018,7428,217466733,5152,3
105378292,LOC105378292,chr10,R,47413386,47414620,75711252,1234,217467967,5153,2
105378293,LOC105378293,chr10,F,48140546,48145048,75715754,4502,217472469,5154,2
105378294,LOC105378294,chr10,R,48043393,48049232,75721593,5839,217478308,5155,1
105378295,LOC105378295,chr10,F,47959321,47968165,75730437,8844,217487152,5156,1
105378296,LOC105378296,chr10,R,47729531,47733997,75734903,4466,217491618,5157,3
105378297,LOC105378297,chr10,F,48511684,48519778,75742997,8094,217499712,5158,2
105378298,LOC105378298,chr10,R,48976985,48984429,75750441,7444,217507156,5159,3
105378299,LOC105378299,chr10,R,48831656,48837052,75755837,5396,217512552,5160,5
105378300,LOC105378300,chr10,F,49419268,49472901,75809470,53633,217566185,5161,2
105378301,LOC105378301,chr10,F,50322933,50342166,75828703,19233,217585418,5162,2
105378302,LOC105378302,chr10,R,50666541,50674958,75837120,8417,217593835,5163,2
105378303,LOC105378303,chr10,F,51748349,51763302,75852073,14953,217608788,5164,3
105378304,LOC105378304,chr10,R,51732916,51737355,75856512,4439,217613227,5165,3
105378305,LOC105378305,chr10,R,52556960,52755564,76055116,198604,217811831,5166,3
105378306,LOC105378306,chr10,F,52790279,52812468,76077305,22189,217834020,5167,3
105378307,LOC105378307,chr10,R,52782140,52810960,76106125,28820,217862840,5168,4
105378308,LOC105378308,chr10,R,52946430,52965394,76125089,18964,217881804,5169,2
105378309,LOC105378309,chr10,R,52972262,53030299,76183126,58037,217939841,5170,4
105378310,LOC105378310,chr10,F,53151802,53163045,76194369,11243,217951084,5171,2
105378311,LOC105378311,chr10,F,54486229,54656051,76364191,169822,218120906,5172,5
105378312,LOC105378312,chr10,R,55938670,56151992,76577513,213322,218334228,5173,3
105378313,LOC105378313,chr10,R,57322248,57416411,76671676,94163,218428391,5174,6
105378314,LOC105378314,chr10,R,57698900,57847359,76820135,148459,218576850,5175,3
105378315,LOC105378315,chr10,F,58346286,58359032,76832881,12746,218589596,5176,1
105378316,LOC105378316,chr10,F,58433929,58503479,76902431,69550,218659146,5177,6
105378317,LOC105378317,chr10,F,58608990,58614513,76907954,5523,218664669,5178,2
105378318,LOC105378318,chr10,F,59578697,59596363,76925620,17666,218682335,5179,2
105378319,LOC105378319,chr10,F,59629369,59649659,76945910,20290,218702625,5180,2
105378320,LOC105378320,chr10,F,60730383,60745082,76960609,14699,218717324,5181,3
105378321,LOC105378321,chr10,F,60967386,60975802,76969025,8416,218725740,5182,2
105378322,LOC105378322,chr10,F,60898762,60903988,76974251,5226,218730966,5183,2
105378323,LOC105378323,chr10,F,61098981,61103756,76979026,4775,218735741,5184,2
105378324,LOC105378324,chr10,R,61997016,62000562,76982572,3546,218739287,5185,2
105378325,LOC105378325,chr10,F,62243505,62304141,77043208,60636,218799923,5186,2
105378326,LOC105378326,chr10,F,62219116,62234277,77058369,15161,218815084,5187,2
105378327,LOC105378327,chr10,R,62624527,62655506,77089348,30979,218846063,5188,2
105378328,LOC105378328,chr10,R,63123928,63125555,77090975,1627,218847690,5189,2
105378329,LOC105378329,chr10,R,63591692,63625310,77124593,33618,218881308,5190,4
105378330,LOC105378330,chr10,F,63430574,63431111,77125130,537,218881845,5191,1
105378331,LOC105378331,chr10,F,63159503,63167571,77133198,8068,218889913,5192,1
105378332,LOC105378332,chr10,F,63887401,64091251,77337048,203850,219093763,5193,9
105378333,LOC105378333,chr10,R,64029391,64037449,77345106,8058,219101821,5194,2
105378334,LOC105378334,chr10,F,64301519,64693763,77737350,392244,219494065,5195,3
105378335,LOC105378335,chr10,R,64589406,64626971,77774915,37565,219531630,5196,3
105378336,LOC105378336,chr10,F,64866864,64883782,77791833,16918,219548548,5197,1
105378337,LOC105378337,chr10,R,65479191,65481670,77794312,2479,219551027,5198,2
105378338,LOC105378338,chr10,R,65745580,65811389,77860121,65809,219616836,5199,3
105378339,LOC105378339,chr10,R,65837943,65891451,77913629,53508,219670344,5200,2
105378340,LOC105378340,chr10,F,66079230,66275772,78110171,196542,219866886,5201,14
105378341,LOC105378341,chr10,R,68199246,68216861,78127786,17615,219884501,5202,2
105378342,LOC105378342,chr10,F,69046958,69048980,78129808,2022,219886523,5203,1
105378343,LOC105378343,chr10,F,69405091,69410996,78135713,5905,219892428,5204,1
105378344,LOC105378344,chr10,F,69547154,69550352,78138911,3198,219895626,5205,2
105378345,LOC105378345,chr10,R,69534934,69539186,78143163,4252,219899878,5206,4
105378346,LOC105378346,chr10,F,69684952,69691179,78149390,6227,219906105,5207,2
105378347,LOC105378347,chr10,R,69808804,69820887,78161473,12083,219918188,5208,2
105378348,LOC105378348,chr10,R,70945914,70947168,78162727,1254,219919442,5209,2
105378349,LOC105378349,chr10,F,70939059,70944144,78167812,5085,219924527,5210,1
105378350,LOC105378350,chr10,F,70978334,70999102,78188580,20768,219945295,5211,3
105378351,LOC105378351,chr10,R,71003506,71005764,78190838,2258,219947553,5212,2
105378352,LOC105378352,chr10,F,71245820,71251690,78196708,5870,219953423,5213,3
105378353,LOC105378353,chr10,R,71338805,71348526,78206429,9721,219963144,5214,2
105378354,LOC105378354,chr10,R,71704181,71709087,78211335,4906,219968050,5215,1
105378355,LOC105378355,chr10,R,71551049,71554006,78214292,2957,219971007,5216,1
105378356,LOC105378356,chr10,R,71472883,71474153,78215562,1270,219972277,5217,2
105378357,LOC105378357,chr10,F,72942162,72945702,78219102,3540,219975817,5218,2
105378358,LOC105378358,chr10,R,73182492,73234843,78271453,52351,220028168,5219,2
105378359,LOC105378359,chr10,F,73139473,73149555,78281535,10082,220038250,5220,1
105378360,LOC105378360,chr10,F,73654128,73669176,78296583,15048,220053298,5221,2
105378361,LOC105378361,chr10,R,75026426,75034790,78304947,8364,220061662,5222,1
105378362,LOC105378362,chr10,R,74976337,75004753,78333363,28416,220090078,5223,2
105378363,LOC105378363,chr10,R,75385342,75389935,78337956,4593,220094671,5224,1
105378364,LOC105378364,chr10,F,76560353,76561407,78339010,1054,220095725,5225,2
105378365,LOC105378365,chr10,R,76289058,76305171,78355123,16113,220111838,5226,3
105378366,LOC105378366,chr10,R,75868050,75879066,78366139,11016,220122854,5227,2
105378367,LOC105378367,chr10,F,75712454,75743848,78397533,31394,220154248,5228,2
105378368,LOC105378368,chr10,F,77618870,77628404,78407067,9534,220163782,5229,4
105378369,LOC105378369,chr10,F,77422983,77432687,78416771,9704,220173486,5230,6
105378370,LOC105378370,chr10,R,77344592,77347463,78419642,2871,220176357,5231,1
105378371,LOC105378371,chr10,F,77045565,77061082,78435159,15517,220191874,5232,2
105378372,LOC105378372,chr10,R,77702442,77711109,78443826,8667,220200541,5233,2
105378373,LOC105378373,chr10,R,78148440,78149333,78444719,893,220201434,5234,1
105378374,LOC105378374,chr10,R,78164901,78178137,78457955,13236,220214670,5235,2
105378375,LOC105378375,chr10,F,78179098,78193046,78471903,13948,220228618,5236,3
105378376,LOC105378376,chr10,F,78213717,78233436,78491622,19719,220248337,5237,2
105378377,LOC105378377,chr10,F,78354273,78356101,78493450,1828,220250165,5238,1
105378378,LOC105378378,chr10,F,78463520,78473947,78503877,10427,220260592,5239,1
105378379,LOC105378379,chr10,R,78645053,78665940,78524764,20887,220281479,5240,2
105378380,LOC105378380,chr10,R,79055999,79056703,78525468,704,220282183,5241,1
105378381,LOC105378381,chr10,R,78834822,78872932,78563578,38110,220320293,5242,2
105378382,LOC105378382,chr10,R,79404302,79420065,78579341,15763,220336056,5243,1
105378383,LOC105378383,chr10,F,79447574,79454750,78586517,7176,220343232,5244,3
105378384,LOC105378384,chr10,F,79798197,79799154,78587474,957,220344189,5245,1
105378385,LOC105378385,chr10,R,79630835,79632186,78588825,1351,220345540,5246,1
105378386,LOC105378386,chr10,F,80649551,80653734,78593008,4183,220349723,5247,2
105378387,LOC105378387,chr10,R,80629685,80649343,78612666,19658,220369381,5248,1
105378388,LOC105378388,chr10,F,81831161,81837085,78618590,5924,220375305,5249,2
105378389,LOC105378389,chr10,F,81838783,81850419,78630226,11636,220386941,5250,2
105378390,LOC105378390,chr10,F,81864103,81869012,78635135,4909,220391850,5251,1
105378391,LOC105378391,chr10,F,82037413,82043641,78641363,6228,220398078,5252,2
105378392,LOC105378392,chr10,R,83188961,83195025,78647427,6064,220404142,5253,3
105378393,LOC105378393,chr10,F,83546314,83547979,78649092,1665,220405807,5254,2
105378394,LOC105378394,chr10,R,83521508,83548449,78676033,26941,220432748,5255,2
105378395,LOC105378395,chr10,R,83560957,83565143,78680219,4186,220436934,5256,1
105378396,LOC105378396,chr10,F,83584615,83649658,78745262,65043,220501977,5257,4
105378397,LOC105378397,chr10,R,83672405,83677118,78749975,4713,220506690,5258,4
105378398,LOC105378398,chr10,R,83953304,83970831,78767502,17527,220524217,5259,2
105378399,LOC105378399,chr10,R,83971589,84003484,78799397,31895,220556112,5260,4
105378400,LOC105378400,chr10,F,84847272,84874407,78826532,27135,220583247,5261,3
105378401,LOC105378401,chr10,F,84947322,84951362,78830572,4040,220587287,5262,2
105378402,LOC105378402,chr10,F,85199066,85212802,78844308,13736,220601023,5263,1
105378403,LOC105378403,chr10,R,85377498,85380116,78846926,2618,220603641,5264,2
105378404,LOC105378404,chr10,R,85537118,85580521,78890329,43403,220647044,5265,7
105378405,LOC105378405,chr10,F,86522064,86525101,78893366,3037,220650081,5266,1
105378406,LOC105378406,chr10,R,86556327,86566402,78903441,10075,220660156,5267,2
105378407,LOC105378407,chr10,R,86546026,86556154,78913569,10128,220670284,5268,3
105378408,LOC105378408,chr10,F,86534095,86558059,78937533,23964,220694248,5269,4
105378409,LOC105378409,chr10,R,86656995,86666318,78946856,9323,220703571,5270,2
105378410,LOC105378410,chr10,R,87189778,87200025,78957103,10247,220713818,5271,3
105378411,LOC105378411,chr10,R,87658443,87658945,78957605,502,220714320,5272,1
105378412,LOC105378412,chr10,F,87596448,87659279,79020436,62831,220777151,5273,4
105378413,LOC105378413,chr10,F,87769962,87802099,79052573,32137,220809288,5274,2
105378414,LOC105378414,chr10,F,88042317,88060177,79070433,17860,220827148,5275,2
105378415,LOC105378415,chr10,R,88066877,88104389,79107945,37512,220864660,5276,6
105378416,LOC105378416,chr10,F,88120312,88122102,79109735,1790,220866450,5277,2
105378417,LOC105378417,chr10,R,88995787,89002993,79116941,7206,220873656,5278,2
105378418,LOC105378418,chr10,F,89179301,89194754,79132394,15453,220889109,5279,2
105378419,LOC105378419,chr10,R,89278359,89314581,79168616,36222,220925331,5280,3
105378420,LOC105378420,chr10,R,89646284,89650780,79173112,4496,220929827,5281,1
105378421,LOC105378421,chr10,F,89645413,89650718,79178417,5305,220935132,5282,4
105378422,LOC105378422,chr10,F,89531700,89592727,79239444,61027,220996159,5283,5
105378423,LOC105378423,chr10,F,89789147,89804646,79254943,15499,221011658,5284,1
105378424,LOC105378424,chr10,R,89823518,89830304,79261729,6786,221018444,5285,2
105378425,LOC105378425,chr10,F,90065756,90079837,79275810,14081,221032525,5286,2
105378426,LOC105378426,chr10,F,90173230,90175714,79278294,2484,221035009,5287,2
105378427,LOC105378427,chr10,F,90981962,90990537,79286869,8575,221043584,5288,1
105378428,LOC105378428,chr10,R,91186675,91199596,79299790,12921,221056505,5289,2
105378429,LOC105378429,chr10,F,91103139,91161299,79357950,58160,221114665,5290,5
105378430,LOC105378430,chr10,F,91033165,91040929,79365714,7764,221122429,5291,2
105378431,LOC105378431,chr10,R,90997578,91023424,79391560,25846,221148275,5292,2
105378432,LOC105378432,chr10,F,91575198,91580815,79397177,5617,221153892,5293,1
105378433,LOC105378433,chr10,F,91553335,91574916,79418758,21581,221175473,5294,3
105378434,LOC105378434,chr10,R,92555432,92573911,79437237,18479,221193952,5295,2
105378435,LOC105378435,chr10,R,93059296,93060500,79438441,1204,221195156,5296,1
105378436,LOC105378436,chr10,F,93556791,93561103,79442753,4312,221199468,5297,2
105378437,LOC105378437,chr10,R,93762879,93788911,79468785,26032,221225500,5298,6
105378438,LOC105378438,chr10,F,93987723,93993737,79474799,6014,221231514,5299,2
105378439,LOC105378439,chr10,R,96042610,96044341,79476530,1731,221233245,5300,1
105378440,LOC105378440,chr10,R,96021199,96022588,79477919,1389,221234634,5301,1
105378441,LOC105378441,chr10,R,95970300,95988250,79495869,17950,221252584,5302,2
105378442,LOC105378442,chr10,F,96627896,96640553,79508526,12657,221265241,5303,2
105378443,LOC105378443,chr10,F,96587097,96609704,79531133,22607,221287848,5304,2
105378444,LOC105378444,chr10,R,97077630,97102199,79555702,24569,221312417,5305,3
105378445,LOC105378445,chr10,F,97195884,97205977,79565795,10093,221322510,5306,3
105378446,LOC105378446,chr10,F,97215160,97219075,79569710,3915,221326425,5307,2
105378447,LOC105378447,chr10,F,97219138,97231983,79582555,12845,221339270,5308,3
105378448,LOC105378448,chr10,F,97335445,97343203,79590313,7758,221347028,5309,1
105378449,LOC105378449,chr10,F,98361314,98368518,79597517,7204,221354232,5310,2
105378450,LOC105378450,chr10,F,99624781,99653622,79626358,28841,221383073,5311,2
105378451,LOC105378451,chr10,F,100093044,100109690,79643004,16646,221399719,5312,2
105378452,LOC105378452,chr10,R,100463786,100479878,79659096,16092,221415811,5313,4
105378453,LOC105378453,chr10,F,101284451,101285679,79660324,1228,221417039,5314,2
105378454,LOC105378454,chr10,F,101311051,101313035,79662308,1984,221419023,5315,2
105378455,LOC105378455,chr10,F,101702064,101704752,79664996,2688,221421711,5316,1
105378456,LOC105378456,chr10,R,101701993,101704541,79667544,2548,221424259,5317,1
105378457,LOC105378457,chr10,F,101767135,101771576,79671985,4441,221428700,5318,2
105378458,LOC105378458,chr10,R,101735890,101767056,79703151,31166,221459866,5319,5
105378459,LOC105378459,chr10,F,102120239,102124115,79707027,3876,221463742,5320,4
105378460,LOC105378460,chr10,R,102650028,102655131,79712130,5103,221468845,5321,2
105378461,LOC105378461,chr10,R,102802753,102806129,79715506,3376,221472221,5322,1
105378462,LOC105378462,chr10,R,102866081,102869412,79718837,3331,221475552,5323,1
105378463,LOC105378463,chr10,F,103101338,103103172,79720671,1834,221477386,5324,1
105378464,LOC105378464,chr10,F,104566945,104624743,79778469,57798,221535184,5325,9
105378465,LOC105378465,chr10,R,105155148,105177761,79801082,22613,221557797,5326,4
105378466,LOC105378466,chr10,F,105328108,105346524,79819498,18416,221576213,5327,2
105378467,LOC105378467,chr10,R,105495883,105496919,79820534,1036,221577249,5328,1
105378468,LOC105378468,chr10,F,106011447,106014022,79823109,2575,221579824,5329,1
105378469,LOC105378469,chr10,R,106095793,106140098,79867414,44305,221624129,5330,6
105378470,LOC105378470,chr10,F,106140183,106157986,79885217,17803,221641932,5331,1
105378471,LOC105378471,chr10,F,106183791,106188591,79890017,4800,221646732,5332,3
105378472,LOC105378472,chr10,F,106567866,106571232,79893383,3366,221650098,5333,2
105378473,LOC105378473,chr10,F,106649103,106676640,79920920,27537,221677635,5334,3
105378474,LOC105378474,chr10,F,107367826,107404836,79957930,37010,221714645,5335,4
105378475,LOC105378475,chr10,R,107363298,107376386,79971018,13088,221727733,5336,2
105378476,LOC105378476,chr10,F,108252087,108295350,80014281,43263,221770996,5337,4
105378477,LOC105378477,chr10,R,108395653,108466397,80085025,70744,221841740,5338,6
105378478,LOC105378478,chr10,F,108710205,108761624,80136444,51419,221893159,5339,2
105378479,LOC105378479,chr10,R,110147954,110167921,80156411,19967,221913126,5340,5
105378480,LOC105378480,chr10,R,110220734,110223385,80159062,2651,221915777,5341,1
105378481,LOC105378481,chr10,R,110474347,110494740,80179455,20393,221936170,5342,1
105378482,LOC105378482,chr10,R,110428768,110460444,80211131,31676,221967846,5343,4
105378483,LOC105378483,chr10,R,110564736,110567588,80213983,2852,221970698,5344,1
105378484,LOC105378484,chr10,F,111400280,111410597,80224300,10317,221981015,5345,2
105378485,LOC105378485,chr10,F,111439299,111442826,80227827,3527,221984542,5346,2
105378486,LOC105378486,chr10,R,111635100,112083383,80676110,448283,222432825,5347,4
105378487,LOC105378487,chr10,R,112799579,112807617,80684148,8038,222440863,5348,2
105378488,LOC105378488,chr10,R,112950492,112957171,80690827,6679,222447542,5349,2
105378489,LOC105378489,chr10,R,113222942,113226906,80694791,3964,222451506,5350,2
105378490,LOC105378490,chr10,F,113306049,113320971,80709713,14922,222466428,5351,1
105378491,LOC105378491,chr10,F,113522763,113532132,80719082,9369,222475797,5352,2
105378492,LOC105378492,chr10,F,114008190,114022695,80733587,14505,222490302,5353,3
105378493,LOC105378493,chr10,F,114027352,114031286,80737521,3934,222494236,5354,2
105378494,LOC105378494,chr10,F,114320824,114326885,80743582,6061,222500297,5355,2
105378495,LOC105378495,chr10,F,114661395,114670580,80752767,9185,222509482,5356,2
105378496,LOC105378496,chr10,R,115072609,115087019,80767177,14410,222523892,5357,2
105378497,LOC105378497,chr10,R,115903251,115919160,80783086,15909,222539801,5358,3
105378498,LOC105378498,chr10,R,116769782,116773756,80787060,3974,222543775,5359,2
105378499,LOC105378499,chr10,F,116670185,116672738,80789613,2553,222546328,5360,2
105378500,LOC105378500,chr10,R,117240037,117242763,80792339,2726,222549054,5361,1
105378501,LOC105378501,chr10,R,117376963,117402556,80817932,25593,222574647,5362,2
105378502,LOC105378502,chr10,F,117436230,117455509,80837211,19279,222593926,5363,2
105378503,LOC105378503,chr10,R,117473214,117479160,80843157,5946,222599872,5364,1
105378504,LOC105378504,chr10,R,117935020,117940266,80848403,5246,222605118,5365,2
105378505,LOC105378505,chr10,R,118260469,118270163,80858097,9694,222614812,5366,2
105378506,LOC105378506,chr10,F,118297666,118302782,80863213,5116,222619928,5367,1
105378507,LOC105378507,chr10,F,118498174,118507761,80872800,9587,222629515,5368,3
105378508,LOC105378508,chr10,R,118783979,118866308,80955129,82329,222711844,5369,2
105378509,LOC105378509,chr10,R,118900895,118902516,80956750,1621,222713465,5370,2
105378510,LOC105378510,chr10,R,119426743,119429244,80959251,2501,222715966,5371,1
105378511,LOC105378511,chr10,R,119334629,119336432,80961054,1803,222717769,5372,1
105378512,LOC105378512,chr10,F,119595563,119599806,80965297,4243,222722012,5373,1
105378513,LOC105378513,chr10,R,119792972,119818208,80990533,25236,222747248,5374,3
105378514,LOC105378514,chr10,R,119724998,119726193,80991728,1195,222748443,5375,1
105378515,LOC105378515,chr10,F,120181238,120337537,81148027,156299,222904742,5376,8
105378516,LOC105378516,chr10,F,120815002,120825307,81158332,10305,222915047,5377,5
105378517,LOC105378517,chr10,F,120608591,120814855,81364596,206264,223121311,5378,3
105378518,LOC105378518,chr10,F,120954166,120954817,81365247,651,223121962,5379,1
105378519,LOC105378519,chr10,R,120902267,120980750,81443730,78483,223200445,5380,2
105378520,LOC105378520,chr10,R,120984965,120996754,81455519,11789,223212234,5381,3
105378521,LOC105378521,chr10,R,121037804,121077465,81495180,39661,223251895,5382,4
105378522,LOC105378522,chr10,F,121129538,121156053,81521695,26515,223278410,5383,2
105378523,LOC105378523,chr10,R,121291287,121322945,81553353,31658,223310068,5384,2
105378524,LOC105378524,chr10,F,122417974,122423094,81558473,5120,223315188,5385,1
105378525,LOC105378525,chr10,R,122449052,122461358,81570779,12306,223327494,5386,3
105378526,LOC105378526,chr10,F,122489632,122493965,81575112,4333,223331827,5387,2
105378527,LOC105378527,chr10,F,122478643,122484021,81580490,5378,223337205,5388,1
105378528,LOC105378528,chr10,R,122588146,122600983,81593327,12837,223350042,5389,3
105378529,LOC105378529,chr10,F,123558624,123562220,81596923,3596,223353638,5390,3
105378530,LOC105378530,chr10,R,123543130,123561427,81615220,18297,223371935,5391,3
105378531,LOC105378531,chr10,F,123352685,123558526,81821061,205841,223577776,5392,24
105378532,LOC105378532,chr10,R,123702975,123713482,81831568,10507,223588283,5393,5
105378533,LOC105378533,chr10,F,123776757,123777850,81832661,1093,223589376,5394,1
105378534,LOC105378534,chr10,F,123893411,123894324,81833574,913,223590289,5395,2
105378535,LOC105378535,chr10,R,123912911,123944112,81864775,31201,223621490,5396,2
105378536,LOC105378536,chr10,R,124133795,124151258,81882238,17463,223638953,5397,4
105378537,LOC105378537,chr10,R,124546808,124548753,81884183,1945,223640898,5398,1
105378538,LOC105378538,chr10,F,124623610,124629802,81890375,6192,223647090,5399,1
105378539,LOC105378539,chr10,F,124616751,124621928,81895552,5177,223652267,5400,1
105378540,LOC105378540,chr10,F,124998178,125001494,81898868,3316,223655583,5401,1
105378541,LOC105378541,chr10,F,125228566,125234053,81904355,5487,223661070,5402,3
105378542,LOC105378542,chr10,F,125263100,125275272,81916527,12172,223673242,5403,2
105378543,LOC105378543,chr10,R,125453387,125494138,81957278,40751,223713993,5404,3
105378544,LOC105378544,chr10,F,125521864,125531051,81966465,9187,223723180,5405,2
105378545,LOC105378545,chr10,F,125536832,125539786,81969419,2954,223726134,5406,2
105378546,LOC105378546,chr10,R,125544087,125555556,81980888,11469,223737603,5407,2
105378547,LOC105378547,chr10,R,125567330,125574268,81987826,6938,223744541,5408,2
105378548,LOC105378548,chr10,F,126607546,126616525,81996805,8979,223753520,5409,4
105378549,LOC105378549,chr10,F,126496846,126503185,82003144,6339,223759859,5410,3
105378550,LOC105378550,chr10,R,126903417,126905140,82004867,1723,223761582,5411,1
105378551,LOC105378551,chr10,R,127363311,127396674,82038230,33363,223794945,5412,3
105378552,LOC105378552,chr10,R,127000316,127026424,82064338,26108,223821053,5413,5
105378553,LOC105378553,chr10,R,128056196,128063076,82071218,6880,223827933,5414,2
105378554,LOC105378554,chr10,R,128685403,128691379,82077194,5976,223833909,5415,2
105378555,LOC105378555,chr10,F,128781953,128813103,82108344,31150,223865059,5416,4
105378556,LOC105378556,chr10,F,129366282,129368689,82110751,2407,223867466,5417,1
105378557,LOC105378557,chr10,R,129370327,129381122,82121546,10795,223878261,5418,2
105378558,LOC105378558,chr10,F,129859709,129867134,82128971,7425,223885686,5419,2
105378559,LOC105378559,chr10,F,129768364,129770983,82131590,2619,223888305,5420,1
105378560,LOC105378560,chr10,F,129715441,129717867,82134016,2426,223890731,5421,1
105378562,LOC105378562,chr10,R,130685607,130697052,82145461,11445,223902176,5422,3
105378563,LOC105378563,chr10,R,131202552,131208816,82151725,6264,223908440,5423,3
105378564,LOC105378564,chr10,R,131830525,131833634,82154834,3109,223911549,5424,1
105378565,LOC105378565,chr10,R,131860661,131875324,82169497,14663,223926212,5425,1
105378566,LOC105378566,chr10,F,131875450,131879783,82173830,4333,223930545,5426,2
105378567,LOC105378567,chr10,R,132178444,132184283,82179669,5839,223936384,5427,2
105378568,LOC105378568,chr10,R,132434605,132442346,82187410,7741,223944125,5428,2
105378569,LOC105378569,chr10,F,132460588,132466073,82192895,5485,223949610,5429,2
105378570,LOC105378570,chr10,R,132455088,132464024,82201831,8936,223958546,5430,2
105378571,LOC105378571,chr10,F,132849212,132857536,82210155,8324,223966870,5431,4
105378572,LOC105378572,chr10,F,132943366,132947851,82214640,4485,223971355,5432,2
105378573,LOC105378573,chr10,R,133202192,133218824,82231272,16632,223987987,5433,4
105378574,LOC105378574,chr10,R,133194486,133195631,82232417,1145,223989132,5434,1
105378575,LOC105378575,chr10,R,133491451,133514259,82255225,22808,224011940,5435,2
105378576,LOC105378576,chr10,R,133462355,133464555,82257425,2200,224014140,5436,1
105378577,LOC105378577,chr10,F,46283256,46285118,82259287,1862,224016002,5437,1
105378578,LOC105378578,chr10,F,85148130,85156883,82268040,8753,224024755,5438,1
105378579,LOC105378579,chr10,R,119198556,119207578,82277062,9022,224033777,5439,3
38,ACAT1,chr11,F,108121530,108148168,26638,26638,224060415,5440,13
53,ACP2,chr11,R,47239301,47248847,36184,9546,224069961,5441,11
56,ACRV1,chr11,R,125672333,125680898,44749,8565,224078526,5442,3
89,ACTN3,chr11,F,66546394,66563329,61684,16935,224095461,5443,21
133,ADM,chr11,F,10304979,10307402,64107,2423,224097884,5444,3
156,ADRBK1,chr11,F,67266399,67286558,84266,20159,224118043,5445,21
161,AP2A2,chr11,F,925808,1012245,170703,86437,224204480,5446,24
187,APLNR,chr11,R,57233576,57237453,174580,3877,224208357,5447,0
221,ALDH3B1,chr11,F,68008546,68029282,195316,20736,224229093,5448,10
222,ALDH3B2,chr11,R,67662154,67681214,214376,19060,224248153,5449,10
272,AMPD3,chr11,F,10450320,10507579,271635,57259,224305412,5450,18
322,APBB1,chr11,R,6395123,6419472,295984,24349,224329761,5451,16
329,BIRC2,chr11,F,102347181,102378670,327473,31489,224361250,5452,8
330,BIRC3,chr11,F,102317372,102339403,349504,22031,224383281,5453,8
334,APLP2,chr11,F,130069820,130144811,424495,74991,224458272,5454,18
335,APOA1,chr11,R,116835750,116837647,426392,1897,224460169,5455,3
337,APOA4,chr11,R,116820701,116823295,428986,2594,224462763,5456,2
345,APOC3,chr11,F,116829907,116833071,432150,3164,224465927,5457,3
372,ARCN1,chr11,F,118572386,118603033,462797,30647,224496574,5458,9
391,RHOG,chr11,R,3826977,3840983,476803,14006,224510580,5459,2
392,ARHGAP1,chr11,R,46677074,46700665,500394,23591,224534171,5460,13
401,PHOX2A,chr11,R,72239076,72244176,505494,5100,224539271,5461,2
402,ARL2,chr11,F,65014112,65022185,513567,8073,224547344,5462,4
406,ARNTL,chr11,F,13277726,13387811,623652,110085,224657429,5463,20
408,ARRB1,chr11,R,75260121,75351831,715362,91710,224749139,5464,18
417,ART1,chr11,F,3642233,3665075,738204,22842,224771981,5465,6
430,ASCL2,chr11,R,2268497,2270952,740659,2455,224774436,5466,1
472,ATM,chr11,F,108222499,108369102,887262,146603,224921039,5467,68
486,FXYD2,chr11,R,117820074,117828092,895280,8018,224929057,5468,6
572,BAD,chr11,R,64269827,64284704,910157,14877,224943934,5469,2
582,BBS1,chr11,F,66510647,66533613,933123,22966,224966900,5470,16
595,CCND1,chr11,F,69641104,69654474,946493,13370,224980270,5471,5
627,BDNF,chr11,R,27654892,27722058,1013659,67166,225047436,5472,10
643,CXCR5,chr11,F,118883765,118896271,1026165,12506,225059942,5473,1
710,SERPING1,chr11,F,57597553,57614853,1043465,17300,225077242,5474,7
726,CAPN5,chr11,F,77066944,77126155,1102676,59211,225136453,5475,13
738,VPS51,chr11,F,65096114,65111860,1118422,15746,225152199,5476,9
740,MRPL49,chr11,F,65122182,65127369,1123609,5187,225157386,5477,3
741,ZNHIT2,chr11,R,65116402,65117738,1124945,1336,225158722,5478,0
744,MPPED2,chr11,R,30384492,30586714,1327167,202222,225360944,5479,13
745,MYRF,chr11,F,61752636,61788518,1363049,35882,225396826,5480,27
746,TMEM258,chr11,R,61789129,61792613,1366533,3484,225400310,5481,3
747,DAGLA,chr11,F,61680432,61747002,1433103,66570,225466880,5482,22
796,CALCA,chr11,R,14966668,14972286,1438721,5618,225472498,5483,5
797,CALCB,chr11,F,15073599,15078631,1443753,5032,225477530,5484,4
823,CAPN1,chr11,F,65181214,65212006,1474545,30792,225508322,5485,23
833,CARS,chr11,R,3000921,3057451,1531075,56530,225564852,5486,22
834,CASP1,chr11,R,105025507,105036662,1542230,11155,225576007,5487,9
837,CASP4,chr11,R,104942865,104968598,1567963,25733,225601740,5488,9
838,CASP5,chr11,R,104992632,105023221,1598552,30589,225632329,5489,9
847,CAT,chr11,F,34438924,34472060,1631688,33136,225665465,5490,12
867,CBL,chr11,F,119206275,119308149,1733562,101874,225767339,5491,16
871,SERPINH1,chr11,F,75562055,75572804,1744311,10749,225778088,5492,7
887,CCKBR,chr11,F,6259610,6272127,1756828,12517,225790605,5493,4
915,CD3D,chr11,R,118339073,118342744,1760499,3671,225794276,5494,4
916,CD3E,chr11,F,118304579,118316175,1772095,11596,225805872,5495,8
917,CD3G,chr11,F,118344315,118353782,1781562,9467,225815339,5496,6
921,CD5,chr11,F,61102457,61127852,1806957,25395,225840734,5497,10
923,CD6,chr11,F,60971640,61020377,1855694,48737,225889471,5498,12
931,MS4A1,chr11,F,60455808,60470752,1870638,14944,225904415,5499,7
932,MS4A3,chr11,F,60056627,60071116,1885127,14489,225918904,5500,7
960,CD44,chr11,F,35138869,35232402,1978660,93533,226012437,5501,20
966,CD59,chr11,R,33703009,33736479,2012130,33470,226045907,5502,6
975,CD81,chr11,F,2376176,2397419,2033373,21243,226067150,5503,9
977,CD151,chr11,F,832951,838835,2039257,5884,226073034,5504,8
1028,CDKN1C,chr11,R,2883217,2885816,2041856,2599,226075633,5505,2
1072,CFL1,chr11,R,65854810,65858333,2045379,3523,226079156,5506,3
1075,CTSC,chr11,R,88293591,88337773,2089561,44182,226123338,5507,8
1111,CHEK1,chr11,F,125624919,125676259,2140901,51340,226174678,5508,14
1119,CHKA,chr11,R,68052858,68121391,2209434,68533,226243211,5509,15
1128,CHRM1,chr11,R,62908678,62921861,2222617,13183,226256394,5510,2
1132,CHRM4,chr11,R,46384791,46386608,2224434,1817,226258211,5511,0
1200,TPP1,chr11,R,6612765,6619461,2231130,6696,226264907,5512,12
1207,CLNS1A,chr11,R,77616150,77637806,2252786,21656,226286563,5513,6
1262,CNGA4,chr11,F,6234773,6245924,2263937,11151,226297714,5514,6
1270,CNTF,chr11,F,58622672,58625733,2266998,3061,226300775,5515,12
1315,COPB1,chr11,R,14457502,14499895,2309391,42393,226343168,5516,21
1351,COX8A,chr11,F,63974606,63976543,2311328,1937,226345105,5517,1
1374,CPT1A,chr11,R,68754619,68841931,2398640,87312,226432417,5518,20
1408,CRY2,chr11,F,45847117,45883248,2434771,36131,226468548,5519,12
1410,CRYAB,chr11,R,111908619,111913213,2439365,4594,226473142,5520,5
1474,CST6,chr11,F,66011990,66013505,2440880,1515,226474657,5521,2
1479,CSTF3,chr11,R,33084583,33161491,2517788,76908,226551565,5522,20
1500,CTNND1,chr11,F,57761761,57819180,2575207,57419,226608984,5523,20
1509,CTSD,chr11,R,1752751,1763992,2586448,11241,226620225,5524,8
1521,CTSW,chr11,F,65879812,65883741,2590377,3929,226624154,5525,9
1642,DDB1,chr11,R,61299446,61333212,2624143,33766,226657920,5526,26
1643,DDB2,chr11,F,47214941,47239218,2648420,24277,226682197,5527,9
1656,DDX6,chr11,R,118747762,118791263,2691921,43501,226725698,5528,14
1662,DDX10,chr11,F,108665024,108940930,2967827,275906,227001604,5529,18
1717,DHCR7,chr11,R,71434410,71448431,2981848,14021,227015625,5530,8
1737,DLAT,chr11,F,112024813,112064278,3021313,39465,227055090,5531,13
1740,DLG2,chr11,R,83455011,85628534,5194836,2173523,229228613,5532,38
1798,DPAGT1,chr11,R,119096502,119102414,5200748,5912,229234525,5533,7
1813,DRD2,chr11,R,113409594,113475279,5266433,65685,229300210,5534,7
1815,DRD4,chr11,F,637304,640706,5269835,3402,229303612,5535,3
1850,DUSP8,chr11,R,1554050,1572831,5288616,18781,229322393,5536,8
1937,EEF1G,chr11,R,62559600,62573988,5303004,14388,229336781,5537,9
1982,EIF4G2,chr11,R,10797045,10809035,5314994,11990,229348771,5538,22
2001,ELF5,chr11,R,34478794,34513800,5350000,35006,229383777,5539,7
2011,MARK2,chr11,F,63838927,63911020,5422093,72093,229455870,5540,20
2017,CTTN,chr11,F,70398505,70436584,5460172,38079,229493949,5541,18
2101,ESRRA,chr11,F,64305527,64316743,5471388,11216,229505165,5542,7
2113,ETS1,chr11,R,128458760,128587584,5600212,128824,229633989,5543,11
2132,EXT2,chr11,F,44095548,44245430,5750094,149882,229783871,5544,16
2147,F2,chr11,F,46719191,46739506,5770409,20315,229804186,5545,13
2188,FANCF,chr11,R,22622532,22625841,5773718,3309,229807495,5546,0
2197,FAU,chr11,R,65120626,65122200,5775292,1574,229809069,5547,4
2206,MS4A2,chr11,F,60088260,60098467,5785499,10207,229819276,5548,7
2230,FDX1,chr11,F,110429936,110464884,5820447,34948,229854224,5549,3
2237,FEN1,chr11,F,61792636,61797244,5825055,4608,229858832,5550,1
2248,FGF3,chr11,R,69809967,69819424,5834512,9457,229868289,5551,2
2249,FGF4,chr11,R,69759042,69775403,5850873,16361,229884650,5552,4
2286,FKBP2,chr11,F,64240940,64244135,5854068,3195,229887845,5553,7
2313,FLI1,chr11,F,128686534,128813267,5980801,126733,230014578,5554,12
2346,FOLH1,chr11,R,49146634,49208670,6042837,62036,230076614,5555,19
2348,FOLR1,chr11,F,72189557,72196323,6049603,6766,230083380,5556,6
2350,FOLR2,chr11,F,72216774,72221950,6054779,5176,230088556,5557,5
2352,FOLR3,chr11,F,72135681,72139892,6058990,4211,230092767,5558,5
2488,FSHB,chr11,F,30230687,30235277,6063580,4590,230097357,5559,3
2495,FTH1,chr11,R,61964284,61967660,6066956,3376,230100733,5560,3
2526,FUT4,chr11,F,94543850,94549898,6073004,6048,230106781,5561,0
2542,SLC37A4,chr11,R,119024350,119030906,6079560,6556,230113337,5562,11
2615,LRRC32,chr11,R,76657523,76670946,6092983,13423,230126760,5563,3
2620,GAS2,chr11,F,22627052,22813001,6278932,185949,230312709,5564,15
2694,GIF,chr11,R,59829267,59845537,6295202,16270,230328979,5565,8
2785,GNG3,chr11,F,62706421,62709206,6297987,2785,230331764,5566,4
2893,GRIA4,chr11,F,105609993,105982092,6670086,372099,230703863,5567,22
2900,GRIK4,chr11,F,120511745,120988805,7147146,477060,231180923,5568,26
2915,GRM5,chr11,R,88504575,89065961,7708532,561386,231742309,5569,12
2950,GSTP1,chr11,F,67583594,67586653,7711591,3059,231745368,5570,6
2965,GTF2H1,chr11,F,18322268,18367043,7756366,44775,231790143,5571,16
2977,GUCY1A2,chr11,R,106674011,107018445,8100800,344434,232134577,5572,8
3014,H2AFX,chr11,R,119093873,119095467,8102394,1594,232136171,5573,0
3043,HBB,chr11,R,5225465,5227071,8104000,1606,232137777,5574,2
3044,HBBP1,chr11,R,5241953,5243592,8105639,1639,232139416,5575,2
3045,HBD,chr11,R,5232828,5234628,8107439,1800,232141216,5576,2
3046,HBE1,chr11,R,5268344,5281945,8121040,13601,232154817,5577,4
3047,HBG1,chr11,R,5248271,5249857,8122626,1586,232156403,5578,2
3048,HBG2,chr11,R,5253190,5254781,8124217,1591,232157994,5579,2
3145,HMBS,chr11,F,119084875,119093549,8132891,8674,232166668,5580,14
3177,SLC29A2,chr11,R,66362520,66372476,8142847,9956,232176624,5581,12
3263,HPX,chr11,R,6431037,6441024,8152834,9987,232186611,5582,9
3265,HRAS,chr11,R,532241,535561,8156154,3320,232189931,5583,5
3312,HSPA8,chr11,R,123057491,123062366,8161029,4875,232194806,5584,9
3316,HSPB2,chr11,F,111912735,111914093,8162387,1358,232196164,5585,1
3338,DNAJC4,chr11,F,64230233,64234281,8166435,4048,232200212,5586,5
3359,HTR3A,chr11,F,113975074,113990313,8181674,15239,232215451,5587,8
3481,IGF2,chr11,R,2129111,2149603,8202166,20492,232235943,5588,8
3508,IGHMBP2,chr11,F,68903850,68940601,8238917,36751,232272694,5589,17
3587,IL10RA,chr11,F,117986390,118001483,8254010,15093,232287787,5590,7
3606,IL18,chr11,R,112143250,112164117,8274877,20867,232308654,5591,5
3611,ILK,chr11,F,6603707,6610874,8282044,7167,232315821,5592,11
3619,INCENP,chr11,F,62123972,62153163,8311235,29191,232345012,5593,18
3630,INS,chr11,R,2159778,2161209,8312666,1431,232346443,5594,7
3636,INPPL1,chr11,F,72223865,72239147,8327948,15282,232361725,5595,28
3665,IRF7,chr11,R,612552,615999,8331395,3447,232365172,5596,9
3703,STT3A,chr11,F,125592794,125622759,8361360,29965,232395137,5597,20
3732,CD82,chr11,F,44564426,44620363,8417297,55937,232451074,5598,12
3739,KCNA4,chr11,R,30009740,30017030,8424587,7290,232458364,5599,1
3746,KCNC1,chr11,F,17735909,17864288,8552966,128379,232586743,5600,5
3758,KCNJ1,chr11,R,128838013,128867373,8582326,29360,232616103,5601,4
3762,KCNJ5,chr11,F,128891417,128921163,8612072,29746,232645849,5602,4
3767,KCNJ11,chr11,R,17364823,17389331,8636580,24508,232670357,5603,3
3784,KCNQ1,chr11,F,2444990,2849110,9040700,404120,233074477,5604,16
3846,KRTAP5-9,chr11,F,71548419,71549607,9041888,1188,233075665,5605,0
3939,LDHA,chr11,F,18394388,18408218,9055718,13830,233089495,5606,8
3948,LDHC,chr11,F,18412305,18451246,9094659,38941,233128436,5607,7
3992,FADS1,chr11,R,61799624,61817057,9112092,17433,233145869,5608,12
3995,FADS3,chr11,R,61873522,61891545,9130115,18023,233163892,5609,11
4004,LMO1,chr11,R,8224303,8268635,9174447,44332,233208224,5610,9
4005,LMO2,chr11,R,33858575,33892289,9208161,33714,233241938,5611,6
4013,VWA5A,chr11,F,124115403,124146912,9239670,31509,233273447,5612,18
4038,LRP4,chr11,R,46856716,46918622,9301576,61906,233335353,5613,40
4041,LRP5,chr11,F,68298865,68449275,9451986,150410,233485763,5614,26
4046,LSP1,chr11,F,1852969,1892263,9491280,39294,233525057,5615,15
4054,LTBP3,chr11,R,65538558,65558361,9511083,19803,233544860,5616,27
4076,CAPRIN1,chr11,F,34051616,34102610,9562077,50994,233595854,5617,18
4135,MAP6,chr11,R,75586913,75668730,9643894,81817,233677671,5618,9
4162,MCAM,chr11,R,119308523,119317130,9652501,8607,233686278,5619,15
4192,MDK,chr11,F,46380783,46383837,9655555,3054,233689332,5620,4
4221,MEN1,chr11,R,64803513,64811294,9663336,7781,233697113,5621,11
4246,SCGB2A1,chr11,F,62208667,62213939,9668608,5272,233702385,5622,2
4250,SCGB2A2,chr11,F,62269932,62273160,9671836,3228,233705613,5623,2
4296,MAP3K11,chr11,R,65597754,65614338,9688420,16584,233722197,5624,10
4297,KMT2A,chr11,F,118436489,118526824,9778755,90335,233812532,5625,36
4312,MMP1,chr11,R,102789909,102798235,9787081,8326,233820858,5626,9
4314,MMP3,chr11,R,102835796,102843611,9794896,7815,233828673,5627,9
4316,MMP7,chr11,R,102520507,102530747,9805136,10240,233838913,5628,5
4317,MMP8,chr11,R,102711794,102724964,9818306,13170,233852083,5629,11
4319,MMP10,chr11,R,102770501,102780628,9828433,10127,233862210,5630,9
4321,MMP12,chr11,R,102862732,102875034,9840735,12302,233874512,5631,9
4322,MMP13,chr11,R,102942991,102955734,9853478,12743,233887255,5632,9
4361,MRE11A,chr11,R,94415577,94512185,9950086,96608,233983863,5633,21
4544,MTNR1B,chr11,F,92969622,92986240,9966704,16618,234000481,5634,2
4583,MUC2,chr11,F,1074874,1110508,10002338,35634,234036115,5635,50
4586,MUC5AC,chr11,F,1157952,1201138,10045524,43186,234079301,5636,48
4588,MUC6,chr11,R,1012823,1036706,10069407,23883,234103184,5637,32
4607,MYBPC3,chr11,R,47331405,47352702,10090704,21297,234124481,5638,34
4647,MYO7A,chr11,F,77128213,77215241,10177732,87028,234211509,5639,54
4654,MYOD1,chr11,F,17719562,17722131,10180301,2569,234214078,5640,2
4676,NAP1L4,chr11,R,2944429,2992377,10228249,47948,234262026,5641,15
4684,NCAM1,chr11,F,112961246,113278436,10545439,317190,234579216,5642,24
4718,NDUFC2,chr11,R,78068346,78080219,10557312,11873,234591089,5643,3
4722,NDUFS3,chr11,F,47579009,47584563,10562866,5554,234596643,5644,6
4723,NDUFV1,chr11,F,67606851,67612541,10568556,5690,234602333,5645,9
4728,NDUFS8,chr11,F,68030616,68036647,10574587,6031,234608364,5646,7
4745,NELL1,chr11,F,20669550,21575686,11480723,906136,235514500,5647,21
4798,NFRKB,chr11,R,129863772,129895595,11512546,31823,235546323,5648,28
4837,NNMT,chr11,F,114295812,114312516,11529250,16704,235563027,5649,66
4863,NPAT,chr11,R,108157214,108222638,11594674,65424,235628451,5650,17
4900,NRGN,chr11,F,124739932,124747206,11601948,7274,235635725,5651,3
4925,NUCB2,chr11,F,17260336,17349980,11691592,89644,235725369,5652,22
4926,NUMA1,chr11,R,72002863,72080693,11769422,77830,235803199,5653,36
4928,NUP98,chr11,R,3675009,3797792,11892205,122783,235925982,5654,34
4975,OMP,chr11,F,77102839,77103331,11892697,492,235926474,5655,0
4978,OPCML,chr11,R,132414980,133532508,13010225,1117528,237044002,5656,8
5002,SLC22A18,chr11,F,2899720,2925246,13035751,25526,237069528,5657,17
5003,SLC22A18AS,chr11,R,2887343,2903945,13052353,16602,237086130,5658,3
5007,OSBP,chr11,R,59574397,59616144,13094100,41747,237127877,5659,13
5017,OVOL1,chr11,F,65787033,65797219,13104286,10186,237138063,5660,6
5024,P2RX3,chr11,F,57335945,57372399,13140740,36454,237174517,5661,15
5029,P2RY2,chr11,F,73216447,73242427,13166720,25980,237200497,5662,5
5031,P2RY6,chr11,F,73264495,73298625,13200850,34130,237234627,5663,7
5049,PAFAH1B2,chr11,F,117144283,117178173,13234740,33890,237268517,5664,8
5058,PAK1,chr11,R,77321550,77474063,13387253,152513,237421030,5665,18
5080,PAX6,chr11,R,31784791,31817961,13420423,33170,237454200,5666,18
5091,PC,chr11,R,66848521,66958376,13530278,109855,237564055,5667,31
5138,PDE2A,chr11,R,72576139,72674453,13628592,98314,237662369,5668,34
5140,PDE3B,chr11,F,14643655,14872059,13856996,228404,237890773,5669,15
5222,PGA5,chr11,F,61241156,61251457,13867297,10301,237901074,5670,8
5241,PGR,chr11,R,101029623,101130668,13968342,101045,238002119,5671,9
5286,PIK3C2A,chr11,R,17086560,17207996,14089778,121436,238123555,5672,33
5331,PLCB3,chr11,F,64251522,64269452,14107708,17930,238141485,5673,30
5436,POLR2G,chr11,F,62761538,62766715,14112885,5177,238146662,5674,7
5441,POLR2L,chr11,R,839720,842529,14115694,2809,238149471,5675,1
5450,POU2AF1,chr11,R,111352250,111379432,14142876,27182,238176653,5676,8
5499,PPP1CA,chr11,R,67398180,67401905,14146601,3725,238180378,5677,6
5519,PPP2R1B,chr11,R,111695073,111766445,14217973,71372,238251750,5678,21
5526,PPP2R5B,chr11,F,64917552,64934478,14234899,16926,238268676,5679,16
5547,PRCP,chr11,R,82824366,82901691,14312224,77325,238346001,5680,10
5553,PRG2,chr11,R,57386786,57390657,14316095,3871,238349872,5681,5
5612,PRKRIR,chr11,R,76349955,76380965,14347105,31010,238380882,5682,5
5682,PSMA1,chr11,R,14504875,14643634,14485864,138759,238519641,5683,11
5702,PSMC3,chr11,R,47418768,47426473,14493569,7705,238527346,5684,11
5719,PSMD13,chr11,F,236807,252984,14509746,16177,238543523,5685,11
5741,PTH,chr11,R,13492053,13496020,14513713,3967,238547490,5686,2
5790,PTPRCAP,chr11,R,67435509,67437682,14515886,2173,238549663,5687,1
5795,PTPRJ,chr11,F,47980557,48170842,14706171,190285,238739948,5688,26
5805,PTS,chr11,F,112226364,112233973,14713780,7609,238747557,5689,6
5818,PVRL1,chr11,R,119638097,119728725,14804408,90628,238838185,5690,9
5837,PYGM,chr11,R,64746388,64760715,14818735,14327,238852512,5691,19
5866,RAB3IL1,chr11,R,61897239,61946311,14867807,49072,238901584,5692,13
5870,RAB6A,chr11,R,73675637,73761156,14953326,85519,238987103,5693,9
5871,MAP4K2,chr11,R,64789136,64803248,14967438,14112,239001215,5694,31
5883,RAD9A,chr11,F,67391951,67398412,14973899,6461,239007676,5695,9
5896,RAG1,chr11,F,36510399,36579762,15043262,69363,239077039,5696,4
5897,RAG2,chr11,R,36591942,36598279,15049599,6337,239083376,5697,2
5913,RAPSN,chr11,R,47437756,47449178,15061021,11422,239094798,5698,7
5920,RARRES3,chr11,F,63536800,63546458,15070679,9658,239104456,5699,3
5936,RBM4,chr11,F,66638616,66668385,15100448,29769,239134225,5700,4
5954,RCN1,chr11,F,32090930,32105726,15115244,14796,239149021,5701,5
5962,RDX,chr11,R,110174879,110296712,15237077,121833,239270854,5702,16
5970,RELA,chr11,R,65653595,65662972,15246454,9377,239280231,5703,10
5977,DPF2,chr11,F,65333753,65352980,15265681,19227,239299458,5704,11
6050,RNH1,chr11,R,494511,507283,15278453,12772,239312230,5705,13
6079,SNORD15A,chr11,F,75400390,75400538,15278601,148,239312378,5706,0
6094,ROM1,chr11,F,62612740,62615120,15280981,2380,239314758,5707,2
6150,MRPL23,chr11,F,1947271,2014017,15347727,66746,239381504,5708,11
6157,RPL27A,chr11,F,8682447,8689872,15355152,7425,239388929,5709,4
6181,RPLP2,chr11,F,809935,812876,15358093,2941,239391870,5710,4
6188,RPS3,chr11,F,75399490,75422302,15380905,22812,239414682,5711,7
6199,RPS6KB2,chr11,F,67428459,67435408,15387854,6949,239421631,5712,15
6207,RPS13,chr11,R,17074391,17077673,15391136,3282,239424913,5713,5
6230,RPS25,chr11,R,119015711,119018347,15393772,2636,239427549,5714,4
6240,RRM1,chr11,F,4094560,4138881,15438093,44321,239471870,5715,19
6288,SAA1,chr11,F,18266260,18269977,15441810,3717,239475587,5716,3
6289,SAA2,chr11,R,18238232,18248674,15452252,10442,239486029,5717,4
6290,SAA3P,chr11,R,18112471,18116132,15455913,3661,239489690,5718,2
6291,SAA4,chr11,R,18231354,18236837,15461396,5483,239495173,5719,3
6309,SC5D,chr11,F,121292678,121313410,15482128,20732,239515905,5720,5
6327,SCN2B,chr11,R,118162803,118176622,15495947,13819,239529724,5721,3
6330,SCN4B,chr11,R,118133376,118152915,15515486,19539,239549263,5722,4
6343,SCT,chr11,R,624988,627240,15517738,2252,239551515,5723,4
6392,SDHD,chr11,F,112086823,112095801,15526716,8978,239560493,5724,5
6484,ST3GAL4,chr11,F,126355644,126652917,15823989,297273,239857766,5725,18
6494,SIPA1,chr11,F,65638106,65650930,15836813,12824,239870590,5726,19
6506,SLC1A2,chr11,R,35251204,35420063,16005672,168859,240039449,5727,15
6520,SLC3A2,chr11,F,62856011,62888883,16038544,32872,240072321,5728,13
6588,SLN,chr11,R,107707374,107712061,16043231,4687,240077008,5729,1
6609,SMPD1,chr11,F,6390300,6394998,16047929,4698,240081706,5730,5
6653,SORL1,chr11,F,121452202,121633762,16229489,181560,240263266,5731,50
6688,SPI1,chr11,R,47354857,47395640,16270272,40783,240304049,5732,9
6712,SPTBN2,chr11,R,66682495,66729237,16317014,46742,240350791,5733,40
6734,SRPR,chr11,R,126262918,126268982,16323078,6064,240356855,5734,13
6737,TRIM21,chr11,R,4384896,4393712,16331894,8816,240365671,5735,6
6749,SSRP1,chr11,R,57325984,57335877,16341787,9893,240375564,5736,17
6764,ST5,chr11,R,8693351,8910951,16559387,217600,240593164,5737,37
6768,ST14,chr11,F,130159786,130210362,16609963,50576,240643740,5738,18
6786,STIM1,chr11,F,3855702,4093210,16847471,237508,240881248,5739,12
6809,STX3,chr11,F,59755058,59805882,16898295,50824,240932072,5740,11
6811,STX5,chr11,R,62806859,62832091,16923527,25232,240957304,5741,11
6833,ABCC8,chr11,R,17392884,17476845,17007488,83961,241041265,5742,39
6876,TAGLN,chr11,F,117199323,117204792,17012957,5469,241046734,5743,4
6881,TAF10,chr11,R,6610816,6612244,17014385,1428,241048162,5744,4
6888,TALDO1,chr11,F,747431,765024,17031978,17593,241065755,5745,7
6947,TCN1,chr11,R,59852807,59866568,17045739,13761,241079516,5746,8
7003,TEAD1,chr11,F,12674421,12944737,17316055,270316,241349832,5747,12
7007,TECTA,chr11,F,121102665,121190806,17404196,88141,241437973,5748,22
7054,TH,chr11,R,2163928,2172137,17412405,8209,241446182,5749,13
7069,THRSP,chr11,F,78063860,78068357,17416902,4497,241450679,5750,1
7070,THY1,chr11,R,119417944,119423536,17422494,5592,241456271,5751,3
7106,TSPAN4,chr11,F,842823,867116,17446787,24293,241480564,5752,12
7108,TM7SF2,chr11,F,65111853,65116235,17451169,4382,241484946,5753,9
7136,TNNI2,chr11,F,1839002,1841680,17453847,2678,241487624,5754,9
7140,TNNT3,chr11,F,1919561,1938706,17472992,19145,241506769,5755,20
7166,TPH1,chr11,R,18020536,18040788,17493244,20252,241527021,5756,9
7189,TRAF6,chr11,R,36483766,36510313,17519791,26547,241553568,5757,7
7221,TRPC2,chr11,F,3626459,3637559,17530891,11100,241564668,5758,6
7225,TRPC6,chr11,R,101451563,101584018,17663346,132455,241697123,5759,13
7251,TSG101,chr11,R,18480310,18526956,17709992,46646,241743769,5760,10
7262,PHLDA2,chr11,R,2928272,2929420,17711140,1148,241744917,5761,1
7275,TUB,chr11,F,8019179,8106241,17798202,87062,241831979,5762,15
7299,TYR,chr11,F,89177857,89295759,17916104,117902,241949881,5763,5
7351,UCP2,chr11,R,73974670,73982844,17924278,8174,241958055,5764,7
7352,UCP3,chr11,R,74000280,74009237,17933235,8957,241967012,5765,6
7356,SCGB1A1,chr11,F,62419034,62423206,17937407,4172,241971184,5766,2
7379,UPK2,chr11,F,118956297,118958559,17939669,2262,241973446,5767,4
7405,UVRAG,chr11,F,75815166,76144238,18268741,329072,242302518,5768,20
7423,VEGFB,chr11,F,64234583,64239264,18273422,4681,242307199,5769,6
7439,BEST1,chr11,F,61946714,61964463,18291171,17749,242324948,5770,12
7465,WEE1,chr11,F,9573649,9593458,18310980,19809,242344757,5771,12
7481,WNT11,chr11,R,76186325,76214008,18338663,27683,242372440,5772,8
7490,WT1,chr11,R,32387774,32435535,18386424,47761,242420201,5773,10
7536,SF1,chr11,R,64764603,64778844,18400665,14241,242434442,5774,13
7542,ZFPL1,chr11,F,65084221,65088402,18404846,4181,242438623,5775,7
7702,ZNF143,chr11,F,9460964,9528524,18472406,67560,242506183,5776,17
7704,ZBTB16,chr11,F,114059578,114250676,18663504,191098,242697281,5777,9
7748,ZNF195,chr11,R,3357926,3379222,18684800,21296,242718577,5778,8
7753,ZNF202,chr11,R,123723926,123741683,18702557,17757,242736334,5779,9
7761,ZNF214,chr11,R,6996612,7020376,18726321,23764,242760098,5780,3
7762,ZNF215,chr11,F,6926417,7005354,18805258,78937,242839035,5781,12
8045,RASSF7,chr11,F,559775,564025,18809508,4250,242843285,5782,6
8048,CSRP3,chr11,R,19182029,19210571,18838050,28542,242871827,5783,6
8050,PDHX,chr11,F,34915828,34996128,18918350,80300,242952127,5784,11
8061,FOSL1,chr11,R,65892135,65900526,18926741,8391,242960518,5785,3
8065,CUL5,chr11,F,108008681,108107766,19025826,99085,243059603,5786,20
8301,PICALM,chr11,R,85957170,86069881,19138537,112711,243172314,5787,22
8322,FZD4,chr11,R,86945674,86955398,19148261,9724,243182038,5788,1
8424,BBOX1,chr11,F,27040704,27127807,19235364,87103,243269141,5789,9
8495,PPFIBP2,chr11,F,7513764,7667344,19388944,153580,243422721,5790,35
8500,PPFIA1,chr11,F,70270686,70384501,19502759,113815,243536536,5791,34
8501,SLC43A1,chr11,R,57484530,57515719,19533948,31189,243567725,5792,16
8519,IFITM1,chr11,F,313990,315272,19535230,1282,243569007,5793,1
8525,DGKZ,chr11,F,46332904,46380554,19582880,47650,243616657,5794,35
8534,CHST1,chr11,R,45647688,45665656,19600848,17968,243634625,5795,3
8538,BARX2,chr11,F,129375237,129452279,19677890,77042,243711667,5796,5
8539,API5,chr11,F,43311954,43344530,19710466,32576,243744243,5797,15
8567,MADD,chr11,F,47269375,47330031,19771122,60656,243804899,5798,42
8587,OR7E2P,chr11,R,86856930,86857954,19772146,1024,243805923,5799,0
8590,OR6A2,chr11,R,6794524,6795908,19773530,1384,243807307,5800,0
8642,DCHS1,chr11,R,6621323,6655849,19808056,34526,243841833,5801,20
8665,EIF3F,chr11,F,7987319,7996171,19816908,8852,243850685,5802,7
8690,JRKL,chr11,F,96389993,96393563,19820478,3570,243854255,5803,0
8722,CTSF,chr11,R,66563462,66568576,19825592,5114,243859369,5804,13
8726,EED,chr11,F,86244543,86285420,19866469,40877,243900246,5805,13
8772,FADD,chr11,F,70203162,70207402,19870709,4240,243904486,5806,1
8815,BANF1,chr11,F,66002078,66004146,19872777,2068,243906554,5807,2
8882,ZPR1,chr11,R,116778559,116788023,19882241,9464,243916018,5808,13
8898,MTMR2,chr11,R,95832879,95924207,19973569,91328,244007346,5809,19
8986,RPS6KA4,chr11,F,64359152,64372215,19986632,13063,244020409,5810,16
9024,BRSK2,chr11,F,1389898,1462689,20059423,72791,244093200,5811,25
9049,AIP,chr11,F,67483028,67491108,20067503,8080,244101280,5812,6
9066,SYT7,chr11,R,61513715,61588396,20142184,74681,244175961,5813,17
9092,SART1,chr11,F,65961688,65980136,20160632,18448,244194409,5814,19
9099,USP2,chr11,R,119355214,119381726,20187144,26512,244220921,5815,15
9152,SLC6A5,chr11,F,20599399,20659285,20247030,59886,244280807,5816,17
9158,FIBP,chr11,R,65883739,65888539,20251830,4800,244285607,5817,9
9159,PCSK7,chr11,R,117205070,117232525,20279285,27455,244313062,5818,19
9177,HTR3B,chr11,F,113898922,113946561,20326924,47639,244360701,5819,11
9183,ZW10,chr11,R,113733182,113773763,20367505,40581,244401282,5820,15
9219,MTA2,chr11,R,62593202,62601840,20376143,8638,244409920,5821,17
9246,UBE2L6,chr11,R,57551654,57568330,20392819,16676,244426596,5822,4
9297,SNORD29,chr11,R,62853903,62853968,20392884,65,244426661,5823,0
9298,SNORD31,chr11,R,62853325,62853393,20392952,68,244426729,5824,0
9299,SNORD30,chr11,R,62853662,62853732,20393022,70,244426799,5825,0
9300,SNORD28,chr11,R,62854620,62854695,20393097,75,244426874,5826,0
9301,SNORD27,chr11,R,62855011,62855083,20393169,72,244426946,5827,0
9302,SNORD26,chr11,R,62855291,62855366,20393244,75,244427021,5828,0
9303,SNORD25,chr11,R,62855564,62855631,20393311,67,244427088,5829,0
9304,SNORD22,chr11,R,62852909,62853035,20393437,126,244427214,5830,0
9313,MMP20,chr11,R,102576834,102625332,20441935,48498,244475712,5831,9
9354,UBE4A,chr11,F,118359580,118399211,20481566,39631,244515343,5832,19
9356,SLC22A6,chr11,R,62976596,62985023,20489993,8427,244523770,5833,9
9376,SLC22A8,chr11,R,62992823,63015845,20513015,23022,244546792,5834,11
9379,NRXN2,chr11,R,64606173,64723188,20630030,117015,244663807,5835,29
9404,LPXN,chr11,R,58526870,58578892,20682052,52022,244715829,5836,12
9409,PEX16,chr11,R,45909668,45918123,20690507,8455,244724284,5837,11
9415,FADS2,chr11,F,61816202,61867354,20741659,51152,244775436,5838,13
9440,MED17,chr11,F,93784238,93813330,20770751,29092,244804528,5839,11
9479,MAPK8IP1,chr11,F,45885495,45906465,20791721,20970,244825498,5840,12
9537,TP53I11,chr11,R,44932347,44951306,20810680,18959,244844457,5841,12
9538,EI24,chr11,F,125569215,125584689,20826154,15474,244859931,5842,12
9600,PITPNM1,chr11,R,67491766,67505372,20839760,13606,244873537,5843,25
9610,RIN1,chr11,R,66332063,66337133,20844830,5070,244878607,5844,10
9633,MTL5,chr11,R,68706673,68751564,20889721,44891,244923498,5845,11
9638,FEZ1,chr11,R,125445744,125496310,20940287,50566,244974064,5846,11
9645,MICAL2,chr11,F,12110575,12281016,21110728,170441,245144505,5847,29
9646,CTR9,chr11,F,10750986,10779755,21139497,28769,245173274,5848,24
9702,CEP57,chr11,F,95790460,95832693,21181730,42233,245215507,5849,11
9743,ARHGAP32,chr11,R,128965059,129267015,21483686,301956,245517463,5850,26
9776,ATG13,chr11,F,46617275,46676019,21542430,58744,245576207,5851,24
9789,SPCS2,chr11,F,74949246,74979031,21572215,29785,245605992,5852,4
9793,CKAP5,chr11,R,46743533,46846308,21674990,102775,245708767,5853,43
9828,ARHGEF17,chr11,F,73305938,73369380,21738432,63442,245772209,5854,22
9846,GAB2,chr11,R,78215289,78417822,21940965,202533,245974742,5855,12
9854,C2CD2L,chr11,F,119107340,119118347,21951972,11007,245985749,5856,14
9866,TRIM66,chr11,R,8612036,8682703,22022639,70667,246056416,5857,34
9873,FCHSD2,chr11,R,72836742,73142454,22328351,305712,246362128,5858,21
9965,FGF19,chr11,R,69698237,69704338,22334452,6101,246368229,5859,2
9973,CCS,chr11,F,66593161,66606019,22347310,12858,246381087,5860,7
9986,RCE1,chr11,F,66843411,66846532,22350431,3121,246384208,5861,7
10003,NAALAD2,chr11,F,90131572,90199743,22418602,68171,246452379,5862,21
10004,NAALADL1,chr11,R,65044817,65059021,22432806,14204,246466583,5863,16
10008,KCNE3,chr11,R,74454840,74467557,22445523,12717,246479300,5864,2
10062,NR1H3,chr11,F,47248299,47269033,22466257,20734,246500034,5865,14
10068,IL18BP,chr11,F,71997943,72002919,22471233,4976,246505010,5866,4
10072,DPP3,chr11,F,66480012,66509659,22500880,29647,246534657,5867,17
10077,TSPAN32,chr11,F,2302012,2318201,22517069,16189,246550846,5868,11
10078,TSSC4,chr11,F,2400444,2403878,22520503,3434,246554280,5869,3
10083,USH1C,chr11,R,17493894,17544416,22571025,50522,246604802,5870,28
10089,KCNK7,chr11,R,65592854,65595996,22574167,3142,246607944,5871,1
10114,HIPK3,chr11,F,33256671,33357023,22674519,100352,246708296,5872,18
10179,RBM7,chr11,F,114400528,114410610,22684601,10082,246718378,5873,4
10196,PRMT3,chr11,F,20387529,20509333,22806405,121804,246840182,5874,16
10205,MPZL2,chr11,R,118253415,118264536,22817526,11121,246851303,5875,5
10235,RASGRP2,chr11,R,64726910,64745456,22836072,18546,246869849,5876,20
10249,GLYAT,chr11,R,58708756,58731974,22859290,23218,246893067,5877,4
10263,CDK2AP2,chr11,R,67506489,67508728,22861529,2239,246895306,5878,2
10312,TCIRG1,chr11,F,68038994,68050899,22873434,11905,246907211,5879,21
10313,RTN3,chr11,F,63681359,63759891,22951966,78532,246985743,5880,8
10335,MRVI1,chr11,R,10573090,10693988,23072864,120898,247106641,5881,21
10346,TRIM22,chr11,F,5689586,5710863,23094141,21277,247127918,5882,7
10394,PRG3,chr11,R,57376768,57381150,23098523,4382,247132300,5883,5
10410,IFITM3,chr11,R,319672,320914,23099765,1242,247133542,5884,1
10413,YAP1,chr11,F,102110253,102233423,23222935,123170,247256712,5885,9
10418,SPON1,chr11,F,13962636,14268133,23528432,305497,247562209,5886,15
10432,RBM14,chr11,F,66616581,66629934,23541785,13353,247575562,5887,2
10435,CDC42EP2,chr11,F,65314817,65322429,23549397,7612,247583174,5888,1
10480,EIF3M,chr11,F,32583766,32604498,23570129,20732,247603906,5889,10
10482,NXF1,chr11,R,62792125,62805492,23583496,13367,247617273,5890,19
10522,DEAF1,chr11,R,644219,695754,23635031,51535,247668808,5891,16
10524,KAT5,chr11,F,65711995,65719606,23642642,7611,247676419,5892,12
10525,HYOU1,chr11,R,119044184,119057246,23655704,13062,247689481,5893,27
10527,IPO7,chr11,F,9384621,9448127,23719210,63506,247752987,5894,24
10534,SSSCA1,chr11,F,65570458,65571888,23720640,1430,247754417,5895,2
10553,HTATIP2,chr11,F,20363684,20383783,23740739,20099,247774516,5896,4
10581,IFITM2,chr11,F,308106,309410,23742043,1304,247775820,5897,1
10589,DRAP1,chr11,F,65919256,65921577,23744364,2321,247778141,5898,6
10612,TRIM3,chr11,R,6448612,6474459,23770211,25847,247803988,5899,14
10629,TAF6L,chr11,F,62771302,62787342,23786251,16040,247820028,5900,10
10632,ATP5L,chr11,F,118401388,118409847,23794710,8459,247828487,5901,3
10647,SCGB1D2,chr11,F,62241629,62244812,23797893,3183,247831670,5902,3
10648,SCGB1D1,chr11,F,62190237,62193537,23801193,3300,247834970,5903,2
10658,CELF1,chr11,R,47465936,47565569,23900826,99633,247934603,5904,19
10714,POLD3,chr11,F,74592529,74669341,23977638,76812,248011415,5905,13
10798,OR5I1,chr11,R,55935455,55936400,23978583,945,248012360,5906,0
10809,STARD10,chr11,R,72754728,72793705,24017560,38977,248051337,5907,6
10819,OR7E14P,chr11,F,17051885,17053044,24018719,1159,248052496,5908,0
10821,OR7E12P,chr11,R,3390706,3391915,24019928,1209,248053705,5909,0
10825,NEU3,chr11,F,74988904,75007698,24038722,18794,248072499,5910,2
10873,ME3,chr11,R,86441107,86672636,24270251,231529,248304028,5911,21
10888,GPR83,chr11,R,94377310,94401419,24294360,24109,248328137,5912,3
10894,LYVE1,chr11,R,10557865,10568818,24305313,10953,248339090,5913,5
10897,YIF1A,chr11,R,66284579,66289167,24309901,4588,248343678,5914,7
10929,SRSF8,chr11,F,95066876,95071227,24314252,4351,248348029,5915,0
10938,EHD1,chr11,R,64852726,64879713,24341239,26987,248375016,5916,6
10944,C11orf58,chr11,F,16738600,16758354,24360993,19754,248394770,5917,6
10963,STIP1,chr11,F,64185271,64204548,24380270,19277,248414047,5918,14
10978,CLP1,chr11,F,57657743,57661865,24384392,4122,248418169,5919,2
10984,KCNQ1OT1,chr11,R,2608327,2699998,24476063,91671,248509840,5920,0
10992,SF3B2,chr11,F,66051774,66068911,24493200,17137,248526977,5921,21
11007,CCDC85B,chr11,F,65890403,65891635,24494432,1232,248528209,5922,0
11041,B4GAT1,chr11,R,66345371,66347690,24496751,2319,248530528,5923,1
11095,ADAMTS8,chr11,R,130404922,130428644,24520473,23722,248554250,5924,8
11098,PRSS23,chr11,F,86791058,86952910,24682325,161852,248716102,5925,7
11145,PLA2G16,chr11,R,63574461,63616926,24724790,42465,248758567,5926,4
11181,TREH,chr11,R,118658231,118679690,24746249,21459,248780026,5927,14
11187,PKP3,chr11,F,392598,404908,24758559,12310,248792336,5928,13
11234,HPS5,chr11,R,18278669,18322498,24802388,43829,248836165,5929,23
11251,PTGDR2,chr11,R,60850924,60855971,24807435,5047,248841212,5930,1
11309,SLCO2B1,chr11,F,75150986,75206400,24862849,55414,248896626,5931,14
22800,RRAS2,chr11,R,14277919,14364506,24949436,86587,248983213,5932,7
22897,CEP164,chr11,F,117321777,117413266,25040925,91489,249074702,5933,39
22917,ZP1,chr11,F,60867541,60875693,25049077,8152,249082854,5934,12
22941,SHANK2,chr11,R,70467855,71252738,25833960,784883,249867737,5935,27
22992,KDM2A,chr11,F,67119267,67258082,25972775,138815,250006552,5936,23
22997,IGSF9B,chr11,R,133908301,133956963,26021437,48662,250055214,5937,23
23052,ENDOD1,chr11,F,95089809,95132651,26064279,42842,250098056,5938,1
23075,SWAP70,chr11,F,9664076,9752991,26153194,88915,250186971,5939,12
23086,EXPH5,chr11,R,108505430,108593765,26241529,88335,250275306,5940,10
23130,ATG2A,chr11,R,64894531,64917250,26264248,22719,250298025,5941,40
23187,PHLDB1,chr11,F,118606438,118658038,26315848,51600,250349625,5942,34
23193,GANAB,chr11,R,62624825,62646726,26337749,21901,250371526,5943,24
23201,FAM168A,chr11,R,73400477,73598189,26535461,197712,250569238,5944,8
23220,DTX4,chr11,F,59171429,59208587,26572619,37158,250606396,5945,10
23235,SIK2,chr11,F,111602390,111732388,26702617,129998,250736394,5946,16
23258,DENND5A,chr11,R,9138824,9265335,26829128,126511,250862905,5947,24
23279,NUP160,chr11,R,47778112,47848505,26899521,70393,250933298,5948,35
23310,NCAPD3,chr11,R,134152441,134225345,26972425,72904,251006202,5949,37
23360,FNBP4,chr11,R,47716516,47767460,27023369,50944,251057146,5950,17
23365,ARHGEF12,chr11,F,120336405,120489936,27176900,153531,251210677,5951,42
23378,RRP8,chr11,R,6514829,6603678,27265749,88849,251299526,5952,9
23387,SIK3,chr11,R,116843401,117098453,27520801,255052,251554578,5953,27
23410,SIRT3,chr11,R,215029,236362,27542134,21333,251575911,5954,7
23529,CLCF1,chr11,R,67364167,67374177,27552144,10010,251585921,5955,3
23538,OR52A1,chr11,R,5151430,5152369,27553083,939,251586860,5956,0
23584,VSIG2,chr11,R,124747471,124753025,27558637,5554,251592414,5957,7
23621,BACE1,chr11,R,117285685,117316256,27589208,30571,251622985,5958,9
23625,FAM89B,chr11,F,65572348,65574198,27591058,1850,251624835,5959,1
23642,SNHG1,chr11,R,62851987,62855888,27594959,3901,251628736,5960,10
23647,ARFIP2,chr11,R,6474682,6481479,27601756,6797,251635533,5961,8
23649,POLA2,chr11,F,65261851,65305598,27645503,43747,251679280,5962,19
23650,TRIM29,chr11,R,120111285,120185423,27719641,74138,251753418,5963,12
23682,RAB38,chr11,R,88113246,88175467,27781862,62221,251815639,5964,2
23705,CADM1,chr11,R,115173624,115504523,28112761,330899,252146538,5965,11
23769,FLRT1,chr11,F,64035969,64119183,28195975,83214,252229752,5966,4
23788,MTCH2,chr11,R,47605203,47642654,28233426,37451,252267203,5967,14
24145,PANX1,chr11,F,94128927,94185596,28290095,56669,252323872,5968,6
24147,FJX1,chr11,F,35618186,35620873,28292782,2687,252326559,5969,0
25758,KIAA1549L,chr11,F,33376567,33674102,28590317,297535,252624094,5970,21
25824,PRDX5,chr11,F,64318087,64321823,28594053,3736,252627830,5971,5
25833,POU2F3,chr11,F,120236639,120319945,28677359,83306,252711136,5972,17
25841,ABTB2,chr11,R,34150986,34358008,28884381,207022,252918158,5973,16
25855,BRMS1,chr11,R,66337332,66345111,28892160,7779,252925937,5974,9
25858,TEX40,chr11,F,64300390,64304767,28896537,4377,252930314,5975,4
25884,CHRDL2,chr11,R,74696427,74731385,28931495,34958,252965272,5976,11
25891,PAMR1,chr11,R,35431826,35530300,29029969,98474,253063746,5977,14
25906,ANAPC15,chr11,R,72109586,72112776,29033159,3190,253066936,5978,7
25921,ZDHHC5,chr11,F,57668001,57701187,29066345,33186,253100122,5979,14
25923,ATL3,chr11,R,63624081,63671974,29114238,47893,253148015,5980,14
25987,TSKU,chr11,F,76782312,76798154,29130080,15842,253163857,5981,3
25988,HINFP,chr11,F,119121522,119135055,29143613,13533,253177390,5982,12
25996,REXO2,chr11,F,114439385,114450279,29154507,10894,253188284,5983,6
26005,C2CD3,chr11,R,74012713,74171210,29313004,158497,253346781,5984,39
26007,DAK,chr11,F,61333181,61353139,29332962,19958,253366739,5985,21
26011,TENM4,chr11,R,78653282,79440989,30120669,787707,254154446,5986,39
26070,DKFZP434K028,chr11,R,61754028,61757664,30124305,3636,254158082,5987,3
26229,B3GAT3,chr11,R,62615295,62622175,30131185,6880,254164962,5988,5
26273,FBXO3,chr11,R,33740943,33774531,30164773,33588,254198550,5989,13
26297,SERGEF,chr11,R,17788047,18013162,30389888,225115,254423665,5990,11
26298,EHF,chr11,F,34621040,34663288,30432136,42248,254465913,5991,13
26338,OR5L2,chr11,F,55827218,55828154,30433072,936,254466849,5992,0
26343,OR5E1P,chr11,F,7849050,7849571,30433593,521,254467370,5993,0
26472,PPP1R14B,chr11,R,64244478,64246941,30436056,2463,254469833,5994,3
26492,OR8G2,chr11,F,124224638,124225663,30437081,1025,254470858,5995,0
26493,OR8B8,chr11,R,124440149,124441085,30438017,936,254471794,5996,0
26494,OR8G1,chr11,F,124249675,124250611,30438953,936,254472730,5997,0
26496,OR10A3,chr11,R,7938575,7939520,30439898,945,254473675,5998,0
26515,TIMM10B,chr11,F,6481446,6484681,30443133,3235,254476910,5999,2
26519,TIMM10,chr11,R,57528462,57530759,30445430,2297,254479207,6000,2
26521,TIMM8B,chr11,R,112084799,112086798,30447429,1999,254481206,6001,2
26579,MYEOV,chr11,F,69294137,69297287,30450579,3150,254484356,6002,1
26580,BSCL2,chr11,R,62690261,62709619,30469937,19358,254503714,6003,12
26595,OR8B2,chr11,R,124382401,124383343,30470879,942,254504656,6004,0
26610,ELP4,chr11,F,31509728,31785252,30746403,275524,254780180,6005,14
26822,SNORD14A,chr11,R,17074652,17074744,30746495,92,254780272,6006,0
26855,RNU2-2P,chr11,R,62841623,62841761,30746633,138,254780410,6007,0
26973,CHORDC1,chr11,R,90193946,90223364,30776051,29418,254809828,6008,13
27034,ACAD8,chr11,F,134253536,134265944,30788459,12408,254822236,6009,11
27087,B3GAT1,chr11,R,134378503,134411987,30821943,33484,254855720,6010,9
27122,DKK3,chr11,R,11962995,12009370,30868318,46375,254902095,6011,8
27288,RBMXL2,chr11,F,7088933,7091148,30870533,2215,254904310,6012,0
27314,RAB30,chr11,R,82973132,83071923,30969324,98791,255003101,6013,6
27315,PGAP2,chr11,F,3797723,3826371,30997972,28648,255031749,6014,12
27339,PRPF19,chr11,R,60890546,60906589,31014015,16043,255047792,6015,15
28960,DCPS,chr11,F,126303751,126345754,31056018,42003,255089795,6016,7
28970,C11orf54,chr11,F,93741593,93763102,31077527,21509,255111304,6017,11
28971,AAMDC,chr11,F,77821106,77872354,31128775,51248,255162552,6018,5
28992,MACROD1,chr11,R,63998555,64166130,31296350,167575,255330127,6019,15
29015,SLC43A3,chr11,R,57406953,57427580,31316977,20627,255350754,6020,14
29068,ZBTB44,chr11,R,130226676,130314769,31405070,88093,255438847,6021,6
29087,THYN1,chr11,R,134248277,134253401,31410194,5124,255443971,6022,6
29099,COMMD9,chr11,R,36272291,36289449,31427352,17158,255461129,6023,5
29118,DDX25,chr11,F,125904365,125923110,31446097,18745,255479874,6024,12
29125,C11orf21,chr11,R,2296276,2301913,31451734,5637,255485511,6025,4
29763,PACSIN3,chr11,R,47177521,47186459,31460672,8938,255494449,6026,11
29850,TRPM5,chr11,R,2403951,2435017,31491738,31066,255525515,6027,27
29901,SAC3D1,chr11,F,65040903,65044828,31495663,3925,255529440,6028,1
29907,SNX15,chr11,F,65027407,65040572,31508828,13165,255542605,6029,10
29984,RHOD,chr11,F,67056817,67072017,31524028,15200,255557805,6030,4
30008,EFEMP2,chr11,R,65866440,65872934,31530522,6494,255564299,6031,10
50507,NOX4,chr11,R,89324352,89589611,31795781,265259,255829558,6032,24
50613,UBQLN3,chr11,R,5507299,5509985,31798467,2686,255832244,6033,1
50801,KCNK4,chr11,F,64291320,64300031,31807178,8711,255840955,6034,6
50862,RNF141,chr11,R,10511677,10541227,31836728,29550,255870505,6035,5
50863,NTM,chr11,F,131370360,132336822,32803190,966462,256836967,6036,13
50937,CDON,chr11,R,125956817,126063292,32909665,106475,256943442,6037,22
51035,UBXN1,chr11,R,62676497,62679117,32912285,2620,256946062,6038,7
51074,APIP,chr11,R,34882294,34916411,32946402,34117,256980179,6039,8
51075,TMX2,chr11,F,57712522,57740973,32974853,28451,257008630,6040,7
51083,GAL,chr11,F,68684514,68691175,32981514,6661,257015291,6041,5
51092,SIDT2,chr11,F,117179222,117197445,32999737,18223,257033514,6042,25
51111,SUV420H1,chr11,R,68154862,68213783,33058658,58921,257092435,6043,12
51144,HSD17B12,chr11,F,43680592,43856619,33234685,176027,257268462,6044,10
51214,IGF2-AS,chr11,F,2140527,2148666,33242824,8139,257276601,6045,1
51259,TMEM216,chr11,F,61391686,61398863,33250001,7177,257283778,6046,5
51272,BET1L,chr11,R,202923,207422,33254500,4499,257288277,6047,2
51286,CEND1,chr11,R,787109,790126,33257517,3017,257291294,6048,1
51287,COA4,chr11,R,73872666,73876845,33261696,4179,257295473,6049,1
51296,SLC15A3,chr11,R,60937082,60952526,33277140,15444,257310917,6050,8
51317,PHF21A,chr11,R,45929318,46121434,33469256,192116,257503033,6051,24
51338,MS4A4A,chr11,F,60280540,60308972,33497688,28432,257531465,6052,7
51352,WT1-AS,chr11,F,32435517,32458769,33520940,23252,257554717,6053,7
51399,TRAPPC4,chr11,F,119018530,119023674,33526084,5144,257559861,6054,4
51400,PPME1,chr11,F,74170890,74254703,33609897,83813,257643674,6055,12
51475,CABP2,chr11,R,67518946,67523614,33614565,4668,257648342,6056,6
51501,C11orf73,chr11,F,86302210,86345943,33658298,43733,257692075,6057,6
51503,CWC15,chr11,R,94962621,94973612,33669289,10991,257703066,6058,6
51504,TRMT112,chr11,R,64316491,64318084,33670882,1593,257704659,6059,2
51524,TMEM138,chr11,F,61362000,61376502,33685384,14502,257719161,6060,7
51585,PCF11,chr11,F,83157094,83185794,33714084,28700,257747861,6061,15
51642,MRPL48,chr11,F,73787871,73864611,33790824,76740,257824601,6062,8
51700,CYB5R2,chr11,R,7665094,7674341,33800071,9247,257833848,6063,9
51773,RSF1,chr11,R,77660008,77820869,33960932,160861,257994709,6064,15
53340,SPA17,chr11,F,124673843,124697545,33984634,23702,258018411,6065,5
53826,FXYD6,chr11,R,117836975,117877486,34025145,40511,258058922,6066,10
53838,C11orf24,chr11,R,68261334,68272001,34035812,10667,258069589,6067,5
53840,TRIM34,chr11,F,5619943,5644398,34060267,24455,258094044,6068,13
53841,CDHR5,chr11,R,616564,625067,34068770,8503,258102547,6069,14
53942,CNTN5,chr11,F,99020975,100358885,35406680,1337910,259440457,6070,25
54414,SIAE,chr11,R,124635788,124676303,35447195,40515,259480972,6071,14
54472,TOLLIP,chr11,R,1274367,1309662,35482490,35295,259516267,6072,6
54494,C11orf71,chr11,R,114391447,114400550,35491593,9103,259525370,6073,1
54503,ZDHHC13,chr11,F,19117098,19176420,35550915,59322,259584692,6074,19
54538,ROBO4,chr11,R,124884217,124897935,35564633,13718,259598410,6075,17
54663,WDR74,chr11,R,62832907,62840572,35572298,7665,259606075,6076,11
54733,SLC35F2,chr11,R,107790990,107859188,35640496,68198,259674273,6077,8
54734,RAB39A,chr11,F,107928474,107963482,35675504,35008,259709281,6078,1
54765,TRIM44,chr11,F,35662691,35811053,35823866,148362,259857643,6079,4
54766,BTG4,chr11,R,111384094,111514733,35954505,130639,259988282,6080,22
54827,NXPE4,chr11,R,114570590,114595840,35979755,25250,260013532,6081,7
54843,SYTL2,chr11,R,85694220,85811159,36096694,116939,260130471,6082,21
54851,ANKRD49,chr11,F,94493986,94499578,36102286,5592,260136063,6083,2
54860,MS4A12,chr11,F,60492741,60507430,36116975,14689,260150752,6084,7
54948,MRPL16,chr11,R,59806134,59810872,36121713,4738,260155490,6085,4
54949,SDHAF2,chr11,F,61430124,61446767,36138356,16643,260172133,6086,3
54961,SSH3,chr11,F,67303447,67312607,36147516,9160,260181293,6087,13
54970,TTC12,chr11,F,113314528,113385952,36218940,71424,260252717,6088,28
54972,TMEM132A,chr11,F,60924440,60937159,36231659,12719,260265436,6089,10
54979,HRASLS2,chr11,R,63552758,63565089,36243990,12331,260277767,6090,4
55004,LAMTOR1,chr11,R,72097291,72103387,36250086,6096,260283863,6091,4
55031,USP47,chr11,F,11841422,11959325,36367989,117903,260401766,6092,29
55048,VPS37C,chr11,R,61130255,61161444,36399178,31189,260432955,6093,5
55107,ANO1,chr11,F,70078301,70189545,36510422,111244,260544199,6094,28
55128,TRIM68,chr11,R,4598671,4608259,36520010,9588,260553787,6095,6
55191,NADSYN1,chr11,F,71453170,71501538,36568378,48368,260602155,6096,20
55199,FAM86C1,chr11,F,71787510,71801234,36582102,13724,260615879,6097,5
55216,C11orf57,chr11,F,112074243,112085150,36593009,10907,260626786,6098,5
55226,NAT10,chr11,F,34105563,34151034,36638480,45471,260672257,6099,29
55231,CCDC87,chr11,R,66590168,66593083,36641395,2915,260675172,6100,0
55291,PPP6R3,chr11,F,68460717,68615334,36796012,154617,260829789,6101,29
55293,UEVLD,chr11,R,18529608,18588938,36855342,59330,260889119,6102,14
55298,RNF121,chr11,F,71928700,71997597,36924239,68897,260958016,6103,10
55327,LIN7C,chr11,R,27494417,27506779,36936601,12362,260970378,6104,4
55331,ACER3,chr11,F,76860872,77026797,37102526,165925,261136303,6105,17
55343,SLC35C1,chr11,F,45804071,45813016,37111471,8945,261145248,6106,4
55346,TCP11L1,chr11,F,33039416,33079454,37151509,40038,261185286,6107,11
55366,LGR4,chr11,R,27365960,27472787,37258336,106827,261292113,6108,17
55367,PIDD1,chr11,R,799178,809501,37268659,10323,261302436,6109,16
55531,ELMOD1,chr11,F,107591090,107666779,37344348,75689,261378125,6110,12
55539,KCNQ1DN,chr11,F,2870032,2872105,37346421,2073,261380198,6111,1
55553,SOX6,chr11,R,15966448,16476388,37856361,509940,261890138,6112,17
55561,CDC42BPG,chr11,R,64823808,64844673,37877226,20865,261911003,6113,39
55572,FOXRED1,chr11,F,126269039,126278132,37886319,9093,261920096,6114,11
55611,OTUB1,chr11,F,63985852,63998420,37898887,12568,261932664,6115,5
55626,AMBRA1,chr11,R,46396411,46594069,38096545,197658,262130322,6116,21
55690,PACS1,chr11,F,66070352,66244747,38270940,174395,262304717,6117,26
55693,KDM4D,chr11,F,94973680,94999514,38296774,25834,262330551,6118,2
55709,KBTBD4,chr11,R,47572196,47579015,38303593,6819,262337370,6119,4
55742,PARVA,chr11,F,12376440,12535356,38462509,158916,262496286,6120,13
55761,TTC17,chr11,F,43358884,43494933,38598558,136049,262632335,6121,26
55800,SCN3B,chr11,R,123629186,123654607,38623979,25421,262657756,6122,5
55823,VPS11,chr11,F,119067751,119081978,38638206,14227,262671983,6123,16
55863,TMEM126B,chr11,F,85628572,85636539,38646173,7967,262679950,6124,6
55867,SLC22A11,chr11,F,64555625,64572875,38663423,17250,262697200,6125,9
56158,TEX12,chr11,F,112167371,112172556,38668608,5185,262702385,6126,4
56253,CRTAM,chr11,F,122838430,122872643,38702821,34213,262736598,6127,9
56547,MMP26,chr11,F,4988193,4992429,38707057,4236,262740834,6128,6
56649,TMPRSS4,chr11,F,118077011,118125505,38755551,48494,262789328,6129,15
56672,AKIP1,chr11,F,8911117,8920079,38764513,8962,262798290,6130,4
56673,C11orf16,chr11,R,8920075,8933006,38777444,12931,262811221,6131,8
56674,TMEM9B,chr11,R,8947200,8965011,38795255,17811,262829032,6132,5
56675,NRIP3,chr11,R,8980575,9004049,38818729,23474,262852506,6133,6
56676,ASCL3,chr11,R,8937571,8943033,38824191,5462,262857968,6134,1
56834,GPR137,chr11,F,64269259,64289500,38844432,20241,262878209,6135,12
56912,IFT46,chr11,R,118544527,118572965,38872870,28438,262906647,6136,13
56935,SMCO4,chr11,R,93478471,93586855,38981254,108384,263015031,6137,7
56946,C11orf30,chr11,F,76444927,76552899,39089226,107972,263123003,6138,22
56980,PRDM10,chr11,R,129899705,130003050,39192571,103345,263226348,6139,21
56981,PRDM11,chr11,F,45094012,45235124,39333683,141112,263367460,6140,14
57010,CABP4,chr11,F,67452414,67461774,39343043,9360,263376820,6141,7
57053,CHRNA10,chr11,R,3665586,3673208,39350665,7622,263384442,6142,3
57084,SLC17A6,chr11,F,22338120,22379503,39392048,41383,263425825,6143,11
57093,TRIM49,chr11,R,89797654,89808575,39402969,10921,263436746,6144,7
57104,PNPLA2,chr11,F,818890,825573,39409652,6683,263443429,6145,8
57124,CD248,chr11,R,66314486,66317044,39412210,2558,263445987,6146,0
57175,CORO1B,chr11,R,67438046,67443821,39417985,5775,263451762,6147,11
57410,SCYL1,chr11,F,65525064,65538711,39431632,13647,263465409,6148,17
57453,DSCAML1,chr11,R,117427771,117797261,39801122,369490,263834899,6149,37
57476,GRAMD1B,chr11,F,123358783,123627771,40070110,268988,264103887,6150,33
57558,USP35,chr11,F,78188811,78217644,40098943,28833,264132720,6151,12
57562,KIAA1377,chr11,F,101915014,102001065,40184994,86051,264218771,6152,11
57569,ARHGAP20,chr11,R,110576854,110713189,40321329,136335,264355106,6153,19
57571,CARNS1,chr11,F,67415677,67425607,40331259,9930,264365036,6154,9
57586,SYT13,chr11,R,45240301,45286333,40377291,46032,264411068,6155,7
57646,USP28,chr11,R,113797874,113875570,40454987,77696,264488764,6156,28
57661,PHRF1,chr11,F,576219,612222,40490990,36003,264524767,6157,17
57689,LRRC4C,chr11,R,40109937,41460212,41841265,1350275,265875042,6158,9
57758,SCUBE2,chr11,R,9019499,9091603,41913369,72104,265947146,6159,24
57804,POLD4,chr11,R,67350764,67353596,41916201,2832,265949978,6160,3
57830,KRTAP5-8,chr11,F,71538024,71539207,41917384,1183,265951161,6161,0
58473,PLEKHB1,chr11,F,73646177,73662819,41934026,16642,265967803,6162,10
58475,MS4A7,chr11,F,60378484,60395954,41951496,17470,265985273,6163,6
58486,ZBED5,chr11,R,10852703,10858073,41956866,5370,265990643,6164,2
58487,CREBZF,chr11,R,85657563,85665138,41964441,7575,265998218,6165,0
59082,CARD18,chr11,R,105137720,105139734,41966455,2014,266000232,6166,2
59307,SIGIRR,chr11,R,405715,417454,41978194,11739,266011971,6167,9
60492,CCDC90B,chr11,R,83259092,83286407,42005509,27315,266039286,6168,9
60494,CCDC81,chr11,F,86374735,86423109,42053883,48374,266087660,6169,14
60496,AASDHPPT,chr11,F,106077564,106098692,42075011,21128,266108788,6170,5
60529,ALX4,chr11,R,44260437,44319220,42133794,58783,266167571,6171,6
60626,RIC8A,chr11,F,207510,215175,42141459,7665,266175236,6172,9
63875,MRPL17,chr11,R,6680384,6683401,42144476,3017,266178253,6173,2
63876,PKNOX2,chr11,F,125164662,125433389,42413203,268727,266446980,6174,14
63901,FAM111A,chr11,F,59142844,59155039,42425398,12195,266459175,6175,5
63970,TP53AIP1,chr11,R,128934731,128943399,42434066,8668,266467843,6176,2
63982,ANO3,chr11,F,26188820,26668409,42913655,479589,266947432,6177,29
64066,MMP27,chr11,R,102691509,102705755,42927901,14246,266961678,6178,9
64137,ABCG4,chr11,F,119149039,119162666,42941528,13627,266975305,6179,16
64221,ROBO3,chr11,F,124865005,124881474,42957997,16469,266991774,6180,30
64231,MS4A6A,chr11,R,60171606,60184666,42971057,13060,267004834,6181,9
64232,MS4A5,chr11,F,60429588,60447792,42989261,18204,267023038,6182,4
64776,C11orf1,chr11,F,111879197,111884074,42994138,4877,267027915,6183,4
64787,EPS8L2,chr11,F,706119,727727,43015746,21608,267049523,6184,20
64837,KLC2,chr11,F,66257293,66267861,43026314,10568,267060091,6185,16
64852,TUT1,chr11,R,62575044,62591637,43042907,16593,267076684,6186,8
65003,MRPL11,chr11,R,66435074,66438848,43046681,3774,267080458,6187,5
65084,TMEM135,chr11,F,87037843,87328834,43337672,290991,267371449,6188,14
65975,STK33,chr11,R,8391865,8594289,43540096,202424,267573873,6189,19
65987,KCTD14,chr11,R,78015714,78046191,43570573,30477,267604350,6190,3
65998,C11orf95,chr11,R,63759891,63768641,43579323,8750,267613100,6191,4
66005,CHID1,chr11,R,867858,915058,43626523,47200,267660300,6192,18
78999,LRFN4,chr11,F,66856479,66860475,43630519,3996,267664296,6193,2
79026,AHNAK,chr11,R,62433541,62546860,43743838,113319,267777615,6194,8
79053,ALG8,chr11,R,78100941,78139660,43782557,38719,267816334,6195,14
79056,PRRG4,chr11,F,32829773,32858123,43810907,28350,267844684,6196,5
79064,TMEM223,chr11,R,62790314,62792014,43812607,1700,267846384,6197,1
79073,TMEM109,chr11,F,60913898,60923443,43822152,9545,267855929,6198,3
79080,CCDC86,chr11,F,60841955,60851088,43831285,9133,267865062,6199,3
79081,LBHD1,chr11,R,62662816,62671769,43840238,8953,267874015,6200,6
79096,C11orf49,chr11,F,46936527,47164381,44068092,227854,268101869,6201,10
79097,TRIM48,chr11,F,55262181,55271119,44077030,8938,268110807,6202,5
79101,TAF1D,chr11,R,93735928,93741537,44082639,5609,268116416,6203,5
79102,RNF26,chr11,F,119334499,119337314,44085454,2815,268119231,6204,0
79324,OR51G1,chr11,R,4923373,4924339,44086420,966,268120197,6205,0
79339,OR51B4,chr11,R,5301013,5301946,44087353,933,268121130,6206,0
79345,OR51B2,chr11,R,5323297,5324352,44088408,1055,268122185,6207,0
79473,OR52N1,chr11,R,5787853,5788816,44089371,963,268123148,6208,0
79607,FAM118B,chr11,F,126211449,126262984,44140906,51535,268174683,6209,8
79608,RIC3,chr11,R,8092964,8169083,44217025,76119,268250802,6210,11
79659,DYNC2H1,chr11,F,103109430,103479863,44587458,370433,268621235,6211,89
79671,NLRX1,chr11,F,119168333,119184016,44603141,15683,268636918,6212,10
79684,MSANTD2,chr11,R,124766491,124800436,44637086,33945,268670863,6213,8
79703,C11orf80,chr11,F,66744735,66843516,44735867,98781,268769644,6214,16
79731,NARS2,chr11,R,78435960,78574864,44874771,138904,268908548,6215,15
79733,E2F8,chr11,R,19224062,19241655,44892364,17593,268926141,6216,13
79751,SLC25A22,chr11,R,790474,798269,44900159,7795,268933936,6217,12
79780,CCDC82,chr11,R,96352764,96389931,44937326,37167,268971103,6218,13
79796,ALG9,chr11,R,111782194,111871581,45026713,89387,269060490,6219,20
79797,ZNF408,chr11,F,46700766,46705916,45031863,5150,269065640,6220,4
79827,CLMP,chr11,R,123072311,123195299,45154851,122988,269188628,6221,6
79829,NAA40,chr11,F,63938969,63957319,45173201,18350,269206978,6222,9
79832,QSER1,chr11,F,32893177,32980270,45260294,87093,269294071,6223,13
79841,AGBL2,chr11,R,47659168,47715382,45316508,56214,269350285,6224,21
79842,ZBTB3,chr11,R,62750962,62754184,45319730,3222,269353507,6225,1
79849,PDZD3,chr11,F,119185435,119190223,45324518,4788,269358295,6226,10
79864,C11orf63,chr11,F,122881638,122959722,45402602,78084,269436379,6227,14
79869,CPSF7,chr11,R,61402647,61429992,45429947,27345,269463724,6228,11
79899,PRR5L,chr11,F,36296174,36465204,45598977,169030,269632754,6229,10
80071,CCDC15,chr11,F,124954120,125041489,45686346,87369,269720123,6230,15
80150,ASRGL1,chr11,F,62337301,62401378,45750423,64077,269784200,6231,9
80162,ATHL1,chr11,F,287831,295688,45758280,7857,269792057,6232,15
80168,MOGAT2,chr11,F,75717818,75731286,45771748,13468,269805525,6233,6
80194,TMEM134,chr11,R,67464347,67469277,45776678,4930,269810455,6234,7
80198,MUS81,chr11,F,65860243,65866443,45782878,6200,269816655,6235,16
80227,PAAF1,chr11,F,73876698,73927736,45833916,51038,269867693,6236,15
80310,PDGFD,chr11,R,103907185,104164299,46091030,257114,270124807,6237,6
80789,INTS5,chr11,R,62646847,62653302,46097485,6455,270131262,6238,1
80829,ZFP91,chr11,F,58579113,58621550,46139922,42437,270173699,6239,10
80975,TMPRSS5,chr11,R,113687545,113714727,46167104,27182,270200881,6240,14
81168,OR8J3,chr11,R,56136770,56137718,46168052,948,270201829,6241,0
81282,OR51G2,chr11,R,4914718,4915663,46168997,945,270202774,6242,0
81285,OR51E2,chr11,R,4680170,4697846,46186673,17676,270220450,6243,1
81300,OR4P4,chr11,F,55638357,55639296,46187612,939,270221389,6244,0
81309,OR4C15,chr11,F,55554306,55555419,46188725,1113,270222502,6245,0
81318,OR4A5,chr11,F,54706831,54707902,46189796,1071,270223573,6246,0
81327,OR4A16,chr11,F,55323660,55344225,46210361,20565,270244138,6247,1
81328,OR4A15,chr11,F,55367883,55368918,46211396,1035,270245173,6248,0
81341,OR10W1,chr11,R,58266791,58268260,46212865,1469,270246642,6249,0
81343,OR10V2P,chr11,F,59748811,59749581,46213635,770,270247412,6250,0
81490,PTDSS2,chr11,F,448270,491399,46256764,43129,270290541,6251,14
81532,MOB2,chr11,R,1469447,1486779,46274096,17332,270307873,6252,4
81544,GDPD5,chr11,R,75434639,75525920,46365377,91281,270399154,6253,22
81570,CLPB,chr11,R,72292424,72434680,46507633,142256,270541410,6254,18
81622,UNC93B1,chr11,R,67991099,68004125,46520659,13026,270554436,6255,10
81846,SBF2,chr11,R,9778666,10294207,47036200,515541,271069977,6256,42
81876,RAB1B,chr11,F,66268584,66277492,47045108,8908,271078885,6257,5
81930,KIF18A,chr11,R,28020615,28108199,47132692,87584,271166469,6258,16
83480,PUS3,chr11,R,125893484,125903369,47142577,9885,271176354,6259,3
83552,MFRP,chr11,R,119338933,119346673,47150317,7740,271184094,6260,14
83638,C11orf68,chr11,R,65916809,65919060,47152568,2251,271186345,6261,1
83661,MS4A8,chr11,F,60699573,60715811,47168806,16238,271202583,6262,6
83700,JAM3,chr11,F,134068924,134151757,47251639,82833,271285416,6263,8
83706,FERMT3,chr11,F,64206654,64223891,47268876,17237,271302653,6264,15
83707,TRPT1,chr11,R,64223798,64226254,47271332,2456,271305109,6265,7
83759,RBM4B,chr11,R,66664993,66677921,47284260,12928,271318037,6266,4
83786,FRMD8,chr11,F,65386569,65413525,47311216,26956,271344993,6267,10
83875,BCO2,chr11,F,112175484,112218929,47354661,43445,271388438,6268,12
83935,TMEM133,chr11,F,100992079,100993935,47356517,1856,271390294,6269,0
84000,TMPRSS13,chr11,R,117900640,117929453,47385330,28813,271419107,6270,13
84067,FAM160A2,chr11,R,6211333,6234711,47408708,23378,271442485,6271,13
84153,RNASEH2C,chr11,R,65717672,65720938,47411974,3266,271445751,6272,3
84188,FAR1,chr11,F,13668658,13732346,47475662,63688,271509439,6273,12
84233,TMEM126A,chr11,F,85647918,85656553,47484297,8635,271518074,6274,4
84259,DCUN1D5,chr11,R,103050683,103092215,47525829,41532,271559606,6275,7
84280,BTBD10,chr11,R,13387995,13463297,47601131,75302,271634908,6276,12
84285,EIF1AD,chr11,R,65996544,66002166,47606753,5622,271640530,6277,5
84304,NUDT22,chr11,F,64226257,64230269,47610765,4012,271644542,6278,6
84364,ARFGAP2,chr11,R,47164297,47177503,47623971,13206,271657748,6279,16
84437,MSANTD4,chr11,R,106007901,106022254,47638324,14353,271672101,6280,3
84441,MAML2,chr11,R,95976203,96343245,48005366,367042,272039143,6281,6
84447,SYVN1,chr11,R,65127278,65135178,48013266,7900,272047043,6282,15
84623,KIRREL3,chr11,R,126423492,127003460,48593234,579968,272627011,6283,20
84649,DGAT2,chr11,F,75768732,75801536,48626038,32804,272659815,6284,8
84680,ACCS,chr11,F,44066178,44084237,48644097,18059,272677874,6285,16
84689,MS4A14,chr11,F,60396013,60417756,48665840,21743,272699617,6286,6
84767,TRIM51,chr11,F,55883296,55891810,48674354,8514,272708131,6287,6
84811,BUD13,chr11,R,116748169,116772998,48699183,24829,272732960,6288,10
84866,TMEM25,chr11,F,118531087,118546598,48714694,15511,272748471,6289,9
84867,PTPN5,chr11,R,18727927,18792721,48779488,64794,272813265,6290,15
84881,RPUSD4,chr11,R,126202093,126211692,48789087,9599,272822864,6291,6
84897,TBRG1,chr11,F,124622598,124635926,48802415,13328,272836192,6292,8
84953,MICALCL,chr11,F,12286899,12359144,48874660,72245,272908437,6293,8
84957,RELT,chr11,F,73376359,73397474,48895775,21115,272929552,6294,12
84959,UBASH3B,chr11,F,122655689,122814479,49054565,158790,273088342,6295,14
85016,C11orf70,chr11,F,102047410,102084560,49091715,37150,273125492,6296,6
85329,LGALS12,chr11,F,63506051,63516774,49102438,10723,273136215,6297,10
85363,TRIM5,chr11,R,5590981,5685109,49196566,94128,273230343,6298,11
85388,SNORD14B,chr11,R,17075777,17075868,49196657,91,273230434,6299,0
85389,SNORD14C,chr11,R,123059334,123059422,49196745,88,273230522,6300,0
85390,SNORD14D,chr11,R,123058908,123058995,49196832,87,273230609,6301,0
85391,SNORD14E,chr11,R,123058076,123058156,49196912,80,273230689,6302,0
85456,TNKS1BP1,chr11,R,57299628,57324952,49222236,25324,273256013,6303,14
85458,DIXDC1,chr11,F,111927143,112022650,49317743,95507,273351520,6304,25
85459,CEP295,chr11,F,93661649,93730358,49386452,68709,273420229,6305,29
85463,ZC3H12C,chr11,F,110088411,110171841,49469882,83430,273503659,6306,8
89792,GAL3ST3,chr11,R,66040764,66049180,49478298,8416,273512075,6307,2
89797,NAV2,chr11,F,19345246,20121601,50254653,776355,274288430,6308,48
89849,ATG16L2,chr11,F,72814405,72842705,50282953,28300,274316730,6309,17
89944,GLB1L2,chr11,F,134331873,134376328,50327408,44455,274361185,6310,18
90019,SYT8,chr11,F,1827478,1837521,50337451,10043,274371228,6311,12
90139,TSPAN18,chr11,F,44727129,44932427,50542749,205298,274576526,6312,11
90952,ESAM,chr11,R,124753122,124762327,50551954,9205,274585731,6313,6
90993,CREB3L1,chr11,F,46277637,46321422,50595739,43785,274629516,6314,12
91056,AP5B1,chr11,R,65773897,65780591,50602433,6694,274636210,6315,1
91057,CCDC34,chr11,R,27338513,27363248,50627168,24735,274660945,6316,5
91252,SLC39A13,chr11,F,47407131,47416500,50636537,9369,274670314,6317,12
91614,DEPDC7,chr11,F,33015863,33033582,50654256,17719,274688033,6318,9
91683,SYT12,chr11,F,67006772,67050863,50698347,44091,274732124,6319,13
91703,ACY3,chr11,R,67642554,67650807,50706600,8253,274740377,6320,8
91801,ALKBH8,chr11,R,107502725,107565737,50769612,63012,274803389,6321,12
91893,FDXACB1,chr11,R,111874055,111879457,50775014,5402,274808791,6322,4
91894,C11orf52,chr11,F,111918876,111926871,50783009,7995,274816786,6323,3
92105,INTS4,chr11,R,77878719,77994842,50899132,116123,274932909,6324,25
92292,GLYATL1,chr11,F,58927628,58957074,50928578,29446,274962355,6325,10
112464,PRKCDBP,chr11,R,6318945,6320510,50930143,1565,274963920,6326,1
112936,VPS26B,chr11,F,134224604,134247792,50953331,23188,274987108,6327,6
112937,GLB1L3,chr11,F,134276321,134321361,50998371,45040,275032148,6328,25
113130,CDCA5,chr11,R,65061008,65084150,51021513,23142,275055290,6329,14
113157,RPLP0P2,chr11,F,61615035,61639449,51045927,24414,275079704,6330,4
113174,SAAL1,chr11,R,18080342,18106091,51071676,25749,275105453,6331,11
113746,ODF3,chr11,F,196640,200258,51075294,3618,275109071,6332,6
114571,SLC22A9,chr11,F,63369788,63410259,51115765,40471,275149542,6333,9
114599,SNORD15B,chr11,F,75404420,75404566,51115911,146,275149688,6334,0
114609,TIRAP,chr11,F,126281892,126294933,51128952,13041,275162729,6335,6
114769,CARD16,chr11,R,105040305,105045416,51134063,5111,275167840,6336,3
114879,OSBPL5,chr11,R,3087114,3165352,51212301,78238,275246078,6337,22
114900,C1QTNF4,chr11,R,47589663,47594409,51217047,4746,275250824,6338,2
114902,C1QTNF5,chr11,R,119338933,119346673,51224787,7740,275258564,6339,14
114908,TMEM123,chr11,R,102396324,102453044,51281507,56720,275315284,6340,4
114971,PTPMT1,chr11,F,47565429,47573461,51289539,8032,275323316,6341,2
115399,LRRC56,chr11,F,518999,554916,51325456,35917,275359233,6342,16
116071,BATF2,chr11,R,64987944,64997653,51335165,9709,275368942,6343,4
116085,SLC22A12,chr11,F,64590809,64602353,51346709,11544,275380486,6344,8
116337,PANX3,chr11,F,124611556,124620356,51355509,8800,275389286,6345,3
116512,MRGPRD,chr11,R,68980020,68980986,51356475,966,275390252,6346,0
116519,APOA5,chr11,R,116789369,116792420,51359526,3051,275393303,6347,3
116534,MRGPRE,chr11,R,3227810,3232386,51364102,4576,275397879,6348,1
116535,MRGPRF,chr11,R,69004393,69013382,51373091,8989,275406868,6349,2
116969,ART5,chr11,R,3638505,3642316,51376902,3811,275410679,6350,3
116985,ARAP1,chr11,R,72685068,72752389,51444223,67321,275478000,6351,35
117144,CATSPER1,chr11,R,66016751,66026519,51453991,9768,275487768,6352,11
117194,MRGPRX2,chr11,R,19054454,19071978,51471515,17524,275505292,6353,4
117195,MRGPRX3,chr11,F,18103651,18138491,51506355,34840,275540132,6354,3
117196,MRGPRX4,chr11,F,18172836,18174280,51507799,1444,275541576,6355,0
117245,HRASLS5,chr11,R,63461403,63491208,51537604,29805,275571381,6356,6
117854,TRIM6,chr11,F,5596100,5612958,51554462,16858,275588239,6357,8
119678,OR52E2,chr11,R,5058649,5059627,51555440,978,275589217,6358,0
119679,OR52J3,chr11,F,5046525,5047461,51556376,936,275590153,6359,0
119682,OR51L1,chr11,F,4998982,4999930,51557324,948,275591101,6360,0
119687,OR51A7,chr11,F,4907369,4908308,51558263,939,275592040,6361,0
119692,OR51S1,chr11,R,4848202,4859600,51569661,11398,275603438,6362,1
119694,OR51F2,chr11,F,4821385,4822414,51570690,1029,275604467,6363,0
119695,OR52R1,chr11,R,4803432,4804380,51571638,948,275605415,6364,0
119710,C11orf74,chr11,F,36594228,36659291,51636701,65063,275670478,6365,7
119749,OR4C46,chr11,R,54603068,54603998,51637631,930,275671408,6366,0
119764,OR4X2,chr11,F,48245103,48246015,51638543,912,275672320,6367,0
119765,OR4B1,chr11,F,48216809,48217739,51639473,930,275673250,6368,0
119772,OR52M1,chr11,F,4545190,4546144,51640427,954,275674204,6369,0
119774,OR52K2,chr11,F,4449294,4450361,51641494,1067,275675271,6370,0
120065,OR5P2,chr11,R,7795973,7796942,51642463,969,275676240,6371,0
120066,OR5P3,chr11,R,7825036,7825972,51643399,936,275677176,6372,0
120071,GYLTL1B,chr11,F,45920973,45929096,51651522,8123,275685299,6373,15
120103,SLC36A4,chr11,R,93144170,93197975,51705327,53805,275739104,6374,12
120114,FAT3,chr11,F,92314282,92896470,52287515,582188,276321292,6375,28
120146,TRIM64,chr11,F,89966086,89974072,52295501,7986,276329278,6376,6
120224,TMEM45B,chr11,F,129815780,129860003,52339724,44223,276373501,6377,9
120227,CYP2R1,chr11,R,14877435,14894034,52356323,16599,276390100,6378,7
120237,DBX1,chr11,R,20156213,20160324,52360434,4111,276394211,6379,3
120376,COLCA2,chr11,F,111298545,111308735,52370624,10190,276404401,6380,6
120379,PIH1D2,chr11,R,112052408,112074171,52392387,21763,276426164,6381,8
120400,NXPE1,chr11,R,114517731,114559895,52434551,42164,276468328,6382,12
120406,NXPE2,chr11,F,114648489,114707117,52493179,58628,276526956,6383,7
120425,AMICA1,chr11,R,118193726,118225094,52524547,31368,276558324,6384,13
120526,DNAJC24,chr11,F,31369814,31432835,52587568,63021,276621345,6385,5
120534,ARL14EP,chr11,F,30323098,30338458,52602928,15360,276636705,6386,4
120586,OR8I2,chr11,F,56093307,56094240,52603861,933,276637638,6387,0
120775,OR2D3,chr11,F,6921001,6921994,52604854,993,276638631,6388,0
120776,OR2D2,chr11,R,6891573,6892500,52605781,927,276639558,6389,0
120787,OR52W1,chr11,F,6199223,6200186,52606744,963,276640521,6390,0
120793,OR56A4,chr11,R,6002050,6003148,52607842,1098,276641619,6391,0
120796,OR56A1,chr11,R,6026670,6027741,52608913,1071,276642690,6392,0
143425,SYT9,chr11,F,7238795,7469045,52839163,230250,276872940,6393,13
143458,LDLRAD3,chr11,F,35943980,36232136,53127319,288156,277161096,6394,6
143496,OR52B4,chr11,R,4367262,4368386,53128443,1124,277162220,6395,0
143501,C11orf40,chr11,R,4571422,4577820,53134841,6398,277168618,6396,3
143502,OR52I2,chr11,F,4586790,4587905,53135956,1115,277169733,6397,0
143503,OR51E1,chr11,F,4643925,4655488,53147519,11563,277181296,6398,1
143570,XRRA1,chr11,R,74840909,74949187,53255797,108278,277289574,6399,19
143630,UBQLNL,chr11,R,5514392,5516726,53258131,2334,277291908,6400,0
143662,MUC15,chr11,R,26559031,26572268,53271368,13237,277305145,6401,4
143666,LOC143666,chr11,R,573807,575885,53273446,2078,277307223,6402,0
143678,C11orf94,chr11,R,45906533,45907282,53274195,749,277307972,6403,2
143684,FAM76B,chr11,R,95768941,95790396,53295650,21455,277329427,6404,11
143686,SESN3,chr11,R,95165512,95232541,53362679,67029,277396456,6405,11
143689,PIWIL4,chr11,F,94567307,94621421,53416793,54114,277450570,6406,19
143872,ARHGAP42,chr11,F,100687675,100990925,53720043,303250,277753820,6407,26
143879,KBTBD3,chr11,R,106046805,106077765,53751003,30960,277784780,6408,4
143884,CWF19L2,chr11,R,107326344,107457846,53882505,131502,277916282,6409,19
143888,KDELC2,chr11,R,108472104,108498519,53908920,26415,277942697,6410,8
143903,LAYN,chr11,F,111538984,111561745,53931681,22761,277965458,6411,8
143941,TTC36,chr11,F,118527494,118531025,53935212,3531,277968989,6412,2
144097,C11orf84,chr11,F,63813373,63827718,53949557,14345,277983334,6413,8
144100,PLEKHA7,chr11,R,16777296,17014417,54186678,237121,278220455,6414,34
144108,SPTY2D1,chr11,R,18606400,18634786,54215064,28386,278248841,6415,6
144110,TMEM86A,chr11,F,18698734,18704785,54221115,6051,278254892,6416,2
144124,OR10A5,chr11,F,6845682,6846636,54222069,954,278255846,6417,0
144125,OR2AG1,chr11,F,6785016,6786014,54223067,998,278256844,6418,0
144132,DNHD1,chr11,F,6497295,6572025,54297797,74730,278331574,6419,40
147199,SCGB1C1,chr11,F,187898,194575,54304474,6677,278338251,6420,3
154810,AMOTL1,chr11,F,94706435,94876753,54474792,170318,278508569,6421,19
159963,SLC5A12,chr11,R,26667018,26723356,54531130,56338,278564907,6422,18
159989,CCDC67,chr11,F,93329951,93438470,54639649,108519,278673426,6423,21
160065,PATE1,chr11,F,125746292,125749848,54643205,3556,278676982,6424,4
160140,C11orf65,chr11,R,108331425,108467547,54779327,136122,278813104,6425,13
160287,LDHAL6A,chr11,F,18455826,18479600,54803101,23774,278836878,6426,7
160298,C11orf42,chr11,F,6205042,6231450,54829509,26408,278863286,6427,4
170589,GPHA2,chr11,R,64934470,64938132,54833171,3662,278866948,6428,5
170689,ADAMTS15,chr11,F,130448973,130476645,54860843,27672,278894620,6429,8
171389,NLRP6,chr11,F,278364,285388,54867867,7024,278901644,6430,7
171391,LOC171391,chr11,F,777577,784297,54874587,6720,278908364,6431,2
192134,B3GNT6,chr11,F,77034340,77041973,54882220,7633,278915997,6432,1
196074,METTL15,chr11,F,28108250,28527041,55301011,418791,279334788,6433,18
196264,MPZL3,chr11,R,118226689,118252368,55326690,25679,279360467,6434,6
196294,IMMP1L,chr11,R,31432398,31509632,55403924,77234,279437701,6435,9
196335,OR56B4,chr11,F,6107683,6108835,55405076,1152,279438853,6436,0
203859,ANO5,chr11,F,22192512,22283367,55495931,90855,279529708,6437,22
219417,OR8U1,chr11,F,56375623,56376553,55496861,930,279530638,6438,0
219428,OR4C16,chr11,F,55572127,55573060,55497794,933,279531571,6439,0
219429,OR4C11,chr11,R,55603353,55604398,55498839,1045,279532616,6440,0
219431,OR4S2,chr11,F,55650903,55651839,55499775,936,279533552,6441,0
219432,OR4C6,chr11,F,55658586,55666189,55507378,7603,279541155,6442,2
219436,OR5D14,chr11,F,55795555,55796500,55508323,945,279542100,6443,0
219437,OR5L1,chr11,F,55811466,55812402,55509259,936,279543036,6444,0
219438,OR5D18,chr11,F,55818022,55820591,55511828,2569,279545605,6445,1
219445,OR7E5P,chr11,R,55978702,55986405,55519531,7703,279553308,6446,3
219447,OR5AS1,chr11,F,56030418,56031393,55520506,975,279554283,6447,0
219453,OR8K5,chr11,R,56159393,56160317,55521430,924,279555207,6448,0
219464,OR5T2,chr11,R,56232105,56233185,55522510,1080,279556287,6449,0
219469,OR8H1,chr11,R,56290126,56291062,55523446,936,279557223,6450,0
219473,OR8K3,chr11,F,56318306,56319245,55524385,939,279558162,6451,0
219477,OR8J1,chr11,F,56360214,56361288,55525459,1074,279559236,6452,0
219479,OR5R1,chr11,R,56417257,56418232,55526434,975,279560211,6453,0
219482,OR5M3,chr11,R,56469487,56470538,55527485,1051,279561262,6454,0
219484,OR5M8,chr11,R,56490434,56491370,55528421,936,279562198,6455,0
219487,OR5M11,chr11,R,56542339,56543257,55529339,918,279563116,6456,0
219493,OR5AR1,chr11,F,56663685,56664618,55530272,933,279564049,6457,0
219525,OR5AK4P,chr11,F,57037533,57038460,55531199,927,279564976,6458,0
219527,LRRC55,chr11,F,57181746,57191714,55541167,9968,279574944,6459,1
219537,SMTNL1,chr11,F,57537551,57550274,55553890,12723,279587667,6460,7
219539,YPEL4,chr11,R,57645086,57649944,55558748,4858,279592525,6461,5
219541,MED19,chr11,R,57703708,57712438,55567478,8730,279601255,6462,3
219595,FOLH1B,chr11,F,89637519,89698718,55628677,61199,279662454,6463,18
219833,C11orf45,chr11,R,128899564,128909717,55638830,10153,279672607,6464,7
219844,HYLS1,chr11,F,125883613,125900646,55655863,17033,279689640,6465,4
219854,TMEM218,chr11,R,125094369,125111763,55673257,17394,279707034,6466,6
219855,SLC37A2,chr11,F,125063066,125090516,55700707,27450,279734484,6467,18
219858,OR8B12,chr11,R,124542721,124543654,55701640,933,279735417,6468,0
219865,OR8G5,chr11,F,124241157,124323224,55783707,82067,279817484,6469,9
219869,OR10G8,chr11,F,124029622,124030558,55784643,936,279818420,6470,0
219870,OR10G9,chr11,F,124023012,124023948,55785579,936,279819356,6471,0
219873,OR10S1,chr11,R,123976695,123977691,55786575,996,279820352,6472,0
219874,OR6T1,chr11,R,123942431,123993780,55837924,51349,279871701,6473,1
219875,OR4D5,chr11,F,123939616,123940573,55838881,957,279872658,6474,0
219899,TBCEL,chr11,F,121024093,121089647,55904435,65554,279938212,6475,7
219902,TMEM136,chr11,F,120324629,120333688,55913494,9059,279947271,6476,2
219927,MRPL21,chr11,R,68891271,68903835,55926058,12564,279959835,6477,6
219931,TPCN2,chr11,F,69048881,69160413,56037590,111532,280071367,6478,29
219938,SPATA19,chr11,R,133835929,133845538,56047199,9609,280080976,6479,7
219952,OR6Q1,chr11,F,58030952,58031906,56048153,954,280081930,6480,0
219954,OR9I1,chr11,R,58118499,58119444,56049098,945,280082875,6481,0
219956,OR9Q1,chr11,F,58023880,58181587,56206805,157707,280240582,6482,2
219957,OR9Q2,chr11,F,58190433,58191518,56207890,1085,280241667,6483,0
219958,OR1S2,chr11,R,58203203,58204181,56208868,978,280242645,6484,0
219959,OR1S1,chr11,F,58214744,58215722,56209846,978,280243623,6485,0
219960,OR10Q1,chr11,R,58227881,58228918,56210883,1037,280244660,6486,0
219965,OR5B17,chr11,R,58358124,58359069,56211828,945,280245605,6487,0
219968,OR5B21,chr11,R,58507175,58508105,56212758,930,280246535,6488,0
219970,GLYATL2,chr11,R,58834064,58844808,56223502,10744,280257279,6489,5
219972,MPEG1,chr11,R,59208509,59213021,56228014,4512,280261791,6490,0
219981,OR5A2,chr11,R,59421978,59422953,56228989,975,280262766,6491,0
219982,OR5A1,chr11,F,59438056,59444188,56235121,6132,280268898,6492,1
219983,OR4D6,chr11,F,59456960,59457905,56236066,945,280269843,6493,0
219986,OR4D11,chr11,F,59503575,59504511,56237002,936,280270779,6494,0
219988,PATL1,chr11,R,59636715,59669040,56269327,32325,280303104,6495,20
219990,OOSP2,chr11,F,60040274,60048044,56277097,7770,280310874,6496,3
219995,MS4A15,chr11,F,60756866,60776733,56296964,19867,280330741,6497,7
220001,VWCE,chr11,R,61258285,61295316,56333995,37031,280367772,6498,20
220002,CYB561A3,chr11,R,61348747,61362299,56347547,13552,280381324,6499,9
220004,PPP1R32,chr11,F,61481112,61490928,56357363,9816,280391140,6500,13
220032,GDPD4,chr11,R,77216557,77301699,56442505,85142,280476282,6501,17
220042,DDIAS,chr11,F,82901694,82934659,56475470,32965,280509247,6502,7
220047,CCDC83,chr11,F,85855054,85920021,56540437,64967,280574214,6503,14
220064,ORAOV1,chr11,R,69653419,69675397,56562415,21978,280596192,6504,5
220070,SHANK2-AS3,chr11,F,70862789,70865115,56564741,2326,280598518,6505,2
220074,LRTOMT,chr11,F,72080330,72110782,56595193,30452,280628970,6506,11
220296,HEPACAM,chr11,R,124919192,124936412,56612413,17220,280646190,6507,6
220323,OAF,chr11,F,120211038,120229941,56631316,18903,280665093,6508,3
220359,TIGD3,chr11,F,65354810,65357613,56634119,2803,280667896,6509,1
220382,FAM181B,chr11,R,82732003,82733864,56635980,1861,280669757,6510,0
220388,CCDC89,chr11,R,85683843,85686277,56638414,2434,280672191,6511,0
221091,LRRN4CL,chr11,R,62686401,62689899,56641912,3498,280675689,6512,1
221092,HNRNPUL2,chr11,R,62712624,62727385,56656673,14761,280690450,6513,13
221120,ALKBH3,chr11,F,43880806,43920275,56696142,39469,280729919,6514,9
221122,LOC221122,chr11,F,44973901,44978028,56700269,4127,280734046,6515,3
245802,MS4A6E,chr11,F,60334881,60340968,56706356,6087,280740133,6516,3
245911,DEFB108B,chr11,F,71833199,71837562,56710719,4363,280744496,6517,1
246330,PELI3,chr11,F,66466326,66477337,56721730,11011,280755507,6518,9
253935,ANGPTL5,chr11,R,101890673,101916715,56747772,26042,280781549,6519,8
254100,SSSCA1-AS1,chr11,R,65569219,65570413,56748966,1194,280782743,6520,0
254102,EHBP1L1,chr11,F,65576037,65592650,56765579,16613,280799356,6521,21
254122,SNX32,chr11,F,65833938,65855049,56786690,21111,280820467,6522,13
254187,TSGA10IP,chr11,F,65945444,65960392,56801638,14948,280835415,6523,7
254225,RNF169,chr11,F,74748854,74842413,56895197,93559,280928974,6524,6
254263,CNIH2,chr11,F,66278200,66284214,56901211,6014,280934988,6525,5
254359,ZDHHC24,chr11,R,66521378,66546200,56926033,24822,280959810,6526,9
254439,C11orf86,chr11,F,66975282,66977008,56927759,1726,280961536,6527,1
254552,NUDT8,chr11,R,67627937,67629937,56929759,2000,280963536,6528,2
255239,ANKK1,chr11,F,113386037,113400418,56944140,14381,280977917,6529,9
255512,TOLLIP-AS1,chr11,F,1309707,1310707,56945140,1000,280978917,6530,0
255649,OOSP1,chr11,F,59942878,59995845,56998107,52967,281031884,6531,8
255725,OR52B2,chr11,R,6169354,6170326,56999079,972,281032856,6532,0
256144,OR4C3,chr11,F,48324940,48325930,57000069,990,281033846,6533,0
256148,OR4S1,chr11,F,48306222,48307152,57000999,930,281034776,6534,0
256329,LMNTD2,chr11,R,554849,560780,57006930,5931,281040707,6535,14
256364,EML3,chr11,R,62602217,62612765,57017478,10548,281051255,6536,23
256472,TMEM151A,chr11,F,66291901,66296664,57022241,4763,281056018,6537,1
256892,OR51F1,chr11,R,4768978,4769917,57023180,939,281056957,6538,0
257160,RNF214,chr11,F,117232624,117285688,57076244,53064,281110021,6539,15
258010,SVIP,chr11,R,22822051,22829836,57084029,7785,281117806,6540,3
259249,MRGPRX1,chr11,R,18933812,18935002,57085219,1190,281118996,6541,0
266743,NPAS4,chr11,F,66421003,66426706,57090922,5703,281124699,6542,7
280636,C11orf31,chr11,F,57741249,57743411,57093084,2162,281126861,6543,3
282679,AQP11,chr11,F,77589634,77610356,57113806,20722,281147583,6544,4
282763,OR51B5,chr11,R,5340478,5505652,57278980,165174,281312757,6545,6
282770,OR10AG1,chr11,R,55967557,55968463,57279886,906,281313663,6546,0
282775,OR5J2,chr11,F,56176617,56177556,57280825,939,281314602,6547,0
283092,OR4C13,chr11,F,49952390,49953419,57281854,1029,281315631,6548,0
283093,OR4C12,chr11,R,49981472,49982535,57282917,1063,281316694,6549,0
283102,KRT8P41,chr11,F,9094362,9096190,57284745,1828,281318522,6550,0
283104,SBF2-AS1,chr11,F,9758292,9811319,57337772,53027,281371549,6551,2
283106,CSNK2A3,chr11,R,11351941,11353357,57339188,1416,281372965,6552,0
283111,OR51V1,chr11,R,5199734,5200700,57340154,966,281373931,6553,0
283116,TRIM49B,chr11,F,49031599,49037977,57346532,6378,281380309,6554,5
283120,H19,chr11,R,1995175,1997835,57349192,2660,281382969,6555,4
283129,C11orf85,chr11,R,64938229,64972112,57383075,33883,281416852,6556,12
283130,SLC25A45,chr11,R,65373052,65383701,57393724,10649,281427501,6557,10
283131,NEAT1,chr11,F,65422797,65426532,57397459,3735,281431236,6558,0
283140,LOC283140,chr11,F,112270748,112362534,57489245,91786,281523022,6559,3
283143,LINC00900,chr11,R,115755330,115760200,57494115,4870,281527892,6560,2
283149,BCL9L,chr11,R,118896139,118925618,57523594,29479,281557371,6561,10
283150,FOXR1,chr11,F,118971542,118981285,57533337,9743,281567114,6562,6
283152,CCDC153,chr11,R,119190225,119206286,57549398,16061,281583175,6563,11
283159,OR8D1,chr11,R,124309839,124310766,57550325,927,281584102,6564,0
283160,OR8D2,chr11,R,124319261,124320197,57551261,936,281585038,6565,0
283162,OR8B4,chr11,R,124423941,124424871,57552191,930,281585968,6566,0
283165,KIRREL3-AS3,chr11,F,127002909,127006058,57555340,3149,281589117,6567,2
283171,C11orf44,chr11,F,130672955,130717352,57599737,44397,281633514,6568,2
283174,MIR4697HG,chr11,R,133896434,133901740,57605043,5306,281638820,6569,0
283177,LOC283177,chr11,F,134436481,134505661,57674223,69180,281708000,6570,5
283189,OR9G4,chr11,R,56742827,56743811,57675207,984,281708984,6571,0
283194,LOC283194,chr11,R,58933642,59058452,57800017,124810,281833794,6572,5
283197,LINC00301,chr11,F,60615750,60687149,57871416,71399,281905193,6573,6
283208,P4HA3,chr11,R,74247862,74311676,57935230,63814,281969007,6574,14
283209,PGM2L1,chr11,R,74330311,74398465,58003384,68154,282037161,6575,14
283212,KLHL35,chr11,R,75422393,75433444,58014435,11051,282048212,6576,6
283214,LOC283214,chr11,R,75758454,75768647,58024628,10193,282058405,6577,3
283219,KCTD21,chr11,R,78171242,78188817,58042203,17575,282075980,6578,5
283229,CRACR2B,chr11,F,826143,831991,58048051,5848,282081828,6579,10
283232,TMEM80,chr11,F,695590,705028,58057489,9438,282091266,6580,5
283234,CCDC88B,chr11,F,64340196,64357534,58074827,17338,282108604,6581,27
283237,TTC9C,chr11,F,62728077,62738638,58085388,10561,282119165,6582,3
283238,SLC22A24,chr11,R,63079254,63144221,58150355,64967,282184132,6583,10
283248,RCOR2,chr11,R,63911220,63916844,58155979,5624,282189756,6584,11
283254,HARBI1,chr11,R,46603305,46617894,58170568,14589,282204345,6585,6
283267,LINC00294,chr11,F,33076149,33079454,58173873,3305,282207650,6586,11
283284,IGSF22,chr11,R,18704304,18726230,58195799,21926,282229576,6587,22
283297,OR10A4,chr11,F,6876624,6877619,58196794,995,282230571,6588,0
283298,OLFML1,chr11,F,7485368,7511897,58223323,26529,282257100,6589,2
283299,LOC283299,chr11,R,7850750,7905955,58278528,55205,282312305,6590,7
283303,MRGPRG-AS1,chr11,F,3218331,3223131,58283328,4800,282317105,6591,1
285407,ALG1L9P,chr11,R,71794362,71813859,58302825,19497,282336602,6592,5
338322,NLRP10,chr11,R,7959022,7965424,58309227,6402,282343004,6593,2
338323,NLRP14,chr11,F,7020445,7089025,58377807,68580,282411584,6594,12
338440,ANO9,chr11,R,417929,442011,58401889,24082,282435666,6595,25
338645,LUZP2,chr11,F,24496487,25082640,58988042,586153,283021819,6596,14
338651,KRTAP5-AS1,chr11,F,1572740,1599184,59014486,26444,283048263,6597,1
338653,KCNQ1-AS1,chr11,R,2840134,2861569,59035921,21435,283069698,6598,2
338657,CCDC84,chr11,F,118994352,119015793,59057362,21441,283091139,6599,12
338661,TMEM225,chr11,R,123882919,123885650,59060093,2731,283093870,6600,3
338662,OR8D4,chr11,F,123906431,123907376,59061038,945,283094815,6601,0
338667,LOC338667,chr11,F,125947423,125957040,59070655,9617,283104432,6602,10
338674,OR5F1,chr11,R,55993680,55994625,59071600,945,283105377,6603,0
338675,OR5AP2,chr11,R,56641488,56642439,59072551,951,283106328,6604,0
338692,ANKRD13D,chr11,F,67289290,67302484,59085745,13194,283119522,6605,16
338694,LOC338694,chr11,R,69147227,69171562,59110080,24335,283143857,6606,2
338699,ANKRD42,chr11,F,83193738,83256099,59172441,62361,283206218,6607,12
338707,B4GALNT4,chr11,F,369778,382117,59184780,12339,283218557,6608,20
338739,CSTF3-AS1,chr11,F,33161656,33191598,59214722,29942,283248499,6609,3
338751,OR52L1,chr11,R,5985891,5986985,59215816,1094,283249593,6610,0
338755,OR2AG2,chr11,R,6767344,6926426,59374898,159082,283408675,6611,4
340980,OR52B6,chr11,F,5580876,5581884,59375906,1008,283409683,6612,0
340990,OTOG,chr11,F,17547372,17645944,59474478,98572,283508255,6613,55
341019,DCDC1,chr11,R,31262623,31369810,59581665,107187,283615442,6614,8
341032,C11orf53,chr11,F,111245703,111286406,59622368,40703,283656145,6615,5
341056,LOC341056,chr11,F,123017565,123019611,59624414,2046,283658191,6616,0
341112,WARSP1,chr11,F,59255467,59258657,59627604,3190,283661381,6617,1
341116,MS4A10,chr11,F,60785303,60801305,59643606,16002,283677383,6618,9
341152,OR2AT4,chr11,R,75088750,75089713,59644569,963,283678346,6619,0
341208,HEPHL1,chr11,F,94021211,94114208,59737566,92997,283771343,6620,19
341276,OR10A2,chr11,F,6869754,6870666,59738478,912,283772255,6621,0
341277,OVCH2,chr11,R,7678691,7706454,59766241,27763,283800018,6622,16
347853,TBX10,chr11,R,67631302,67639560,59774499,8258,283808276,6623,7
347862,PDDC1,chr11,R,767216,777501,59784784,10285,283818561,6624,5
349633,PLET1,chr11,R,112248152,112260860,59797492,12708,283831269,6625,3
349667,RTN4RL2,chr11,F,57460536,57477539,59814495,17003,283848272,6626,2
374378,GALNT18,chr11,R,11270873,11622045,60165667,351172,284199444,6627,15
374383,NCR3LG1,chr11,F,17351731,17381661,60195597,29930,284229374,6628,8
374387,DKFZp779M0652,chr11,F,45771431,45772358,60196524,927,284230301,6629,1
374393,FAM111B,chr11,F,59107184,59127415,60216755,20231,284250532,6630,3
374395,TMEM179B,chr11,F,62787398,62790400,60219757,3002,284253534,6631,4
374403,TBC1D10C,chr11,F,67403685,67410090,60226162,6405,284259939,6632,9
374407,DNAJB13,chr11,F,73950318,73970287,60246131,19969,284279908,6633,15
378938,MALAT1,chr11,F,65497761,65506469,60254839,8708,284288616,6634,0
386607,ZFP91-CNTF,chr11,F,58579113,58625733,60301459,46620,284335236,6635,12
386746,MRGPRG,chr11,R,3217943,3218813,60302329,870,284336106,6636,0
387264,KRTAP5-1,chr11,R,1584341,1585283,60303271,942,284337048,6637,0
387266,KRTAP5-3,chr11,R,1607564,1608463,60304170,899,284337947,6638,0
387273,KRTAP5-10,chr11,F,71565562,71566620,60305228,1058,284339005,6639,0
387601,SLC22A25,chr11,R,63162265,63243516,60386479,81251,284420256,6640,12
387733,IFITM5,chr11,R,298199,299526,60387806,1327,284421583,6641,1
387742,FAM99A,chr11,F,1665598,1667856,60390064,2258,284423841,6642,2
387748,OR56B1,chr11,F,5736447,5737538,60391155,1091,284424932,6643,0
387751,GVINP1,chr11,R,6713138,6721879,60399896,8741,284433673,6644,0
387755,INSC,chr11,F,15111429,15247208,60535675,135779,284569452,6645,20
387758,FIBIN,chr11,F,26994080,26997087,60538682,3007,284572459,6646,0
387763,C11orf96,chr11,F,43942555,43943883,60540010,1328,284573787,6647,0
387775,SLC22A10,chr11,F,63268719,63311774,60583065,43055,284616842,6648,13
387778,SPDYC,chr11,F,65169993,65173368,60586440,3375,284620217,6649,6
387787,LIPT2,chr11,R,74490726,74493719,60589433,2993,284623210,6650,1
387804,VSTM5,chr11,R,93820568,93850502,60619367,29934,284653144,6651,3
387810,LOC387810,chr11,R,112534219,112555802,60640950,21583,284674727,6652,3
388572,LOC388572,chr11,R,133724,185265,60692491,51541,284726268,6653,26
390036,OR52K1,chr11,F,4488878,4489908,60693521,1030,284727298,6654,0
390037,OR52I1,chr11,F,4594038,4595013,60694496,975,284728273,6655,0
390038,OR51D1,chr11,F,4639714,4640838,60695620,1124,284729397,6656,0
390054,OR52A5,chr11,R,5131691,5132642,60696571,951,284730348,6657,0
390058,OR51B6,chr11,F,5351507,5352446,60697510,939,284731287,6658,0
390059,OR51M1,chr11,F,5389376,5390434,60698568,1058,284732345,6659,0
390061,OR51Q1,chr11,F,5422110,5423206,60699664,1096,284733441,6660,0
390063,OR51I1,chr11,R,5440541,5441553,60700676,1012,284734453,6661,0
390064,OR51I2,chr11,F,5453407,5454477,60701746,1070,284735523,6662,0
390066,OR52D1,chr11,F,5488684,5489749,60702811,1065,284736588,6663,0
390067,OR52H1,chr11,R,5544560,5545523,60703774,963,284737551,6664,0
390072,OR52N4,chr11,F,5722258,5755958,60737474,33700,284771251,6665,7
390075,OR52N5,chr11,R,5777633,5778667,60738508,1034,284772285,6666,0
390077,OR52N2,chr11,F,5808904,5821400,60751004,12496,284784781,6667,1
390078,OR52E6,chr11,R,5840955,5841897,60751946,942,284785723,6668,0
390079,OR52E8,chr11,R,5856748,5857702,60752900,954,284786677,6669,0
390081,OR52E4,chr11,F,5880629,5885294,60757565,4665,284791342,6670,2
390083,OR56A3,chr11,F,5947346,5948294,60758513,948,284792290,6671,0
390084,OR56A5,chr11,R,5967552,5968494,60759455,942,284793232,6672,0
390093,OR10A6,chr11,R,7927717,7928662,60760400,945,284794177,6673,0
390110,ACCSL,chr11,F,43921083,44060307,60899624,139224,284933401,6674,17
390113,OR4X1,chr11,F,48263860,48264778,60900542,918,284934319,6675,0
390142,OR5D13,chr11,F,55773437,55774382,60901487,945,284935264,6676,0
390144,OR5D16,chr11,F,55838751,55839738,60902474,987,284936251,6677,0
390148,OR5W2,chr11,R,55913649,55914582,60903407,933,284937184,6678,0
390151,OR8H2,chr11,F,56105042,56105981,60904346,939,284938123,6679,0
390152,OR8H3,chr11,F,56122372,56123311,60905285,939,284939062,6680,0
390154,OR5T3,chr11,F,56252199,56253222,60906308,1023,284940085,6681,0
390155,OR5T1,chr11,F,56275638,56276619,60907289,981,284941066,6682,0
390157,OR8K1,chr11,F,56346038,56346998,60908249,960,284942026,6683,0
390162,OR5M9,chr11,R,56462468,56463401,60909182,933,284942959,6684,0
390167,OR5M10,chr11,R,56576773,56577721,60910130,948,284943907,6685,0
390168,OR5M1,chr11,R,56612554,56613502,60911078,948,284944855,6686,0
390174,OR9G1,chr11,F,56700387,56701305,60911996,918,284945773,6687,0
390181,OR5AK2,chr11,F,56988913,56989843,60912926,930,284946703,6688,0
390190,OR5B2,chr11,R,58422264,58423313,60913975,1049,284947752,6689,0
390191,OR5B12,chr11,R,58439119,58440173,60915029,1054,284948806,6690,0
390195,OR5AN1,chr11,F,59364458,59365394,60915965,936,284949742,6691,0
390197,OR4D10,chr11,F,59477429,59478365,60916901,936,284950678,6692,0
390199,OR4D9,chr11,F,59514912,59515857,60917846,945,284951623,6693,0
390201,OR10V1,chr11,R,59712915,59713845,60918776,930,284952553,6694,0
390205,LRRC10B,chr11,F,61508799,61511018,60920995,2219,284954772,6695,0
390212,GPR152,chr11,R,67451300,67452729,60922424,1429,284956201,6696,0
390213,DOC2GP,chr11,R,67613523,67615664,60924565,2141,284958342,6697,4
390226,GUCY2EP,chr11,R,76680165,76721789,60966189,41624,284999966,6698,20
390231,TRIM77,chr11,F,89710298,89717872,60973763,7574,285007540,6699,5
390243,IZUMO1R,chr11,F,94304560,94307762,60976965,3202,285010742,6700,4
390245,KDM4E,chr11,F,95025257,95027596,60979304,2339,285013081,6701,0
390259,BSX,chr11,R,122977648,122981671,60983327,4023,285017104,6702,2
390260,OR6X1,chr11,R,123753579,123754518,60984266,939,285018043,6703,0
390261,OR6M1,chr11,R,123805407,123806349,60985208,942,285018985,6704,0
390264,OR10G4,chr11,F,124015574,124016510,60986144,936,285019921,6705,0
390265,OR10G7,chr11,R,124038065,124039001,60987080,936,285020857,6706,0
390271,OR8B3,chr11,R,124396409,124399522,60990193,3113,285023970,6707,2
390275,OR8A1,chr11,F,124570002,124602563,61022754,32561,285056531,6708,3
399876,NAV2-AS4,chr11,R,19510892,19524078,61035940,13186,285069717,6709,3
399881,HNRNPKP3,chr11,R,43261503,43269369,61043806,7866,285077583,6710,1
399886,LOC399886,chr11,F,45371396,45388508,61060918,17112,285094695,6711,4
399888,FAM180B,chr11,F,47586677,47589194,61063435,2517,285097212,6712,2
399900,LOC399900,chr11,F,61967737,61969275,61064973,1538,285098750,6713,0
399909,PCNXL3,chr11,F,65614321,65637439,61088091,23118,285121868,6714,37
399923,FLJ42102,chr11,R,71405745,71423354,61105700,17609,285139477,6715,2
399939,TRIM49D1,chr11,R,89911408,89920388,61114680,8980,285148457,6716,6
399940,TRIM51EP,chr11,R,89981445,89991691,61124926,10246,285158703,6717,6
399947,C11orf87,chr11,F,109421727,109429167,61132366,7440,285166143,6718,4
399948,COLCA1,chr11,R,111293388,111305048,61144026,11660,285177803,6719,5
399949,C11orf88,chr11,F,111514784,111537031,61166273,22247,285200050,6720,6
399959,MIR100HG,chr11,R,122089102,122203062,61280233,113960,285314010,6721,3
399967,PATE2,chr11,R,125772310,125778834,61286757,6524,285320534,6722,5
399968,PATE4,chr11,F,125833315,125840072,61293514,6757,285327291,6723,2
399972,ST3GAL4-AS1,chr11,R,126341715,126355587,61307386,13872,285341163,6724,1
399979,SNX19,chr11,R,130875870,130916487,61348003,40617,285381780,6725,15
401665,OR51T1,chr11,F,4881818,4882883,61349068,1065,285382845,6726,0
401666,OR51A4,chr11,R,4946158,4947100,61350010,942,285383787,6727,0
401667,OR51A2,chr11,R,4954771,4955713,61350952,942,285384729,6728,0
402778,IFITM10,chr11,R,1732409,1750594,61369137,18185,285402914,6729,2
403253,OR4A47,chr11,F,48483465,48489774,61375446,6309,285409223,6730,1
403257,OR4C45,chr11,F,50032873,50033794,61376367,921,285410144,6731,0
403312,LOC403312,chr11,F,125495213,125499526,61380680,4313,285414457,6732,1
404552,SCGB1D4,chr11,R,62296281,62299064,61383463,2783,285417240,6733,2
406882,MIRLET7A2,chr11,R,122146521,122146593,61383535,72,285417312,6734,0
406892,MIR100,chr11,R,122152228,122152308,61383615,80,285417392,6735,0
406911,MIR125B1,chr11,R,122099756,122099844,61383703,88,285417480,6736,0
406918,MIR129-2,chr11,F,43581393,43581483,61383793,90,285417570,6737,0
406919,MIR130A,chr11,F,57641197,57641286,61383882,89,285417659,6738,0
406931,MIR139,chr11,R,72615062,72615130,61383950,68,285417727,6739,0
406967,MIR192,chr11,R,64891136,64891246,61384060,110,285417837,6740,0
406970,MIR194-2,chr11,R,64891354,64891439,61384145,85,285417922,6741,0
406992,MIR210,chr11,R,568088,568198,61384255,110,285418032,6742,0
407041,MIR34B,chr11,F,111512937,111513021,61384339,84,285418116,6743,0
407042,MIR34C,chr11,F,111513438,111513515,61384416,77,285418193,6744,0
414301,DDI1,chr11,F,104036579,104039194,61387031,2615,285420808,6745,0
414899,BLID,chr11,R,122115353,122116215,61387893,862,285421670,6746,0
439915,KRTAP5-5,chr11,F,1629802,1630930,61389021,1128,285422798,6747,0
440021,KRTAP5-2,chr11,R,1597176,1598294,61390139,1118,285423916,6748,0
440023,KRTAP5-6,chr11,F,1697194,1697755,61390700,561,285424477,6749,0
440026,TMEM41B,chr11,R,9280653,9314768,61424815,34115,285458592,6750,6
440028,LOC440028,chr11,R,9754769,9759533,61429579,4764,285463356,6751,2
440034,DKFZp686K1684,chr11,F,31816565,31887041,61500055,70476,285533832,6752,2
440040,LOC440040,chr11,F,49558527,49810419,61751947,251892,285785724,6753,6
440041,TRIM51HP,chr11,R,55293702,55298232,61756477,4530,285790254,6754,4
440044,SLC22A20,chr11,F,65213839,65242757,61785395,28918,285819172,6755,10
440050,KRTAP5-7,chr11,F,71527266,71528164,61786293,898,285820070,6756,0
440051,KRTAP5-11,chr11,R,71581854,71582875,61787314,1021,285821091,6757,0
440067,CASP1P2,chr11,R,105062601,105071556,61796269,8955,285830046,6758,5
440068,CARD17,chr11,R,105092468,105101465,61805266,8997,285839043,6759,3
440072,LINC00167,chr11,F,130002623,130005486,61808129,2863,285841906,6760,0
441601,LOC441601,chr11,R,50279827,50298462,61826764,18635,285860541,6761,5
441608,OR5B3,chr11,R,58402464,58403409,61827709,945,285861486,6762,0
442900,MIR326,chr11,R,75335091,75335186,61827804,95,285861581,6763,0
445372,TRIM6-TRIM34,chr11,F,5596634,5644398,61875568,47764,285909345,6764,13
493860,CCDC73,chr11,R,32602079,32794658,62068147,192579,286101924,6765,18
493900,TMEM9B-AS1,chr11,F,8964674,8976283,62079756,11609,286113533,6766,4
494141,LOC494141,chr11,F,18209137,18213578,62084197,4441,286117974,6767,2
497258,BDNF-AS,chr11,F,27506851,27698171,62275517,191320,286309294,6768,9
503497,MS4A13,chr11,F,60515375,60543424,62303566,28049,286337343,6769,7
619383,SCARNA9,chr11,F,93721513,93721866,62303919,353,286337696,6770,0
619552,MIR483,chr11,R,2134133,2134209,62303995,76,286337772,6771,0
619562,SNORA45A,chr11,F,8684226,8684356,62304125,130,286337902,6772,0
619565,SNORA52,chr11,F,811680,811814,62304259,134,286338036,6773,0
641654,HEPN1,chr11,F,124919249,124920677,62305687,1428,286339464,6774,0
642446,TRIM64B,chr11,R,89870126,89878437,62313998,8311,286347775,6775,7
642569,TRIM53AP,chr11,R,89993540,90002508,62322966,8968,286356743,6776,6
642612,TRIM49C,chr11,F,90030148,90042029,62334847,11881,286368624,6777,8
642623,UBTFL1,chr11,F,90085949,90087131,62336029,1182,286369806,6778,0
643037,C11orf97,chr11,F,94512528,94532123,62355624,19595,286389401,6779,3
643376,BTBD18,chr11,R,57743513,57753256,62365367,9743,286399144,6780,3
643680,MS4A4E,chr11,R,60201252,60243114,62407229,41862,286441006,6781,8
643733,LOC643733,chr11,R,104901548,104918175,62423856,16627,286457633,6782,4
643834,PGA3,chr11,F,61203494,61212878,62433240,9384,286467017,6783,8
643847,PGA4,chr11,F,61222330,61231707,62442617,9377,286476394,6784,8
643923,LOC643923,chr11,F,107591744,107593223,62444096,1479,286477873,6785,2
644277,LOC644277,chr11,F,111445885,111456605,62454816,10720,286488593,6786,10
644656,LOC644656,chr11,R,9459555,9460698,62455959,1143,286489736,6787,0
644672,CLDN25,chr11,F,113779795,113780485,62456649,690,286490426,6788,0
644943,RASSF10,chr11,F,13009422,13012106,62459333,2684,286493110,6789,0
645332,FAM86C2P,chr11,R,67791766,67805336,62472903,13570,286506680,6790,3
646029,LOC646029,chr11,F,77571088,77575662,62477477,4574,286511254,6791,2
646383,LOC646383,chr11,F,130314989,130446204,62608692,131215,286642469,6792,15
646522,LOC646522,chr11,R,133783670,133810376,62635398,26706,286669175,6793,2
646754,TRIM64C,chr11,R,49053713,49059112,62640797,5399,286674574,6794,5
646813,LOC646813,chr11,F,50409146,50420631,62652282,11485,286686059,6795,5
649133,LOC649133,chr11,R,120249758,120265932,62668456,16174,286702233,6796,7
649946,RPL23AP64,chr11,R,119002952,119003593,62669097,641,286702874,6797,0
650368,TSSC2,chr11,F,3380960,3409148,62697285,28188,286731062,6798,10
654320,SNORA8,chr11,R,93732360,93732499,62697424,139,286731201,6799,0
677792,SNORA1,chr11,R,93732003,93732133,62697554,130,286731331,6800,0
677805,SNORA18,chr11,R,93733465,93733597,62697686,132,286731463,6801,0
677808,SNORA23,chr11,F,9428765,9428954,62697875,189,286731652,6802,0
677822,SNORA40,chr11,R,93735109,93735236,62698002,127,286731779,6803,0
677826,SNORA45B,chr11,F,8685438,8685569,62698133,131,286731910,6804,0
677833,SNORA54,chr11,R,2963770,2963893,62698256,123,286732033,6805,0
684959,SNORA25,chr11,R,93730512,93730646,62698390,134,286732167,6806,0
692063,SNORA32,chr11,R,93730978,93731099,62698511,121,286732288,6807,0
692072,SNORD5,chr11,R,93733227,93733300,62698584,73,286732361,6808,0
692075,SNORD6,chr11,R,93731502,93731573,62698655,71,286732432,6809,0
692108,SNORD67,chr11,R,46762388,46762499,62698766,111,286732543,6810,0
692158,SNORA57,chr11,F,62665421,62665570,62698915,149,286732692,6811,0
692223,SNORD97,chr11,R,10801466,10801608,62699057,142,286732834,6812,0
693195,MIR610,chr11,F,28056814,28056910,62699153,96,286732930,6813,0
693196,MIR611,chr11,R,61792494,61792561,62699220,67,286732997,6814,0
693197,MIR612,chr11,F,65444457,65444557,62699320,100,286733097,6815,0
723961,INS-IGF2,chr11,R,2129111,2161209,62731418,32098,286765195,6816,7
727897,MUC5B,chr11,F,1223064,1262176,62770530,39112,286804307,6817,48
728588,MS4A18,chr11,F,60724008,60744213,62790735,20205,286824512,6818,6
728975,LOC728975,chr11,R,65179870,65181337,62792202,1467,286825979,6819,1
729013,ZBED5-AS1,chr11,F,10858216,10879276,62813262,21060,286847039,6820,2
729173,LOC729173,chr11,F,120168543,120171679,62816398,3136,286850175,6821,1
729384,TRIM49D2,chr11,F,89924063,89933063,62825398,9000,286859175,6822,6
729799,SEC14L1P1,chr11,F,43897302,43899888,62827984,2586,286861761,6823,0
751071,METTL12,chr11,F,62665262,62667451,62830173,2189,286863950,6824,1
790955,UQCC3,chr11,F,62671653,62673690,62832210,2037,286865987,6825,1
100009605,TRF-GAA2-1,chr11,R,59566379,59566452,62832283,73,286866060,6826,0
100009613,ANO1-AS2,chr11,R,70072433,70075348,62835198,2915,286868975,6827,2
100033819,MIR675,chr11,R,1996758,1996831,62835271,73,286869048,6828,0
100049613,TRK-TTT3-3,chr11,R,59560334,59560407,62835344,73,286869121,6829,0
100126333,MIR708,chr11,R,79402021,79402109,62835432,88,286869209,6830,0
100126784,LOC100126784,chr11,R,19710933,19714672,62839171,3739,286872948,6831,0
100128239,LOC100128239,chr11,F,134032271,134041341,62848241,9070,286882018,6832,2
100128242,LOC100128242,chr11,F,123430235,123435715,62853721,5480,286887498,6833,3
100128386,LOC100128386,chr11,R,100684160,100687955,62857516,3795,286891293,6834,1
100128494,LOC100128494,chr11,F,72014290,72020910,62864136,6620,286897913,6835,3
100129203,LOC100129203,chr11,F,95230185,95234404,62868355,4219,286902132,6836,5
100129216,LOC100129216,chr11,F,71878452,71884561,62874464,6109,286908241,6837,1
100129473,LOC100129473,chr11,F,61766242,61767601,62875823,1359,286909600,6838,0
100129827,MRVI1-AS1,chr11,F,10541235,10599932,62934520,58697,286968297,6839,4
100130348,TMEM262,chr11,R,65088211,65089990,62936299,1779,286970076,6840,1
100130460,CAND1.11,chr11,F,10308312,10430673,63058660,122361,287092437,6841,3
100130987,LOC100130987,chr11,F,67317838,67391687,63132509,73849,287166286,6842,3
100131378,C11orf91,chr11,R,33698107,33700740,63135142,2633,287168919,6843,1
100131539,ZNF705E,chr11,R,71814044,71821547,63142645,7503,287176422,6844,4
100131626,LOC100131626,chr11,R,118381219,118418815,63180241,37596,287214018,6845,3
100132078,LOC100132078,chr11,R,111414241,111418186,63184186,3945,287217963,6846,3
100132464,FAM99B,chr11,R,1683269,1685629,63186546,2360,287220323,6847,2
100133161,LINC01001,chr11,R,126986,131920,63191480,4934,287225257,6848,2
100133315,LOC100133315,chr11,R,71865508,71928447,63254419,62939,287288196,6849,6
100133545,MRPL23-AS1,chr11,R,1983208,1989920,63261131,6712,287294908,6850,3
100169851,PATE3,chr11,F,125788110,125791600,63264621,3490,287298398,6851,2
100188993,TRV-TAC1-1,chr11,R,59550628,59550701,63264694,73,287298471,6852,0
100189072,TRP-AGG2-2,chr11,F,76235512,76235584,63264766,72,287298543,6853,0
100189115,TRR-TCT3-1,chr11,F,59551293,59551379,63264852,86,287298629,6854,1
100189224,TRP-TGG2-1,chr11,R,76235824,76235896,63264924,72,287298701,6855,0
100189238,TRK-TTT5-1,chr11,F,59556428,59556501,63264997,73,287298774,6856,0
100189240,TRL-TAA3-1,chr11,F,59551754,59551837,63265080,83,287298857,6857,0
100189283,TRV-TAC2-1,chr11,R,59550986,59551059,63265153,73,287298930,6858,0
100189285,TRS-GCT3-1,chr11,F,66348119,66348201,63265235,82,287299012,6859,0
100189294,TRK-TTT2-1,chr11,F,122559946,122560019,63265308,73,287299085,6860,0
100189370,TRL-CAA5-1,chr11,F,9275242,9275316,63265382,74,287299159,6861,0
100189415,TRF-GAA1-1,chr11,R,59557496,59557569,63265455,73,287299232,6862,0
100287413,LOC100287413,chr11,F,58905309,58908598,63268744,3289,287302521,6863,1
100287896,LOC100287896,chr11,F,74493439,74498242,63273547,4803,287307324,6864,1
100288077,WTAPP1,chr11,F,102783675,102836766,63326638,53091,287360415,6865,7
100288346,NCAM1-AS1,chr11,R,113269531,113273901,63331008,4370,287364785,6866,2
100289388,KCTD21-AS1,chr11,F,78139792,78173977,63365193,34185,287398970,6867,3
100302228,MIR1261,chr11,R,90869120,90869202,63365275,82,287399052,6868,0
100302240,MIR1304,chr11,R,93733673,93733764,63365366,91,287399143,6869,0
100302263,MIR1908,chr11,R,61815160,61815240,63365446,80,287399223,6870,0
100302275,MIR548L,chr11,R,94466494,94466580,63365532,86,287399309,6871,0
100302280,MIR1237,chr11,F,64368601,64368703,63365634,102,287399411,6872,0
100313770,MIR548K,chr11,F,70283954,70284070,63365750,116,287399527,6873,0
100313774,MIR302E,chr11,F,7234765,7234837,63365822,72,287399599,6874,0
100313777,MIR670,chr11,F,43559655,43559753,63365920,98,287399697,6875,0
100379250,SNORA70E,chr11,R,83041463,83041598,63366055,135,287399832,6876,0
100379571,BACE1-AS,chr11,F,117291345,117292170,63366880,825,287400657,6877,0
100422823,MIR4300,chr11,R,81890740,81890836,63366976,96,287400753,6878,0
100422825,MIR3160-2,chr11,F,46451806,46451887,63367057,81,287400834,6879,0
100422827,MIR3160-1,chr11,R,46451804,46451889,63367142,85,287400919,6880,0
100422846,MIR3164,chr11,F,69083175,69083258,63367225,83,287401002,6881,0
100422855,MIR4301,chr11,R,113450022,113450088,63367291,66,287401068,6882,0
100422880,MIR3162,chr11,R,59595076,59595158,63367373,82,287401150,6883,0
100422918,MIR3167,chr11,R,126988457,126988542,63367458,85,287401235,6884,0
100422953,MIR3165,chr11,R,72072227,72072302,63367533,75,287401310,6885,0
100422991,MIR1260B,chr11,F,96341437,96341526,63367622,89,287401399,6886,0
100423000,MIR3161,chr11,F,48096781,48096858,63367699,77,287401476,6887,0
100423016,MIR3159,chr11,F,18387786,18387860,63367773,74,287401550,6888,0
100423021,MIR4298,chr11,R,1859463,1859536,63367846,73,287401623,6889,0
100423026,MIR4299,chr11,R,11656650,11656722,63367918,72,287401695,6890,0
100423029,MIR3163,chr11,R,66934433,66934506,63367991,73,287401768,6891,0
100423040,MIR3166,chr11,F,88176501,88176593,63368083,92,287401860,6892,0
100463486,MTRNR2L8,chr11,R,10507886,10509176,63369373,1290,287403150,6893,0
100499227,USP2-AS1,chr11,F,119381777,119499233,63486829,117456,287520606,6894,3
100500823,MIR3920,chr11,R,101519819,101519905,63486915,86,287520692,6895,0
100500840,MIR3656,chr11,F,119018943,119019012,63486984,69,287520761,6896,0
100500844,MIR3664,chr11,R,70872269,70872368,63487083,99,287520860,6897,0
100500938,CCDC179,chr11,R,22846921,22860486,63500648,13565,287534425,6898,6
100505504,LOC100505504,chr11,F,66409273,66417137,63508512,7864,287542289,6899,1
100505570,LOC100505570,chr11,F,1687505,1689058,63510065,1553,287543842,6900,1
100505621,C11orf72,chr11,R,67602879,67606706,63513892,3827,287547669,6901,2
100506082,LOC100506082,chr11,F,4187151,4202653,63529394,15502,287563171,6902,1
100506113,LOC100506113,chr11,R,75800757,75815187,63543824,14430,287577601,6903,6
100506127,LOC100506127,chr11,F,76381324,76408132,63570632,26808,287604409,6904,1
100506211,MIR210HG,chr11,R,565656,568457,63573433,2801,287607210,6905,1
100506233,RAB30-AS1,chr11,F,83072065,83073712,63575080,1647,287608857,6906,2
100506258,LOC100506258,chr11,R,7437626,7465835,63603289,28209,287637066,6907,4
100506282,LOC100506282,chr11,R,83190905,83193794,63606178,2889,287639955,6908,2
100506305,LINC00958,chr11,R,12979533,12989548,63616193,10015,287649970,6909,1
100506368,LOC100506368,chr11,F,86955620,87000950,63661523,45330,287695300,6910,2
100506540,SPTY2D1-AS1,chr11,F,18599803,18610255,63671975,10452,287705752,6911,4
100506627,DCDC5,chr11,R,30863602,30992686,63801059,129084,287834836,6912,19
100506675,LOC100506675,chr11,R,32035978,32041318,63806399,5340,287840176,6913,3
100506742,CASP12,chr11,R,104885717,104898670,63819352,12953,287853129,6914,8
100507050,TPBGL,chr11,F,75240904,75243704,63822152,2800,287855929,6915,0
100507144,LOC100507144,chr11,R,35132649,35138032,63827535,5383,287861312,6916,2
100507205,LOC100507205,chr11,R,42187742,42253690,63893483,65948,287927260,6917,5
100507261,MIR670HG,chr11,F,43568400,43572643,63897726,4243,287931503,6918,2
100507283,LOC100507283,chr11,F,124800427,124834487,63931786,34060,287965563,6919,4
100507300,ALKBH3-AS1,chr11,R,43909288,43920944,63943442,11656,287977219,6920,5
100507384,LOC100507384,chr11,F,45722307,45724555,63945690,2248,287979467,6921,2
100507392,SENCR,chr11,R,128691671,128696023,63950042,4352,287983819,6922,2
100507401,LRP4-AS1,chr11,F,46846410,46874416,63978048,28006,288011825,6923,2
100507431,LOC100507431,chr11,R,130844192,130862110,63995966,17918,288029743,6924,5
100507521,LOC100507521,chr11,R,62050912,62082393,64027447,31481,288061224,6925,3
100507548,LOC100507548,chr11,F,134985283,134986939,64029103,1656,288062880,6926,0
100526737,RBM14-RBM4,chr11,F,66616581,66646473,64058995,29892,288092772,6927,2
100526771,TMPRSS4-AS1,chr11,R,118015771,118086793,64130017,71022,288163794,6928,3
100528016,TMX2-CTNND1,chr11,F,57712522,57819180,64236675,106658,288270452,6929,20
100528017,SAA2-SAA4,chr11,R,18231354,18248674,64253995,17320,288287772,6930,4
100528018,ARL2-SNX15,chr11,F,65014112,65040572,64280455,26460,288314232,6931,10
100528019,HSPB2-C11orf52,chr11,F,111912735,111926871,64294591,14136,288328368,6932,3
100532726,NDUFC2-KCTD14,chr11,R,78015714,78080219,64359096,64505,288392873,6933,3
100533181,FXYD6-FXYD2,chr11,R,117820074,117877031,64416053,56957,288449830,6934,11
100534595,HNRNPUL2-BSCL2,chr11,R,62690261,62727384,64453176,37123,288486953,6935,23
100616118,MIR4486,chr11,F,19575309,19575372,64453239,63,288487016,6936,0
100616119,MIR4697,chr11,R,133898503,133898581,64453317,78,288487094,6937,0
100616126,MIR4686,chr11,F,2173062,2173138,64453393,76,288487170,6938,0
100616186,MIR4490,chr11,R,90555773,90555857,64453477,84,288487254,6939,0
100616215,MIR548AL,chr11,F,74399236,74399333,64453574,97,288487351,6940,0
100616222,MIR4487,chr11,F,47400969,47401042,64453647,73,288487424,6941,0
100616263,MIR4485,chr11,R,10508269,10508326,64453704,57,288487481,6942,0
100616284,MIR4489,chr11,F,65649191,65649253,64453766,62,288487543,6943,0
100616292,MIR4690,chr11,F,65636309,65636369,64453826,60,288487603,6944,0
100616311,MIR3973,chr11,F,36010097,36010204,64453933,107,288487710,6945,0
100616319,MIR4493,chr11,R,123381439,123381512,64454006,73,288487783,6946,0
100616330,MIR4491,chr11,F,111347756,111347824,64454074,68,288487851,6947,0
100616368,MIR4688,chr11,F,46376401,46376484,64454157,83,288487934,6948,0
100616376,MIR4492,chr11,F,118910707,118910787,64454237,80,288488014,6949,0
100616402,MIR4696,chr11,R,74720267,74720337,64454307,70,288488084,6950,0
100616403,MIR4691,chr11,F,68033896,68033981,64454392,85,288488169,6951,0
100616410,MIR4692,chr11,F,72783529,72783592,64454455,63,288488232,6952,0
100616426,MIR4694,chr11,R,19760003,19760083,64454535,80,288488312,6953,0
100616437,MIR1343,chr11,F,34941836,34941920,64454619,84,288488396,6954,0
100616453,MIR4687,chr11,F,3856061,3856141,64454699,80,288488476,6955,0
100616457,MIR4693,chr11,F,103849905,103849980,64454774,75,288488551,6956,0
100616470,MIR4488,chr11,F,61508595,61508657,64454836,62,288488613,6957,0
100652768,LOC100652768,chr11,R,117195612,117201914,64461138,6302,288494915,6958,7
100847000,MIR5579,chr11,R,79422168,79422226,64461196,58,288494973,6959,0
100847015,MIR5691,chr11,R,9090311,9090379,64461264,68,288495041,6960,0
100847020,MIR5582,chr11,R,46753124,46753192,64461332,68,288495109,6961,0
100873753,RNU6-16P,chr11,R,88612804,88612911,64461439,107,288495216,6962,0
100873759,RNU6-45P,chr11,F,63970469,63970576,64461546,107,288495323,6963,0
100873760,RNU6-46P,chr11,F,67895630,67895737,64461653,107,288495430,6964,0
100873989,GRM5-AS1,chr11,F,88504575,88524054,64481132,19479,288514909,6965,5
100874012,NAV2-AS5,chr11,R,19502671,19507229,64485690,4558,288519467,6966,2
100874014,NAV2-AS2,chr11,R,20043774,20049303,64491219,5529,288524996,6967,1
100874053,JRKL-AS1,chr11,R,96443280,96506876,64554815,63596,288588592,6968,4
100874198,SHANK2-AS1,chr11,F,70631093,70635490,64559212,4397,288592989,6969,2
100874251,KIRREL3-AS2,chr11,F,126940745,126945090,64563557,4345,288597334,6970,2
100874281,NTM-IT,chr11,F,132284301,132288459,64567715,4158,288601492,6971,2
100996455,LOC100996455,chr11,F,64449056,64451657,64570316,2601,288604093,6972,1
101054525,LOC101054525,chr11,F,101129076,101159270,64600510,30194,288634287,6973,4
101059906,LOC101059906,chr11,F,528483,532263,64604290,3780,288638067,6974,3
101060179,LOC101060179,chr11,F,45213065,45214744,64605969,1679,288639746,6975,0
101060224,LOC101060224,chr11,R,50081830,50088477,64612616,6647,288646393,6976,2
101410541,LINC00678,chr11,R,27617625,27634627,64629618,17002,288663395,6977,3
101927120,LOC101927120,chr11,F,56848477,56878078,64659219,29601,288692996,6978,3
101927204,LOC101927204,chr11,R,59133971,59142808,64668056,8837,288701833,6979,3
101927226,LOC101927226,chr11,F,59616288,59635536,64687304,19248,288721081,6980,2
101927423,PANO1,chr11,F,797510,799185,64688979,1675,288722756,6981,0
101927495,LOC101927495,chr11,F,61588493,61607546,64708032,19053,288741809,6982,3
101927503,LOC101927503,chr11,F,1039199,1055749,64724582,16550,288758359,6983,8
101927562,LOC101927562,chr11,R,1554606,1556457,64726433,1851,288760210,6984,1
101927617,LOC101927617,chr11,F,62545767,62546423,64727089,656,288760866,6985,1
101927624,LINC01150,chr11,F,1896758,1908359,64738690,11601,288772467,6986,3
101927673,LOC101927673,chr11,F,64000350,64008379,64746719,8029,288780496,6987,2
101927682,CD81-AS1,chr11,R,2328748,2377992,64795963,49244,288829740,6988,2
101927696,LOC101927696,chr11,R,64248079,64252644,64800528,4565,288834305,6989,2
101927708,LOC101927708,chr11,R,3507979,3571987,64864536,64008,288898313,6990,2
101927763,LOC101927763,chr11,R,5514392,5521635,64871779,7243,288905556,6991,3
101927789,LOC101927789,chr11,F,65454420,65466720,64884079,12300,288917856,6992,4
101927825,LOC101927825,chr11,F,6317500,6344772,64911351,27272,288945128,6993,11
101927828,OVOL1-AS1,chr11,R,65789000,65790868,64913219,1868,288946996,6994,1
101927853,LOC101927853,chr11,R,65796549,65833497,64950167,36948,288983944,6995,6
101927917,TUB-AS1,chr11,F,8060037,8069373,64959503,9336,288993280,6996,3
101927936,LOC101927936,chr11,F,8169081,8180247,64970669,11166,289004446,6997,5
101927955,LOC101927955,chr11,R,9704616,9706902,64972955,2286,289006732,6998,1
101928008,LOC101928008,chr11,F,9839141,9929263,65063077,90122,289096854,6999,2
101928053,LOC101928053,chr11,F,10809296,10822931,65076712,13635,289110489,7000,2
101928069,LOC101928069,chr11,R,66473489,66480249,65083472,6760,289117249,7001,3
101928110,LOC101928110,chr11,F,13412425,13427412,65098459,14987,289132236,7002,2
101928132,LOC101928132,chr11,R,13921449,13924863,65101873,3414,289135650,7003,1
101928175,LOC101928175,chr11,R,68327111,68338808,65113570,11697,289147347,7004,4
101928200,MRGPRF-AS1,chr11,F,69012353,69018447,65119664,6094,289153441,7005,5
101928292,LINC01488,chr11,F,69485560,69493543,65127647,7983,289161424,7006,5
101928316,LOC101928316,chr11,R,30686552,30735039,65176134,48487,289209911,7007,6
101928338,LOC101928338,chr11,F,30741420,30794447,65229161,53027,289262938,7008,4
101928385,LOC101928385,chr11,R,32052905,32053335,65229591,430,289263368,7009,1
101928424,LOC101928424,chr11,F,102452918,102462038,65238711,9120,289272488,7010,1
101928440,FBXO3-AS1,chr11,F,33774698,33775670,65239683,972,289273460,7011,2
101928443,LOC101928443,chr11,R,70056229,70065371,65248825,9142,289282602,7012,1
101928473,LOC101928473,chr11,R,70172150,70175898,65252573,3748,289286350,7013,3
101928477,LOC101928477,chr11,F,102627110,102683913,65309376,56803,289343153,7014,5
101928506,LOC101928506,chr11,R,105974325,105979660,65314711,5335,289348488,7015,3
101928510,LOC101928510,chr11,R,36063282,36078277,65329706,14995,289363483,7016,2
101928535,LOC101928535,chr11,F,106250018,106264905,65344593,14887,289378370,7017,7
101928536,LINC01493,chr11,F,38648857,38655249,65350985,6392,289384762,7018,2
101928555,LINC01537,chr11,F,72570655,72573222,65353552,2567,289387329,7019,1
101928561,LOC101928561,chr11,F,108499061,108517723,65372214,18662,289405991,7020,3
101928563,LOC101928563,chr11,R,38868367,38885214,65389061,16847,289422838,7021,5
101928580,LOC101928580,chr11,F,74311361,74324705,65402405,13344,289436182,7022,6
101928591,LOC101928591,chr11,R,42001721,42085460,65486144,83739,289519921,7023,10
101928704,LOC101928704,chr11,F,43556695,43674197,65603646,117502,289637423,7024,4
101928812,LOC101928812,chr11,F,45355370,45356657,65604933,1287,289638710,7025,1
101928813,LOC101928813,chr11,R,76608150,76630363,65627146,22213,289660923,7026,5
101928823,LOC101928823,chr11,F,112482231,112541916,65686831,59685,289720608,7027,4
101928837,LOC101928837,chr11,R,76782580,76783062,65687313,482,289721090,7028,1
101928847,LOC101928847,chr11,R,112959278,112963460,65691495,4182,289725272,7029,2
101928865,LOC101928865,chr11,R,78423981,78429836,65697350,5855,289731127,7030,3
101928875,LOC101928875,chr11,R,114158508,114174468,65713310,15960,289747087,7031,2
101928894,LOC101928894,chr11,F,46171954,46177106,65718462,5152,289752239,7032,2
101928896,LOC101928896,chr11,F,78533175,78558565,65743852,25390,289777629,7033,3
101928919,LOC101928919,chr11,R,46256354,46274643,65762141,18289,289795918,7034,3
101928940,LOC101928940,chr11,R,114360634,114380039,65781546,19405,289815323,7035,2
101928943,LOC101928943,chr11,R,47270656,47272110,65783000,1454,289816777,7036,3
101928944,LOC101928944,chr11,R,80751199,80762803,65794604,11604,289828381,7037,2
101928962,LOC101928962,chr11,F,114528842,114542751,65808513,13909,289842290,7038,2
101928964,LOC101928964,chr11,R,80458974,81252971,66602510,793997,290636287,7039,3
101928985,LOC101928985,chr11,R,115732953,115734740,66604297,1787,290638074,7040,1
101928989,LOC101928989,chr11,R,81879850,82403913,67128360,524063,291162137,7041,7
101929011,LOC101929011,chr11,F,116639421,116658252,67147191,18831,291180968,7042,3
101929043,LOC101929043,chr11,F,83637652,83665596,67175135,27944,291208912,7043,10
101929089,LOC101929089,chr11,R,118511917,118531094,67194312,19177,291228089,7044,5
101929133,LOC101929133,chr11,R,118886126,118891007,67199193,4881,291232970,7045,1
101929156,LOC101929156,chr11,F,119751960,119770074,67217307,18114,291251084,7046,2
101929174,LOC101929174,chr11,F,88337872,88428192,67307627,90320,291341404,7047,7
101929208,LOC101929208,chr11,R,120940463,120958061,67325225,17598,291359002,7048,3
101929222,DISC1FP1,chr11,F,90251231,90915052,67989046,663821,292022823,7049,6
101929227,LOC101929227,chr11,R,120867932,120894797,68015911,26865,292049688,7050,1
101929267,LOC101929267,chr11,F,122963986,122977631,68029556,13645,292063333,7051,2
101929289,LOC101929289,chr11,F,123062466,123084713,68051803,22247,292085580,7052,3
101929295,LOC101929295,chr11,F,95150538,95159148,68060413,8610,292094190,7053,2
101929340,LOC101929340,chr11,F,124759133,124765925,68067205,6792,292100982,7054,2
101929427,LOC101929427,chr11,F,126652777,126682104,68096532,29327,292130309,7055,2
101929473,LOC101929473,chr11,F,127067001,127101306,68130837,34305,292164614,7056,2
101929497,LOC101929497,chr11,F,127271069,127337033,68196801,65964,292230578,7057,2
101929517,LOC101929517,chr11,F,128526141,128530383,68201043,4242,292234820,7058,3
101929538,LOC101929538,chr11,R,128681239,128687011,68206815,5772,292240592,7059,1
101929557,LINC01395,chr11,R,129612115,129617269,68211969,5154,292245746,7060,3
101929637,C11orf39,chr11,R,131662128,131663556,68213397,1428,292247174,7061,1
101929653,LOC101929653,chr11,R,131533856,131540867,68220408,7011,292254185,7062,7
101929918,LOC101929918,chr11,R,34044871,34052509,68228046,7638,292261823,7063,5
102288414,C11orf98,chr11,R,62662816,62665216,68230446,2400,292264223,7064,2
102464826,MIR6073,chr11,R,15969532,15969621,68230535,89,292264312,7065,0
102465135,MIR6128,chr11,F,56743872,56743981,68230644,109,292264421,7066,0
102465250,MIR6503,chr11,R,60209070,60209156,68230730,86,292264507,7067,0
102465257,MIR6514,chr11,R,62792701,62792771,68230800,70,292264577,7068,0
102465445,MIR6743,chr11,F,209335,209406,68230871,71,292264648,7069,0
102465446,MIR6746,chr11,R,61878215,61878278,68230934,63,292264711,7070,0
102465447,MIR6747,chr11,R,62567010,62567071,68230995,61,292264772,7071,0
102465448,MIR6748,chr11,F,62789814,62789885,68231066,71,292264843,7072,0
102465449,MIR6751,chr11,R,65129915,65129978,68231129,63,292264906,7073,0
102465450,MIR6752,chr11,F,67490244,67490315,68231200,71,292264977,7074,0
102465451,MIR6753,chr11,F,68044793,68044957,68231364,164,292265141,7075,0
102465452,MIR6755,chr11,F,86278332,86278398,68231430,66,292265207,7076,0
102465453,MIR6756,chr11,R,119312949,119313012,68231493,63,292265270,7077,0
102465518,MIR6860,chr11,F,67045642,67045708,68231559,66,292265336,7078,0
102465669,MIR7113,chr11,F,68032863,68032922,68231618,59,292265395,7079,0
102465691,MIR7154,chr11,R,45691703,45691776,68231691,73,292265468,7080,0
102465752,MIR7641-1,chr11,F,104252590,104252651,68231752,61,292265529,7081,0
102465860,MIR8054,chr11,R,23419104,23419190,68231838,86,292265615,7082,0
102465870,MIR8070,chr11,R,11783134,11783222,68231926,88,292265703,7083,0
102465881,MIR8087,chr11,R,27514969,27515047,68232004,78,292265781,7084,0
102465993,MIR7847,chr11,F,1880044,1880147,68232107,103,292265884,7085,0
102466104,MIR6090,chr11,F,128522389,128522449,68232167,60,292265944,7086,0
102466192,MIR6750,chr11,R,64898362,64898437,68232242,75,292266019,7087,0
102466719,MIR6716,chr11,F,118643999,118644079,68232322,80,292266099,7088,0
102466725,MIR6744,chr11,F,1256604,1256670,68232388,66,292266165,7089,0
102466726,MIR6745,chr11,R,47179610,47179737,68232515,127,292266292,7090,0
102466727,MIR6749,chr11,R,64902386,64902455,68232584,69,292266361,7091,0
102466728,MIR6754,chr11,F,71473502,71473568,68232650,66,292266427,7092,0
102466756,MIR6879,chr11,F,65018504,65018570,68232716,66,292266493,7093,0
102466815,MIR7155,chr11,R,64341848,64341904,68232772,56,292266549,7094,0
102466873,MIR8052,chr11,F,130666734,130666803,68232841,69,292266618,7095,0
102466876,MIR8068,chr11,R,28477480,28477548,68232909,68,292266686,7096,0
102466906,MIR6124,chr11,F,12163682,12163767,68232994,85,292266771,7097,0
102723330,LOC102723330,chr11,R,17695266,17697526,68235254,2260,292269031,7098,1
102723370,LOC102723370,chr11,F,21753592,22121531,68603193,367939,292636970,7099,13
102723378,LINC01495,chr11,R,22445671,22492019,68649541,46348,292683318,7100,3
102723403,LOC102723403,chr11,R,30359365,30363158,68653334,3793,292687111,7101,2
102723539,LOC102723539,chr11,F,34154777,34159974,68658531,5197,292692308,7102,2
102723568,LOC102723568,chr11,F,34692783,34877212,68842960,184429,292876737,7103,6
102723575,LOC102723575,chr11,F,59537531,59560746,68866175,23215,292899952,7104,4
102723644,LINC01499,chr11,F,41714567,41836442,68988050,121875,293021827,7105,5
102723746,LOC102723746,chr11,R,93286634,93385970,69087386,99336,293121163,7106,5
102723765,LOC102723765,chr11,R,62410574,62427799,69104611,17225,293138388,7107,4
102723838,LOC102723838,chr11,F,102493779,102498801,69109633,5022,293143410,7108,1
102723862,LOC102723862,chr11,R,103838796,103849540,69120377,10744,293154154,7109,5
102723878,LOC102723878,chr11,R,64325049,64340625,69135953,15576,293169730,7110,6
102723879,LOC102723879,chr11,F,104194444,104358989,69300498,164545,293334275,7111,7
102723895,LOC102723895,chr11,R,104568488,104609302,69341312,40814,293375089,7112,3
102723966,LOC102723966,chr11,F,111097271,111106961,69351002,9690,293384779,7113,2
102724064,LOC102724064,chr11,F,66347543,66363764,69367223,16221,293401000,7114,3
102724165,LOC102724165,chr11,F,115919625,115946880,69394478,27255,293428255,7115,10
102724209,LOC102724209,chr11,F,68272183,68275036,69397331,2853,293431108,7116,1
102724265,LOC102724265,chr11,F,69425670,69429624,69401285,3954,293435062,7117,1
102724301,LOC102724301,chr11,F,119729582,119739623,69411326,10041,293445103,7118,3
102724410,LOC102724410,chr11,R,124218135,124228128,69421319,9993,293455096,7119,3
102724457,LOC102724457,chr11,R,124740134,124745998,69427183,5864,293460960,7120,3
102724644,LOC102724644,chr11,R,133250654,133337349,69513878,86695,293547655,7121,3
102724711,LOC102724711,chr11,R,6958638,6994175,69549415,35537,293583192,7122,2
102724712,LOC102724712,chr11,F,83286465,83292150,69555100,5685,293588877,7123,2
102724775,LOC102724775,chr11,F,86763059,86765464,69557505,2405,293591282,7124,1
102724784,LOC102724784,chr11,F,8768777,8810276,69599004,41499,293632781,7125,4
102724957,LOC102724957,chr11,F,15623773,15705368,69680599,81595,293714376,7126,4
102725195,LOC102725195,chr11,R,134092571,134095196,69683224,2625,293717001,7127,1
103157000,PAUPAR,chr11,F,31826566,31829303,69685961,2737,293719738,7128,0
103312105,LOC103312105,chr11,R,38618263,38646356,69714054,28093,293747831,7129,5
103344929,BGLT3,chr11,R,5244553,5245546,69715047,993,293748824,7130,0
103581031,CASC23,chr11,R,8011277,8016509,69720279,5232,293754056,7131,2
103611081,LOC103611081,chr11,R,130866248,130870247,69724278,3999,293758055,7132,0
103695364,PKNOX2-AS1,chr11,R,125158460,125164609,69730427,6149,293764204,7133,2
103695435,BBOX1-AS1,chr11,R,27047185,27220113,69903355,172928,293937132,7134,6
104326055,APOA1-AS,chr11,F,116836116,116855729,69922968,19613,293956745,7135,1
104355220,LINC01219,chr11,F,1991095,1993469,69925342,2374,293959119,7136,2
105369149,LOC105369149,chr11,F,9780375,9792120,69937087,11745,293970864,7137,3
105369150,LOC105369150,chr11,F,50298562,50360997,69999522,62435,294033299,7138,13
105369176,LOC105369176,chr11,F,89821829,89826934,70004627,5105,294038404,7139,3
105369181,LOC105369181,chr11,R,61577285,61580198,70007540,2913,294041317,7140,2
105369190,LOC105369190,chr11,F,779358,780898,70009080,1540,294042857,7141,0
105369206,LOC105369206,chr11,R,66464652,66466706,70011134,2054,294044911,7142,2
105369272,LOC105369272,chr11,F,66348076,66353487,70016545,5411,294050322,7143,2
105369286,LOC105369286,chr11,R,31727483,31767953,70057015,40470,294090792,7144,2
105369309,LOC105369309,chr11,R,57189068,57231589,70099536,42521,294133313,7145,5
105369310,LOC105369310,chr11,R,56902742,56949853,70146647,47111,294180424,7146,2
105369311,LOC105369311,chr11,F,57322394,57325956,70150209,3562,294183986,7147,2
105369312,LOC105369312,chr11,R,57392989,57404155,70161375,11166,294195152,7148,1
105369313,LOC105369313,chr11,R,58493614,58526239,70194000,32625,294227777,7149,8
105369314,LOC105369314,chr11,F,58770399,58785705,70209306,15306,294243083,7150,1
105369315,LOC105369315,chr11,R,59095071,59102572,70216807,7501,294250584,7151,2
105369316,LOC105369316,chr11,R,59260050,59284695,70241452,24645,294275229,7152,5
105369317,LOC105369317,chr11,R,59560306,59565495,70246641,5189,294280418,7153,4
105369318,LOC105369318,chr11,F,59674310,59676041,70248372,1731,294282149,7154,1
105369319,LOC105369319,chr11,R,60159240,60164400,70253532,5160,294287309,7155,2
105369320,LOC105369320,chr11,R,60503823,60507018,70256727,3195,294290504,7156,2
105369321,LOC105369321,chr11,R,60607592,60699116,70348251,91524,294382028,7157,5
105369322,LOC105369322,chr11,R,60792332,60836139,70392058,43807,294425835,7158,2
105369323,LOC105369323,chr11,R,60913165,60913975,70392868,810,294426645,7159,1
105369324,LOC105369324,chr11,F,61035350,61041355,70398873,6005,294432650,7160,2
105369325,LOC105369325,chr11,R,61029758,61092441,70461556,62683,294495333,7161,2
105369326,LOC105369326,chr11,R,61003720,61008519,70466355,4799,294500132,7162,1
105369327,LOC105369327,chr11,F,61174662,61199441,70491134,24779,294524911,7163,3
105369329,LOC105369329,chr11,F,61496310,61506649,70501473,10339,294535250,7164,4
105369330,LOC105369330,chr11,R,61511020,61513544,70503997,2524,294537774,7165,1
105369331,LOC105369331,chr11,R,61581405,61587840,70510432,6435,294544209,7166,4
105369332,LOC105369332,chr11,F,62832165,62834056,70512323,1891,294546100,7167,1
105369333,LOC105369333,chr11,F,62919641,62934768,70527450,15127,294561227,7168,3
105369334,LOC105369334,chr11,R,63245694,63251074,70532830,5380,294566607,7169,2
105369335,LOC105369335,chr11,F,63575052,63590086,70547864,15034,294581641,7170,2
105369336,LOC105369336,chr11,R,63844466,63863192,70566590,18726,294600367,7171,4
105369337,LOC105369337,chr11,R,63836864,63839417,70569143,2553,294602920,7172,1
105369338,LOC105369338,chr11,F,64028668,64033449,70573924,4781,294607701,7173,2
105369339,LOC105369339,chr11,F,64166231,64170665,70578358,4434,294612135,7174,2
105369340,LOC105369340,chr11,F,64245376,64248219,70581201,2843,294614978,7175,2
105369341,LOC105369341,chr11,R,64410117,64420238,70591322,10121,294625099,7176,2
105369342,LOC105369342,chr11,F,64502459,64505386,70594249,2927,294628026,7177,1
105369343,LOC105369343,chr11,R,64888228,64893452,70599473,5224,294633250,7178,2
105369344,LOC105369344,chr11,R,65305623,65314720,70608570,9097,294642347,7179,2
105369345,LOC105369345,chr11,R,65435346,65445919,70619143,10573,294652920,7180,2
105369346,LOC105369346,chr11,R,65487240,65489968,70621871,2728,294655648,7181,1
105369347,LOC105369347,chr11,F,65662991,65671701,70630581,8710,294664358,7182,3
105369348,LOC105369348,chr11,F,65856248,65856893,70631226,645,294665003,7183,1
105369349,LOC105369349,chr11,F,65922563,65929479,70638142,6916,294671919,7184,2
105369350,LOC105369350,chr11,R,65937399,65945524,70646267,8125,294680044,7185,2
105369351,LOC105369351,chr11,R,66267740,66269694,70648221,1954,294681998,7186,3
105369352,LOC105369352,chr11,R,66261925,66265666,70651962,3741,294685739,7187,5
105369353,LOC105369353,chr11,R,66259282,66261745,70654425,2463,294688202,7188,1
105369354,LOC105369354,chr11,F,66184339,66190236,70660322,5897,294694099,7189,1
105369355,LOC105369355,chr11,F,66954248,66970128,70676202,15880,294709979,7190,2
105369356,LOC105369356,chr11,R,67267924,67274059,70682337,6135,294716114,7191,1
105369357,LOC105369357,chr11,F,67436356,67438141,70684122,1785,294717899,7192,1
105369358,LOC105369358,chr11,R,67758562,67762743,70688303,4181,294722080,7193,2
105369360,LOC105369360,chr11,F,67884298,67894096,70698101,9798,294731878,7194,5
105369361,LOC105369361,chr11,R,68023933,68030592,70704760,6659,294738537,7195,3
105369362,LOC105369362,chr11,F,68121648,68130507,70713619,8859,294747396,7196,3
105369363,LOC105369363,chr11,F,68272086,68284643,70726176,12557,294759953,7197,3
105369364,LOC105369364,chr11,F,68870421,68874548,70730303,4127,294764080,7198,1
105369365,LOC105369365,chr11,F,69033407,69041393,70738289,7986,294772066,7199,2
105369366,LOC105369366,chr11,F,69166790,69177976,70749475,11186,294783252,7200,3
105369367,LOC105369367,chr11,R,69228748,69234945,70755672,6197,294789449,7201,3
105369368,LOC105369368,chr11,F,69235245,69251181,70771608,15936,294805385,7202,3
105369369,LOC105369369,chr11,F,69273081,69293989,70792516,20908,294826293,7203,2
105369370,LOC105369370,chr11,F,69298917,69372512,70866111,73595,294899888,7204,5
105369371,LOC105369371,chr11,F,70065375,70071175,70871911,5800,294905688,7205,1
105369372,LOC105369372,chr11,R,70141568,70142487,70872830,919,294906607,7206,1
105369373,LOC105369373,chr11,R,70324807,70327459,70875482,2652,294909259,7207,1
105369374,LOC105369374,chr11,F,72350689,72355995,70880788,5306,294914565,7208,2
105369375,LOC105369375,chr11,F,72298746,72307190,70889232,8444,294923009,7209,4
105369376,LOC105369376,chr11,R,72525469,72535026,70898789,9557,294932566,7210,2
105369377,LOC105369377,chr11,F,72606156,72619225,70911858,13069,294945635,7211,3
105369378,LOC105369378,chr11,F,72585697,72588206,70914367,2509,294948144,7212,1
105369379,LOC105369379,chr11,F,72658075,72670957,70927249,12882,294961026,7213,5
105369380,LOC105369380,chr11,F,72793925,72810568,70943892,16643,294977669,7214,3
105369381,LOC105369381,chr11,R,73156047,73183578,70971423,27531,295005200,7215,4
105369382,LOC105369382,chr11,F,73253425,73259158,70977156,5733,295010933,7216,2
105369383,LOC105369383,chr11,F,74209207,74210807,70978756,1600,295012533,7217,1
105369384,LOC105369384,chr11,F,73994266,74037418,71021908,43152,295055685,7218,2
105369385,LOC105369385,chr11,F,74328307,74368479,71062080,40172,295095857,7219,2
105369386,LOC105369386,chr11,F,74575981,74578375,71064474,2394,295098251,7220,2
105369387,LOC105369387,chr11,R,74698304,74700678,71066848,2374,295100625,7221,0
105369388,LOC105369388,chr11,R,75205716,75225564,71086696,19848,295120473,7222,5
105369389,LOC105369389,chr11,F,75509912,75519957,71096741,10045,295130518,7223,6
105369390,LOC105369390,chr11,F,75569679,75570992,71098054,1313,295131831,7224,1
105369391,LOC105369391,chr11,F,75583195,75605128,71119987,21933,295153764,7225,1
105369392,LOC105369392,chr11,R,75701618,75718752,71137121,17134,295170898,7226,2
105369393,LOC105369393,chr11,R,75736937,75741350,71141534,4413,295175311,7227,1
105369394,LOC105369394,chr11,F,76208979,76211532,71144087,2553,295177864,7228,1
105369395,LOC105369395,chr11,F,76284396,76321105,71180796,36709,295214573,7229,7
105369396,LOC105369396,chr11,R,76767362,76768659,71182093,1297,295215870,7230,2
105369397,LOC105369397,chr11,F,76752686,76758136,71187543,5450,295221320,7231,2
105369398,LOC105369398,chr11,R,76812140,76819752,71195155,7612,295228932,7232,2
105369399,LOC105369399,chr11,F,77047865,77048740,71196030,875,295229807,7233,1
105369400,LOC105369400,chr11,R,77058400,77063723,71201353,5323,295235130,7234,2
105369401,LOC105369401,chr11,F,78081400,78087362,71207315,5962,295241092,7235,2
105369402,LOC105369402,chr11,F,78296147,78319731,71230899,23584,295264676,7236,2
105369403,LOC105369403,chr11,F,78473145,78497594,71255348,24449,295289125,7237,2
105369404,LOC105369404,chr11,F,79437755,79438948,71256541,1193,295290318,7238,2
105369405,LOC105369405,chr11,F,79595876,79600351,71261016,4475,295294793,7239,2
105369406,LOC105369406,chr11,F,80137125,80162669,71286560,25544,295320337,7240,5
105369407,LOC105369407,chr11,R,80088735,80168657,71366482,79922,295400259,7241,3
105369408,LOC105369408,chr11,F,80203225,80225953,71389210,22728,295422987,7242,4
105369409,LOC105369409,chr11,F,80709046,80737278,71417442,28232,295451219,7243,2
105369410,LOC105369410,chr11,F,82472179,82480087,71425350,7908,295459127,7244,2
105369411,LOC105369411,chr11,R,81821273,81824932,71429009,3659,295462786,7245,1
105369412,LOC105369412,chr11,R,82713068,82718322,71434263,5254,295468040,7246,2
105369413,LOC105369413,chr11,F,82781523,82849036,71501776,67513,295535553,7247,3
105369414,LOC105369414,chr11,R,83094780,83117273,71524269,22493,295558046,7248,2
105369415,LOC105369415,chr11,F,82983639,82998256,71538886,14617,295572663,7249,2
105369416,LOC105369416,chr11,F,84594826,84608462,71552522,13636,295586299,7250,3
105369417,LOC105369417,chr11,F,84189897,84194286,71556911,4389,295590688,7251,2
105369418,LOC105369418,chr11,F,83891798,83919607,71584720,27809,295618497,7252,2
105369419,LOC105369419,chr11,F,83690745,83693964,71587939,3219,295621716,7253,2
105369420,LOC105369420,chr11,F,83306112,83307142,71588969,1030,295622746,7254,1
105369421,LOC105369421,chr11,R,86336614,86353615,71605970,17001,295639747,7255,2
105369422,LOC105369422,chr11,R,87014122,87037773,71629621,23651,295663398,7256,3
105369423,LOC105369423,chr11,R,87718353,87719422,71630690,1069,295664467,7257,1
105369424,LOC105369424,chr11,R,88733200,88735631,71633121,2431,295666898,7258,2
105369426,LOC105369426,chr11,F,90928902,90930929,71635148,2027,295668925,7259,2
105369427,LOC105369427,chr11,F,91158015,91228398,71705531,70383,295739308,7260,4
105369428,LOC105369428,chr11,F,91794338,91872454,71783647,78116,295817424,7261,15
105369429,LOC105369429,chr11,F,92146408,92153903,71791142,7495,295824919,7262,3
105369430,LOC105369430,chr11,R,92647277,92654733,71798598,7456,295832375,7263,2
105369431,LOC105369431,chr11,R,92914137,92915629,71800090,1492,295833867,7264,2
105369432,LOC105369432,chr11,F,93248394,93252254,71803950,3860,295837727,7265,2
105369435,LOC105369435,chr11,F,94199726,94282055,71886279,82329,295920056,7266,5
105369436,LOC105369436,chr11,F,94634737,94657461,71909003,22724,295942780,7267,11
105369437,LOC105369437,chr11,F,94804058,94807421,71912366,3363,295946143,7268,1
105369438,LOC105369438,chr11,R,94675543,94740400,71977223,64857,296011000,7269,3
105369439,LOC105369439,chr11,F,95466100,95480923,71992046,14823,296025823,7270,3
105369440,LOC105369440,chr11,R,95513843,95518014,71996217,4171,296029994,7271,3
105369441,LOC105369441,chr11,R,95611681,95615158,71999694,3477,296033471,7272,1
105369442,LOC105369442,chr11,F,96467977,96499167,72030884,31190,296064661,7273,1
105369443,LOC105369443,chr11,F,96507439,96568658,72092103,61219,296125880,7274,5
105369444,LOC105369444,chr11,F,60023802,60030834,72099135,7032,296132912,7275,3
105369445,LOC105369445,chr11,R,66721447,66727977,72105665,6530,296139442,7276,2
105369447,LOC105369447,chr11,F,93197638,93203569,72111596,5931,296145373,7277,3
105369448,LOC105369448,chr11,F,97011541,97017278,72117333,5737,296151110,7278,3
105369449,LOC105369449,chr11,R,97222642,97259565,72154256,36923,296188033,7279,1
105369450,LOC105369450,chr11,R,97270982,97273429,72156703,2447,296190480,7280,2
105369451,LOC105369451,chr11,R,97391215,97399723,72165211,8508,296198988,7281,2
105369452,LOC105369452,chr11,F,97668262,97676750,72173699,8488,296207476,7282,2
105369453,LOC105369453,chr11,F,97798442,97802391,72177648,3949,296211425,7283,2
105369454,LOC105369454,chr11,R,97878568,97957056,72256136,78488,296289913,7284,6
105369455,LOC105369455,chr11,R,98453811,98495667,72297992,41856,296331769,7285,2
105369456,LOC105369456,chr11,R,100054978,100106102,72349116,51124,296382893,7286,2
105369457,LOC105369457,chr11,R,100865744,100866157,72349529,413,296383306,7287,1
105369458,LOC105369458,chr11,F,101320632,101342762,72371659,22130,296405436,7288,2
105369459,LOC105369459,chr11,F,101444098,101452699,72380260,8601,296414037,7289,1
105369460,LOC105369460,chr11,F,102267960,102281239,72393539,13279,296427316,7290,4
105369461,LOC105369461,chr11,F,102466690,102485765,72412614,19075,296446391,7291,2
105369462,LOC105369462,chr11,F,102606157,102626731,72433188,20574,296466965,7292,2
105369463,LOC105369463,chr11,R,103565864,103644551,72511875,78687,296545652,7293,3
105369464,LOC105369464,chr11,R,103864986,103904816,72551705,39830,296585482,7294,3
105369465,LOC105369465,chr11,F,104072186,104092974,72572493,20788,296606270,7295,3
105369466,LOC105369466,chr11,F,104671228,104696722,72597987,25494,296631764,7296,2
105369467,LOC105369467,chr11,R,105080452,105082393,72599928,1941,296633705,7297,1
105369468,LOC105369468,chr11,R,105370791,105541338,72770475,170547,296804252,7298,6
105369469,LOC105369469,chr11,F,105162821,105184806,72792460,21985,296826237,7299,5
105369470,LOC105369470,chr11,R,105926783,105974333,72840010,47550,296873787,7300,4
105369471,LOC105369471,chr11,F,105798266,105802433,72844177,4167,296877954,7301,1
105369472,LOC105369472,chr11,R,106085696,106094509,72852990,8813,296886767,7302,1
105369473,LOC105369473,chr11,R,106112455,106132169,72872704,19714,296906481,7303,2
105369474,LOC105369474,chr11,F,106367230,106409184,72914658,41954,296948435,7304,2
105369475,LOC105369475,chr11,F,106856641,106857718,72915735,1077,296949512,7305,1
105369476,LOC105369476,chr11,F,106585989,106778512,73108258,192523,297142035,7306,6
105369477,LOC105369477,chr11,R,107273288,107314842,73149812,41554,297183589,7307,4
105369479,LOC105369479,chr11,F,108478127,108481246,73152931,3119,297186708,7308,2
105369480,LOC105369480,chr11,R,108699212,108766450,73220169,67238,297253946,7309,2
105369481,LOC105369481,chr11,R,109741666,109746620,73225123,4954,297258900,7310,2
105369482,LOC105369482,chr11,R,109780979,109823844,73267988,42865,297301765,7311,3
105369483,LOC105369483,chr11,R,109859558,109860587,73269017,1029,297302794,7312,2
105369484,LOC105369484,chr11,F,109946549,109972995,73295463,26446,297329240,7313,2
105369485,LOC105369485,chr11,F,110086059,110088107,73297511,2048,297331288,7314,2
105369486,LOC105369486,chr11,F,110355113,110406423,73348821,51310,297382598,7315,3
105369488,LOC105369488,chr11,R,110922006,110923953,73350768,1947,297384545,7316,1
105369489,LOC105369489,chr11,R,111000829,111021362,73371301,20533,297405078,7317,2
105369490,LOC105369490,chr11,R,111089881,111097319,73378739,7438,297412516,7318,1
105369491,LOC105369491,chr11,F,111320986,111323074,73380827,2088,297414604,7319,1
105369492,LOC105369492,chr11,F,111466098,111473436,73388165,7338,297421942,7320,4
105369493,LOC105369493,chr11,F,111670914,111673314,73390565,2400,297424342,7321,1
105369494,LOC105369494,chr11,R,111915562,111918618,73393621,3056,297427398,7322,1
105369495,LOC105369495,chr11,F,112097457,112119132,73415296,21675,297449073,7323,3
105369496,LOC105369496,chr11,R,112698771,112737683,73454208,38912,297487985,7324,4
105369497,LOC105369497,chr11,R,112781361,112784905,73457752,3544,297491529,7325,2
105369498,LOC105369498,chr11,R,112822541,112835383,73470594,12842,297504371,7326,3
105369499,LOC105369499,chr11,R,113276701,113314458,73508351,37757,297542128,7327,4
105369500,LOC105369500,chr11,R,113475668,113479567,73512250,3899,297546027,7328,2
105369501,LOC105369501,chr11,R,113488736,113500738,73524252,12002,297558029,7329,2
105369502,LOC105369502,chr11,F,114411413,114436319,73549158,24906,297582935,7330,5
105369503,LOC105369503,chr11,F,114465765,114497068,73580461,31303,297614238,7331,2
105369504,LOC105369504,chr11,R,114639576,114651202,73592087,11626,297625864,7332,6
105369505,LOC105369505,chr11,R,114829404,114831663,73594346,2259,297628123,7333,2
105369506,LOC105369506,chr11,R,114779670,114872773,73687449,93103,297721226,7334,2
105369507,LOC105369507,chr11,F,115396722,115397660,73688387,938,297722164,7335,1
105369508,LOC105369508,chr11,F,115363209,115378717,73703895,15508,297737672,7336,2
105369509,LOC105369509,chr11,F,115333540,115340262,73710617,6722,297744394,7337,1
105369510,LOC105369510,chr11,R,115331883,115333244,73711978,1361,297745755,7338,1
105369511,LOC105369511,chr11,R,115518543,115520220,73713655,1677,297747432,7339,2
105369512,LOC105369512,chr11,F,115900742,115901736,73714649,994,297748426,7340,2
105369513,LOC105369513,chr11,R,116033384,116081056,73762321,47672,297796098,7341,6
105369514,LOC105369514,chr11,F,116773235,116773989,73763075,754,297796852,7342,1
105369515,LOC105369515,chr11,F,117659054,117668885,73772906,9831,297806683,7343,2
105369516,LOC105369516,chr11,R,117496577,117503835,73780164,7258,297813941,7344,1
105369517,LOC105369517,chr11,R,118092346,118098978,73786796,6632,297820573,7345,3
105369518,LOC105369518,chr11,F,118565067,118568236,73789965,3169,297823742,7346,3
105369519,LOC105369519,chr11,F,118692004,118709304,73807265,17300,297841042,7347,5
105369520,LOC105369520,chr11,F,119642370,119659530,73824425,17160,297858202,7348,2
105369521,LOC105369521,chr11,R,119581944,119587369,73829850,5425,297863627,7349,2
105369522,LOC105369522,chr11,F,119576370,119579909,73833389,3539,297867166,7350,2
105369523,LOC105369523,chr11,F,119523188,119526780,73836981,3592,297870758,7351,2
105369524,LOC105369524,chr11,F,119512229,119517888,73842640,5659,297876417,7352,2
105369525,LOC105369525,chr11,F,119709851,119720455,73853244,10604,297887021,7353,4
105369526,LOC105369526,chr11,F,119905354,119951015,73898905,45661,297932682,7354,10
105369527,LOC105369527,chr11,F,120026794,120028995,73901106,2201,297934883,7355,2
105369528,LOC105369528,chr11,R,119987957,119994851,73908000,6894,297941777,7356,3
105369529,LOC105369529,chr11,F,120128501,120139424,73918923,10923,297952700,7357,2
105369530,LOC105369530,chr11,F,120188763,120189452,73919612,689,297953389,7358,2
105369531,LOC105369531,chr11,R,120274114,120291109,73936607,16995,297970384,7359,2
105369532,LOC105369532,chr11,R,120811251,120819799,73945155,8548,297978932,7360,3
105369533,LOC105369533,chr11,F,121237337,121245159,73952977,7822,297986754,7361,2
105369534,LOC105369534,chr11,F,121245198,121247035,73954814,1837,297988591,7362,1
105369535,LOC105369535,chr11,R,121478812,121482907,73958909,4095,297992686,7363,2
105369536,LOC105369536,chr11,R,121439081,121453013,73972841,13932,298006618,7364,3
105369537,LOC105369537,chr11,R,122066450,122070156,73976547,3706,298010324,7365,3
105369538,LOC105369538,chr11,R,122748336,122757325,73985536,8989,298019313,7366,2
105369539,LOC105369539,chr11,R,123206431,123207336,73986441,905,298020218,7367,1
105369540,LOC105369540,chr11,F,123204311,123208396,73990526,4085,298024303,7368,2
105369541,LOC105369541,chr11,R,123313673,123314972,73991825,1299,298025602,7369,1
105369542,LOC105369542,chr11,R,123425084,123431036,73997777,5952,298031554,7370,1
105369543,LOC105369543,chr11,F,123653976,123672257,74016058,18281,298049835,7371,2
105369544,LOC105369544,chr11,F,123797386,123817027,74035699,19641,298069476,7372,2
105369545,LOC105369545,chr11,R,124082357,124086660,74040002,4303,298073779,7373,1
105369547,LOC105369547,chr11,R,124950382,124954061,74043681,3679,298077458,7374,2
105369548,LOC105369548,chr11,R,125405272,125410189,74048598,4917,298082375,7375,1
105369549,LOC105369549,chr11,R,125258627,125267323,74057294,8696,298091071,7376,4
105369550,LOC105369550,chr11,R,125570197,125592635,74079732,22438,298113509,7377,2
105369551,LOC105369551,chr11,F,125696118,125699621,74083235,3503,298117012,7378,1
105369552,LOC105369552,chr11,F,125827567,125828337,74084005,770,298117782,7379,1
105369553,LOC105369553,chr11,R,125873448,125875396,74085953,1948,298119730,7380,1
105369554,LOC105369554,chr11,R,125924220,125939101,74100834,14881,298134611,7381,3
105369555,LOC105369555,chr11,F,125939135,125943674,74105373,4539,298139150,7382,2
105369556,LOC105369556,chr11,R,126100500,126106217,74111090,5717,298144867,7383,1
105369557,LOC105369557,chr11,R,126294297,126297845,74114638,3548,298148415,7384,1
105369558,LOC105369558,chr11,F,126992209,126995458,74117887,3249,298151664,7385,1
105369559,LOC105369559,chr11,R,126883038,126940647,74175496,57609,298209273,7386,6
105369560,LOC105369560,chr11,R,126869367,126873252,74179381,3885,298213158,7387,3
105369561,LOC105369561,chr11,F,126728169,126731990,74183202,3821,298216979,7388,3
105369562,LOC105369562,chr11,F,127109522,127116762,74190442,7240,298224219,7389,3
105369563,LOC105369563,chr11,F,128167197,128184046,74207291,16849,298241068,7390,4
105369564,LOC105369564,chr11,F,128208756,128241441,74239976,32685,298273753,7391,4
105369565,LOC105369565,chr11,F,128565278,128586628,74261326,21350,298295103,7392,3
105369566,LOC105369566,chr11,F,128413019,128459813,74308120,46794,298341897,7393,1
105369567,LOC105369567,chr11,R,128597301,128607392,74318211,10091,298351988,7394,3
105369568,LOC105369568,chr11,R,128610398,128621889,74329702,11491,298363479,7395,4
105369569,LOC105369569,chr11,F,128714935,128721378,74336145,6443,298369922,7396,1
105369570,LOC105369570,chr11,R,128868843,128887587,74354889,18744,298388666,7397,3
105369571,LOC105369571,chr11,R,129299741,129302906,74358054,3165,298391831,7398,2
105369572,LOC105369572,chr11,R,129307295,129331215,74381974,23920,298415751,7399,2
105369573,LOC105369573,chr11,F,130220735,130223631,74384870,2896,298418647,7400,2
105369574,LOC105369574,chr11,F,130547220,130558466,74396116,11246,298429893,7401,3
105369575,LOC105369575,chr11,F,130723241,130735530,74408405,12289,298442182,7402,4
105369576,LOC105369576,chr11,R,130772354,130785488,74421539,13134,298455316,7403,3
105369577,LOC105369577,chr11,R,130994086,130997506,74424959,3420,298458736,7404,3
105369578,LOC105369578,chr11,R,131175562,131187098,74436495,11536,298470272,7405,6
105369579,LOC105369579,chr11,R,131074922,131083468,74445041,8546,298478818,7406,3
105369580,LOC105369580,chr11,F,132959934,132983331,74468438,23397,298502215,7407,4
105369581,LOC105369581,chr11,F,132736138,132762196,74494496,26058,298528273,7408,2
105369582,LOC105369582,chr11,R,134035453,134036981,74496024,1528,298529801,7409,1
105369583,LOC105369583,chr11,F,134640183,134646294,74502135,6111,298535912,7410,2
105369584,LOC105369584,chr11,F,134712437,134715922,74505620,3485,298539397,7411,1
105369585,LOC105369585,chr11,F,134805767,134807514,74507367,1747,298541144,7412,2
105369586,LOC105369586,chr11,F,134950484,134951568,74508451,1084,298542228,7413,1
105369587,LOC105369587,chr11,F,135005162,135010928,74514217,5766,298547994,7414,4
105369588,LOC105369588,chr11,R,134996906,135007912,74525223,11006,298559000,7415,3
105369589,LOC105369589,chr11,R,135072410,135076140,74528953,3730,298562730,7416,2
105369590,LOC105369590,chr11,R,119317223,119321858,74533588,4635,298567365,7417,6
105369591,LOC105369591,chr11,R,126111557,126140687,74562718,29130,298596495,7418,8
105376503,LOC105376503,chr11,R,283061,288263,74567920,5202,298601697,7419,1
105376504,LOC105376504,chr11,R,325702,327479,74569697,1777,298603474,7420,1
105376505,LOC105376505,chr11,F,330064,332192,74571825,2128,298605602,7421,2
105376506,LOC105376506,chr11,F,432107,440672,74580390,8565,298614167,7422,3
105376507,LOC105376507,chr11,F,513843,515068,74581615,1225,298615392,7423,1
105376508,LOC105376508,chr11,R,697606,706658,74590667,9052,298624444,7424,1
105376509,LOC105376509,chr11,F,736675,747315,74601307,10640,298635084,7425,3
105376510,LOC105376510,chr11,F,881305,881569,74601571,264,298635348,7426,2
105376511,LOC105376511,chr11,R,1061344,1063848,74604075,2504,298637852,7427,2
105376512,LOC105376512,chr11,R,1298145,1302574,74608504,4429,298642281,7428,1
105376513,LOC105376513,chr11,F,1350314,1365193,74623383,14879,298657160,7429,2
105376514,LOC105376514,chr11,R,1454628,1456337,74625092,1709,298658869,7430,2
105376515,LOC105376515,chr11,R,1451347,1454380,74628125,3033,298661902,7431,1
105376516,LOC105376516,chr11,R,1424112,1429630,74633643,5518,298667420,7432,2
105376517,LOC105376517,chr11,R,1771395,1778593,74640841,7198,298674618,7433,3
105376518,LOC105376518,chr11,R,2310753,2313647,74643735,2894,298677512,7434,2
105376519,LOC105376519,chr11,F,2353058,2354434,74645111,1376,298678888,7435,2
105376520,LOC105376520,chr11,R,2373192,2375686,74647605,2494,298681382,7436,1
105376521,LOC105376521,chr11,R,2435066,2444570,74657109,9504,298690886,7437,2
105376522,LOC105376522,chr11,R,2793767,2799443,74662785,5676,298696562,7438,2
105376523,LOC105376523,chr11,F,2680733,2697018,74679070,16285,298712847,7439,1
105376524,LOC105376524,chr11,F,3057503,3063242,74684809,5739,298718586,7440,2
105376525,LOC105376525,chr11,R,3437495,3447645,74694959,10150,298728736,7441,2
105376526,LOC105376526,chr11,R,3473570,3478053,74699442,4483,298733219,7442,1
105376527,LOC105376527,chr11,R,3854322,3855603,74700723,1281,298734500,7443,1
105376528,LOC105376528,chr11,F,4666624,4673496,74707595,6872,298741372,7444,2
105376529,LOC105376529,chr11,F,5509586,5513464,74711473,3878,298745250,7445,1
105376530,LOC105376530,chr11,F,6362781,6371269,74719961,8488,298753738,7446,3
105376531,LOC105376531,chr11,R,6733719,6746480,74732722,12761,298766499,7447,1
105376532,LOC105376532,chr11,F,6690913,6704471,74746280,13558,298780057,7448,3
105376533,LOC105376533,chr11,F,7701744,7721067,74765603,19323,298799380,7449,5
105376534,LOC105376534,chr11,F,7676469,7700287,74789421,23818,298823198,7450,6
105376535,LOC105376535,chr11,R,7571273,7597180,74815328,25907,298849105,7451,3
105376536,LOC105376536,chr11,F,8229884,8233020,74818464,3136,298852241,7452,3
105376537,LOC105376537,chr11,R,8317217,8335622,74836869,18405,298870646,7453,2
105376538,LOC105376538,chr11,F,8659428,8665617,74843058,6189,298876835,7454,1
105376539,LOC105376539,chr11,F,8766782,8779535,74855811,12753,298889588,7455,3
105376540,LOC105376540,chr11,F,8932958,8936954,74859807,3996,298893584,7456,2
105376541,LOC105376541,chr11,F,9004349,9065242,74920700,60893,298954477,7457,3
105376542,LOC105376542,chr11,R,9116174,9121858,74926384,5684,298960161,7458,2
105376543,LOC105376543,chr11,F,9539853,9556816,74943347,16963,298977124,7459,1
105376544,LOC105376544,chr11,R,10301744,10304753,74946356,3009,298980133,7460,3
105376545,LOC105376545,chr11,R,10811283,10825690,74960763,14407,298994540,7461,2
105376546,LOC105376546,chr11,R,10843990,10847945,74964718,3955,298998495,7462,1
105376547,LOC105376547,chr11,R,10834836,10838454,74968336,3618,299002113,7463,2
105376548,LOC105376548,chr11,R,11152395,11156532,74972473,4137,299006250,7464,2
105376550,LOC105376550,chr11,F,11073773,11177321,75076021,103548,299109798,7465,4
105376551,LOC105376551,chr11,R,11475187,11476452,75077286,1265,299111063,7466,1
105376552,LOC105376552,chr11,F,11293730,11299188,75082744,5458,299116521,7467,2
105376553,LOC105376553,chr11,R,11635325,11642781,75090200,7456,299123977,7468,2
105376554,LOC105376554,chr11,F,12030874,12061791,75121117,30917,299154894,7469,1
105376555,LOC105376555,chr11,R,12213416,12224656,75132357,11240,299166134,7470,3
105376556,LOC105376556,chr11,F,12619301,12669097,75182153,49796,299215930,7471,6
105376557,LOC105376557,chr11,R,12997046,13009204,75194311,12158,299228088,7472,2
105376558,LOC105376558,chr11,R,13111502,13112981,75195790,1479,299229567,7473,2
105376559,LOC105376559,chr11,R,13360015,13381154,75216929,21139,299250706,7474,3
105376560,LOC105376560,chr11,R,13271756,13277572,75222745,5816,299256522,7475,1
105376561,LOC105376561,chr11,R,13844757,13872421,75250409,27664,299284186,7476,4
105376562,LOC105376562,chr11,F,13781378,13847956,75316987,66578,299350764,7477,6
105376563,LOC105376563,chr11,R,13966450,13969081,75319618,2631,299353395,7478,1
105376564,LOC105376564,chr11,R,14451830,14453257,75321045,1427,299354822,7479,1
105376565,LOC105376565,chr11,F,14905081,14915499,75331463,10418,299365240,7480,8
105376566,LOC105376566,chr11,F,15478933,15483131,75335661,4198,299369438,7481,2
105376567,LOC105376567,chr11,R,15700971,15768476,75403166,67505,299436943,7482,10
105376568,LOC105376568,chr11,R,15571835,15623691,75455022,51856,299488799,7483,4
105376569,LOC105376569,chr11,F,15562155,15604112,75496979,41957,299530756,7484,3
105376570,LOC105376570,chr11,F,15910571,15930917,75517325,20346,299551102,7485,8
105376571,LOC105376571,chr11,F,16613022,16655850,75560153,42828,299593930,7486,3
105376572,LOC105376572,chr11,F,16022698,16047546,75585001,24848,299618778,7487,6
105376573,LOC105376573,chr11,F,16768343,16776362,75593020,8019,299626797,7488,2
105376574,LOC105376574,chr11,F,17014749,17020512,75598783,5763,299632560,7489,2
105376575,LOC105376575,chr11,F,17333649,17337515,75602649,3866,299636426,7490,1
105376576,LOC105376576,chr11,R,17350697,17351866,75603818,1169,299637595,7491,2
105376577,LOC105376577,chr11,F,18349237,18350914,75605495,1677,299639272,7492,1
105376578,LOC105376578,chr11,F,18634869,18635997,75606623,1128,299640400,7493,1
105376579,LOC105376579,chr11,F,18706324,18708821,75609120,2497,299642897,7494,2
105376580,LOC105376580,chr11,F,19297173,19310713,75622660,13540,299656437,7495,4
105376581,LOC105376581,chr11,R,20008910,20024779,75638529,15869,299672306,7496,2
105376582,LOC105376582,chr11,F,19505946,19510279,75642862,4333,299676639,7497,3
105376583,LOC105376583,chr11,F,20187502,20199929,75655289,12427,299689066,7498,1
105376584,LOC105376584,chr11,R,20560067,20572998,75668220,12931,299701997,7499,3
105376585,LOC105376585,chr11,R,20880671,20926897,75714446,46226,299748223,7500,2
105376586,LOC105376586,chr11,R,20670353,20672328,75716421,1975,299750198,7501,2
105376587,LOC105376587,chr11,F,21912502,21932735,75736654,20233,299770431,7502,1
105376588,LOC105376588,chr11,F,22492130,22510387,75754911,18257,299788688,7503,2
105376589,LOC105376589,chr11,F,22489531,22491469,75756849,1938,299790626,7504,1
105376590,LOC105376590,chr11,F,22829475,22885695,75813069,56220,299846846,7505,6
105376591,LOC105376591,chr11,F,23116578,23163139,75859630,46561,299893407,7506,5
105376592,LOC105376592,chr11,F,23163562,23192385,75888453,28823,299922230,7507,7
105376593,LOC105376593,chr11,F,23730587,23749918,75907784,19331,299941561,7508,3
105376594,LOC105376594,chr11,R,24259384,24262168,75910568,2784,299944345,7509,2
105376595,LOC105376595,chr11,R,24310688,24338799,75938679,28111,299972456,7510,3
105376596,LOC105376596,chr11,F,25734785,25848603,76052497,113818,300086274,7511,8
105376597,LOC105376597,chr11,F,25853803,25924375,76123069,70572,300156846,7512,3
105376598,LOC105376598,chr11,R,26328602,26332111,76126578,3509,300160355,7513,2
105376599,LOC105376599,chr11,R,26287333,26294073,76133318,6740,300167095,7514,2
105376600,LOC105376600,chr11,F,27219747,27235670,76149241,15923,300183018,7515,3
105376601,LOC105376601,chr11,R,27294004,27296085,76151322,2081,300185099,7516,1
105376602,LOC105376602,chr11,F,28661234,28679640,76169728,18406,300203505,7517,2
105376603,LOC105376603,chr11,F,28902281,29063683,76331130,161402,300364907,7518,4
105376604,LOC105376604,chr11,R,28894430,28941029,76377729,46599,300411506,7519,7
105376605,LOC105376605,chr11,R,29335712,29531385,76573402,195673,300607179,7520,4
105376606,LOC105376606,chr11,F,29618801,29630766,76585367,11965,300619144,7521,2
105376607,LOC105376607,chr11,R,30042721,30322980,76865626,280259,300899403,7522,3
105376608,LOC105376608,chr11,R,30363240,30374007,76876393,10767,300910170,7523,1
105376609,LOC105376609,chr11,F,30584148,30630436,76922681,46288,300956458,7524,4
105376610,LOC105376610,chr11,F,30890118,30904873,76937436,14755,300971213,7525,4
105376611,LOC105376611,chr11,F,30868522,30889948,76958862,21426,300992639,7526,4
105376612,LOC105376612,chr11,F,32003041,32008054,76963875,5013,300997652,7527,1
105376613,LOC105376613,chr11,F,32041963,32047124,76969036,5161,301002813,7528,3
105376614,LOC105376614,chr11,F,32702284,32715828,76982580,13544,301016357,7529,2
105376615,LOC105376615,chr11,R,32956199,33015362,77041743,59163,301075520,7530,4
105376616,LOC105376616,chr11,F,33080605,33084577,77045715,3972,301079492,7531,1
105376617,LOC105376617,chr11,R,33669558,33697150,77073307,27592,301107084,7532,2
105376618,LOC105376618,chr11,R,33654287,33656045,77075065,1758,301108842,7533,2
105376619,LOC105376619,chr11,F,33804919,33810357,77080503,5438,301114280,7534,4
105376620,LOC105376620,chr11,R,33814140,33822384,77088747,8244,301122524,7535,3
105376621,LOC105376621,chr11,F,33893958,33911209,77105998,17251,301139775,7536,2
105376622,LOC105376622,chr11,F,34432360,34436378,77110016,4018,301143793,7537,2
105376623,LOC105376623,chr11,F,34570887,34578608,77117737,7721,301151514,7538,2
105376624,LOC105376624,chr11,R,34853601,34875283,77139419,21682,301173196,7539,5
105376625,LOC105376625,chr11,R,34824570,34825834,77140683,1264,301174460,7540,2
105376626,LOC105376626,chr11,R,35050135,35067254,77157802,17119,301191579,7541,3
105376627,LOC105376627,chr11,F,35086799,35097559,77168562,10760,301202339,7542,4
105376628,LOC105376628,chr11,R,35176746,35186825,77178641,10079,301212418,7543,2
105376629,LOC105376629,chr11,R,36420741,36428106,77186006,7365,301219783,7544,2
105376630,LOC105376630,chr11,R,36148179,36151184,77189011,3005,301222788,7545,2
105376631,LOC105376631,chr11,R,36709048,36710990,77190953,1942,301224730,7546,2
105376632,LOC105376632,chr11,R,37471811,37489050,77208192,17239,301241969,7547,3
105376633,LOC105376633,chr11,F,37938600,37954663,77224255,16063,301258032,7548,2
105376634,LOC105376634,chr11,R,38200941,38337044,77360358,136103,301394135,7549,2
105376635,LOC105376635,chr11,F,38646465,38686693,77400586,40228,301434363,7550,9
105376636,LOC105376636,chr11,F,39542645,39549877,77407818,7232,301441595,7551,2
105376637,LOC105376637,chr11,R,39480664,39779540,77706694,298876,301740471,7552,2
105376638,LOC105376638,chr11,F,40826420,40829545,77709819,3125,301743596,7553,2
105376639,LOC105376639,chr11,R,41853692,41875785,77731912,22093,301765689,7554,6
105376640,LOC105376640,chr11,R,41521166,41714477,77925223,193311,301959000,7555,9
105376641,LOC105376641,chr11,F,42067014,42080205,77938414,13191,301972191,7556,2
105376642,LOC105376642,chr11,F,42253827,42261931,77946518,8104,301980295,7557,4
105376643,LOC105376643,chr11,R,43329207,43335334,77952645,6127,301986422,7558,2
105376644,LOC105376644,chr11,R,43874135,43880741,77959251,6606,301993028,7559,2
105376645,LOC105376645,chr11,F,44510111,44517170,77966310,7059,302000087,7560,2
105376646,LOC105376646,chr11,R,44518826,44526066,77973550,7240,302007327,7561,5
105376647,LOC105376647,chr11,R,44689379,44701306,77985477,11927,302019254,7562,2
105376648,LOC105376648,chr11,R,44901002,44903885,77988360,2883,302022137,7563,2
105376649,LOC105376649,chr11,R,44972768,44973719,77989311,951,302023088,7564,1
105376650,LOC105376650,chr11,F,45008272,45043897,78024936,35625,302058713,7565,2
105376651,LOC105376651,chr11,R,44983931,45008175,78049180,24244,302082957,7566,2
105376652,LOC105376652,chr11,R,45106484,45145307,78088003,38823,302121780,7567,5
105376653,LOC105376653,chr11,F,45253913,45254882,78088972,969,302122749,7568,3
105376654,LOC105376654,chr11,R,45531001,45533527,78091498,2526,302125275,7569,2
105376655,LOC105376655,chr11,R,45569342,45578134,78100290,8792,302134067,7570,2
105376656,LOC105376656,chr11,R,45578339,45582398,78104349,4059,302138126,7571,2
105376657,LOC105376657,chr11,R,45739159,45741128,78106318,1969,302140095,7572,2
105376658,LOC105376658,chr11,R,45750822,45751602,78107098,780,302140875,7573,1
105376659,LOC105376659,chr11,F,45813054,45825632,78119676,12578,302153453,7574,2
105376660,LOC105376660,chr11,R,45898183,45899921,78121414,1738,302155191,7575,2
105376661,LOC105376661,chr11,F,46126289,46135646,78130771,9357,302164548,7576,2
105376662,LOC105376662,chr11,R,46213652,46220948,78138067,7296,302171844,7577,3
105376663,LOC105376663,chr11,R,47153439,47155136,78139764,1697,302173541,7578,1
105376664,LOC105376664,chr11,F,47001697,47011880,78149947,10183,302183724,7579,2
105376665,LOC105376665,chr11,R,49554361,49558290,78153876,3929,302187653,7580,2
105376666,LOC105376666,chr11,R,50070330,50079477,78163023,9147,302196800,7581,1
105376667,LOC105376667,chr11,F,574015,577669,78166677,3654,302200454,7582,2
105376671,LOC105376671,chr11,F,27472362,27476635,78170950,4273,302204727,7583,2
105378955,LOC105378955,chr11,F,90071053,90073512,78173409,2459,302207186,7584,2
105378956,LOC105378956,chr11,R,120078112,120102354,78197651,24242,302231428,7585,4
105379405,LOC105379405,chr11,F,66483127,66483820,78198344,693,302232121,7586,1
105379406,LOC105379406,chr11,R,67779600,67784428,78203172,4828,302236949,7587,1
105379407,LOC105379407,chr11,R,69475603,69479894,78207463,4291,302241240,7588,1
105379409,LOC105379409,chr11,R,71775844,71786680,78218299,10836,302252076,7589,2
105379410,LOC105379410,chr11,F,86580010,86591195,78229484,11185,302263261,7590,2
105379411,LOC105379411,chr11,R,73580219,73648096,78297361,67877,302331138,7591,4
2,A2M,chr12,R,9067707,9115962,48255,48255,302379393,7592,34
3,A2MP1,chr12,R,9228532,9234207,53930,5675,302385068,7593,8
32,ACACB,chr12,F,109111183,109268226,210973,157043,302542111,7594,57
35,ACADS,chr12,F,120725737,120740008,225244,14271,302556382,7595,10
41,ASIC1,chr12,F,50057636,50083622,251230,25986,302582368,7596,13
91,ACVR1B,chr12,F,51951666,51997079,296643,45413,302627781,7597,11
94,ACVRL1,chr12,F,51906912,51923361,313092,16449,302644230,7598,10
112,ADCY6,chr12,R,48766191,48789037,335938,22846,302667076,7599,22
217,ALDH2,chr12,F,111766886,111809985,379037,43099,302710175,7600,12
225,ABCD2,chr12,R,39550352,39651328,480013,100976,302811151,7601,11
269,AMHR2,chr12,F,53423854,53431534,487693,7680,302818831,7602,11
317,APAF1,chr12,F,98645227,98735433,577899,90206,302909037,7603,28
319,APOF,chr12,R,56360570,56362799,580128,2229,302911266,7604,1
339,APOBEC1,chr12,R,7649399,7670599,601328,21200,302932466,7605,5
359,AQP2,chr12,F,49950740,49958881,609469,8141,302940607,7606,3
362,AQP5,chr12,F,49961495,49965682,613656,4187,302944794,7607,4
363,AQP6,chr12,F,49972836,49977139,617959,4303,302949097,7608,3
377,ARF3,chr12,R,48931155,48957526,644330,26371,302975468,7609,7
397,ARHGDIB,chr12,R,14942014,14961628,663944,19614,302995082,7610,7
400,ARL1,chr12,R,101393119,101407820,678645,14701,303009783,7611,5
420,ART4,chr12,R,14829310,14843479,692814,14169,303023952,7612,2
429,ASCL1,chr12,F,102957673,102960516,695657,2843,303026795,7613,1
466,ATF1,chr12,F,50763709,50821167,753115,57458,303084253,7614,8
488,ATP2A2,chr12,F,110281226,110351093,822982,69867,303154120,7615,20
490,ATP2B1,chr12,R,89588048,89709353,944287,121305,303275425,7616,23
506,ATP5B,chr12,R,56638174,56646068,952181,7894,303283319,7617,9
517,ATP5G2,chr12,R,53665159,53676728,963750,11569,303294888,7618,5
552,AVPR1A,chr12,R,63142286,63153860,975324,11574,303306462,7619,2
586,BCAT1,chr12,R,24810023,24949459,1114760,139436,303445898,7620,12
605,BCL7A,chr12,F,122021885,122062044,1154919,40159,303486057,7621,5
636,BICD1,chr12,F,32106735,32383650,1431834,276915,303762972,7622,10
694,BTG1,chr12,R,92140277,92145897,1437454,5620,303768592,7623,1
715,C1R,chr12,R,7080208,7082108,1439354,1900,303770492,7624,1
715,C1R,chr12,R,7085859,7092447,1445942,6588,303777080,7625,8
716,C1S,chr12,F,7060675,7071032,1456299,10357,303787437,7626,12
719,C3AR1,chr12,R,8058322,8066359,1464336,8037,303795474,7627,1
775,CACNA1C,chr12,F,1970785,2697949,2191500,727164,304522638,7628,55
784,CACNB3,chr12,F,48814431,48828943,2206012,14512,304537150,7629,18
894,CCND2,chr12,F,4273732,4305356,2237636,31624,304568774,7630,5
904,CCNT1,chr12,R,48688457,48716998,2266177,28541,304597315,7631,8
920,CD4,chr12,F,6789471,6820810,2297516,31339,304628654,7632,9
928,CD9,chr12,F,6199843,6238271,2335944,38428,304667082,7633,7
939,CD27,chr12,F,6444884,6451718,2342778,6834,304673916,7634,6
949,SCARB1,chr12,R,124777627,124863973,2429124,86346,304760262,7635,12
967,CD63,chr12,R,55725442,55729673,2433355,4231,304764493,7636,11
969,CD69,chr12,R,9752485,9760901,2441771,8416,304772909,7637,4
1017,CDK2,chr12,F,55966768,55972789,2447792,6021,304778930,7638,7
1019,CDK4,chr12,R,57747726,57752447,2452513,4721,304783651,7639,7
1027,CDKN1B,chr12,F,12717269,12722383,2457627,5114,304788765,7640,2
1108,CHD4,chr12,R,6570081,6607439,2494985,37358,304826123,7641,38
1240,CMKLR1,chr12,R,108288043,108339317,2546259,51274,304877397,7642,4
1272,CNTN1,chr12,F,40692441,41072412,2926230,379971,305257368,7643,27
1280,COL2A1,chr12,R,47972964,48025286,2978552,52322,305309690,7644,66
1337,COX6A1,chr12,F,120438089,120440742,2981205,2653,305312343,7645,2
1368,CPM,chr12,R,68851174,68963240,3093271,112066,305424409,7646,9
1389,CREBL2,chr12,F,12611832,12645108,3126547,33276,305457685,7647,3
1407,CRY1,chr12,R,106991363,107093857,3229041,102494,305560179,7648,13
1431,CS,chr12,R,56271698,56300391,3257734,28693,305588872,7649,10
1466,CSRP2,chr12,R,76858714,76879046,3278066,20332,305609204,7650,6
1594,CYP27B1,chr12,R,57762333,57767193,3282926,4860,305614064,7651,8
1606,DGKA,chr12,F,55931161,55954027,3305792,22866,305636930,7652,29
1610,DAO,chr12,F,108880029,108901043,3326806,21014,305657944,7653,11
1634,DCN,chr12,R,91145257,91183029,3364578,37772,305695716,7654,10
1649,DDIT3,chr12,R,57516587,57521698,3369689,5111,305700827,7655,3
1663,DDX11,chr12,F,31073580,31104799,3400908,31219,305732046,7656,28
1822,ATN1,chr12,F,6924462,6942321,3418767,17859,305749905,7657,10
1833,EPYC,chr12,R,90963678,91007906,3462995,44228,305794133,7658,8
1840,DTX1,chr12,F,113056713,113098028,3504310,41315,305835448,7659,9
1848,DUSP6,chr12,R,89347824,89352859,3509345,5035,305840483,7660,2
1911,PHC1,chr12,F,8914683,8941467,3536129,26784,305867267,7661,15
1967,EIF2B1,chr12,R,123621022,123633776,3548883,12754,305880021,7662,8
1975,EIF4B,chr12,F,53006257,53042209,3584835,35952,305915973,7663,15
1990,CELA1,chr12,R,51328442,51346679,3603072,18237,305934210,7664,7
2004,ELK3,chr12,F,96194381,96269835,3678526,75454,306009664,7665,6
2012,EMP1,chr12,F,13196667,13216774,3698633,20107,306029771,7666,4
2026,ENO2,chr12,F,6914449,6923696,3707880,9247,306039018,7667,11
2054,STX2,chr12,R,130774882,130839274,3772272,64392,306103410,7668,13
2059,EPS8,chr12,R,15620140,15789576,3941708,169436,306272846,7669,24
2065,ERBB3,chr12,F,56080024,56103507,3965191,23483,306296329,7670,27
2120,ETV6,chr12,F,11649853,11895402,4210740,245549,306541878,7671,12
2251,FGF6,chr12,R,4434141,4445614,4222213,11473,306553351,7672,2
2288,FKBP4,chr12,F,2794941,2805423,4232695,10482,306563833,7673,10
2305,FOXM1,chr12,R,2857680,2877155,4252170,19475,306583308,7674,10
2583,B4GALNT1,chr12,R,57625894,57633239,4259515,7345,306590653,7675,12
2597,GAPDH,chr12,F,6534404,6538375,4263486,3971,306594624,7676,8
2647,BLOC1S1,chr12,F,55716033,55719707,4267160,3674,306598298,7677,4
2735,GLI1,chr12,F,57460134,57472268,4279294,12134,306610432,7678,12
2784,GNB3,chr12,F,6840853,6847395,4285836,6542,306616974,7679,9
2799,GNS,chr12,R,64713441,64759446,4331841,46005,306662979,7680,13
2802,GOLGA3,chr12,R,132768908,132829118,4392051,60210,306723189,7681,29
2819,GPD1,chr12,F,50103818,50111320,4399553,7502,306730691,7682,7
2842,GPR19,chr12,R,12660883,12717272,4455942,56389,306787080,7683,9
2904,GRIN2B,chr12,R,13537336,13982002,4900608,444666,307231746,7684,15
2967,GTF2H3,chr12,F,123633738,123662604,4929474,28866,307260612,7685,12
2984,GUCY2C,chr12,R,14612631,14696618,5013461,83987,307344599,7686,26
2998,GYS2,chr12,R,21531526,21630773,5112708,99247,307443846,7687,19
3034,HAL,chr12,R,95972661,95996365,5136412,23704,307467550,7688,20
3071,NCKAP1L,chr12,F,54497710,54543115,5181817,45405,307512955,7689,31
3164,NR4A1,chr12,F,52022831,52059507,5218493,36676,307549631,7690,12
3178,HNRNPA1,chr12,F,54280695,54287087,5224885,6392,307556023,7691,11
3221,HOXC4,chr12,F,54016851,54056030,5264064,39179,307595202,7692,3
3222,HOXC5,chr12,F,54016851,54035361,5282574,18510,307613712,7693,2
3223,HOXC6,chr12,F,54016851,54030823,5296546,13972,307627684,7694,2
3224,HOXC8,chr12,F,54009105,54012763,5300204,3658,307631342,7695,1
3225,HOXC9,chr12,F,54000092,54003337,5303449,3245,307634587,7696,1
3226,HOXC10,chr12,F,53985161,53990279,5308567,5118,307639705,7697,1
3227,HOXC11,chr12,F,53973125,53976419,5311861,3294,307642999,7698,1
3228,HOXC12,chr12,F,53954929,53956566,5313498,1637,307644636,7699,1
3229,HOXC13,chr12,F,53938791,53946544,5321251,7753,307652389,7700,1
3242,HPD,chr12,R,121839526,121888611,5370336,49085,307701474,7701,16
3375,IAPP,chr12,F,21372867,21379980,5377449,7113,307708587,7702,2
3458,IFNG,chr12,R,68154769,68159741,5382421,4972,307713559,7703,3
3479,IGF1,chr12,R,102395866,102481786,5468341,85920,307799479,7704,6
3489,IGFBP6,chr12,F,53097651,53102344,5473034,4693,307804172,7705,3
3626,INHBC,chr12,F,57434684,57452062,5490412,17378,307821550,7706,1
3678,ITGA5,chr12,R,54395260,54419266,5514418,24006,307845556,7707,29
3679,ITGA7,chr12,R,55684567,55716037,5545888,31470,307877026,7708,30
3695,ITGB7,chr12,R,53191317,53207310,5561881,15993,307893019,7709,15
3709,ITPR2,chr12,R,26335351,26833198,6059728,497847,308390866,7710,59
3736,KCNA1,chr12,F,4909906,4918256,6068078,8350,308399216,7711,1
3741,KCNA5,chr12,F,5043918,5046788,6070948,2870,308402086,7712,0
3742,KCNA6,chr12,F,4806884,4851114,6115178,44230,308446316,7713,2
3747,KCNC2,chr12,R,75040077,75209748,6284849,169671,308615987,7714,9
3764,KCNJ8,chr12,R,21764954,21775502,6295397,10548,308626535,7715,3
3798,KIF5A,chr12,F,57550063,57584771,6330105,34708,308661243,7716,28
3820,KLRB1,chr12,R,9595273,9607901,6342733,12628,308673871,7717,5
3821,KLRC1,chr12,R,10442263,10454685,6355155,12422,308686293,7718,8
3822,KLRC2,chr12,R,10430598,10435993,6360550,5395,308691688,7719,5
3823,KLRC3,chr12,R,10412314,10420595,6368831,8281,308699969,7720,6
3824,KLRD1,chr12,F,10304445,10360876,6425262,56431,308756400,7721,12
3845,KRAS,chr12,R,25204788,25250931,6471405,46143,308802543,7722,5
3848,KRT1,chr12,R,52674735,52680407,6477077,5672,308808215,7723,8
3849,KRT2,chr12,R,52644557,52652175,6484695,7618,308815833,7724,8
3850,KRT3,chr12,R,52789684,52805717,6500728,16033,308831866,7725,9
3851,KRT4,chr12,R,52806542,52814116,6508302,7574,308839440,7726,8
3852,KRT5,chr12,R,52514574,52520459,6514187,5885,308845325,7727,8
3853,KRT6A,chr12,R,52487173,52493397,6520411,6224,308851549,7728,8
3854,KRT6B,chr12,R,52446650,52452126,6525887,5476,308857025,7729,8
3855,KRT7,chr12,F,52233169,52252667,6545385,19498,308876523,7730,8
3856,KRT8,chr12,R,52897186,52949866,6598065,52680,308929203,7731,9
3875,KRT18,chr12,F,52948870,52952901,6602096,4031,308933234,7732,7
3887,KRT81,chr12,R,52285912,52308410,6624594,22498,308955732,7733,10
3888,KRT82,chr12,R,52393950,52406392,6637036,12442,308968174,7734,8
3889,KRT83,chr12,R,52314300,52321398,6644134,7098,308975272,7735,8
3890,KRT84,chr12,R,52377811,52386906,6653229,9095,308984367,7736,9
3891,KRT85,chr12,R,52360005,52367525,6660749,7520,308991887,7737,9
3892,KRT86,chr12,F,52274630,52309163,6695282,34533,309026420,7738,10
3902,LAG3,chr12,F,6772482,6778455,6701255,5973,309032393,7739,7
3906,LALBA,chr12,R,48567683,48600111,6733683,32428,309064821,7740,5
3945,LDHB,chr12,R,21635340,21657971,6756314,22631,309087452,7741,7
4033,LRMP,chr12,F,25052100,25108335,6812549,56235,309143687,7742,24
4035,LRP1,chr12,F,57128498,57213359,6897410,84861,309228548,7743,88
4040,LRP6,chr12,R,12116024,12267007,7048393,150983,309379531,7744,22
4048,LTA4H,chr12,R,96000752,96043520,7091161,42768,309422299,7745,20
4055,LTBR,chr12,F,6375367,6391571,7107365,16204,309438503,7746,11
4060,LUM,chr12,R,91103454,91111765,7115676,8311,309446814,7747,2
4069,LYZ,chr12,F,69348353,69354233,7121556,5880,309452694,7748,3
4074,M6PR,chr12,R,8940360,8949761,7130957,9401,309462095,7749,8
4141,MARS,chr12,F,57487952,57516655,7159660,28703,309490798,7750,20
4193,MDM2,chr12,F,68808167,68845544,7197037,37377,309528175,7751,12
4234,METTL1,chr12,R,57768470,57772131,7200698,3661,309531836,7752,6
4254,KITLG,chr12,R,88492792,88580473,7288379,87681,309619517,7753,9
4256,MGP,chr12,R,14881180,14885919,7293118,4739,309624256,7754,4
4257,MGST1,chr12,F,16347141,16377189,7323166,30048,309654304,7755,10
4284,MIP,chr12,R,56449501,56456553,7330218,7052,309661356,7756,6
4326,MMP17,chr12,F,131828395,131851771,7353594,23376,309684732,7757,12
4327,MMP19,chr12,R,55835429,55842983,7361148,7554,309692286,7758,8
4440,MSI1,chr12,R,120339649,120369180,7390679,29531,309721817,7759,21
4598,MVK,chr12,F,109573352,109597270,7414597,23918,309745735,7760,11
4604,MYBPC1,chr12,F,101594930,101685883,7505550,90953,309836688,7761,32
4617,MYF5,chr12,F,80716928,80719668,7508290,2740,309839428,7762,2
4618,MYF6,chr12,F,80707628,80709478,7510140,1850,309841278,7763,2
4633,MYL2,chr12,R,110910818,110920600,7519922,9782,309851060,7764,6
4637,MYL6,chr12,F,56158260,56161582,7523244,3322,309854382,7765,6
4640,MYO1A,chr12,R,57028516,57050765,7545493,22249,309876631,7766,29
4659,PPP1R12A,chr12,R,79773562,79935455,7707386,161893,310038524,7767,30
4665,NAB2,chr12,F,57088893,57095476,7713969,6583,310045107,7768,6
4666,NACA,chr12,R,56712426,56726275,7727818,13849,310058956,7769,7
4673,NAP1L1,chr12,R,76044891,76084958,7767885,40067,310099023,7770,17
4704,NDUFA9,chr12,F,4649097,4687554,7806342,38457,310137480,7771,10
4753,NELL2,chr12,R,44508274,44921848,8219916,413574,310551054,7772,24
4778,NFE2,chr12,R,54292106,54301037,8228847,8931,310559985,7773,6
4801,NFYB,chr12,R,104117079,104138262,8250030,21183,310581168,7774,9
4815,NINJ2,chr12,R,564295,663741,8349476,99446,310680614,7775,5
4839,NOP2,chr12,R,6556869,6568332,8360939,11463,310692077,7776,16
4842,NOS1,chr12,R,117208141,117361802,8514600,153661,310845738,7777,34
4848,CNOT2,chr12,F,70242993,70354993,8626600,112000,310957738,7778,19
4891,SLC11A2,chr12,R,50979409,51028335,8675526,48926,311006664,7779,22
4908,NTF3,chr12,F,5432113,5495299,8738712,63186,311069850,7780,2
4922,NTS,chr12,F,85874294,85882992,8747410,8698,311078548,7781,3
4938,OAS1,chr12,F,112906933,112932049,8772526,25116,311103664,7782,6
4939,OAS2,chr12,F,112970818,113011723,8813431,40905,311144569,7783,11
4940,OAS3,chr12,F,112938432,112973249,8848248,34817,311179386,7784,15
4973,OLR1,chr12,R,10158299,10176261,8866210,17962,311197348,7785,6
5025,P2RX4,chr12,F,121209860,121234106,8890456,24246,311221594,7786,13
5027,P2RX7,chr12,F,121132818,121186551,8944189,53733,311275327,7787,12
5036,PA2G4,chr12,F,56104318,56113910,8953781,9592,311284919,7788,12
5037,PEBP1,chr12,F,118136064,118145585,8963302,9521,311294440,7789,3
5053,PAH,chr12,R,102838320,102917603,9042585,79283,311373723,7790,12
5074,PAWR,chr12,R,79587790,79691010,9145805,103220,311476943,7791,10
5094,PCBP2,chr12,F,53452101,53481162,9174866,29061,311506004,7792,14
5128,CDK17,chr12,R,96278260,96400588,9297194,122328,311628332,7793,16
5139,PDE3A,chr12,F,20368509,20687641,9616326,319132,311947464,7794,17
5149,PDE6H,chr12,F,14973021,14981865,9625170,8844,311956308,7795,3
5153,PDE1B,chr12,F,54549392,54579239,9655017,29847,311986155,7796,18
5204,PFDN5,chr12,F,53295450,53299450,9659017,4000,311990155,7797,5
5213,PFKM,chr12,F,48105401,48146404,9700020,41003,312031158,7798,28
5250,SLC25A3,chr12,F,98593624,98602000,9708396,8376,312039534,7799,7
5288,PIK3C2G,chr12,F,18242964,18699660,10165092,456696,312496230,7800,42
5318,PKP2,chr12,R,32790745,32896846,10271193,106101,312602331,7801,13
5319,PLA2G1B,chr12,R,120322110,120327789,10276872,5679,312608010,7802,3
5367,PMCH,chr12,R,102196458,102197836,10278250,1378,312609388,7803,2
5426,POLE,chr12,R,132623761,132687524,10342013,63763,312673151,7804,53
5463,POU6F1,chr12,R,51186935,51217693,10372771,30758,312703909,7805,10
5501,PPP1CC,chr12,R,110708969,110742978,10406780,34009,312737918,7806,8
5502,PPP1R1A,chr12,R,54579239,54588677,10416218,9438,312747356,7807,7
5542,PRB1,chr12,R,11351822,11355590,10419986,3768,312751124,7808,3
5544,PRB3,chr12,R,11265913,11269707,10423780,3794,312754918,7809,4
5545,PRB4,chr12,R,11307080,11310435,10427135,3355,312758273,7810,3
5554,PRH1,chr12,R,10880960,11171623,10717798,290663,313048936,7811,6
5555,PRH2,chr12,F,10929234,10934845,10723409,5611,313054547,7812,2
5557,PRIM1,chr12,R,56731579,56752362,10744192,20783,313075330,7813,12
5564,PRKAB1,chr12,F,119667863,119681624,10757953,13761,313089091,7814,6
5571,PRKAG1,chr12,R,49002271,49018980,10774662,16709,313105800,7815,13
5630,PRPH,chr12,F,49295012,49298698,10778348,3686,313109486,7816,8
5715,PSMD9,chr12,F,121888730,121917865,10807483,29135,313138621,7817,5
5744,PTHLH,chr12,R,27958083,27972731,10822131,14648,313153269,7818,7
5756,TWF1,chr12,R,43793722,43806375,10834784,12653,313165922,7819,9
5763,PTMS,chr12,F,6766138,6770952,10839598,4814,313170736,7820,4
5777,PTPN6,chr12,F,6946575,6961316,10854339,14741,313185477,7821,16
5781,PTPN11,chr12,F,112418731,112509918,10945526,91187,313276664,7822,15
5787,PTPRB,chr12,R,70516849,70637440,11066117,120591,313397255,7823,35
5800,PTPRO,chr12,F,15322256,15598331,11342192,276075,313673330,7824,25
5801,PTPRR,chr12,R,70638072,70920804,11624924,282732,313956062,7825,17
5827,PXMP2,chr12,F,132687605,132704991,11642310,17386,313973448,7826,4
5829,PXN,chr12,R,120210438,120265771,11697643,55333,314028781,7827,18
5830,PEX5,chr12,F,7189162,7218574,11727055,29412,314058193,7828,18
5858,PZP,chr12,R,9142818,9208370,11792607,65552,314123745,7829,37
5869,RAB5B,chr12,F,55973912,55996683,11815378,22771,314146516,7830,7
5893,RAD52,chr12,R,911258,990608,11894728,79350,314225866,7831,15
5901,RAN,chr12,F,130871993,130877678,11900413,5685,314231551,7832,6
5908,RAP1B,chr12,F,68610838,68660605,11950180,49767,314281318,7833,7
5916,RARG,chr12,R,53210565,53232256,11971871,21691,314303009,7834,12
5927,KDM5A,chr12,R,280056,389455,12081270,109399,314412408,7835,27
5939,RBMS2,chr12,F,56521823,56596196,12155643,74373,314486781,7836,16
5959,RDH5,chr12,F,55720366,55724742,12160019,4376,314491157,7837,4
5965,RECQL,chr12,R,21468909,21501669,12192779,32760,314523917,7838,14
5985,RFC5,chr12,F,118016700,118033564,12209643,16864,314540781,7839,12
5992,RFX4,chr12,F,106582906,106762804,12389541,179898,314720679,7840,19
6128,RPL6,chr12,R,112405189,112418838,12403190,13649,314734328,7841,11
6171,RPL41,chr12,F,56116589,56117832,12404433,1243,314735571,7842,2
6175,RPLP0,chr12,R,120196699,120201211,12408945,4512,314740083,7843,7
6231,RPS26,chr12,F,56041901,56044223,12411267,2322,314742405,7844,3
6249,CLIP1,chr12,R,122271431,122422632,12562468,151201,314893606,7845,26
6302,TSPAN31,chr12,F,57744089,57748243,12566622,4154,314897760,7846,5
6311,ATXN2,chr12,R,111452213,111599676,12714085,147463,315045223,7847,24
6334,SCN8A,chr12,F,51590192,51812864,12936757,222672,315267895,7848,29
6337,SCNN1A,chr12,R,6346842,6377357,12967272,30515,315298410,7849,13
6404,SELPLG,chr12,R,108621894,108633954,12979332,12060,315310470,7850,2
6433,SFSWAP,chr12,F,131711086,131799738,13067984,88652,315399122,7851,19
6472,SHMT2,chr12,F,57229572,57234935,13073347,5363,315404485,7852,13
6489,ST8SIA1,chr12,R,22129134,22334714,13278927,205580,315610065,7853,8
6490,PMEL,chr12,R,55954104,55966712,13291535,12608,315622673,7854,11
6515,SLC2A3,chr12,R,7919227,7936296,13308604,17069,315639742,7855,9
6539,SLC6A12,chr12,R,187457,214205,13335352,26748,315666490,7856,21
6540,SLC6A13,chr12,R,220620,264308,13379040,43688,315710178,7857,18
6579,SLCO1A2,chr12,R,21264599,21403657,13518098,139058,315849236,7858,19
6601,SMARCC2,chr12,R,56161851,56189567,13545814,27716,315876952,7859,28
6602,SMARCD1,chr12,F,50085199,50100711,13561326,15512,315892464,7860,12
6636,SNRPF,chr12,F,95858930,95866460,13568856,7530,315899994,7861,3
6660,SOX5,chr12,R,23529494,24562669,14602031,1033175,316933169,7862,27
6667,SP1,chr12,F,53380194,53416446,14638283,36252,316969421,7863,7
6773,STAT2,chr12,R,56341596,56360253,14656940,18657,316988078,7864,24
6778,STAT6,chr12,R,57095403,57111433,14672970,16030,317004108,7865,23
6821,SUOX,chr12,F,55997258,56005525,14681237,8267,317012375,7866,6
6843,VAMP1,chr12,R,6462236,6470899,14689900,8663,317021038,7867,3
6857,SYT1,chr12,F,78863992,79452008,15277916,588016,317609054,7868,12
6866,TAC3,chr12,R,57009996,57016560,15284480,6564,317615618,7869,8
6895,TARBP2,chr12,F,53500202,53506431,15290709,6229,317621847,7870,9
6910,TBX5,chr12,R,114353929,114408442,15345222,54513,317676360,7871,9
6926,TBX3,chr12,R,114670253,114684164,15359133,13911,317690271,7872,7
6927,HNF1A,chr12,F,120977786,121002512,15383859,24726,317714997,7873,8
6996,TDG,chr12,F,103965814,103988878,15406923,23064,317738061,7874,9
7004,TEAD4,chr12,F,2959311,3040676,15488288,81365,317819426,7875,12
7009,TMBIM6,chr12,F,49741509,49764934,15511713,23425,317842851,7876,10
7024,TFCP2,chr12,R,51093755,51173143,15591101,79388,317922239,7877,14
7103,TSPAN8,chr12,R,71125092,71157999,15624008,32907,317955146,7878,9
7112,TMPO,chr12,F,98515572,98550379,15658815,34807,317989953,7879,9
7132,TNFRSF1A,chr12,R,6328756,6342117,15672176,13361,318003314,7880,9
7167,TPI1,chr12,F,6867419,6870946,15675703,3527,318006841,7881,7
7181,NR2C1,chr12,R,95020228,95073628,15729103,53400,318060241,7882,15
7184,HSP90B1,chr12,F,103930333,103947930,15746700,17597,318077838,7883,17
7289,TULP3,chr12,F,2890866,2941140,15796974,50274,318128112,7884,10
7296,TXNRD1,chr12,F,104215778,104350307,15931503,134529,318262641,7885,17
7316,UBC,chr12,R,124911644,124915041,15934900,3397,318266038,7886,1
7334,UBE2N,chr12,R,93408311,93443445,15970034,35134,318301172,7887,6
7374,UNG,chr12,F,109097593,109110993,15983434,13400,318314572,7888,6
7421,VDR,chr12,R,47841536,47905031,16046929,63495,318378067,7889,10
7450,VWF,chr12,R,5948873,6124670,16222726,175797,318553864,7890,51
7471,WNT1,chr12,F,48978452,48982613,16226887,4161,318558025,7891,3
7480,WNT10B,chr12,R,48965339,48971858,16233406,6519,318564544,7892,5
7556,ZNF10,chr12,F,133130627,133159465,16262244,28838,318593382,7893,4
7574,ZNF26,chr12,F,132986347,133012568,16288465,26221,318619603,7894,8
7637,ZNF84,chr12,F,133037285,133063304,16314484,26019,318645622,7895,6
7699,ZNF140,chr12,F,133079686,133108803,16343601,29117,318674739,7896,8
7786,MAP3K12,chr12,R,53479668,53500136,16364069,20468,318695207,7897,16
7846,TUBA1A,chr12,R,49184794,49189324,16368599,4530,318699737,7898,3
8074,FGF23,chr12,R,4368226,4379728,16380101,11502,318711239,7899,2
8076,MFAP5,chr12,R,8645942,8662888,16397047,16946,318728185,7900,10
8078,USP5,chr12,F,6852117,6866632,16411562,14515,318742700,7901,19
8079,MLF2,chr12,R,6747991,6753470,16417041,5479,318748179,7902,9
8082,SSPN,chr12,F,26121950,26234777,16529868,112827,318861006,7903,6
8085,KMT2D,chr12,R,49018974,49061895,16572789,42921,318903927,7904,55
8086,AAAS,chr12,R,53307455,53321628,16586962,14173,318918100,7905,17
8089,YEATS4,chr12,F,69359699,69424838,16652101,65139,318983239,7906,8
8091,HMGA2,chr12,F,65824459,65966291,16793933,141832,319125071,7907,6
8092,ALX1,chr12,F,85279794,85301784,16815923,21990,319147061,7908,5
8099,CDK2AP1,chr12,R,123260969,123272316,16827270,11347,319158408,7909,7
8302,KLRC4,chr12,R,10407383,10409757,16829644,2374,319160782,7910,3
8315,BRAP,chr12,R,111642145,111685996,16873495,43851,319204633,7911,11
8408,ULK1,chr12,F,131894733,131923162,16901924,28429,319233062,7912,27
8411,EEA1,chr12,R,92772508,92929331,17058747,156823,319389885,7913,31
8435,SOAT2,chr12,F,53102503,53124539,17080783,22036,319411921,7914,14
8437,RASAL1,chr12,R,113098818,113136239,17118204,37421,319449342,7915,23
8445,DYRK2,chr12,F,67648731,67662664,17132137,13933,319463275,7916,2
8496,PPFIBP1,chr12,F,27524111,27695564,17303590,171453,319634728,7917,31
8499,PPFIA2,chr12,R,81257974,81759548,17805164,501574,320136302,7918,39
8531,YBX3,chr12,R,10699076,10723448,17829536,24372,320160674,7919,10
8549,LGR5,chr12,F,71439161,71586310,17976685,147149,320307823,7920,19
8550,MAPKAPK5,chr12,F,111842227,111901619,18036077,59392,320367215,7921,18
8562,DENR,chr12,F,122752820,122771064,18054321,18244,320385459,7922,7
8608,RDH16,chr12,R,56951430,56959374,18062265,7944,320393403,7923,4
8620,NPFF,chr12,R,53506689,53507638,18063214,949,320394352,7924,2
8630,HSD17B6,chr12,F,56752448,56787790,18098556,35342,320429694,7925,6
8638,OASL,chr12,R,121020291,121039242,18117507,18951,320448645,7926,5
8655,DYNLL1,chr12,F,120469856,120498495,18146146,28639,320477284,7927,3
8683,SRSF9,chr12,R,120461667,120469755,18154234,8088,320485372,7928,3
8693,GALNT4,chr12,R,89519411,89524806,18159629,5395,320490767,7929,0
8738,CRADD,chr12,F,93677350,93894742,18377021,217392,320708159,7930,3
8739,HRK,chr12,R,116860419,116881427,18398029,21008,320729167,7931,4
8759,ADAM1A,chr12,F,111899062,111901902,18400869,2840,320732007,7932,0
8798,DYRK4,chr12,F,4590071,4613888,18424686,23817,320755824,7933,12
8825,LIN7A,chr12,R,80792519,80937923,18570090,145404,320901228,7934,5
8835,SOCS2,chr12,F,93569821,93626236,18626505,56415,320957643,7935,9
8843,HCAR3,chr12,R,122714755,122716892,18628642,2137,320959780,7936,0
8909,ENDOU,chr12,R,47709733,47725572,18644481,15839,320975619,7937,9
8914,TIMELESS,chr12,R,56416372,56449416,18677525,33044,321008663,7938,28
9026,HIP1R,chr12,F,122834497,122862961,18705989,28464,321037127,7939,33
9052,GPRC5A,chr12,F,12891021,12913666,18728634,22645,321059772,7940,3
9119,KRT75,chr12,R,52424069,52434326,18738891,10257,321070029,7941,8
9169,SCAF11,chr12,R,45919130,45992040,18811801,72910,321142939,7942,19
9182,RASSF9,chr12,R,85800702,85836540,18847639,35838,321178777,7943,2
9194,SLC16A7,chr12,F,59595933,59789855,19041561,193922,321372699,7944,13
9271,PIWIL1,chr12,F,130337886,130426260,19129935,88374,321461073,7945,24
9332,CD163,chr12,R,7470815,7503818,19162938,33003,321494076,7946,15
9412,MED21,chr12,F,27022521,27030673,19171090,8152,321502228,7947,3
9416,DDX23,chr12,R,48829755,48852174,19193509,22419,321524647,7948,16
9478,CABP1,chr12,F,120640618,120667324,19220215,26706,321551353,7949,7
9498,SLC4A8,chr12,F,51391316,51515763,19344662,124447,321675800,7950,31
9573,GDF3,chr12,R,7689784,7695764,19350642,5980,321681780,7951,1
9612,NCOR2,chr12,R,124324410,124567464,19593696,243054,321924834,7952,48
9671,WSCD2,chr12,F,108129342,108250537,19714891,121195,322046029,7953,13
9700,ESPL1,chr12,F,53268265,53293643,19740269,25378,322071407,7954,31
9733,SART3,chr12,R,108522213,108561389,19779445,39176,322110583,7955,19
9735,KNTC1,chr12,F,122527248,122627311,19879508,100063,322210646,7956,65
9746,CLSTN3,chr12,F,7130370,7158945,19908083,28575,322239221,7957,17
9761,MLEC,chr12,F,120687123,120701864,19922824,14741,322253962,7958,5
9802,DAZAP2,chr12,F,51238723,51246717,19930818,7994,322261956,7959,4
9815,GIT2,chr12,R,109929801,109996389,19997406,66588,322328544,7960,21
9840,TESPA1,chr12,R,54948302,54985161,20034265,36859,322365403,7961,15
9847,C2CD5,chr12,R,22448545,22544546,20130266,96001,322461404,7962,30
9880,ZBTB39,chr12,R,56998832,57006513,20137947,7681,322469085,7963,1
9891,NUAK1,chr12,R,106063346,106140033,20214634,76687,322545772,7964,6
9904,RBM19,chr12,R,113816737,113966371,20364268,149634,322695406,7965,24
9918,NCAPD2,chr12,F,6494131,6531966,20402103,37835,322733241,7966,31
9921,RNF10,chr12,F,120534307,120577594,20445390,43287,322776528,7967,18
9924,PAN2,chr12,R,56316222,56334053,20463221,17831,322794359,7968,26
9958,USP15,chr12,F,62260339,62409721,20612603,149382,322943741,7969,24
9971,NR1H4,chr12,F,100473758,100563867,20702712,90109,323033850,7970,13
9976,CLEC2B,chr12,R,9852368,9869859,20720203,17491,323051341,7971,4
10019,SH2B3,chr12,F,111405107,111451624,20766720,46517,323097858,7972,11
10024,TROAP,chr12,F,49322137,49331733,20776316,9596,323107454,7973,15
10059,DNM1L,chr12,F,32679199,32745650,20842767,66451,323173905,7974,21
10060,ABCC9,chr12,R,21797388,21941863,20987242,144475,323318380,7975,41
10094,ARPC3,chr12,R,110434889,110450411,21002764,15522,323333902,7976,6
10102,TSFM,chr12,F,57782744,57802856,21022876,20112,323354014,7977,7
10106,CTDSP2,chr12,R,57819926,57846964,21049914,27038,323381052,7978,7
10138,YAF2,chr12,R,42157103,42238352,21131163,81249,323462301,7979,10
10154,PLXNC1,chr12,F,94148722,94307675,21290116,158953,323621254,7980,33
10162,LPCAT3,chr12,R,6976184,7018538,21332470,42354,323663608,7981,12
10193,RNF41,chr12,R,56202503,56221982,21351949,19479,323683087,7982,9
10198,MPHOSPH9,chr12,R,123152323,123244014,21443640,91691,323774778,7983,27
10219,KLRG1,chr12,F,8989624,9010747,21464763,21123,323795901,7984,4
10220,GDF11,chr12,F,55743277,55757466,21478952,14189,323810090,7985,3
10233,LRRC23,chr12,F,6904732,6914242,21488462,9510,323819600,7986,7
10329,TMEM5,chr12,F,63779802,63809558,21518218,29756,323849356,7987,7
10330,CNPY2,chr12,R,56310427,56316344,21524135,5917,323855273,7988,5
10376,TUBA1B,chr12,R,49127781,49131521,21527875,3740,323859013,7989,3
10411,RAPGEF3,chr12,R,47734669,47771035,21564241,36366,323895379,7990,29
10436,EMG1,chr12,F,6970780,6976003,21569464,5223,323900602,7991,5
10445,MCRS1,chr12,R,49558293,49568225,21579396,9932,323910534,7992,16
10526,IPO8,chr12,R,30628980,30695995,21646411,67015,323977549,7993,27
10536,P3H3,chr12,F,6828372,6839854,21657893,11482,323989031,7994,14
10540,DCTN2,chr12,R,57530049,57547331,21675175,17282,324006313,7995,16
10566,AKAP3,chr12,R,4615507,4649047,21708715,33540,324039853,7996,5
10576,CCT2,chr12,F,69585427,69601577,21724865,16150,324056003,7997,16
10599,SLCO1B1,chr12,F,21131193,21239796,21833468,108603,324164606,7998,14
10635,RAD51AP1,chr12,F,4538745,4560047,21854770,21302,324185908,7999,9
10645,CAMKK2,chr12,R,121237691,121298308,21915387,60617,324246525,8000,18
10677,AVIL,chr12,R,57797371,57819824,21937840,22453,324268978,8001,20
10728,PTGES3,chr12,R,56663340,56688408,21962908,25068,324294046,8002,9
10748,KLRAP1,chr12,R,10588477,10599835,21974266,11358,324305404,8003,6
10795,ZNF268,chr12,F,133181408,133207112,21999970,25704,324331108,8004,6
10818,FRS2,chr12,F,69470348,69579793,22109415,109445,324440553,8005,13
10867,TSPAN9,chr12,F,3077354,3286564,22318625,209210,324649763,8006,10
10906,TRAFD1,chr12,F,112125544,112153604,22346685,28060,324677823,8007,11
10956,OS9,chr12,F,57693954,57721557,22374288,27603,324705426,8008,14
10959,TMED2,chr12,F,123584528,123598144,22387904,13616,324719042,8009,4
10961,ERP29,chr12,F,112013347,112023220,22397777,9873,324728915,8010,2
10970,CKAP4,chr12,R,106237880,106247935,22407832,10055,324738970,8011,1
10985,GCN1L1,chr12,R,120127209,120194710,22475333,67501,324806471,8012,57
10988,METAP2,chr12,F,95474045,95515839,22517127,41794,324848265,8013,10
10993,SDS,chr12,R,113392444,113403887,22528570,11443,324859708,8014,7
11010,GLIPR1,chr12,F,75480732,75501936,22549774,21204,324880912,8015,6
11016,ATF7,chr12,R,53507855,53626415,22668334,118560,324999472,8016,14
11021,RAB35,chr12,R,120095093,120116839,22690080,21746,325021218,8017,5
11052,CPSF6,chr12,F,69239536,69274358,22724902,34822,325056040,8018,10
11066,SNRNP35,chr12,F,123458025,123472362,22739239,14337,325070377,8019,4
11081,KERA,chr12,R,91050490,91058354,22747103,7864,325078241,8020,2
11103,KRR1,chr12,R,75497638,75511638,22761103,14000,325092241,8021,9
11108,PRDM4,chr12,R,107732865,107761272,22789510,28407,325120648,8022,11
11113,CIT,chr12,R,119685789,119877318,22981039,191529,325312177,8023,49
11137,PWP1,chr12,F,107685812,107712480,23007707,26668,325338845,8024,14
11153,FICD,chr12,F,108515210,108521210,23013707,6000,325344845,8025,3
11163,NUDT4,chr12,F,93377922,93403248,23039033,25326,325370171,8026,7
11171,STRAP,chr12,F,15882353,15903478,23060158,21125,325391296,8027,9
11176,BAZ2A,chr12,R,56595595,56636816,23101379,41221,325432517,8028,34
11197,WIF1,chr12,R,65050623,65121566,23172322,70943,325503460,8029,9
11211,FZD10,chr12,F,130162458,130165740,23175604,3282,325506742,8030,0
11213,IRAK3,chr12,F,66189197,66254622,23241029,65425,325572167,8031,11
11226,GALNT6,chr12,R,51351869,51391955,23281115,40086,325612253,8032,14
11228,RASSF8,chr12,F,25959030,26079892,23401977,120862,325733115,8033,8
11247,NXPH4,chr12,F,57216794,57226449,23411632,9655,325742770,8034,1
11260,XPOT,chr12,F,64404349,64451125,23458408,46776,325789546,8035,24
11272,PRR4,chr12,R,10845848,10849476,23462036,3628,325793174,8036,3
11318,GPR182,chr12,F,56994354,57000007,23467689,5653,325798827,8037,4
11331,PHB2,chr12,R,6965351,6970823,23473161,5472,325804299,8038,9
22818,COPZ1,chr12,F,54325089,54351851,23499923,26762,325831061,8039,8
22822,PHLDA1,chr12,R,76025446,76031776,23506253,6330,325837391,8040,1
22864,R3HDM2,chr12,R,57253763,57431000,23683490,177237,326014628,8041,26
22877,MLXIP,chr12,F,122078727,122147347,23752110,68620,326083248,8042,18
22895,RPH3A,chr12,F,112791537,112898881,23859454,107344,326190592,8043,22
22914,KLRK1,chr12,R,10372352,10390054,23877156,17702,326208294,8044,7
22953,P2RX2,chr12,F,132618779,132622462,23880839,3683,326211977,8045,8
23011,RAB21,chr12,F,71754849,71787370,23913360,32521,326244498,8046,6
23012,STK38L,chr12,F,27244144,27325959,23995175,81815,326326313,8047,15
23014,FBXO21,chr12,R,117143779,117190495,24041891,46716,326373029,8048,11
23017,FAIM2,chr12,R,49866895,49903977,24078973,37082,326410111,8049,12
23041,MON2,chr12,F,62466816,62597583,24209740,130767,326540878,8050,38
23067,SETD1B,chr12,F,121803529,121832656,24238867,29127,326570005,8051,18
23074,UHRF1BP1L,chr12,R,100036793,100142864,24344938,106071,326676076,8052,23
23085,ERC1,chr12,F,991207,1495933,24849664,504726,327180802,8053,24
23109,DDN,chr12,R,48995148,49001091,24855607,5943,327186745,8054,2
23141,ANKLE2,chr12,R,132725666,132761888,24891829,36222,327222967,8055,16
23306,TMEM194A,chr12,R,57055642,57088857,24925044,33215,327256182,8056,10
23316,CUX2,chr12,F,111034023,111350554,25241575,316531,327572713,8057,31
23325,KIAA1033,chr12,F,105107713,105169135,25302997,61422,327634135,8058,36
23329,TBC1D30,chr12,F,64824571,64881022,25359448,56451,327690586,8059,12
23344,ESYT1,chr12,F,56128201,56144676,25375923,16475,327707061,8060,30
23371,TNS2,chr12,F,53046979,53064379,25393323,17400,327724461,8061,30
23389,MED13L,chr12,R,115955770,116277203,25714756,321433,328045894,8062,31
23390,ZDHHC17,chr12,F,76764073,76853701,25804384,89628,328135522,8063,19
23409,SIRT4,chr12,F,120292198,120313242,25825428,21044,328156566,8064,5
23416,KCNH3,chr12,F,49539040,49558308,25844696,19268,328175834,8065,15
23426,GRIP1,chr12,R,66347397,67069267,26566566,721870,328897704,8066,27
23457,ABCB9,chr12,R,122918707,122975125,26622984,56418,328954122,8067,18
23468,CBX5,chr12,R,54230945,54280131,26672170,49186,329003308,8068,5
23479,ISCU,chr12,F,108561462,108569384,26680092,7922,329011230,8069,7
23504,RIMBP2,chr12,R,130396132,130716351,27000311,320219,329331449,8070,24
23519,ANP32D,chr12,F,48472664,48473060,27000707,396,329331845,8071,0
23545,ATP6V0A2,chr12,F,123712317,123761755,27050145,49438,329381283,8072,20
23583,SMUG1,chr12,R,54172030,54188994,27067109,16964,329398247,8073,7
23592,LEMD3,chr12,F,65169570,65248361,27145900,78791,329477038,8074,12
23603,CORO1C,chr12,R,108645108,108731550,27232342,86442,329563480,8075,15
23710,GABARAPL1,chr12,F,10212840,10223128,27242630,10288,329573768,8076,3
25766,PRPF40B,chr12,F,49623413,49644669,27263886,21256,329595024,8077,27
25834,MGAT4C,chr12,R,85976234,86838904,28126556,862670,330457694,8078,14
25840,METTL7A,chr12,F,50923810,50932517,28135263,8707,330466401,8079,2
25875,LETMD1,chr12,F,51048229,51067369,28154403,19140,330485541,8080,9
25895,METTL21B,chr12,F,57772599,57782541,28164345,9942,330495483,8081,3
25900,IFFO1,chr12,R,6539527,6556083,28180901,16556,330512039,8082,11
25946,ZNF385A,chr12,R,54369128,54391305,28203078,22177,330534216,8083,9
25977,NECAP1,chr12,F,8082210,8097777,28218645,15567,330549783,8084,7
26127,FGFR1OP2,chr12,F,26938371,26966648,28246922,28277,330578060,8085,6
26253,CLEC4E,chr12,R,8533304,8540962,28254580,7658,330585718,8086,5
26259,FBXW8,chr12,F,116910950,117032498,28376128,121548,330707266,8087,13
26290,GALNT8,chr12,F,4720585,4772726,28428269,52141,330759407,8088,10
26353,HSPB8,chr12,F,119178789,119194746,28444226,15957,330775364,8089,2
26628,OR7E47P,chr12,F,52079695,52108319,28472850,28624,330803988,8090,6
26789,SNORD59A,chr12,R,56645026,56645101,28472925,75,330804063,8091,0
26834,RNU4-2,chr12,R,120291762,120291903,28473066,141,330804204,8092,0
26835,RNU4-1,chr12,R,120293093,120293237,28473210,144,330804348,8093,0
27165,GLS2,chr12,R,56470943,56488414,28490681,17471,330821819,8094,18
27198,HCAR1,chr12,R,122727605,122730582,28493658,2977,330824796,8095,0
27239,GPR162,chr12,F,6821796,6827418,28499280,5622,330830418,8096,4
27289,RND1,chr12,R,48857132,48865870,28508018,8738,330839156,8097,4
27340,UTP20,chr12,F,101280126,101386619,28614511,106493,330945649,8098,61
27345,KCNMB4,chr12,F,70366222,70434292,28682581,68070,331013719,8099,4
28234,SLCO1B3,chr12,F,20810703,20916911,28788789,106208,331119927,8100,15
28977,MRPL42,chr12,F,93467489,93503772,28825072,36283,331156210,8101,6
28981,IFT81,chr12,F,110124334,110218795,28919533,94461,331250671,8102,20
29080,CCDC59,chr12,R,82352303,82358805,28926035,6502,331257173,8103,4
29095,ORMDL2,chr12,F,55818021,55821175,28929189,3154,331260327,8104,3
29110,TBK1,chr12,F,64452059,64502119,28979249,50060,331310387,8105,23
29121,CLEC2D,chr12,F,9669707,9699555,29009097,29848,331340235,8106,5
29127,RACGAP1,chr12,R,49989161,50033136,29053072,43975,331384210,8107,21
29843,SENP1,chr12,R,48042897,48106308,29116483,63411,331447621,8108,19
29902,FAM216A,chr12,F,110468426,110490387,29138444,21961,331469582,8109,7
29915,HCFC2,chr12,F,104064457,104106525,29180512,42068,331511650,8110,16
29951,PDZRN4,chr12,F,41187849,41574745,29567408,386896,331898546,8111,10
29953,TRHDE,chr12,F,72272579,72665644,29960473,393065,332291611,8112,21
50511,SYCP3,chr12,R,101728647,101739513,29971339,10866,332302477,8113,7
50515,CHST11,chr12,F,104456913,104762014,30276440,305101,332607578,8114,2
50614,GALNT9,chr12,R,132196371,132206028,30286097,9657,332617235,8115,6
50614,GALNT9,chr12,R,132238676,132329319,30376740,90643,332707878,8116,7
50616,IL22,chr12,R,68248244,68253501,30381997,5257,332713135,8117,4
50813,COPS7A,chr12,F,6723983,6731875,30389889,7892,332721027,8118,7
50835,TAS2R9,chr12,R,10809093,10810168,30390964,1075,332722102,8119,0
50836,TAS2R8,chr12,R,10806050,10806980,30391894,930,332723032,8120,0
50837,TAS2R7,chr12,R,10801531,10802627,30392990,1096,332724128,8121,0
50838,TAS2R13,chr12,R,10907925,10909562,30394627,1637,332725765,8122,0
50839,TAS2R10,chr12,R,10815850,10828965,30407742,13115,332738880,8123,1
50840,TAS2R14,chr12,R,10938253,10939207,30408696,954,332739834,8124,0
50846,DHH,chr12,R,49089420,49094819,30414095,5399,332745233,8125,2
50856,CLEC4A,chr12,F,8123631,8138607,30429071,14976,332760209,8126,6
50865,HEBP1,chr12,R,12974863,13000309,30454517,25446,332785655,8127,3
51019,CCDC53,chr12,R,102012839,102062124,30503802,49285,332834940,8128,7
51026,GOLT1B,chr12,F,21501764,21518403,30520441,16639,332851579,8129,4
51054,PLEKHA8P1,chr12,R,45173033,45216006,30563414,42973,332894552,8130,2
51067,YARS2,chr12,R,32725090,32755961,30594285,30871,332925423,8131,8
51071,DERA,chr12,F,15911171,16037381,30720495,126210,333051633,8132,8
51134,CEP83,chr12,R,94265651,94459988,30914832,194337,333245970,8133,27
51135,IRAK4,chr12,F,43758943,43789543,30945432,30600,333276570,8134,16
51147,ING4,chr12,R,6650537,6663149,30958044,12612,333289182,8135,8
51184,GPN3,chr12,R,110452485,110468721,30974280,16236,333305418,8136,8
51202,DDX47,chr12,F,12813345,12829981,30990916,16636,333322054,8137,11
51228,GLTP,chr12,R,109850942,109880488,31020462,29546,333351600,8138,5
51258,MRPL51,chr12,R,6492149,6493305,31021618,1156,333352756,8139,2
51266,CLEC1B,chr12,R,9985696,10001865,31037787,16169,333368925,8140,8
51267,CLEC1A,chr12,R,10069503,10099065,31067349,29562,333398487,8141,7
51275,MAPKAPK5-AS1,chr12,R,111839768,111842902,31070483,3134,333401621,8142,1
51279,C1RL,chr12,R,7093667,7109278,31086094,15611,333417232,8143,8
51290,ERGIC2,chr12,R,29340645,29381210,31126659,40565,333457797,8144,13
51303,FKBP11,chr12,R,48921958,48925547,31130248,3589,333461386,8145,7
51329,ARL6IP4,chr12,F,122980059,122982913,31133102,2854,333464240,8146,4
51347,TAOK3,chr12,R,118149800,118372945,31356247,223145,333687385,8147,25
51348,KLRF1,chr12,F,9827391,9845005,31373861,17614,333704999,8148,5
51350,KRT76,chr12,R,52768154,52777345,31383052,9191,333714190,8149,8
51367,POP5,chr12,R,120579044,120581452,31385460,2408,333716598,8150,4
51380,CSAD,chr12,R,53157662,53180909,31408707,23247,333739845,8151,19
51411,BIN2,chr12,R,51281037,51324680,31452350,43643,333783488,8152,13
51433,ANAPC5,chr12,R,121308244,121354209,31498315,45965,333829453,8153,17
51434,ANAPC7,chr12,R,110372899,110403730,31529146,30831,333860284,8154,12
51474,LIMA1,chr12,R,50175779,50283570,31636937,107791,333968075,8155,11
51499,TRIAP1,chr12,R,120443960,120446412,31639389,2452,333970527,8156,1
51535,PPHLN1,chr12,F,42326136,42450965,31764218,124829,334095356,8157,16
51559,NT5DC3,chr12,R,103763311,103841245,31842152,77934,334173290,8158,19
51561,IL23A,chr12,F,56334157,56340410,31848405,6253,334179543,8159,5
51564,HDAC7,chr12,R,47782721,47820612,31886296,37891,334217434,8160,31
51643,TMBIM4,chr12,R,66136935,66170072,31919433,33137,334250571,8161,7
51699,VPS29,chr12,R,110491522,110502142,31930053,10620,334261191,8162,7
51729,WBP11,chr12,R,14786477,14803467,31947043,16990,334278181,8163,11
51768,TM7SF3,chr12,R,26971569,27014427,31989901,42858,334321039,8164,12
53373,TPCN1,chr12,F,113221079,113298589,32067411,77510,334398549,8165,33
53831,GPR84,chr12,R,54350783,54365253,32081881,14470,334413019,8166,2
53919,SLCO1C1,chr12,F,20695354,20753386,32139913,58032,334471051,8167,18
54407,SLC38A2,chr12,R,46358187,46372862,32154588,14675,334485726,8168,15
54434,SSH1,chr12,R,108782689,108857583,32229482,74894,334560620,8169,18
54458,PRR13,chr12,F,53441648,53446643,32234477,4995,334565615,8170,3
54477,PLEKHA5,chr12,F,19129691,19376400,32481186,246709,334812324,8171,34
54509,RHOF,chr12,R,121777753,121793688,32497121,15935,334828259,8172,4
54621,VSIG10,chr12,R,118063592,118104005,32537534,40413,334868672,8173,8
54682,MANSC1,chr12,R,12329283,12350235,32558486,20952,334889624,8174,3
54934,KANSL2,chr12,R,48653210,48682252,32587528,29042,334918666,8175,9
54997,TESC,chr12,R,117038922,117099446,32648052,60524,334979190,8176,8
55010,PARPBP,chr12,F,102120170,102197520,32725402,77350,335056540,8177,13
55080,TAPBPL,chr12,F,6451654,6462322,32736070,10668,335067208,8178,9
55089,SLC38A4,chr12,R,46764760,46832422,32803732,67662,335134870,8179,17
55110,MAGOHB,chr12,R,10603764,10613609,32813577,9845,335144715,8180,5
55117,SLC6A15,chr12,R,84859487,84913615,32867705,54128,335198843,8181,14
55138,FAM90A1,chr12,R,8221259,8227703,32874149,6444,335205287,8182,6
55188,RIC8B,chr12,F,106774284,106889316,32989181,115032,335320319,8183,15
55196,KIAA1551,chr12,F,31959418,31993107,33022870,33689,335354008,8184,6
55198,APPL2,chr12,R,105173296,105236230,33085804,62934,335416942,8185,23
55200,PLEKHG6,chr12,F,6310435,6328506,33103875,18071,335435013,8186,19
55206,SBNO1,chr12,R,123289108,123365525,33180292,76417,335511430,8187,33
55259,CASC1,chr12,R,25107056,25195162,33268398,88106,335599536,8188,17
55266,TMEM19,chr12,F,71686097,71704060,33286361,17963,335617499,8189,5
55297,CCDC91,chr12,F,28188258,28550166,33648269,361908,335979407,8190,20
55332,DRAM1,chr12,F,101877326,101923623,33694566,46297,336025704,8191,7
55359,STYK1,chr12,R,10618922,10674318,33749962,55396,336081100,8192,13
55500,ETNK1,chr12,F,22625141,22690674,33815495,65533,336146633,8193,13
55507,GPRC5D,chr12,R,12940553,12979517,33854459,38964,336185597,8194,7
55508,SLC35E3,chr12,F,68746147,68766073,33874385,19926,336205523,8195,5
55530,SVOP,chr12,R,108908128,109021240,33987497,113112,336318635,8196,15
55576,STAB2,chr12,F,103587254,103766729,34166972,179475,336498110,8197,72
55591,VEZT,chr12,F,95217745,95302790,34252017,85045,336583155,8198,18
55592,GOLGA2P5,chr12,R,100156390,100173343,34268970,16953,336600108,8199,16
55596,ZCCHC8,chr12,R,122471598,122501073,34298445,29475,336629583,8200,16
55605,KIF21A,chr12,R,39293227,39443390,34448608,150163,336779746,8201,37
55652,SLC48A1,chr12,F,47753841,47782753,34477520,28912,336808658,8202,6
55681,SCYL2,chr12,F,100267136,100341722,34552106,74586,336883244,8203,21
55703,POLR3B,chr12,F,106357657,106510198,34704647,152541,337035785,8204,28
55711,FAR2,chr12,F,29149002,29335616,34891261,186614,337222399,8205,13
55716,LMBR1L,chr12,R,49097138,49110900,34905023,13762,337236161,8206,16
55726,ASUN,chr12,R,26905056,26938326,34938293,33270,337269431,8207,17
55729,ATF7IP,chr12,F,14365631,14502935,35075597,137304,337406735,8208,20
55743,CHFR,chr12,R,132840351,132887618,35122864,47267,337454002,8209,18
55766,H2AFJ,chr12,F,14774335,14778002,35126531,3667,337457669,8210,0
55785,FGD6,chr12,R,95076748,95217464,35267247,140716,337598385,8211,20
55801,IL26,chr12,R,68163986,68225791,35329052,61805,337660190,8212,5
55810,FOXJ2,chr12,F,8032707,8055522,35351867,22815,337683005,8213,12
55832,CAND1,chr12,F,67269280,67314692,35397279,45412,337728417,8214,14
55846,ITFG2,chr12,F,2812620,2836956,35421615,24336,337752753,8215,14
55884,WSB2,chr12,R,118032686,118062174,35451103,29488,337782241,8216,9
55885,LMO3,chr12,R,16548371,16610130,35512862,61759,337844000,8217,12
55907,CMAS,chr12,F,22046173,22065674,35532363,19501,337863501,8218,7
55967,NDUFA12,chr12,R,94971327,95003713,35564749,32386,337895887,8219,3
56341,PRMT8,chr12,F,3381348,3593973,35777374,212625,338108512,8220,11
56616,DIABLO,chr12,R,122207661,122227534,35797247,19873,338128385,8221,7
56890,MDM1,chr12,R,68294565,68332381,35835063,37816,338166201,8222,14
56899,ANKS1B,chr12,R,98729903,99984727,37089887,1254824,339421025,8223,33
56901,NDUFA4L2,chr12,R,57234902,57240762,37095747,5860,339426885,8224,4
56938,ARNTL2,chr12,F,27332853,27425813,37188707,92960,339519845,8225,20
56994,CHPT1,chr12,F,101697638,101729074,37220143,31436,339551281,8226,9
57097,PARP11,chr12,R,3808860,3873448,37284731,64588,339615869,8227,13
57101,ANO2,chr12,R,5560240,5948791,37673282,388551,340004420,8228,40
57102,C12orf4,chr12,R,4487729,4538508,37724061,50779,340055199,8229,14
57103,C12orf5,chr12,F,4321192,4360028,37762897,38836,340094035,8230,5
57121,LPAR5,chr12,R,6618834,6636131,37780194,17297,340111332,8231,2
57122,NUP107,chr12,F,68686950,68742693,37835937,55743,340167075,8232,27
57228,SMAGP,chr12,R,51245348,51270418,37861007,25070,340192145,8233,4
57379,AICDA,chr12,R,8602165,8612888,37871730,10723,340202868,8234,4
57458,TMCC3,chr12,R,94567123,94650562,37955169,83439,340286307,8235,4
57460,PPM1H,chr12,R,62643981,62934885,38246073,290904,340577211,8236,11
57494,RIMKLB,chr12,F,8681610,8783098,38347561,101488,340678699,8237,10
57522,SRGAP1,chr12,F,63844511,64147863,38650913,303352,340982051,8238,25
57542,KLHL42,chr12,F,27779957,27803040,38673996,23083,341005134,8239,3
57605,PITPNM2,chr12,R,122983479,123150810,38841327,167331,341172465,8240,28
57609,DIP2B,chr12,F,50504984,50748667,39085010,243683,341416148,8241,39
57613,KIAA1467,chr12,F,13044380,13083449,39124079,39069,341455217,8242,12
57634,EP400,chr12,F,131949919,132080466,39254626,130547,341585764,8243,52
57647,DHX37,chr12,R,124946823,124989131,39296934,42308,341628072,8244,27
57658,CALCOCO1,chr12,R,53711117,53727523,39313340,16406,341644478,8245,17
57666,FBRSL1,chr12,F,132490427,132585188,39408101,94761,341739239,8246,21
57696,DDX55,chr12,F,123602091,123620938,39426948,18847,341758086,8247,11
57701,NCKAP5L,chr12,R,49791138,49828750,39464560,37612,341795698,8248,13
58158,NEUROD4,chr12,F,55019944,55030017,39474633,10073,341805771,8249,1
58516,FAM60A,chr12,R,31280421,31326225,39520437,45804,341851575,8250,9
59277,NTN4,chr12,R,95657806,95790787,39653418,132981,341984556,8251,10
59341,TRPV4,chr12,R,109783086,109833407,39703739,50321,342034877,8252,17
60314,C12orf10,chr12,F,53299685,53307181,39711235,7496,342042373,8253,6
60488,MRPS35,chr12,F,27710772,27756304,39756767,45532,342087905,8254,7
60673,ATG101,chr12,F,52069973,52077495,39764289,7522,342095427,8255,3
64211,LHX5,chr12,R,113462888,113472072,39773473,9184,342104611,8256,4
64333,ARHGAP9,chr12,R,57472254,57483959,39785178,11705,342116316,8257,21
64375,IKZF4,chr12,F,56007646,56038435,39815967,30789,342147105,8258,12
64426,SUDS3,chr12,F,118373188,118418035,39860814,44847,342191952,8259,14
64431,ACTR6,chr12,F,100200086,100224424,39885152,24338,342216290,8260,10
64581,CLEC7A,chr12,R,10116776,10130273,39898649,13497,342229787,8261,7
64786,TBC1D15,chr12,F,71839706,71926849,39985792,87143,342316930,8262,25
64897,C12orf43,chr12,R,121002421,121016502,39999873,14081,342331011,8263,6
65012,SLC26A10,chr12,F,57619909,57626151,40006115,6242,342337253,8264,13
65082,VPS33A,chr12,R,122231546,122266521,40041090,34975,342372228,8265,12
65117,RSRC2,chr12,R,122504642,122527013,40063461,22371,342394599,8266,14
65125,WNK1,chr12,F,752592,911452,40222321,158860,342553459,8267,30
65244,SPATS2,chr12,F,49366904,49527426,40382843,160522,342713981,8268,16
65981,CAPRIN2,chr12,R,30709551,30823235,40496527,113684,342827665,8269,20
65985,AACS,chr12,F,125065378,125143327,40574476,77949,342905614,8270,18
79022,TMEM106C,chr12,F,47963546,47968878,40579808,5332,342910946,8271,7
79023,NUP37,chr12,R,102074188,102120139,40625759,45951,342956897,8272,10
79035,NABP2,chr12,F,56222092,56229854,40633521,7762,342964659,8273,8
79039,DDX54,chr12,R,113157172,113185479,40661828,28307,342992966,8274,19
79050,NOC4L,chr12,F,132144421,132152473,40669880,8052,343001018,8275,14
79158,GNPTAB,chr12,R,101745496,101830867,40755251,85371,343086389,8276,22
79365,BHLHE41,chr12,R,26120025,26125070,40760296,5045,343091434,8277,4
79369,B3GNT4,chr12,F,122203680,122208135,40764751,4455,343095889,8278,2
79370,BCL2L14,chr12,F,12049879,12099695,40814567,49816,343145705,8279,10
79600,TCTN1,chr12,F,110614026,110649130,40849671,35104,343180809,8280,18
79602,ADIPOR2,chr12,F,1690980,1788679,40947370,97699,343278508,8281,8
79611,ACSS3,chr12,F,81078017,81257795,41127148,179778,343458286,8282,18
79657,RPAP3,chr12,R,47661931,47706061,41171278,44130,343502416,8283,16
79676,OGFOD2,chr12,F,122974702,122980041,41176617,5339,343507755,8284,9
79720,VPS37B,chr12,R,122865327,122896220,41207510,30893,343538648,8285,9
79738,BBS10,chr12,R,76344485,76348442,41211467,3957,343542605,8286,1
79785,RERGL,chr12,R,18080868,18090193,41220792,9325,343551930,8287,5
79794,C12orf49,chr12,R,116713319,116738070,41245543,24751,343576681,8288,4
79837,PIP4K2C,chr12,F,57591158,57603428,41257813,12270,343588951,8289,11
79857,FLJ13224,chr12,F,31324315,31325945,41259443,1630,343590581,8290,0
79867,TCTN2,chr12,F,123671112,123708405,41296736,37293,343627874,8291,17
79887,PLBD1,chr12,R,14503662,14567857,41360931,64195,343692069,8292,10
79912,PYROXD1,chr12,F,21437603,21471250,41394578,33647,343725716,8293,12
79923,NANOG,chr12,F,7788425,7796061,41402214,7636,343733352,8294,4
79962,DNAJC22,chr12,F,49346916,49353684,41408982,6768,343740120,8295,5
80018,NAA25,chr12,R,112026688,112109022,41491316,82334,343822454,8296,25
80024,SLC8B1,chr12,R,113298765,113335142,41527693,36377,343858831,8297,14
80070,ADAMTS20,chr12,R,43352842,43551940,41726791,199098,344057929,8298,39
80184,CEP290,chr12,R,88049012,88142216,41819995,93204,344151133,8299,59
80196,RNF34,chr12,F,121400082,121424352,41844265,24270,344175403,8300,6
80212,CCDC92,chr12,R,123936408,123972985,41880842,36577,344211980,8301,8
80298,MTERF2,chr12,R,106977290,106987166,41890718,9876,344221856,8302,3
80324,PUS1,chr12,F,131929199,131943861,41905380,14662,344236518,8303,8
80724,ACAD10,chr12,F,111686052,111757107,41976435,71055,344307573,8304,21
80763,SPX,chr12,F,21526321,21531276,41981390,4955,344312528,8305,5
80824,DUSP16,chr12,R,12473281,12562839,42070948,89558,344402086,8306,8
81029,WNT5B,chr12,F,1529890,1647213,42188271,117323,344519409,8307,6
81539,SLC38A1,chr12,R,46183054,46269425,42274642,86371,344605780,8308,21
81566,CSRNP2,chr12,R,51061204,51083671,42297109,22467,344628247,8309,7
81575,APOLD1,chr12,F,12725916,12791466,42362659,65550,344693797,8310,2
83445,GSG1,chr12,R,13083536,13103720,42382843,20184,344713981,8311,7
83448,PUS7L,chr12,R,43728024,43758817,42413636,30793,344744774,8312,9
83461,CDCA3,chr12,R,6844797,6852066,42420905,7269,344752043,8313,7
83468,GLT8D2,chr12,R,103988983,104064183,42496105,75200,344827243,8314,13
83591,THAP2,chr12,F,71663896,71680648,42512857,16752,344843995,8315,2
83695,RHNO1,chr12,F,2876257,2889525,42526125,13268,344857263,8316,4
83714,NRIP2,chr12,R,2824881,2835536,42536780,10655,344867918,8317,6
83729,INHBE,chr12,F,57455312,57458008,42539476,2696,344870614,8318,1
83758,RBP5,chr12,R,7119073,7130236,42550639,11163,344881777,8319,6
83857,TMTC1,chr12,R,29500812,29784759,42834586,283947,345165724,8320,22
83892,KCTD10,chr12,R,109448654,109477350,42863282,28696,345194420,8321,7
83956,RACGAP1P,chr12,R,45062617,45065411,42866076,2794,345197214,8322,0
84070,FAM186B,chr12,R,49582874,49605650,42888852,22776,345219990,8323,8
84101,USP44,chr12,R,95516559,95551529,42923822,34970,345254960,8324,13
84102,SLC41A2,chr12,R,104802552,104958740,43080010,156188,345411148,8325,16
84125,LRRIQ1,chr12,F,85036320,85272867,43316557,236547,345647695,8326,35
84190,METTL25,chr12,F,82358405,82479239,43437391,120834,345768529,8327,16
84216,TMEM117,chr12,F,43795763,44437808,44079436,642045,346410574,8328,12
84260,TCHP,chr12,F,109880679,109918069,44116826,37390,346447964,8329,14
84274,COQ5,chr12,R,120503278,120529161,44142709,25883,346473847,8330,7
84298,LLPH,chr12,R,66123068,66130753,44150394,7685,346481532,8331,2
84305,WIBG,chr12,R,55901412,55927913,44176895,26501,346508033,8332,3
84318,CCDC77,chr12,F,389349,442642,44230188,53293,346561326,8333,13
84324,SARNP,chr12,R,55752462,55817756,44295482,65294,346626620,8334,11
84329,HVCN1,chr12,R,110648685,110704950,44351747,56265,346682885,8335,14
84519,ACRBP,chr12,R,6638075,6647414,44361086,9339,346692224,8336,9
84530,SRRM4,chr12,F,118981485,119163053,44542654,181568,346873792,8337,12
84660,CCDC62,chr12,F,122774508,122827385,44595531,52877,346926669,8338,13
84678,KDM2B,chr12,R,121402500,121581113,44774144,178613,347105282,8339,32
84698,CAPS2,chr12,R,75257035,75390928,44908037,133893,347239175,8340,23
84727,SPSB2,chr12,R,6870934,6873471,44910574,2537,347241712,8341,2
84747,UNC119B,chr12,F,120710434,120723640,44923780,13206,347254918,8342,4
84749,USP30,chr12,F,109023088,109088026,44988718,64938,347319856,8343,18
84766,CRACR2A,chr12,R,3612929,3753200,45128989,140271,347460127,8344,22
84790,TUBA1C,chr12,F,49227925,49273338,45174402,45413,347505540,8345,6
84872,ZC3H10,chr12,F,56118219,56122497,45178680,4278,347509818,8346,3
84876,ORAI1,chr12,F,121626549,121642040,45194171,15491,347525309,8347,1
84900,RNFT2,chr12,F,116738290,116853631,45309512,115341,347640650,8348,14
84915,FAM222A,chr12,F,109714381,109770509,45365640,56128,347696778,8349,3
84920,ALG10,chr12,F,34022280,34028302,45371662,6022,347702800,8350,2
84926,SPRYD3,chr12,R,53064315,53079420,45386767,15105,347717905,8351,10
84934,RITA1,chr12,F,113185525,113192368,45393610,6843,347724748,8352,3
84975,MFSD5,chr12,F,53251250,53254406,45396766,3156,347727904,8353,3
84983,FAM222A-AS1,chr12,R,109734208,109773487,45436045,39279,347767183,8354,3
84987,COX14,chr12,F,50109634,50120457,45446868,10823,347778006,8355,3
85004,RERG,chr12,R,15107781,15221477,45560564,113696,347891702,8356,5
85406,DNAJC14,chr12,R,55820959,55829636,45569241,8677,347900379,8357,6
85437,ZCRB1,chr12,R,42312085,42326130,45583286,14045,347914424,8358,7
85478,CCDC65,chr12,F,48904109,48921576,45600753,17467,347931891,8359,7
88455,ANKRD13A,chr12,F,109999168,110039432,45641017,40264,347972155,8360,16
89795,NAV3,chr12,F,77571861,78213012,46282168,641151,348613306,8361,41
89869,PLCZ1,chr12,R,18641989,18738059,46378238,96070,348709376,8362,20
89894,TMEM116,chr12,R,111894929,112013219,46496528,118290,348827666,8363,16
89910,UBE3B,chr12,F,109477409,109543628,46562747,66219,348893885,8364,31
90070,LACRT,chr12,R,54630838,54634879,46566788,4041,348897926,8365,4
90488,TMEM263,chr12,F,106953414,106974035,46587409,20621,348918547,8366,4
91010,FMNL3,chr12,R,49637940,49707414,46656883,69474,348988021,8367,31
91012,CERS5,chr12,R,50129305,50167533,46695111,38228,349026249,8368,11
91298,C12orf29,chr12,F,88035490,88050160,46709781,14670,349040919,8369,6
91419,XRCC6BP1,chr12,F,57941540,57957269,46725510,15729,349056648,8370,7
91523,PCED1B,chr12,F,47079602,47236663,46882571,157061,349213709,8371,9
91574,C12orf65,chr12,F,123233296,123257959,46907234,24663,349238372,8372,5
92293,TMEM132C,chr12,F,128267402,128707915,47347747,440513,349678885,8373,9
92558,CCDC64,chr12,F,119989798,120094495,47452444,104697,349783582,8374,14
92797,HELB,chr12,F,66302554,66343643,47493533,41089,349824671,8375,13
92979,MARCH9,chr12,F,57753621,57760410,47500322,6789,349831460,8376,4
93058,COQ10A,chr12,F,56266857,56270966,47504431,4109,349835569,8377,5
93164,HTR7P1,chr12,F,13000441,13004830,47508820,4389,349839958,8378,0
93589,CACNA2D4,chr12,R,1791956,1920865,47637729,128909,349968867,8379,37
93661,CAPZA3,chr12,F,18738110,18739188,47638807,1078,349969945,8380,0
93978,CLEC6A,chr12,F,8455994,8478330,47661143,22336,349992281,8381,5
112802,KRT71,chr12,R,52543908,52553147,47670382,9239,350001520,8382,8
113246,C12orf57,chr12,F,6943437,6946003,47672948,2566,350004086,8383,3
113251,LARP4,chr12,F,50400808,50480005,47752145,79197,350083283,8384,21
113675,SDSL,chr12,F,113422267,113438277,47768155,16010,350099293,8385,9
114134,SLC2A13,chr12,R,39755020,40106074,48119209,351054,350450347,8386,12
114785,MBD6,chr12,F,57520709,57530148,48128648,9439,350459786,8387,15
114795,TMEM132B,chr12,F,125186773,125662377,48604252,475604,350935390,8388,12
114882,OSBPL8,chr12,R,76351796,76559809,48812265,208013,351143403,8389,29
115557,ARHGEF25,chr12,F,57610179,57617245,48819331,7066,351150469,8390,17
115749,C12orf56,chr12,R,64264761,64390584,48945154,125823,351276292,8391,13
115811,IQCD,chr12,R,113195440,113221094,48970808,25654,351301946,8392,6
116437,LINC01257,chr12,F,131165010,131212931,49018729,47921,351349867,8393,4
116986,AGAP2,chr12,R,57723760,57742201,49037170,18441,351368308,8394,19
117159,DCD,chr12,R,54644590,54648493,49041073,3903,351372211,8395,5
117177,RAB3IP,chr12,F,69738399,69823204,49125878,84805,351457016,8396,15
118426,LOH12CR1,chr12,F,12357078,12469410,49238210,112332,351569348,8397,4
118430,MUCL1,chr12,F,54830356,54858393,49266247,28037,351597385,8398,4
120863,DEPDC4,chr12,R,100203668,100267172,49329751,63504,351660889,8399,13
120892,LRRK2,chr12,F,40225010,40369285,49474026,144275,351805164,8400,53
120935,CCDC38,chr12,R,95867047,95943254,49550233,76207,351881371,8401,18
120939,TMEM52B,chr12,F,10170598,10191804,49571439,21206,351902577,8402,5
121006,FAM186A,chr12,R,50326851,50396635,49641223,69784,351972361,8403,8
121053,C12orf45,chr12,F,104986319,104994727,49649631,8408,351980769,8404,3
121129,OR2AP1,chr12,F,55574414,55575344,49650561,930,351981699,8405,0
121130,OR10P1,chr12,F,55636891,55637833,49651503,942,351982641,8406,0
121214,SDR9C7,chr12,R,56923153,56934405,49662755,11252,351993893,8407,3
121227,LRIG3,chr12,R,58872148,58920538,49711145,48390,352042283,8408,20
121256,TMEM132D,chr12,R,129071725,129903730,50543150,832005,352874288,8409,8
121260,SLC15A4,chr12,R,128793193,128823996,50573953,30803,352905091,8410,8
121268,RHEBL1,chr12,R,49064675,49070025,50579303,5350,352910441,8411,7
121273,C12orf54,chr12,F,48455580,48496514,50620237,40934,352951375,8412,11
121274,ZNF641,chr12,R,48335490,48351414,50636161,15924,352967299,8413,8
121275,OR10AD1,chr12,R,48201771,48205682,50640072,3911,352971210,8414,1
121278,TPH2,chr12,F,71938845,72035297,50736524,96452,353067662,8415,13
121340,SP7,chr12,R,53326574,53344793,50754743,18219,353085881,8416,4
121355,GTSF1,chr12,R,54455951,54473602,50772394,17651,353103532,8417,10
121364,OR10A7,chr12,F,55221024,55221975,50773345,951,353104483,8418,0
121391,KRT74,chr12,R,52565721,52574092,50781716,8371,353112854,8419,8
121441,NEDD1,chr12,F,96907222,96953696,50828190,46474,353159328,8420,16
121456,SLC9A7P1,chr12,R,98453839,98457145,50831496,3306,353162634,8421,0
121457,IKBIP,chr12,R,98613403,98645051,50863144,31648,353194282,8422,3
121504,HIST4H4,chr12,R,14770719,14771131,50863556,412,353194694,8423,0
121506,ERP27,chr12,R,14914026,14938549,50888079,24523,353219217,8424,7
121512,FGD4,chr12,F,32399540,32646050,51134589,246510,353465727,8425,24
121536,AEBP2,chr12,F,19439491,19522239,51217337,82748,353548475,8426,9
121549,ASCL4,chr12,F,107774384,107776644,51219597,2260,353550735,8427,0
121551,BTBD11,chr12,F,107317167,107659642,51562072,342475,353893210,8428,20
121599,SPIC,chr12,F,101475322,101487566,51574316,12244,353905454,8429,5
121601,ANO4,chr12,F,100717462,101128641,51985495,411179,354316633,8430,32
121642,ALKBH2,chr12,R,109088187,109093631,51990939,5444,354322077,8431,3
121643,FOXN4,chr12,R,109277977,109310490,52023452,32513,354354590,8432,13
121665,SPPL3,chr12,R,120762509,120904352,52165295,141843,354496433,8433,12
140461,ASB8,chr12,R,48147787,48157594,52175102,9807,354506240,8434,4
140465,MYL6B,chr12,F,56152419,56157987,52180670,5568,354511808,8435,7
140707,BRI3BP,chr12,F,124993647,125051845,52238868,58198,354570006,8436,3
140807,KRT72,chr12,R,52585588,52602944,52256224,17356,354587362,8437,12
144165,PRICKLE1,chr12,R,42458337,42589770,52387657,131433,354718795,8438,10
144193,AMDHD1,chr12,F,95943292,95968592,52412957,25300,354744095,8439,8
144195,SLC2A14,chr12,R,7812511,7891196,52491642,78685,354822780,8440,18
144203,OVOS2,chr12,R,31111656,31232532,52612518,120876,354943656,8441,46
144233,BCDIN3D,chr12,R,49836042,49843129,52619605,7087,354950743,8442,1
144245,ALG10B,chr12,F,38316685,38329726,52632646,13041,354963784,8443,2
144321,GLIPR1L2,chr12,F,75391069,75432688,52674265,41619,355005403,8444,7
144347,FAM101A,chr12,F,124289163,124316024,52701126,26861,355032264,8445,2
144348,ZNF664,chr12,F,123973214,124015439,52743351,42225,355074489,8446,4
144360,LINC00477,chr12,R,24566963,24584168,52760556,17205,355091694,8447,3
144363,LYRM5,chr12,F,25195215,25205015,52770356,9800,355101494,8448,3
144402,CPNE8,chr12,R,38652199,38906135,53024292,253936,355355430,8449,23
144404,TMEM120B,chr12,F,121712751,121782924,53094465,70173,355425603,8450,12
144406,WDR66,chr12,F,121918556,122003927,53179836,85371,355510974,8451,22
144423,GLT1D1,chr12,F,128853439,128984968,53311365,131529,355642503,8452,12
144448,TSPAN19,chr12,R,85014310,85036278,53333333,21968,355664471,8453,10
144453,BEST3,chr12,R,69643507,69699416,53389242,55909,355720380,8454,15
144455,E2F7,chr12,R,77021245,77065580,53433577,44335,355764715,8455,13
144481,SOCS2-AS1,chr12,R,93565627,93571398,53439348,5771,355770486,8456,3
144486,CEP83-AS1,chr12,F,94460002,94462570,53441916,2568,355773054,8457,0
144501,KRT80,chr12,R,52168995,52192000,53464921,23005,355796059,8458,7
144535,CFAP54,chr12,F,96489545,96875555,53850931,386010,356182069,8459,75
144568,A2ML1,chr12,F,8822553,8886918,53915296,64365,356246434,8460,39
144571,A2M-AS1,chr12,F,9065176,9068055,53918175,2879,356249313,8461,2
144577,C12orf66,chr12,R,64186311,64237341,53969205,51030,356300343,8462,4
144608,C12orf60,chr12,F,14785216,14823858,54007847,38642,356338985,8463,6
144699,FBXL14,chr12,R,1565992,1594180,54036035,28188,356367173,8464,3
144715,RAD9B,chr12,F,110502199,110532086,54065922,29887,356397060,8465,11
144717,FAM109A,chr12,R,111360650,111369121,54074393,8471,356405531,8466,5
144742,LINC00934,chr12,R,119283824,119303380,54093949,19556,356425087,8467,3
160313,KRT19P2,chr12,F,94834453,94835028,54094524,575,356425662,8468,0
160335,TMTC2,chr12,F,82686951,83134868,54542441,447917,356873579,8469,12
160364,CLEC12A,chr12,F,9951315,9999354,54590480,48039,356921618,8470,11
160365,CLECL1,chr12,R,9715859,9733299,54607920,17440,356939058,8471,3
160418,TMTC3,chr12,F,88142295,88199887,54665512,57592,356996650,8472,14
160419,C12orf50,chr12,R,87980038,88035403,54720877,55365,357052015,8473,14
160428,ALDH1L2,chr12,R,105019783,105084583,54785677,64800,357116815,8474,26
160492,LMNTD1,chr12,R,25476081,25648594,54958190,172513,357289328,8475,24
160518,DENND5B,chr12,R,31382222,31591018,55166986,208796,357498124,8476,24
160622,GRASP,chr12,F,52006936,52015889,55175939,8953,357507077,8477,9
160728,SLC5A8,chr12,R,101156215,101210274,55229998,54059,357561136,8478,15
160760,PPTC7,chr12,R,110533244,110583259,55280013,50015,357611151,8479,6
160762,CCDC63,chr12,F,110844485,110907535,55343063,63050,357674201,8480,15
160777,CCDC60,chr12,F,119334711,119541047,55549399,206336,357880537,8481,16
170482,CLEC4C,chr12,R,7729414,7749473,55569458,20059,357900596,8482,6
171017,ZNF384,chr12,R,6666476,6689572,55592554,23096,357923692,8483,12
171220,DSTNP2,chr12,F,6884681,6885786,55593659,1105,357924797,8484,0
192111,PGAM5,chr12,F,132710806,132722737,55605590,11931,357936728,8485,6
196374,KRT78,chr12,R,52837803,52848994,55616781,11191,357947919,8486,9
196383,RILPL2,chr12,R,123410075,123436733,55643439,26658,357974577,8487,4
196385,DNAH10,chr12,F,123761132,123935720,55818027,174588,358149165,8488,78
196394,AMN1,chr12,R,31671136,31730392,55877283,59256,358208421,8489,10
196403,DTX3,chr12,F,57604326,57609804,55882761,5478,358213899,8490,7
196410,METTL7B,chr12,F,55681545,55684611,55885827,3066,358216965,8491,1
196415,C12orf77,chr12,R,24993423,24997439,55889843,4016,358220981,8492,3
196441,ZFC3H1,chr12,R,71609598,71663969,55944214,54371,358275352,8493,34
196446,MYRFL,chr12,F,69824568,69958724,56078370,134156,358409508,8494,30
196463,PLBD2,chr12,F,113358565,113389715,56109520,31150,358440658,8495,12
196472,FAM71C,chr12,F,99647749,99650114,56111885,2365,358443023,8496,1
196475,RMST,chr12,F,97465020,97533766,56180631,68746,358511769,8497,8
196477,CCER1,chr12,R,90952214,90955176,56183593,2962,358514731,8498,0
196500,PIANP,chr12,R,6690933,6700843,56193503,9910,358524641,8499,7
196513,DCP1B,chr12,R,1946047,2004511,56251967,58464,358583105,8500,11
196527,ANO6,chr12,F,45215986,45440404,56476385,224418,358807523,8501,23
196528,ARID2,chr12,F,45729688,45908037,56654734,178349,358985872,8502,23
204010,RPSAP52,chr12,R,65758019,65826974,56723689,68955,359054827,8503,1
246213,SLC17A8,chr12,F,100357078,100422059,56788670,64981,359119808,8504,11
246329,STAC3,chr12,R,57243452,57251193,56796411,7741,359127549,8505,11
253128,LINC00612,chr12,R,9055588,9065070,56805893,9482,359137031,8506,2
253724,GNN,chr12,R,103843748,103930211,56892356,86463,359223494,8507,15
253827,MSRB3,chr12,F,65278642,65466907,57080621,188265,359411759,8508,8
254013,METTL20,chr12,F,31647159,31669086,57102548,21927,359433686,8509,5
254050,LRRC43,chr12,F,122167718,122203471,57138301,35753,359469439,8510,13
254783,OR6C74,chr12,F,55239761,55248226,57146766,8465,359477904,8511,1
254786,OR6C3,chr12,F,55331700,55332636,57147702,936,359478840,8512,0
255394,TCP11L2,chr12,F,106302783,106347587,57192506,44804,359523644,8513,15
255411,LINC00935,chr12,F,48727434,48765786,57230858,38352,359561996,8514,4
255480,TBX5-AS1,chr12,F,114408194,114412832,57235496,4638,359566634,8515,2
256021,C12orf79,chr12,R,91984975,92142671,57393192,157696,359724330,8516,6
256710,GLIPR1L1,chr12,F,75334638,75370390,57428944,35752,359760082,8517,6
259289,TAS2R43,chr12,R,11091286,11092313,57429971,1027,359761109,8518,0
259290,TAS2R31,chr12,R,11030386,11031407,57430992,1021,359762130,8519,0
259292,TAS2R46,chr12,R,11061364,11062294,57431922,930,359763060,8520,0
259293,TAS2R30,chr12,R,11133284,11134244,57432882,960,359764020,8521,0
259294,TAS2R19,chr12,R,11021618,11022620,57433884,1002,359765022,8522,0
259295,TAS2R20,chr12,R,10995961,10997875,57435798,1914,359766936,8523,0
259296,TAS2R50,chr12,R,10985912,10986912,57436798,1000,359767936,8524,0
282809,POC1B,chr12,R,89419717,89526262,57543343,106545,359874481,8525,12
283310,OTOGL,chr12,F,80130501,80379090,57791932,248589,360123070,8526,64
283314,C1RL-AS1,chr12,F,7108307,7121851,57805476,13544,360136614,8527,11
283316,CD163L1,chr12,R,7326483,7444185,57923178,117702,360254316,8528,24
283332,LOC283332,chr12,R,49908881,49911863,57926160,2982,360257298,8529,2
283335,LOC283335,chr12,R,53043188,53054438,57937410,11250,360268548,8530,3
283337,ZNF740,chr12,F,53180750,53190870,57947530,10120,360278668,8531,6
283345,RPL13P5,chr12,F,6883980,6884614,57948164,634,360279302,8532,0
283349,RASSF3,chr12,F,64610512,64697567,58035219,87055,360366357,8533,7
283352,LOC283352,chr12,F,129109689,129113298,58038828,3609,360369966,8534,3
283358,B4GALNT3,chr12,F,460376,561892,58140344,101516,360471482,8535,19
283365,OR6C6,chr12,R,55294287,55295232,58141289,945,360472427,8536,0
283373,ANKRD52,chr12,R,56237806,56258359,58161842,20553,360492980,8537,28
283375,SLC39A5,chr12,F,56230035,56237846,58169653,7811,360500791,8538,12
283377,SPRYD4,chr12,F,56468516,56470985,58172122,2469,360503260,8539,1
283383,ADGRD1,chr12,F,130953906,131141465,58359681,187559,360690819,8540,29
283385,MORN3,chr12,R,121651117,121672639,58381203,21522,360712341,8541,6
283387,LOC283387,chr12,R,57869172,57893819,58405850,24647,360736988,8542,2
283392,TRHDE-AS1,chr12,R,72253506,72273509,58425853,20003,360756991,8543,2
283403,C12orf80,chr12,R,52205580,52210855,58431128,5275,360762266,8544,3
283404,LINC00592,chr12,F,52210929,52223813,58444012,12884,360775150,8545,4
283416,LINC01465,chr12,R,62601750,62603434,58445696,1684,360776834,8546,0
283417,DPY19L2,chr12,R,63558912,63669201,58555985,110289,360887123,8547,26
283420,CLEC9A,chr12,F,10030676,10066030,58591339,35354,360922477,8548,8
283422,LINC01559,chr12,R,13370670,13376745,58597414,6075,360928552,8549,2
283431,GAS2L3,chr12,F,100573645,100628288,58652057,54643,360983195,8550,12
283432,LINC00485,chr12,R,102809282,102824399,58667174,15117,360998312,8551,4
283440,LOC283440,chr12,R,2761199,2771669,58677644,10470,361008782,8552,4
283446,MYO1H,chr12,F,109388276,109449004,58738372,60728,361069510,8553,31
283450,HECTD4,chr12,R,112160187,112382092,58960277,221905,361291415,8554,75
283455,KSR2,chr12,R,117453011,117969103,59476369,516092,361807507,8555,28
283459,GATC,chr12,F,120446437,120463753,59493685,17316,361824823,8556,4
283460,HNF1A-AS1,chr12,R,120969837,120972292,59496140,2455,361827278,8557,0
283461,C12orf40,chr12,F,39626169,39721914,59591885,95745,361923023,8558,15
283463,MUC19,chr12,F,40393393,40570757,59769249,177364,362100387,8559,170
283464,GXYLT1,chr12,R,42081844,42144871,59832276,63027,362163414,8560,7
283471,TMPRSS12,chr12,F,50842917,50887884,59877243,44967,362208381,8561,4
286887,KRT6C,chr12,R,52468515,52473785,59882513,5270,362213651,8562,8
317781,DDX51,chr12,R,132136593,132144335,59890255,7742,362221393,8563,14
319101,KRT73,chr12,R,52602882,52620116,59907489,17234,362238627,8564,9
326625,MMAB,chr12,R,109553714,109573553,59927328,19839,362258466,8565,11
338339,CLEC4D,chr12,F,8513481,8522366,59936213,8885,362267351,8566,5
338442,HCAR2,chr12,R,122701292,122703357,59938278,2065,362269416,8567,0
338758,LINC00936,chr12,F,89708954,89711952,59941276,2998,362272414,8568,0
338761,C1QL4,chr12,R,49332415,49337188,59946049,4773,362277187,8569,1
338773,TMEM119,chr12,R,108589845,108598118,59954322,8273,362285460,8570,2
338785,KRT79,chr12,R,52821446,52834293,59967169,12847,362298307,8571,8
338797,LOC338797,chr12,F,131347469,131367555,59987255,20086,362318393,8572,4
338799,LINC01089,chr12,R,121795266,121803484,59995473,8218,362326611,8573,6
338809,C12orf74,chr12,F,92702842,92708549,60001180,5707,362332318,8574,1
338811,FAM19A2,chr12,R,61708247,62260064,60552997,551817,362884135,8575,7
338817,LINC01252,chr12,F,11548029,11564403,60569371,16374,362900509,8576,7
338821,SLCO1B7,chr12,F,21015695,21090106,60643782,74411,362974920,8577,12
341346,SMCO2,chr12,F,27446743,27502322,60699361,55579,363030499,8578,9
341350,OVCH1,chr12,R,29422127,29497800,60775034,75673,363106172,8579,34
341359,SYT10,chr12,R,33375412,33439819,60839441,64407,363170579,8580,8
341392,ACSM4,chr12,F,7304331,7328373,60863483,24042,363194621,8581,12
341405,ANKRD33,chr12,F,51888008,51891721,60867196,3713,363198334,8582,4
341416,OR6C2,chr12,F,55452213,55453152,60868135,939,363199273,8583,0
341418,OR6C4,chr12,F,55551226,55552156,60869065,930,363200203,8584,0
341567,H1FNT,chr12,F,48328979,48330279,60870365,1300,363201503,8585,0
341568,OR8S1,chr12,F,48525631,48528103,60872837,2472,363203975,8586,1
347902,AMIGO2,chr12,R,47075706,47080826,60877957,5120,363209095,8587,2
347918,EP400NL,chr12,F,132084282,132126340,60920015,42058,363251153,8588,9
353116,RILPL1,chr12,R,123471361,123533718,60982372,62357,363313510,8589,14
353164,TAS2R42,chr12,R,11185992,11186937,60983317,945,363314455,8590,0
359787,DPPA3,chr12,F,7711453,7717559,60989423,6106,363320561,8591,3
360030,NANOGNB,chr12,F,7765215,7774121,60998329,8906,363329467,8592,3
374443,LOC374443,chr12,F,9617283,9658415,61039461,41132,363370599,8593,9
374454,KRT77,chr12,R,52689611,52703534,61053384,13923,363384522,8594,9
374462,PTPRQ,chr12,F,80444273,80680189,61289300,235916,363620438,8595,46
374470,C12orf42,chr12,R,103079644,103525254,61734910,445610,364066048,8596,34
376132,LRRC10,chr12,R,69608563,69611162,61737509,2599,364068647,8597,0
386653,IL31,chr12,R,122172029,122182963,61748443,10934,364079581,8598,3
387836,CLEC2A,chr12,R,9880902,9932407,61799948,51505,364131086,8599,7
387837,CLEC12B,chr12,F,10009046,10018800,61809702,9754,364140840,8600,6
387841,RPL13AP20,chr12,F,12875476,12876136,61810362,660,364141500,8601,0
387849,REP15,chr12,F,27696494,27697633,61811501,1139,364142639,8602,0
387856,CCDC184,chr12,F,48183582,48185926,61813845,2344,364144983,8603,0
387882,C12orf75,chr12,F,105330635,105371518,61854728,40883,364185866,8604,5
387885,CCDC42B,chr12,F,113149180,113159276,61864824,10096,364195962,8605,7
387890,TMEM233,chr12,F,119592635,119654442,61926631,61807,364257769,8606,6
387893,SETD8,chr12,F,123383777,123409358,61952212,25581,364283350,8607,9
387895,LINC00944,chr12,R,126730700,126772262,61993774,41562,364324912,8608,4
389634,LINC00937,chr12,R,8356962,8390752,62027564,33790,364358702,8609,1
390321,OR6C1,chr12,F,55320599,55321538,62028503,939,364359641,8610,0
390323,OR6C75,chr12,F,55365110,55366049,62029442,939,364360580,8611,0
390326,OR6C76,chr12,F,55426253,55427192,62030381,939,364361519,8612,0
390327,OR6C70,chr12,R,55469199,55659844,62221026,190645,364552164,8613,7
400002,LOC400002,chr12,R,9948136,9953336,62226226,5200,364557364,8614,2
400027,LINC00938,chr12,R,45725719,45727921,62228428,2202,364559566,8615,0
400043,LOC400043,chr12,F,54126070,54132843,62235201,6773,364566339,8616,1
400046,FLJ41278,chr12,F,64883773,64977522,62328950,93749,364660088,8617,2
400058,MKRN9P,chr12,R,87782884,87784711,62330777,1827,364661915,8618,0
400073,C12orf76,chr12,R,110028041,110082224,62384960,54183,364716098,8619,9
400084,LINC00939,chr12,R,125958683,125983374,62409651,24691,364740789,8620,5
400087,FLJ37505,chr12,F,127881616,127898639,62426674,17023,364757812,8621,2
401720,FIGNL2,chr12,R,51817891,51848760,62457543,30869,364788681,8622,6
403282,OR6C65,chr12,F,55400528,55401467,62458482,939,364789620,8623,0
403284,OR6C68,chr12,F,55492377,55493316,62459421,939,364790559,8624,0
406891,MIRLET7I,chr12,F,62603685,62603769,62459505,84,364790643,8625,0
406926,MIR135A2,chr12,F,97563811,97563911,62459605,100,364790743,8626,0
406933,MIR141,chr12,F,6964096,6964191,62459700,95,364790838,8627,0
406973,MIR196A2,chr12,F,53991737,53991847,62459810,110,364790948,8628,0
406985,MIR200C,chr12,F,6963698,6963766,62459878,68,364791016,8629,0
407016,MIR26A2,chr12,R,57824608,57824692,62459962,84,364791100,8630,0
408186,OVOS,chr12,F,9517802,9573297,62515457,55495,364846595,8631,29
414300,LOC414300,chr12,R,105102471,105107642,62520628,5171,364851766,8632,1
439916,LINC00615,chr12,F,90918022,90948669,62551275,30647,364882413,8633,4
440073,IQSEC3,chr12,F,66795,178460,62662940,111665,364994078,8634,15
440077,ZNF705A,chr12,F,8157011,8180046,62685975,23035,365017113,8635,7
440078,FAM66C,chr12,F,8180208,8201000,62706767,20792,365037905,8636,7
440081,DDX12P,chr12,R,9417690,9448172,62737249,30482,365068387,8637,26
440087,SMCO3,chr12,R,14803722,14814182,62747709,10460,365078847,8638,3
440093,H3F3C,chr12,R,31791184,31792241,62748766,1057,365079904,8639,0
440097,DBX2,chr12,R,45014755,45051099,62785110,36344,365116248,8640,3
440101,FLJ12825,chr12,F,54058253,54122234,62849091,63981,365180229,8641,1
440104,TMEM198B,chr12,F,55829607,55836246,62855730,6639,365186868,8642,4
440107,PLEKHG7,chr12,F,92736488,92772745,62891987,36257,365223125,8643,11
440117,LOC440117,chr12,R,126869493,126874690,62897184,5197,365228322,8644,2
440119,FZD10-AS1,chr12,R,130151592,130161678,62907270,10086,365238408,8645,3
441631,TSPAN11,chr12,F,30926448,31016490,62997312,90042,365328450,8646,15
441639,OR9K2,chr12,F,55129768,55130776,62998320,1008,365329458,8647,0
442892,MIR148B,chr12,F,54337215,54337314,62998419,99,365329557,8648,0
442903,MIR331,chr12,F,95308419,95308513,62998513,94,365329651,8649,0
493861,EID3,chr12,F,104303731,104305205,62999987,1474,365331125,8650,0
503693,LOH12CR2,chr12,R,12355407,12357067,63001647,1660,365332785,8651,1
552889,ATXN7L3B,chr12,F,74537770,74541452,63005329,3682,365336467,8652,0
574016,CLLU1OS,chr12,R,92420093,92428545,63013781,8452,365344919,8653,4
574028,CLLU1,chr12,F,92421530,92431002,63023253,9472,365354391,8654,2
574449,MIR492,chr12,F,94834397,94834513,63023369,116,365354507,8655,0
574538,LOC574538,chr12,R,137410,149169,63035128,11759,365366266,8656,9
613227,HIGD1C,chr12,F,50936222,50972571,63071477,36349,365402615,8657,5
642559,POU5F1P3,chr12,R,8133768,8134852,63072561,1084,365403699,8658,0
642846,LOC642846,chr12,F,9283656,9314088,63102993,30432,365434131,8659,21
643246,MAP1LC3B2,chr12,F,116559207,116576620,63120406,17413,365451544,8660,1
643339,LOC643339,chr12,R,93003757,93377736,63494385,373979,365825523,8661,4
643711,LOC643711,chr12,R,97713411,97756517,63537491,43106,365868629,8662,8
643770,LOC643770,chr12,R,98485543,98503855,63555803,18312,365886941,8663,3
644076,GLYCAM1,chr12,R,54608186,54610462,63558079,2276,365889217,8664,3
645177,LOC645177,chr12,F,24997561,25066516,63627034,68955,365958172,8665,20
645485,LOC645485,chr12,F,30755028,30780739,63652745,25711,365983883,8666,1
647589,ANHX,chr12,R,133218311,133236220,63670654,17909,366001792,8667,13
653113,FAM86FP,chr12,R,8231048,8242946,63682552,11898,366013690,8668,4
653247,PRB2,chr12,R,11391539,11395564,63686577,4025,366017715,8669,3
654429,LRTM2,chr12,F,1820266,1836753,63703064,16487,366034202,8670,4
677777,SCARNA12,chr12,R,6967336,6967606,63703334,270,366034472,8671,0
677780,SCARNA11,chr12,R,6581472,6581609,63703471,137,366034609,8672,0
677784,FAM138D,chr12,R,36660,38133,63704944,1473,366036082,8673,2
677793,SNORA2A,chr12,R,48656647,48656782,63705079,135,366036217,8674,0
677794,SNORA2B,chr12,R,48667456,48667593,63705216,137,366036354,8675,0
677815,SNORA34,chr12,R,48654381,48654518,63705353,137,366036491,8676,0
677829,SNORA49,chr12,F,132031223,132031360,63705490,137,366036628,8677,0
677832,SNORA53,chr12,F,98599634,98599884,63705740,250,366036878,8678,0
678655,CD27-AS1,chr12,R,6439000,6451517,63718257,12517,366049395,8679,5
692090,SNORD59B,chr12,R,56643679,56643754,63718332,75,366049470,8680,0
692148,SCARNA10,chr12,F,6510221,6510551,63718662,330,366049800,8681,0
693129,MIR548C,chr12,F,64622508,64622605,63718759,97,366049897,8682,0
693198,MIR613,chr12,F,12764648,12764743,63718854,95,366049992,8683,0
693199,MIR614,chr12,F,12915828,12915918,63718944,90,366050082,8684,0
693200,MIR615,chr12,F,54033949,54034045,63719040,96,366050178,8685,0
693201,MIR616,chr12,R,57519162,57519259,63719137,97,366050275,8686,0
693202,MIR617,chr12,R,80832532,80832629,63719234,97,366050372,8687,0
693203,MIR618,chr12,R,80935735,80935833,63719332,98,366050470,8688,0
693204,MIR619,chr12,R,108836907,108837006,63719431,99,366050569,8689,0
693205,MIR620,chr12,R,116148559,116148654,63719526,95,366050664,8690,0
728084,LOC728084,chr12,R,89011125,89019692,63728093,8567,366059231,8691,2
728568,C12orf73,chr12,R,103950201,103957215,63735107,7014,366066245,8692,5
728622,SKP1P2,chr12,F,16988746,16990628,63736989,1882,366068127,8693,0
728715,LOC728715,chr12,R,9397061,9403060,63742988,5999,366074126,8694,8
728739,LOC728739,chr12,R,107903149,107903771,63743610,622,366074748,8695,0
728858,C12orf71,chr12,R,27081056,27084144,63746698,3088,366077836,8696,2
729025,SLC15A5,chr12,R,16188484,16277685,63835899,89201,366167037,8697,8
729633,MRS2P2,chr12,R,71848291,71850983,63838591,2692,366169729,8698,0
100009606,TRF-GAA1-2,chr12,R,124927842,124927915,63838664,73,366169802,8699,0
100049716,LOC100049716,chr12,F,630890,645878,63853652,14988,366184790,8700,4
100124700,HOTAIR,chr12,R,53962307,53974956,63866301,12649,366197439,8701,6
100126320,MIR920,chr12,F,24212420,24212495,63866376,75,366197514,8702,0
100127967,KRT73-AS1,chr12,F,52609850,52615305,63871831,5455,366202969,8703,2
100128002,LOC100128002,chr12,F,131295521,131298212,63874522,2691,366205660,8704,0
100128191,TMPO-AS1,chr12,R,98512972,98516226,63877776,3254,366208914,8705,1
100128276,LOC100128276,chr12,R,128849171,128853404,63882009,4233,366213147,8706,1
100128554,LOC100128554,chr12,F,126442480,126472785,63912314,30305,366243452,8707,11
100129223,LOC100129223,chr12,R,3483711,3492819,63921422,9108,366252560,8708,1
100129361,LOC100129361,chr12,F,11171180,11176020,63926262,4840,366257400,8709,0
100129528,MUC8,chr12,R,132471099,132474630,63929793,3531,366260931,8710,1
100129940,LOC100129940,chr12,R,65851226,65883544,63962111,32318,366293249,8711,7
100130075,LOC100130075,chr12,R,68804436,68805494,63963169,1058,366294307,8712,0
100130083,HBCBP,chr12,F,56996783,56998440,63964826,1657,366295964,8713,0
100130238,LOC100130238,chr12,F,132275390,132280900,63970336,5510,366301474,8714,3
100130268,LOC100130268,chr12,F,75234723,75298661,64034274,63938,366365412,8715,7
100130776,AGAP2-AS1,chr12,F,57726239,57728356,64036391,2117,366367529,8716,1
100131138,LINC01405,chr12,F,110936601,110937448,64037238,847,366368376,8717,1
100131733,USP30-AS1,chr12,R,109052040,109053965,64039163,1925,366370301,8718,1
100132594,PGAM1P5,chr12,F,95649254,95673999,64063908,24745,366395046,8719,4
100147744,RNU7-1,chr12,F,6943815,6943878,64063971,63,366395109,8720,0
100189152,TRS-CGA4-1,chr12,F,56190363,56190445,64064053,82,366395191,8721,0
100189171,TRW-CCA4-1,chr12,F,98504251,98504323,64064125,72,366395263,8722,0
100189207,TRD-GTC1-1,chr12,F,98503502,98503574,64064197,72,366395335,8723,0
100189232,TRA-TGC3-1,chr12,R,124921754,124921826,64064269,72,366395407,8724,0
100189239,TRD-GTC2-6,chr12,F,96036020,96036092,64064341,72,366395479,8725,0
100189339,TRA-TGC4-1,chr12,F,124939965,124940037,64064413,72,366395551,8726,0
100189343,TRD-GTC2-7,chr12,R,124927344,124927416,64064485,72,366395623,8727,0
100189347,TRD-GTC2-8,chr12,R,124939646,124939718,64064557,72,366395695,8728,0
100190940,LOC100190940,chr12,R,130033811,130042342,64073088,8531,366404226,8729,2
100233209,PCED1B-AS1,chr12,R,47208419,47216443,64081112,8024,366412250,8730,2
100240734,LOC100240734,chr12,F,54102208,54102699,64081603,491,366412741,8731,0
100240735,LOC100240735,chr12,R,54078838,54081823,64084588,2985,366415726,8732,2
100271702,LINC00940,chr12,R,1929201,1936576,64091963,7375,366423101,8733,1
100286844,BCDIN3D-AS1,chr12,F,49828542,49841154,64104575,12612,366435713,8734,2
100287284,MANSC4,chr12,R,27762640,27773083,64115018,10443,366446156,8735,3
100287314,LINC00941,chr12,F,30795680,30802711,64122049,7031,366453187,8736,4
100287569,LINC00173,chr12,F,116533421,116536513,64125141,3092,366456279,8737,3
100287944,LOC100287944,chr12,R,106496409,106774831,64403563,278422,366734701,8738,3
100288778,LOC100288778,chr12,R,14476,32015,64421102,17539,366752240,8739,10
100288798,LOC100288798,chr12,F,46383675,46652579,64690006,268904,367021144,8740,6
100289635,ZNF605,chr12,R,132921432,132956306,64724880,34874,367056018,8741,5
100292680,LINC00942,chr12,F,1500490,1504424,64728814,3934,367059952,8742,1
100293704,LOC100293704,chr12,F,123363058,123365789,64731545,2731,367062683,8743,3
100302136,MIR1252,chr12,F,79419256,79419321,64731610,65,367062748,8744,0
100302182,MIR1279,chr12,R,69273156,69273218,64731672,62,367062810,8745,0
100302201,MIR1228,chr12,F,57194503,57194576,64731745,73,367062883,8746,0
100302217,MIR1827,chr12,F,100189883,100189949,64731811,66,367062949,8747,0
100302220,MIR1293,chr12,R,50234141,50234212,64731882,71,367063020,8748,0
100302221,MIR1291,chr12,R,48654443,48654530,64731969,87,367063107,8749,0
100302227,MIR1302-1,chr12,R,112695033,112695176,64732112,143,367063250,8750,0
100302274,MIR1178,chr12,R,119713633,119713724,64732203,91,367063341,8751,0
100302289,MIR1251,chr12,F,97491908,97491978,64732273,70,367063411,8752,0
100335030,LOC100335030,chr12,F,49389173,49392335,64735435,3162,367066573,8753,0
100379132,SNORA70G,chr12,R,68627233,68627375,64735577,142,367066715,8754,0
100422872,MIR1244-3,chr12,R,9239466,9239551,64735662,85,367066800,8755,0
100422897,MIR4302,chr12,R,25874019,25874079,64735722,60,367066860,8756,0
100422924,MIR4303,chr12,R,97995382,97995448,64735788,66,367066926,8757,0
100422931,MIR4304,chr12,R,123010666,123010728,64735850,62,367066988,8758,0
100431172,KLRF2,chr12,F,9881488,9895833,64750195,14345,367081333,8759,5
100499405,LINC00987,chr12,F,9240002,9243049,64753242,3047,367084380,8760,1
100500802,MIR3685,chr12,F,95309922,95309984,64753304,62,367084442,8761,0
100500816,MIR3649,chr12,R,1660314,1660380,64753370,66,367084508,8762,0
100500817,MIR3612,chr12,F,128294091,128294178,64753457,87,367084595,8763,0
100500842,MIR3652,chr12,F,103930424,103930555,64753588,131,367084726,8764,0
100500843,MIR3922,chr12,F,104591632,104591716,64753672,84,367084810,8765,0
100500856,MIR548Z,chr12,R,64622508,64622605,64753769,97,367084907,8766,0
100500868,MIR3913-2,chr12,F,69584722,69584822,64753869,100,367085007,8767,0
100500889,MIR3657,chr12,R,112037598,112037715,64753986,117,367085124,8768,0
100500903,MIR3913-1,chr12,R,69584721,69584823,64754088,102,367085226,8769,0
100500909,MIR3908,chr12,F,123536408,123536534,64754214,126,367085352,8770,0
100505978,LOC100505978,chr12,R,106680757,106684700,64758157,3943,367089295,8771,3
100506125,LOC100506125,chr12,F,48789146,48790535,64759546,1389,367090684,8772,3
100506159,LOC100506159,chr12,R,9936578,9943495,64766463,6917,367097601,8773,4
100506248,LOC100506248,chr12,F,12111001,12111688,64767150,687,367098288,8774,0
100506314,LOC100506314,chr12,F,12979836,12984642,64771956,4806,367103094,8775,2
100506393,LOC100506393,chr12,F,20014684,20098868,64856140,84184,367187278,8776,2
100506451,RASSF8-AS1,chr12,R,25954653,25959442,64860929,4789,367192067,8777,4
100506465,LINC01234,chr12,R,113744576,113773683,64890036,29107,367221174,8778,2
100506551,LOC100506551,chr12,R,116977439,116987337,64899934,9898,367231072,8779,3
100506606,LOC100506606,chr12,R,29280414,29317848,64937368,37434,367268506,8780,6
100506649,PXN-AS1,chr12,F,120201290,120212828,64948906,11538,367280044,8781,3
100506660,DDX11-AS1,chr12,R,31020762,31073847,65001991,53085,367333129,8782,2
100506668,NRAV,chr12,R,120490337,120495946,65007600,5609,367338738,8783,1
100506691,LOC100506691,chr12,F,122063252,122068560,65012908,5308,367344046,8784,4
100506844,LOC100506844,chr12,R,57931448,57936164,65017624,4716,367348762,8785,2
100506869,LOC100506869,chr12,F,58591701,58812669,65238592,220968,367569730,8786,1
100507055,LRCOL1,chr12,R,132602223,132610451,65246820,8228,367577958,8787,6
100507065,LOC100507065,chr12,R,65466816,65642372,65422376,175556,367753514,8788,8
100507066,CLIP1-AS1,chr12,F,122395541,122399944,65426779,4403,367757917,8789,2
100507091,LOC100507091,chr12,F,123081383,123084744,65430140,3361,367761278,8790,2
100507175,LOC100507175,chr12,F,67520081,67567131,65477190,47050,367808328,8791,2
100507195,LOC100507195,chr12,R,68431841,68451484,65496833,19643,367827971,8792,3
100507206,LINC00943,chr12,F,126737006,126746256,65506083,9250,367837221,8793,3
100507250,LOC100507250,chr12,R,68674370,68686859,65518572,12489,367849710,8794,2
100507377,LOC100507377,chr12,R,74133172,74292631,65678031,159459,368009169,8795,6
100507424,LOC100507424,chr12,F,2836815,2859795,65701011,22980,368032149,8796,3
100507560,LOC100507560,chr12,F,5017684,5025594,65708921,7910,368040059,8797,5
100507616,LOC100507616,chr12,F,92466430,92486360,65728851,19930,368059989,8798,1
100528022,BLOC1S1-RDH5,chr12,F,55716033,55724742,65737560,8709,368068698,8799,4
100528030,POC1B-GALNT4,chr12,R,89519411,89526262,65744411,6851,368075549,8800,12
100528032,KLRC4-KLRK1,chr12,R,10372352,10410146,65782205,37794,368113343,8801,12
100533183,ZNF664-FAM101A,chr12,F,123973214,124316024,66125015,342810,368456153,8802,2
100533464,PRH1-PRR4,chr12,R,10845848,11171625,66450792,325777,368781930,8803,9
100616133,MIR4699,chr12,F,81158387,81158461,66450866,74,368782004,8804,0
100616179,MIR4498,chr12,R,120155433,120155499,66450932,66,368782070,8805,0
100616240,MIR4496,chr12,F,108635809,108635870,66450993,61,368782131,8806,0
100616262,MIR4701,chr12,R,48771974,48772037,66451056,63,368782194,8807,0
100616279,MIR3974,chr12,F,17673298,17673394,66451152,96,368782290,8808,0
100616287,MIR4495,chr12,R,97939055,97939121,66451218,66,368782356,8809,0
100616298,MIR4419B,chr12,F,128244505,128244573,66451286,68,368782424,8810,0
100616309,MIR4472-2,chr12,R,116428251,116428318,66451353,67,368782491,8811,0
100616329,MIR4700,chr12,F,120723192,120723266,66451427,74,368782565,8812,0
100616400,MIR3198-2,chr12,R,54231396,54231476,66451507,80,368782645,8813,0
100616454,MIR4497,chr12,F,109833347,109833436,66451596,89,368782734,8814,0
100616478,MIR4494,chr12,R,47364185,47364269,66451680,84,368782818,8815,0
100616486,MIR4698,chr12,F,47187811,47187891,66451760,80,368782898,8816,0
100652846,CACNA1C-AS1,chr12,R,2676000,2691157,66466917,15157,368798055,8817,3
100652999,LOC100652999,chr12,F,53513983,53517608,66470542,3625,368801680,8818,2
100847004,MIR5188,chr12,F,124915546,124915659,66470655,113,368801793,8819,0
100847031,MIR5700,chr12,F,94561788,94561859,66470726,71,368801864,8820,0
100862680,LINC00507,chr12,F,127915409,127951552,66506869,36143,368838007,8821,4
100873757,RNU6-36P,chr12,F,97721715,97721822,66506976,107,368838114,8822,0
100873980,RERG-AS1,chr12,F,15151922,15155283,66510337,3361,368841475,8823,2
100874234,CACNA1C-AS4,chr12,R,2220536,2223481,66513282,2945,368844420,8824,3
100874235,CACNA1C-AS2,chr12,R,2668499,2672220,66517003,3721,368848141,8825,1
100874249,DENND5B-AS1,chr12,F,31589922,31615351,66542432,25429,368873570,8826,2
100874363,HOXC-AS1,chr12,R,53999021,54000010,66543421,989,368874559,8827,1
100874364,HOXC-AS2,chr12,R,53995207,53996785,66544999,1578,368876137,8828,2
100874365,HOXC-AS3,chr12,R,53983950,53985519,66546568,1569,368877706,8829,2
100874366,HOXC13-AS,chr12,R,53935327,53939643,66550884,4316,368882022,8830,2
100874369,CACNA1C-IT2,chr12,F,2048351,2049463,66551996,1112,368883134,8831,1
100874370,CACNA1C-IT3,chr12,F,2269775,2288745,66570966,18970,368902104,8832,2
100885789,IFNG-AS1,chr12,F,67989444,68021327,66602849,31883,368933987,8833,4
100996246,LOC100996246,chr12,R,132186734,132189727,66605842,2993,368936980,8834,1
100996573,LOC100996573,chr12,F,132550728,132554890,66610004,4162,368941142,8835,0
100996671,LOC100996671,chr12,R,126652945,126690318,66647377,37373,368978515,8836,3
100996679,LOC100996679,chr12,R,128086981,128118141,66678537,31160,369009675,8837,4
100996701,LOC100996701,chr12,R,131663773,131665416,66680180,1643,369011318,8838,0
101055625,OVCH1-AS1,chr12,F,29389293,29487324,66778211,98031,369109349,8839,3
101060038,LOC101060038,chr12,F,10552660,10575720,66801271,23060,369132409,8840,3
101060200,ZNF891,chr12,R,133119968,133130473,66811776,10505,369142914,8841,1
101593348,LOC101593348,chr12,F,122226441,122228792,66814127,2351,369145265,8842,0
101927019,LOC101927019,chr12,F,39315931,39329491,66827687,13560,369158825,8843,4
101927038,LOC101927038,chr12,F,41764149,41765571,66829109,1422,369160247,8844,2
101927058,LOC101927058,chr12,R,42615502,42646498,66860105,30996,369191243,8845,5
101927241,LOC101927241,chr12,R,48813761,48814547,66860891,786,369192029,8846,1
101927267,LOC101927267,chr12,R,49292630,49324576,66892837,31946,369223975,8847,7
101927292,LOC101927292,chr12,F,49911952,49926339,66907224,14387,369238362,8848,5
101927318,LOC101927318,chr12,R,49951511,49962924,66918637,11413,369249775,8849,4
101927340,LOC101927340,chr12,F,50143422,50165623,66940838,22201,369271976,8850,3
101927415,LOC101927415,chr12,R,123581065,123584327,66944100,3262,369275238,8851,2
101927436,LOC101927436,chr12,R,124605056,124609077,66948121,4021,369279259,8852,3
101927464,LOC101927464,chr12,F,126095991,126103932,66956062,7941,369287200,8853,4
101927484,LOC101927484,chr12,R,55023487,55035740,66968315,12253,369299453,8854,4
101927583,LOC101927583,chr12,R,57618404,57621903,66971814,3499,369302952,8855,3
101927592,LOC101927592,chr12,R,126915226,127060397,67116985,145171,369448123,8856,6
101927608,LOC101927608,chr12,F,57893267,57896846,67120564,3579,369451702,8857,1
101927616,LOC101927616,chr12,R,127324154,127340072,67136482,15918,369467620,8858,2
101927637,LOC101927637,chr12,R,127631268,127636467,67141681,5199,369472819,8859,3
101927653,LOC101927653,chr12,R,58565958,58781716,67357439,215758,369688577,8860,7
101927694,LOC101927694,chr12,F,128118216,128121952,67361175,3736,369692313,8861,2
101927735,LOC101927735,chr12,F,129208600,129212662,67365237,4062,369696375,8862,4
101927786,LOC101927786,chr12,R,130332668,130336240,67368809,3572,369699947,8863,2
101927882,LOC101927882,chr12,F,7338841,7341916,67371884,3075,369703022,8864,2
101927901,LOC101927901,chr12,R,67709046,67729475,67392313,20429,369723451,8865,4
101927905,LOC101927905,chr12,F,8235414,8242564,67399463,7150,369730601,8866,2
101927922,LINC01479,chr12,F,67929234,67970017,67440246,40783,369771384,8867,2
101928002,LOC101928002,chr12,R,69713632,69738568,67465182,24936,369796320,8868,3
101928030,LOC101928030,chr12,R,9371781,9381422,67474823,9641,369805961,8869,1
101928062,LINC01481,chr12,R,70222189,70243360,67495994,21171,369827132,8870,5
101928100,LOC101928100,chr12,F,10363768,10398506,67530732,34738,369861870,8871,3
101928137,LOC101928137,chr12,F,73159189,73208317,67579860,49128,369910998,8872,3
101928138,LINC01486,chr12,R,109354186,109359488,67585162,5302,369916300,8873,2
101928162,LOC101928162,chr12,F,10750233,10777451,67612380,27218,369943518,8874,6
101928207,LOC101928207,chr12,F,77777347,77783581,67618614,6234,369949752,8875,1
101928225,LOC101928225,chr12,F,115362929,115364745,67620430,1816,369951568,8876,1
101928244,TESC-AS1,chr12,F,117099466,117141489,67662453,42023,369993591,8877,2
101928274,LOC101928274,chr12,R,118117621,118135946,67680778,18325,370011916,8878,5
101928290,PLBD1-AS1,chr12,F,14567731,14619755,67732802,52024,370063940,8879,5
101928300,LOC101928300,chr12,R,120629610,120640501,67743693,10891,370074831,8880,1
101928317,LOC101928317,chr12,F,14529830,14535673,67749536,5843,370080674,8881,3
101928340,LINC01489,chr12,F,15001832,15006683,67754387,4851,370085525,8882,3
101928346,LOC101928346,chr12,F,121581175,121596000,67769212,14825,370100350,8883,4
101928362,LOC101928362,chr12,F,16268300,16332337,67833249,64037,370164387,8884,9
101928387,LOC101928387,chr12,F,19590780,19673089,67915558,82309,370246696,8885,8
101928416,LOC101928416,chr12,F,132329849,132331575,67917284,1726,370248422,8886,1
101928420,LINC01490,chr12,F,80763153,80770717,67924848,7564,370255986,8887,4
101928441,LOC101928441,chr12,F,23175635,23191587,67940800,15952,370271938,8888,4
101928449,LOC101928449,chr12,F,81953718,81993133,67980215,39415,370311353,8889,2
101928471,LOC101928471,chr12,F,24223270,24237965,67994910,14695,370326048,8890,4
101928530,LOC101928530,chr12,F,132887841,132888571,67995640,730,370326778,8891,1
101928554,LOC101928554,chr12,R,26210841,26219348,68004147,8507,370335285,8892,2
101928584,LOC101928584,chr12,R,91171197,91178107,68011057,6910,370342195,8893,1
101928597,LOC101928597,chr12,R,133032658,133037222,68015621,4564,370346759,8894,2
101928617,LOC101928617,chr12,F,92146084,92167560,68037097,21476,370368235,8895,3
101928625,LOC101928625,chr12,F,27046192,27068609,68059514,22417,370390652,8896,5
101928646,ARNTL2-AS1,chr12,R,27389788,27446634,68116360,56846,370447498,8897,3
101928705,LOC101928705,chr12,F,28566431,28581505,68131434,15074,370462572,8898,2
101928731,LOC101928731,chr12,R,93707790,93737823,68161467,30033,370492605,8899,3
101928735,LOC101928735,chr12,F,29040669,29056711,68177509,16042,370508647,8900,5
101928912,LOC101928912,chr12,R,97229810,97257412,68205111,27602,370536249,8901,5
101928937,LOC101928937,chr12,F,99093358,99105011,68216764,11653,370547902,8902,4
101928981,LOC101928981,chr12,F,101730592,101743753,68229925,13161,370561063,8903,2
101929005,LOC101929005,chr12,F,101747247,101748944,68231622,1697,370562760,8904,1
101929027,LOC101929027,chr12,R,31363480,31370055,68238197,6575,370569335,8905,1
101929036,LOC101929036,chr12,R,102927666,102951231,68261762,23565,370592900,8906,6
101929058,LOC101929058,chr12,F,103151841,103168309,68278230,16468,370609368,8907,6
101929084,LOC101929084,chr12,F,103547793,103559815,68290252,12022,370621390,8908,4
101929110,CASC18,chr12,F,105704202,105744063,68330113,39861,370661251,8909,5
101929132,LOC101929132,chr12,F,106248236,106252213,68334090,3977,370665228,8910,2
101929162,LOC101929162,chr12,F,107736554,107759968,68357504,23414,370688642,8911,4
101929204,LOC101929204,chr12,F,108802374,108817031,68372161,14657,370703299,8912,3
101929384,LOC101929384,chr12,F,203644,205093,68373610,1449,370704748,8913,2
101929432,LOC101929432,chr12,F,689794,711006,68394822,21212,370725960,8914,2
101929469,LOC101929469,chr12,R,2848242,2857215,68403795,8973,370734933,8915,2
101929549,LOC101929549,chr12,R,4700416,4720102,68423481,19686,370754619,8916,3
101929584,LOC101929584,chr12,R,5233995,5243151,68432637,9156,370763775,8917,4
101929967,LOC101929967,chr12,R,74611827,74621059,68441869,9232,370773007,8918,3
101929974,LOC101929974,chr12,R,131453246,131560378,68549001,107132,370880139,8919,8
101930023,LOC101930023,chr12,R,92146488,92363858,68766371,217370,371097509,8920,11
101930162,LOC101930162,chr12,F,3367485,3371641,68770527,4156,371101665,8921,2
101930164,LOC101930164,chr12,R,40141293,40158559,68787793,17266,371118931,8922,4
101930452,LOC101930452,chr12,F,9367463,9397617,68817947,30154,371149085,8923,3
102157401,PCBP2-OT1,chr12,F,53464467,53465057,68818537,590,371149675,8924,0
102216268,CISTR,chr12,R,53750446,53757034,68825125,6588,371156263,8925,3
102464827,MIR6074,chr12,R,66023619,66023726,68825232,107,371156370,8926,0
102465133,MIR6125,chr12,F,62260358,62260454,68825328,96,371156466,8927,0
102465249,MIR6502,chr12,F,66251081,66251157,68825404,76,371156542,8928,0
102465454,MIR6758,chr12,F,57512687,57512750,68825467,63,371156605,8929,0
102465455,MIR6760,chr12,F,111304141,111304209,68825535,68,371156673,8930,0
102465456,MIR6761,chr12,F,111799833,111799905,68825607,72,371156745,8931,0
102465457,MIR6762,chr12,F,113291522,113291608,68825693,86,371156831,8932,0
102465519,MIR6861,chr12,R,112163257,112163321,68825757,64,371156895,8933,0
102465665,MIR7107,chr12,R,121444272,121444352,68825837,80,371156975,8934,0
102465834,MIR7844,chr12,R,94571230,94571352,68825959,122,371157097,8935,0
102465975,MIR6763,chr12,F,132581996,132582061,68826024,65,371157162,8936,0
102466193,MIR6757,chr12,F,53056943,53057012,68826093,69,371157231,8937,0
102466204,MIR6880,chr12,R,124337180,124337242,68826155,62,371157293,8938,0
102466222,MIR7106,chr12,R,113159112,113159177,68826220,65,371157358,8939,0
102466657,MIR6505,chr12,F,48132796,48132867,68826291,71,371157429,8940,0
102466729,MIR6759,chr12,R,57748617,57748682,68826356,65,371157494,8941,0
102466877,MIR8072,chr12,R,123364763,123364843,68826436,80,371157574,8942,0
102467003,MIR7851,chr12,R,42323699,42323859,68826596,160,371157734,8943,0
102659353,THRIL,chr12,R,125025442,125027423,68828577,1981,371159715,8944,0
102723340,LOC102723340,chr12,F,95996445,96011704,68843836,15259,371174974,8945,3
102723544,LOC102723544,chr12,R,253441,257299,68847694,3858,371178832,8946,2
102723562,LINC01498,chr12,R,108459424,108473689,68861959,14265,371193097,8947,3
102723619,LOC102723619,chr12,F,111599497,111601280,68863742,1783,371194880,8948,2
102723639,LOC102723639,chr12,F,115013186,115105119,68955675,91933,371286813,8949,7
102723712,LOC102723712,chr12,F,119173959,119177318,68959034,3359,371290172,8950,1
102723723,LOC102723723,chr12,F,119939397,119975189,68994826,35792,371325964,8951,3
102723757,LOC102723757,chr12,F,46372782,46373778,68995822,996,371326960,8952,1
102723963,LOC102723963,chr12,R,49976930,49978419,68997311,1489,371328449,8953,1
102723983,LOC102723983,chr12,F,51270255,51271362,68998418,1107,371329556,8954,1
102724020,LOC102724020,chr12,R,10015351,10030606,69013673,15255,371344811,8955,2
102724030,LOC102724030,chr12,F,54150218,54168595,69032050,18377,371363188,8956,2
102724050,LOC102724050,chr12,F,54353690,54467030,69145390,113340,371476528,8957,6
102724112,LOC102724112,chr12,R,55913745,55923482,69155127,9737,371486265,8958,3
102724146,LOC102724146,chr12,R,15817068,15882348,69220407,65280,371551545,8959,6
102724196,LOC102724196,chr12,F,16567191,16575230,69228446,8039,371559584,8960,1
102724211,LOC102724211,chr12,F,57873872,57891558,69246132,17686,371577270,8961,3
102724227,LOC102724227,chr12,F,18753525,18800108,69292715,46583,371623853,8962,3
102724247,LOC102724247,chr12,R,20234852,20264157,69322020,29305,371653158,8963,2
102724261,LOC102724261,chr12,R,21727122,21757855,69352753,30733,371683891,8964,2
102724318,LOC102724318,chr12,F,62470066,62480285,69362972,10219,371694110,8965,2
102724337,LOC102724337,chr12,F,63008742,63022906,69377136,14164,371708274,8966,2
102724371,LOC102724371,chr12,F,24902308,24904261,69379089,1953,371710227,8967,0
102724421,LOC102724421,chr12,R,67077625,67096284,69397748,18659,371728886,8968,3
102724433,LOC102724433,chr12,R,67440997,67442952,69399703,1955,371730841,8969,1
102724618,LOC102724618,chr12,F,31996894,32017487,69420296,20593,371751434,8970,2
102724663,LOC102724663,chr12,F,81279188,81312422,69453530,33234,371784668,8971,5
102724680,LOC102724680,chr12,F,84912836,84992723,69533417,79887,371864555,8972,7
102724702,LOC102724702,chr12,F,9511773,9517795,69539439,6022,371870577,8973,4
102724782,LOC102724782,chr12,F,89525663,89598063,69611839,72400,371942977,8974,10
102724834,LOC102724834,chr12,F,90675298,90680690,69617231,5392,371948369,8975,2
102724933,LOC102724933,chr12,F,93174365,93181832,69624698,7467,371955836,8976,2
102724960,LOC102724960,chr12,F,94472308,94539214,69691604,66906,372022742,8977,3
102725208,LOC102725208,chr12,F,93619690,93620970,69692884,1280,372024022,8978,2
102725258,LOC102725258,chr12,F,48197001,48252461,69748344,55460,372079482,8979,7
103504734,MIR1244-4,chr12,F,12111951,12112036,69748429,85,372079567,8980,0
103625681,LLPH-AS1,chr12,F,66130750,66134449,69752128,3699,372083266,8981,1
103752584,CCND2-AS1,chr12,R,4248766,4276184,69779546,27418,372110684,8982,1
104169670,TMEM5-AS1,chr12,R,63808844,63822156,69792858,13312,372123996,8983,3
104355219,LHX5-AS1,chr12,F,113472002,113480481,69801337,8479,372132475,8984,1
104472718,LINC00508,chr12,R,127883988,127983891,69901240,99903,372232378,8985,3
105369151,LOC105369151,chr12,R,22326021,22333987,69909206,7966,372240344,8986,1
105369187,LOC105369187,chr12,R,65544237,65557311,69922280,13074,372253418,8987,2
105369223,LOC105369223,chr12,F,8244234,8298345,69976391,54111,372307529,8988,6
105369592,LOC105369592,chr12,R,163634,183016,69995773,19382,372326911,8989,2
105369593,LOC105369593,chr12,R,106522,111926,70001177,5404,372332315,8990,1
105369594,LOC105369594,chr12,R,389976,401548,70012749,11572,372343887,8991,5
105369595,LOC105369595,chr12,R,585697,591130,70018182,5433,372349320,8992,1
105369596,LOC105369596,chr12,F,711074,728428,70035536,17354,372366674,8993,2
105369597,LOC105369597,chr12,R,681741,716584,70070379,34843,372401517,8994,2
105369598,LOC105369598,chr12,F,730917,739279,70078741,8362,372409879,8995,2
105369599,LOC105369599,chr12,F,1174064,1174986,70079663,922,372410801,8996,2
105369601,LOC105369601,chr12,F,1812846,1817525,70084342,4679,372415480,8997,4
105369602,LOC105369602,chr12,F,1800618,1807491,70091215,6873,372422353,8998,3
105369603,LOC105369603,chr12,R,2436762,2451199,70105652,14437,372436790,8999,2
105369604,LOC105369604,chr12,R,2032187,2035065,70108530,2878,372439668,9000,2
105369605,LOC105369605,chr12,R,3230003,3234890,70113417,4887,372444555,9001,2
105369606,LOC105369606,chr12,F,3315740,3323452,70121129,7712,372452267,9002,2
105369607,LOC105369607,chr12,F,3419259,3432395,70134265,13136,372465403,9003,2
105369608,LOC105369608,chr12,R,3907929,3958606,70184942,50677,372516080,9004,4
105369609,LOC105369609,chr12,F,3868372,3916586,70233156,48214,372564294,9005,6
105369610,LOC105369610,chr12,F,3964335,3965714,70234535,1379,372565673,9006,2
105369611,LOC105369611,chr12,F,4013026,4019019,70240528,5993,372571666,9007,3
105369612,LOC105369612,chr12,R,4173055,4203932,70271405,30877,372602543,9008,3
105369613,LOC105369613,chr12,R,4549907,4556346,70277844,6439,372608982,9009,1
105369614,LOC105369614,chr12,R,4813559,4829582,70293867,16023,372625005,9010,2
105369615,LOC105369615,chr12,F,5076991,5090256,70307132,13265,372638270,9011,2
105369616,LOC105369616,chr12,R,5198223,5201964,70310873,3741,372642011,9012,2
105369617,LOC105369617,chr12,F,5122363,5379083,70567593,256720,372898731,9013,10
105369618,LOC105369618,chr12,F,5392428,5404187,70579352,11759,372910490,9014,2
105369619,LOC105369619,chr12,F,5404191,5407370,70582531,3179,372913669,9015,2
105369620,LOC105369620,chr12,R,5427317,5431533,70586747,4216,372917885,9016,2
105369621,LOC105369621,chr12,F,5881613,5912929,70618063,31316,372949201,9017,6
105369622,LOC105369622,chr12,F,6171413,6174071,70620721,2658,372951859,9018,2
105369623,LOC105369623,chr12,R,6169854,6180941,70631808,11087,372962946,9019,2
105369624,LOC105369624,chr12,F,6295279,6297489,70634018,2210,372965156,9020,2
105369626,LOC105369626,chr12,F,6365328,6374352,70643042,9024,372974180,9021,3
105369627,LOC105369627,chr12,F,6345018,6347078,70645102,2060,372976240,9022,1
105369628,LOC105369628,chr12,F,6393365,6395074,70646811,1709,372977949,9023,2
105369629,LOC105369629,chr12,F,6606459,6609304,70649656,2845,372980794,9024,1
105369630,LOC105369630,chr12,F,6568401,6570386,70651641,1985,372982779,9025,1
105369631,LOC105369631,chr12,F,6613960,6618323,70656004,4363,372987142,9026,2
105369632,LOC105369632,chr12,R,6875764,6890191,70670431,14427,373001569,9027,3
105369633,LOC105369633,chr12,R,6923178,6928092,70675345,4914,373006483,9028,2
105369634,LOC105369634,chr12,R,6961631,6963177,70676891,1546,373008029,9029,1
105369635,LOC105369635,chr12,F,6963203,6964452,70678140,1249,373009278,9030,1
105369636,LOC105369636,chr12,F,6983015,7006303,70701428,23288,373032566,9031,5
105369639,LOC105369639,chr12,R,7166712,7188831,70723547,22119,373054685,9032,2
105369640,LOC105369640,chr12,R,7324581,7326253,70725219,1672,373056357,9033,2
105369641,LOC105369641,chr12,R,7623757,7628695,70730157,4938,373061295,9034,2
105369642,LOC105369642,chr12,R,8026327,8027461,70731291,1134,373062429,9035,1
105369643,LOC105369643,chr12,F,8323583,8329614,70737322,6031,373068460,9036,1
105369644,LOC105369644,chr12,R,8565566,8567922,70739678,2356,373070816,9037,1
105369645,LOC105369645,chr12,F,8564566,8566019,70741131,1453,373072269,9038,2
105369647,LOC105369647,chr12,F,9403059,9408752,70746824,5693,373077962,9039,3
105369649,LOC105369649,chr12,R,9334242,9346756,70759338,12514,373090476,9040,2
105369650,LOC105369650,chr12,R,9323030,9324593,70760901,1563,373092039,9041,1
105369652,LOC105369652,chr12,F,9703625,9711454,70768730,7829,373099868,9042,1
105369653,LOC105369653,chr12,F,9769178,9822815,70822367,53637,373153505,9043,4
105369654,LOC105369654,chr12,F,9953001,9956991,70826357,3990,373157495,9044,1
105369655,LOC105369655,chr12,F,10115385,10133805,70844777,18420,373175915,9045,3
105369656,LOC105369656,chr12,R,10280337,10291285,70855725,10948,373186863,9046,1
105369657,LOC105369657,chr12,R,10498720,10537099,70894104,38379,373225242,9047,5
105369658,LOC105369658,chr12,R,10537151,10551823,70908776,14672,373239914,9048,3
105369659,LOC105369659,chr12,R,10726191,10741323,70923908,15132,373255046,9049,3
105369660,LOC105369660,chr12,F,10723106,10727487,70928289,4381,373259427,9050,1
105369662,LOC105369662,chr12,F,12481715,12484653,70931227,2938,373262365,9051,1
105369663,LOC105369663,chr12,R,12721811,12724319,70933735,2508,373264873,9052,1
105369664,LOC105369664,chr12,R,12879725,12883081,70937091,3356,373268229,9053,1
105369665,LOC105369665,chr12,R,13102760,13103445,70937776,685,373268914,9054,1
105369666,LOC105369666,chr12,F,13101355,13102436,70938857,1081,373269995,9055,1
105369667,LOC105369667,chr12,F,13833334,13838128,70943651,4794,373274789,9056,3
105369668,LOC105369668,chr12,F,13582054,13620069,70981666,38015,373312804,9057,4
105369669,LOC105369669,chr12,R,14733576,14770662,71018752,37086,373349890,9058,4
105369670,LOC105369670,chr12,R,14962603,14989661,71045810,27058,373376948,9059,2
105369671,LOC105369671,chr12,F,15162910,15172272,71055172,9362,373386310,9060,2
105369672,LOC105369672,chr12,R,15521941,15555769,71089000,33828,373420138,9061,5
105369673,LOC105369673,chr12,R,15239347,15348497,71198150,109150,373529288,9062,6
105369674,LOC105369674,chr12,F,15246458,15265279,71216971,18821,373548109,9063,2
105369675,LOC105369675,chr12,F,16060828,16236798,71392941,175970,373724079,9064,5
105369676,LOC105369676,chr12,F,16796593,16854342,71450690,57749,373781828,9065,2
105369677,LOC105369677,chr12,R,16787935,16988633,71651388,200698,373982526,9066,5
105369678,LOC105369678,chr12,R,17581387,17589080,71659081,7693,373990219,9067,4
105369679,LOC105369679,chr12,F,18714850,18726817,71671048,11967,374002186,9068,3
105369680,LOC105369680,chr12,R,18413137,18501176,71759087,88039,374090225,9069,2
105369681,LOC105369681,chr12,R,19276603,19306609,71789093,30006,374120231,9070,5
105369682,LOC105369682,chr12,R,19843746,19850510,71795857,6764,374126995,9071,2
105369683,LOC105369683,chr12,F,20009881,20012616,71798592,2735,374129730,9072,2
105369684,LOC105369684,chr12,R,20121028,20136259,71813823,15231,374144961,9073,5
105369685,LOC105369685,chr12,R,20104586,20109904,71819141,5318,374150279,9074,2
105369686,LOC105369686,chr12,F,20192443,20211926,71838624,19483,374169762,9075,2
105369687,LOC105369687,chr12,F,20212469,20215215,71841370,2746,374172508,9076,2
105369688,LOC105369688,chr12,R,20320670,20328654,71849354,7984,374180492,9077,2
105369689,LOC105369689,chr12,F,21662312,21828991,72016033,166679,374347171,9078,4
105369690,LOC105369690,chr12,R,22063888,22083113,72035258,19225,374366396,9079,5
105369691,LOC105369691,chr12,R,22576570,22625099,72083787,48529,374414925,9080,3
105369692,LOC105369692,chr12,F,22578296,22599815,72105306,21519,374436444,9081,3
105369693,LOC105369693,chr12,F,22859177,22972463,72218592,113286,374549730,9082,5
105369694,LOC105369694,chr12,F,23046112,23126723,72299203,80611,374630341,9083,4
105369695,LOC105369695,chr12,F,24049662,24081218,72330759,31556,374661897,9084,3
105369696,LOC105369696,chr12,F,23738649,23757019,72349129,18370,374680267,9085,2
105369697,LOC105369697,chr12,F,23626959,23640625,72362795,13666,374693933,9086,4
105369699,LOC105369699,chr12,F,24818669,24836555,72380681,17886,374711819,9087,4
105369701,LOC105369701,chr12,R,25342604,25357942,72396019,15338,374727157,9088,3
105369702,LOC105369702,chr12,R,26008336,26011570,72399253,3234,374730391,9089,2
105369703,LOC105369703,chr12,R,25944855,25947557,72401955,2702,374733093,9090,1
105369704,LOC105369704,chr12,R,26273328,26275988,72404615,2660,374735753,9091,1
105369705,LOC105369705,chr12,F,26252873,26304350,72456092,51477,374787230,9092,6
105369706,LOC105369706,chr12,F,26783107,26819012,72491997,35905,374823135,9093,4
105369707,LOC105369707,chr12,R,27315356,27332797,72509438,17441,374840576,9094,2
105369708,LOC105369708,chr12,R,27280647,27291550,72520341,10903,374851479,9095,2
105369709,LOC105369709,chr12,R,27811101,27824097,72533337,12996,374864475,9096,2
105369710,LOC105369710,chr12,R,28036663,28129572,72626246,92909,374957384,9097,5
105369711,LOC105369711,chr12,R,28715345,28795050,72705951,79705,375037089,9098,3
105369712,LOC105369712,chr12,F,29052746,29056133,72709338,3387,375040476,9099,2
105369713,LOC105369713,chr12,F,29560064,29562626,72711900,2562,375043038,9100,2
105369714,LOC105369714,chr12,F,29518623,29532657,72725934,14034,375057072,9101,2
105369715,LOC105369715,chr12,R,29868737,30051496,72908693,182759,375239831,9102,6
105369716,LOC105369716,chr12,F,29873419,29890563,72925837,17144,375256975,9103,2
105369717,LOC105369717,chr12,R,30230784,30296979,72992032,66195,375323170,9104,5
105369718,LOC105369718,chr12,R,30315008,30320798,72997822,5790,375328960,9105,2
105369719,LOC105369719,chr12,R,30581697,30600830,73016955,19133,375348093,9106,5
105369720,LOC105369720,chr12,R,30615474,30624459,73025940,8985,375357078,9107,4
105369721,LOC105369721,chr12,F,31558031,31568862,73036771,10831,375367909,9108,3
105369722,LOC105369722,chr12,F,31723507,31728860,73042124,5353,375373262,9109,2
105369723,LOC105369723,chr12,R,31876965,31887267,73052426,10302,375383564,9110,1
105369724,LOC105369724,chr12,R,31748803,31757072,73060695,8269,375391833,9111,3
105369725,LOC105369725,chr12,R,31958492,31959219,73061422,727,375392560,9112,1
105369726,LOC105369726,chr12,F,33685980,33691838,73067280,5858,375398418,9113,2
105369727,LOC105369727,chr12,F,34036910,34057906,73088276,20996,375419414,9114,2
105369728,LOC105369728,chr12,R,9647013,9653535,73094798,6522,375425936,9115,3
105369729,LOC105369729,chr12,F,37541739,37577517,73130576,35778,375461714,9116,7
105369730,LOC105369730,chr12,R,39087492,39095745,73138829,8253,375469967,9117,3
105369731,LOC105369731,chr12,F,39538793,39550561,73150597,11768,375481735,9118,1
105369732,LOC105369732,chr12,F,40072154,40085255,73163698,13101,375494836,9119,2
105369733,LOC105369733,chr12,F,39823694,39829359,73169363,5665,375500501,9120,1
105369734,LOC105369734,chr12,F,40156031,40168375,73181707,12344,375512845,9121,2
105369735,LOC105369735,chr12,F,40207540,40210471,73184638,2931,375515776,9122,2
105369736,LOC105369736,chr12,R,40354499,40443896,73274035,89397,375605173,9123,9
105369737,LOC105369737,chr12,R,42023610,42026585,73277010,2975,375608148,9124,1
105369738,LOC105369738,chr12,F,42646582,42652583,73283011,6001,375614149,9125,2
105369739,LOC105369739,chr12,F,42682792,42717098,73317317,34306,375648455,9126,8
105369740,LOC105369740,chr12,F,43154442,43163820,73326695,9378,375657833,9127,3
105369741,LOC105369741,chr12,F,44322124,44323258,73327829,1134,375658967,9128,2
105369742,LOC105369742,chr12,F,45035133,45045641,73338337,10508,375669475,9129,2
105369743,LOC105369743,chr12,R,45378119,45568843,73529061,190724,375860199,9130,8
105369744,LOC105369744,chr12,R,45595874,45610610,73543797,14736,375874935,9131,2
105369745,LOC105369745,chr12,R,45825918,45849646,73567525,23728,375898663,9132,5
105369746,LOC105369746,chr12,R,47237670,47250459,73580314,12789,375911452,9133,1
105369747,LOC105369747,chr12,R,47305916,47307399,73581797,1483,375912935,9134,1
105369748,LOC105369748,chr12,F,47706057,47740134,73615874,34077,375947012,9135,6
105369749,LOC105369749,chr12,F,47846814,47852657,73621717,5843,375952855,9136,1
105369750,LOC105369750,chr12,F,48014102,48031876,73639491,17774,375970629,9137,5
105369751,LOC105369751,chr12,F,47996598,47998004,73640897,1406,375972035,9138,3
105369752,LOC105369752,chr12,F,47980656,47982875,73643116,2219,375974254,9139,3
105369753,LOC105369753,chr12,R,48279015,48307443,73671544,28428,376002682,9140,3
105369754,LOC105369754,chr12,F,48357560,48361380,73675364,3820,376006502,9141,1
105369755,LOC105369755,chr12,F,48851438,48852549,73676475,1111,376007613,9142,1
105369756,LOC105369756,chr12,F,48987780,48988743,73677438,963,376008576,9143,2
105369757,LOC105369757,chr12,R,48982498,48987194,73682134,4696,376013272,9144,4
105369758,LOC105369758,chr12,F,48998366,49019809,73703577,21443,376034715,9145,1
105369759,LOC105369759,chr12,F,49091397,49096969,73709149,5572,376040287,9146,4
105369760,LOC105369760,chr12,F,49131625,49147865,73725389,16240,376056527,9147,2
105369761,LOC105369761,chr12,R,49550339,49553199,73728249,2860,376059387,9148,2
105369762,LOC105369762,chr12,F,49707720,49731390,73751919,23670,376083057,9149,3
105369763,LOC105369763,chr12,F,49942746,49946888,73756061,4142,376087199,9150,3
105369764,LOC105369764,chr12,R,49965169,49970532,73761424,5363,376092562,9151,1
105369765,LOC105369765,chr12,R,50744892,50763560,73780092,18668,376111230,9152,2
105369767,LOC105369767,chr12,R,51322605,51324008,73781495,1403,376112633,9153,1
105369768,LOC105369768,chr12,R,51466777,51467364,73782082,587,376113220,9154,1
105369770,LOC105369770,chr12,F,52065119,52069966,73786929,4847,376118067,9155,2
105369771,LOC105369771,chr12,R,52105710,52118841,73800060,13131,376131198,9156,2
105369772,LOC105369772,chr12,R,52629764,52631549,73801845,1785,376132983,9157,2
105369773,LOC105369773,chr12,R,53106823,53115377,73810399,8554,376141537,9158,2
105369774,LOC105369774,chr12,F,53726425,53731221,73815195,4796,376146333,9159,3
105369775,LOC105369775,chr12,R,53953555,53956427,73818067,2872,376149205,9160,2
105369776,LOC105369776,chr12,F,54142601,54147422,73822888,4821,376154026,9161,2
105369777,LOC105369777,chr12,F,54189096,54201845,73835637,12749,376166775,9162,3
105369779,LOC105369779,chr12,F,55729281,55730862,73837218,1581,376168356,9163,1
105369780,LOC105369780,chr12,R,56019744,56041712,73859186,21968,376190324,9164,5
105369781,LOC105369781,chr12,R,56010091,56014750,73863845,4659,376194983,9165,2
105369782,LOC105369782,chr12,R,56103204,56104474,73865115,1270,376196253,9166,1
105369783,LOC105369783,chr12,F,57826408,57843761,73882468,17353,376213606,9167,1
105369784,LOC105369784,chr12,R,58081119,58099618,73900967,18499,376232105,9168,5
105369785,LOC105369785,chr12,F,58087891,58093386,73906462,5495,376237600,9169,3
105369786,LOC105369786,chr12,R,58176306,58178151,73908307,1845,376239445,9170,2
105369787,LOC105369787,chr12,R,58335838,58336628,73909097,790,376240235,9171,1
105369788,LOC105369788,chr12,F,58444556,58463985,73928526,19429,376259664,9172,3
105369789,LOC105369789,chr12,R,58550943,58556861,73934444,5918,376265582,9173,2
105369790,LOC105369790,chr12,F,58588302,58590854,73936996,2552,376268134,9174,2
105369791,LOC105369791,chr12,F,58920629,59165442,74181809,244813,376512947,9175,6
105369792,LOC105369792,chr12,R,59486917,59524149,74219041,37232,376550179,9176,5
105369793,LOC105369793,chr12,R,61669036,61682235,74232240,13199,376563378,9177,3
105369794,LOC105369794,chr12,R,61682283,61699884,74249841,17601,376580979,9178,3
105369795,LOC105369795,chr12,F,62840360,62896169,74305650,55809,376636788,9179,3
105369797,LOC105369797,chr12,R,63545474,63549368,74309544,3894,376640682,9180,2
105369798,LOC105369798,chr12,R,64099419,64130267,74340392,30848,376671530,9181,1
105369799,LOC105369799,chr12,R,64091934,64098297,74346755,6363,376677893,9182,2
105369800,LOC105369800,chr12,R,64091327,64091918,74347346,591,376678484,9183,1
105369801,LOC105369801,chr12,R,63994881,64020588,74373053,25707,376704191,9184,6
105369802,LOC105369802,chr12,F,64469210,64470190,74374033,980,376705171,9185,1
105369803,LOC105369803,chr12,R,64515380,64537416,74396069,22036,376727207,9186,3
105369804,LOC105369804,chr12,R,64599077,64610368,74407360,11291,376738498,9187,1
105369806,LOC105369806,chr12,F,65622309,65629787,74414838,7478,376745976,9188,3
105369807,LOC105369807,chr12,F,65582206,65622223,74454855,40017,376785993,9189,5
105369808,LOC105369808,chr12,F,65556992,65560084,74457947,3092,376789085,9190,3
105369809,LOC105369809,chr12,F,65473890,65489889,74473946,15999,376805084,9191,3
105369810,LOC105369810,chr12,R,66027692,66032392,74478646,4700,376809784,9192,2
105369811,LOC105369811,chr12,F,66362396,66371837,74488087,9441,376819225,9193,2
105369812,LOC105369812,chr12,F,67354653,67455618,74589052,100965,376920190,9194,7
105369813,LOC105369813,chr12,R,67380818,67388542,74596776,7724,376927914,9195,2
105369814,LOC105369814,chr12,F,67545385,67547872,74599263,2487,376930401,9196,2
105369815,LOC105369815,chr12,R,67570953,67589947,74618257,18994,376949395,9197,2
105369816,LOC105369816,chr12,F,67678216,67683038,74623079,4822,376954217,9198,1
105369817,LOC105369817,chr12,F,67689426,67692216,74625869,2790,376957007,9199,1
105369818,LOC105369818,chr12,F,68198464,68313102,74740507,114638,377071645,9200,2
105369819,LOC105369819,chr12,F,68333665,68337556,74744398,3891,377075536,9201,2
105369820,LOC105369820,chr12,F,68781810,68793968,74756556,12158,377087694,9202,2
105369821,LOC105369821,chr12,F,69212335,69222526,74766747,10191,377097885,9203,2
105369822,LOC105369822,chr12,F,69431550,69461008,74796205,29458,377127343,9204,2
105369823,LOC105369823,chr12,F,69624432,69639013,74810786,14581,377141924,9205,2
105369824,LOC105369824,chr12,F,70064393,70085135,74831528,20742,377162666,9206,3
105369825,LOC105369825,chr12,R,70254967,70314854,74891415,59887,377222553,9207,4
105369826,LOC105369826,chr12,F,70180332,70201014,74912097,20682,377243235,9208,2
105369827,LOC105369827,chr12,F,70468095,70513227,74957229,45132,377288367,9209,4
105369828,LOC105369828,chr12,F,70521519,70571019,75006729,49500,377337867,9210,7
105369829,LOC105369829,chr12,F,70719339,70773765,75061155,54426,377392293,9211,2
105369830,LOC105369830,chr12,R,71109840,71118109,75069424,8269,377400562,9212,2
105369831,LOC105369831,chr12,F,71217022,71220821,75073223,3799,377404361,9213,2
105369832,LOC105369832,chr12,R,71276085,71315893,75113031,39808,377444169,9214,4
105369833,LOC105369833,chr12,R,71527292,71575195,75160934,47903,377492072,9215,3
105369834,LOC105369834,chr12,R,71430073,71450832,75181693,20759,377512831,9216,2
105369835,LOC105369835,chr12,R,71659220,71663006,75185479,3786,377516617,9217,1
105369836,LOC105369836,chr12,F,71736406,71738181,75187254,1775,377518392,9218,2
105369837,LOC105369837,chr12,F,72148016,72181492,75220730,33476,377551868,9219,2
105369838,LOC105369838,chr12,F,72919849,73042903,75343784,123054,377674922,9220,6
105369839,LOC105369839,chr12,R,73290798,73342971,75395957,52173,377727095,9221,4
105369840,LOC105369840,chr12,F,73758674,73846186,75483469,87512,377814607,9222,3
105369841,LOC105369841,chr12,F,74039416,74048789,75492842,9373,377823980,9223,2
105369842,LOC105369842,chr12,F,74847450,74898846,75544238,51396,377875376,9224,3
105369843,LOC105369843,chr12,R,75015938,75025839,75554139,9901,377885277,9225,5
105369844,LOC105369844,chr12,R,75663724,75694971,75585386,31247,377916524,9226,4
105369845,LOC105369845,chr12,R,75524329,75527868,75588925,3539,377920063,9227,2
105369846,LOC105369846,chr12,R,75772271,75780953,75597607,8682,377928745,9228,5
105369847,LOC105369847,chr12,R,76002407,76009591,75604791,7184,377935929,9229,3
105369848,LOC105369848,chr12,F,76259851,76293837,75638777,33986,377969915,9230,2
105369849,LOC105369849,chr12,F,76293872,76313462,75658367,19590,377989505,9231,2
105369850,LOC105369850,chr12,F,76559841,76615406,75713932,55565,378045070,9232,4
105369851,LOC105369851,chr12,R,76636118,76664977,75742791,28859,378073929,9233,1
105369852,LOC105369852,chr12,F,77010831,77013672,75745632,2841,378076770,9234,3
105369853,LOC105369853,chr12,F,77122434,77152104,75775302,29670,378106440,9235,4
105369854,LOC105369854,chr12,R,77219602,77229665,75785365,10063,378116503,9236,4
105369855,LOC105369855,chr12,R,77309928,77317199,75792636,7271,378123774,9237,2
105369856,LOC105369856,chr12,R,77383053,77391277,75800860,8224,378131998,9238,4
105369857,LOC105369857,chr12,F,77379759,77402954,75824055,23195,378155193,9239,3
105369858,LOC105369858,chr12,R,77330249,77380921,75874727,50672,378205865,9240,2
105369859,LOC105369859,chr12,F,78335584,78352674,75891817,17090,378222955,9241,2
105369860,LOC105369860,chr12,R,78326679,78359746,75924884,33067,378256022,9242,1
105369861,LOC105369861,chr12,R,78423191,78440788,75942481,17597,378273619,9243,2
105369862,LOC105369862,chr12,R,79090601,79167321,76019201,76720,378350339,9244,4
105369863,LOC105369863,chr12,R,78905070,79036913,76151044,131843,378482182,9245,5
105369864,LOC105369864,chr12,F,79715241,79778543,76214346,63302,378545484,9246,2
105369865,LOC105369865,chr12,F,79935280,79941389,76220455,6109,378551593,9247,2
105369866,LOC105369866,chr12,F,80030444,80083692,76273703,53248,378604841,9248,4
105369867,LOC105369867,chr12,R,80550625,80580408,76303486,29783,378634624,9249,2
105369868,LOC105369868,chr12,F,80400694,80423307,76326099,22613,378657237,9250,10
105369869,LOC105369869,chr12,F,80936092,80937633,76327640,1541,378658778,9251,1
105369870,LOC105369870,chr12,F,80873587,80886155,76340208,12568,378671346,9252,3
105369871,LOC105369871,chr12,F,81417080,81471193,76394321,54113,378725459,9253,2
105369872,LOC105369872,chr12,F,81343892,81353236,76403665,9344,378734803,9254,3
105369873,LOC105369873,chr12,R,82138344,82308315,76573636,169971,378904774,9255,3
105369874,LOC105369874,chr12,R,83458771,83472608,76587473,13837,378918611,9256,1
105369875,LOC105369875,chr12,R,84492412,84508846,76603907,16434,378935045,9257,2
105369876,LOC105369876,chr12,F,85318059,85355057,76640905,36998,378972043,9258,4
105369877,LOC105369877,chr12,F,86264557,86270602,76646950,6045,378978088,9259,3
105369878,LOC105369878,chr12,R,87041915,87055246,76660281,13331,378991419,9260,2
105369879,LOC105369879,chr12,F,87330738,87332321,76661864,1583,378993002,9261,1
105369880,LOC105369880,chr12,F,87429151,87440513,76673226,11362,379004364,9262,2
105369881,LOC105369881,chr12,R,87612216,87670542,76731552,58326,379062690,9263,4
105369882,LOC105369882,chr12,F,87815907,87821541,76737186,5634,379068324,9264,2
105369883,LOC105369883,chr12,F,88054419,88082376,76765143,27957,379096281,9265,2
105369884,LOC105369884,chr12,R,88381173,88419332,76803302,38159,379134440,9266,2
105369885,LOC105369885,chr12,F,88597967,88602195,76807530,4228,379138668,9267,1
105369886,LOC105369886,chr12,R,88749452,88770156,76828234,20704,379159372,9268,2
105369887,LOC105369887,chr12,R,88781949,88784285,76830570,2336,379161708,9269,2
105369888,LOC105369888,chr12,F,89639580,89647020,76838010,7440,379169148,9270,2
105369889,LOC105369889,chr12,F,89352602,89455111,76940519,102509,379271657,9271,7
105369890,LOC105369890,chr12,F,89919421,90112278,77133376,192857,379464514,9272,15
105369891,LOC105369891,chr12,F,89947599,89949726,77135503,2127,379466641,9273,2
105369892,LOC105369892,chr12,F,90253824,90263894,77145573,10070,379476711,9274,2
105369893,LOC105369893,chr12,F,90293317,90300378,77152634,7061,379483772,9275,3
105369894,LOC105369894,chr12,F,90576279,90631103,77207458,54824,379538596,9276,3
105369895,LOC105369895,chr12,R,90761802,90809151,77254807,47349,379585945,9277,3
105369896,LOC105369896,chr12,R,91365633,91399373,77288547,33740,379619685,9278,4
105369897,LOC105369897,chr12,F,91326959,91368601,77330189,41642,379661327,9279,6
105369898,LOC105369898,chr12,R,91228959,91365436,77466666,136477,379797804,9280,5
105369899,LOC105369899,chr12,R,91485901,91633824,77614589,147923,379945727,9281,2
105369900,LOC105369900,chr12,F,91875302,91880655,77619942,5353,379951080,9282,3
105369901,LOC105369901,chr12,R,91918365,91961098,77662675,42733,379993813,9283,3
105369902,LOC105369902,chr12,F,92349344,92388403,77701734,39059,380032872,9284,2
105369903,LOC105369903,chr12,F,92272641,92273897,77702990,1256,380034128,9285,2
105369904,LOC105369904,chr12,F,92505322,92512399,77710067,7077,380041205,9286,3
105369905,LOC105369905,chr12,F,92557248,92629891,77782710,72643,380113848,9287,2
105369906,LOC105369906,chr12,F,92989823,93020571,77813458,30748,380144596,9288,3
105369907,LOC105369907,chr12,F,93090230,93096154,77819382,5924,380150520,9289,3
105369908,LOC105369908,chr12,F,93096199,93109302,77832485,13103,380163623,9290,3
105369910,LOC105369910,chr12,R,93388388,93398761,77842858,10373,380173996,9291,1
105369911,LOC105369911,chr12,R,93894964,93943606,77891500,48642,380222638,9292,3
105369912,LOC105369912,chr12,R,93969695,94012119,77933924,42424,380265062,9293,3
105369913,LOC105369913,chr12,F,94042819,94048613,77939718,5794,380270856,9294,2
105369914,LOC105369914,chr12,F,94648496,94651091,77942313,2595,380273451,9295,2
105369915,LOC105369915,chr12,R,94897054,94928258,77973517,31204,380304655,9296,3
105369916,LOC105369916,chr12,R,95337569,95342887,77978835,5318,380309973,9297,2
105369917,LOC105369917,chr12,R,95358387,95380762,78001210,22375,380332348,9298,2
105369918,LOC105369918,chr12,F,95738159,95748904,78011955,10745,380343093,9299,2
105369919,LOC105369919,chr12,R,95717105,95725015,78019865,7910,380351003,9300,3
105369920,LOC105369920,chr12,F,95803096,95823314,78040083,20218,380371221,9301,1
105369921,LOC105369921,chr12,R,95791781,95838668,78086970,46887,380418108,9302,3
105369922,LOC105369922,chr12,R,95858236,95858830,78087564,594,380418702,9303,1
105369923,LOC105369923,chr12,F,96096306,96108624,78099882,12318,380431020,9304,2
105369924,LOC105369924,chr12,R,96160920,96171999,78110961,11079,380442099,9305,2
105369926,LOC105369926,chr12,R,97019568,97025288,78116681,5720,380447819,9306,2
105369927,LOC105369927,chr12,R,97193746,97228433,78151368,34687,380482506,9307,2
105369928,LOC105369928,chr12,F,97185081,97212723,78179010,27642,380510148,9308,2
105369929,LOC105369929,chr12,R,97270098,97275112,78184024,5014,380515162,9309,3
105369930,LOC105369930,chr12,F,97270020,97271530,78185534,1510,380516672,9310,2
105369932,LOC105369932,chr12,F,98294472,98304683,78195745,10211,380526883,9311,4
105369933,LOC105369933,chr12,R,98337757,98350599,78208587,12842,380539725,9312,3
105369934,LOC105369934,chr12,F,99131034,99135125,78212678,4091,380543816,9313,2
105369935,LOC105369935,chr12,F,101526353,101534280,78220605,7927,380551743,9314,3
105369936,LOC105369936,chr12,R,101659837,101665062,78225830,5225,380556968,9315,2
105369938,LOC105369938,chr12,R,101600927,101618839,78243742,17912,380574880,9316,4
105369939,LOC105369939,chr12,F,101694564,101695841,78245019,1277,380576157,9317,1
105369940,LOC105369940,chr12,F,101743989,101745279,78246309,1290,380577447,9318,1
105369941,LOC105369941,chr12,R,101923363,101924719,78247665,1356,380578803,9319,1
105369942,LOC105369942,chr12,F,102281269,102463647,78430043,182378,380761181,9320,13
105369943,LOC105369943,chr12,R,102326910,102350918,78454051,24008,380785189,9321,3
105369945,LOC105369945,chr12,F,103496044,103497695,78455702,1651,380786840,9322,2
105369946,LOC105369946,chr12,R,103668737,103671526,78458491,2789,380789629,9323,4
105369947,LOC105369947,chr12,F,104140257,104148544,78466778,8287,380797916,9324,2
105369948,LOC105369948,chr12,F,104169971,104177652,78474459,7681,380805597,9325,3
105369949,LOC105369949,chr12,F,104377587,104398688,78495560,21101,380826698,9326,3
105369950,LOC105369950,chr12,F,104864910,104870566,78501216,5656,380832354,9327,1
105369951,LOC105369951,chr12,R,104994811,105007672,78514077,12861,380845215,9328,2
105369952,LOC105369952,chr12,R,104984205,104986387,78516259,2182,380847397,9329,2
105369953,LOC105369953,chr12,F,105200060,105211913,78528112,11853,380859250,9330,2
105369954,LOC105369954,chr12,R,105303551,105326985,78551546,23434,380882684,9331,2
105369955,LOC105369955,chr12,F,105424099,105442764,78570211,18665,380901349,9332,3
105369956,LOC105369956,chr12,R,105426180,105444135,78588166,17955,380919304,9333,2
105369957,LOC105369957,chr12,F,105372126,105412881,78628921,40755,380960059,9334,6
105369958,LOC105369958,chr12,F,105509774,105550037,78669184,40263,381000322,9335,5
105369959,LOC105369959,chr12,R,105705195,105708027,78672016,2832,381003154,9336,2
105369960,LOC105369960,chr12,F,105783977,105787678,78675717,3701,381006855,9337,2
105369961,LOC105369961,chr12,R,106862621,106885505,78698601,22884,381029739,9338,4
105369962,LOC105369962,chr12,F,107441957,107449844,78706488,7887,381037626,9339,2
105369963,LOC105369963,chr12,R,107795422,107799183,78710249,3761,381041387,9340,2
105369964,LOC105369964,chr12,F,107910419,107916265,78716095,5846,381047233,9341,5
105369965,LOC105369965,chr12,R,108178076,108234367,78772386,56291,381103524,9342,8
105369966,LOC105369966,chr12,F,108473206,108475906,78775086,2700,381106224,9343,2
105369967,LOC105369967,chr12,R,108479643,108516908,78812351,37265,381143489,9344,5
105369968,LOC105369968,chr12,F,108628466,108645249,78829134,16783,381160272,9345,2
105369969,LOC105369969,chr12,F,108733408,108754415,78850141,21007,381181279,9346,2
105369970,LOC105369970,chr12,F,45990061,46004827,78864907,14766,381196045,9347,3
105369971,LOC105369971,chr12,F,51847780,51853515,78870642,5735,381201780,9348,4
105369972,LOC105369972,chr12,R,58323534,58332034,78879142,8500,381210280,9349,2
105369974,LOC105369974,chr12,R,109118686,109131869,78892325,13183,381223463,9350,2
105369975,LOC105369975,chr12,R,109840326,109843373,78895372,3047,381226510,9351,1
105369976,LOC105369976,chr12,R,110082723,110102376,78915025,19653,381246163,9352,2
105369977,LOC105369977,chr12,R,110470290,110489282,78934017,18992,381265155,9353,2
105369979,LOC105369979,chr12,F,110662671,110670451,78941797,7780,381272935,9354,1
105369980,LOC105369980,chr12,R,110956295,110957761,78943263,1466,381274401,9355,2
105369981,LOC105369981,chr12,R,111012242,111026007,78957028,13765,381288166,9356,3
105369982,LOC105369982,chr12,F,111026326,111032964,78963666,6638,381294804,9357,1
105369983,LOC105369983,chr12,R,111285226,111320162,78998602,34936,381329740,9358,3
105369984,LOC105369984,chr12,F,111396829,111403313,79005086,6484,381336224,9359,1
105369985,LOC105369985,chr12,R,111436871,111439030,79007245,2159,381338383,9360,1
105369986,LOC105369986,chr12,R,112557760,112558427,79007912,667,381339050,9361,1
105369988,LOC105369988,chr12,R,113136506,113142361,79013767,5855,381344905,9362,2
105369989,LOC105369989,chr12,R,113353456,113360663,79020974,7207,381352112,9363,2
105369990,LOC105369990,chr12,F,113639042,113644515,79026447,5473,381357585,9364,3
105369991,LOC105369991,chr12,F,113653887,113656000,79028560,2113,381359698,9365,2
105369992,LOC105369992,chr12,R,113838258,113840054,79030356,1796,381361494,9366,2
105369993,LOC105369993,chr12,F,114011258,114031052,79050150,19794,381381288,9367,6
105369994,LOC105369994,chr12,R,114073180,114077037,79054007,3857,381385145,9368,2
105369995,LOC105369995,chr12,F,114077132,114195426,79172301,118294,381503439,9369,10
105369996,LOC105369996,chr12,R,114238221,114242173,79176253,3952,381507391,9370,2
105369997,LOC105369997,chr12,F,114405712,114407019,79177560,1307,381508698,9371,1
105369998,LOC105369998,chr12,R,114414356,114448646,79211850,34290,381542988,9372,5
105369999,LOC105369999,chr12,R,114733759,114735788,79213879,2029,381545017,9373,1
105370000,LOC105370000,chr12,F,114713840,114734111,79234150,20271,381565288,9374,8
105370001,LOC105370001,chr12,F,115040650,115077476,79270976,36826,381602114,9375,4
105370002,LOC105370002,chr12,R,115597041,115641122,79315057,44081,381646195,9376,3
105370003,LOC105370003,chr12,R,115373835,115763260,79704482,389425,382035620,9377,4
105370004,LOC105370004,chr12,R,115808379,115877463,79773566,69084,382104704,9378,3
105370005,LOC105370005,chr12,R,116340201,116350727,79784092,10526,382115230,9379,2
105370006,LOC105370006,chr12,F,116359382,116360570,79785280,1188,382116418,9380,2
105370007,LOC105370007,chr12,R,116484427,116488505,79789358,4078,382120496,9381,2
105370008,LOC105370008,chr12,R,116504966,116508216,79792608,3250,382123746,9382,2
105370009,LOC105370009,chr12,F,116537009,116554381,79809980,17372,382141118,9383,4
105370010,LOC105370010,chr12,R,117105476,117121031,79825535,15555,382156673,9384,4
105370011,LOC105370011,chr12,F,117832667,117844760,79837628,12093,382168766,9385,5
105370012,LOC105370012,chr12,F,117513552,117517190,79841266,3638,382172404,9386,2
105370013,LOC105370013,chr12,R,118644691,118650401,79846976,5710,382178114,9387,3
105370014,LOC105370014,chr12,R,118758801,118761689,79849864,2888,382181002,9388,2
105370015,LOC105370015,chr12,R,118773055,118774733,79851542,1678,382182680,9389,3
105370016,LOC105370016,chr12,R,118782955,118833536,79902123,50581,382233261,9390,4
105370017,LOC105370017,chr12,F,118781039,118834639,79955723,53600,382286861,9391,5
105370018,LOC105370018,chr12,F,118837488,118867985,79986220,30497,382317358,9392,7
105370019,LOC105370019,chr12,F,118871454,118920284,80035050,48830,382366188,9393,6
105370020,LOC105370020,chr12,R,118945683,118956189,80045556,10506,382376694,9394,4
105370021,LOC105370021,chr12,R,119069343,119124985,80101198,55642,382432336,9395,3
105370022,LOC105370022,chr12,R,119030927,119052216,80122487,21289,382453625,9396,2
105370023,LOC105370023,chr12,F,118990413,119001750,80133824,11337,382464962,9397,4
105370024,LOC105370024,chr12,R,119174064,119176484,80136244,2420,382467382,9398,1
105370025,LOC105370025,chr12,R,119224699,119250464,80162009,25765,382493147,9399,2
105370026,LOC105370026,chr12,F,119210937,119221452,80172524,10515,382503662,9400,2
105370027,LOC105370027,chr12,R,119387990,119668006,80452540,280016,382783678,9401,7
105370028,LOC105370028,chr12,R,120700448,120704370,80456462,3922,382787600,9402,1
105370029,LOC105370029,chr12,R,120676074,120687026,80467414,10952,382798552,9403,3
105370030,LOC105370030,chr12,F,121109588,121120157,80477983,10569,382809121,9404,4
105370031,LOC105370031,chr12,R,121100690,121108922,80486215,8232,382817353,9405,2
105370032,LOC105370032,chr12,R,121162334,121209934,80533815,47600,382864953,9406,3
105370034,LOC105370034,chr12,F,121663523,121690417,80560709,26894,382891847,9407,5
105370035,LOC105370035,chr12,F,121857749,121870211,80573171,12462,382904309,9408,1
105370037,LOC105370037,chr12,F,122656948,122661957,80578180,5009,382909318,9409,2
105370038,LOC105370038,chr12,F,122836423,122843921,80585678,7498,382916816,9410,2
105370039,LOC105370039,chr12,F,122864139,122865607,80587146,1468,382918284,9411,1
105370040,LOC105370040,chr12,R,123252029,123260353,80595470,8324,382926608,9412,2
105370041,LOC105370041,chr12,R,123613312,123617750,80599908,4438,382931046,9413,2
105370042,LOC105370042,chr12,R,123712692,123724108,80611324,11416,382942462,9414,2
105370043,LOC105370043,chr12,R,123919431,123921707,80613600,2276,382944738,9415,1
105370044,LOC105370044,chr12,R,123764130,123790927,80640397,26797,382971535,9416,4
105370045,LOC105370045,chr12,F,124295090,124301978,80647285,6888,382978423,9417,1
105370046,LOC105370046,chr12,F,124205985,124208380,80649680,2395,382980818,9418,1
105370047,LOC105370047,chr12,F,124512508,124516861,80654033,4353,382985171,9419,2
105370048,LOC105370048,chr12,R,124395391,124398099,80656741,2708,382987879,9420,1
105370049,LOC105370049,chr12,R,124620828,124684204,80720117,63376,383051255,9421,2
105370050,LOC105370050,chr12,F,124865518,124877917,80732516,12399,383063654,9422,2
105370051,LOC105370051,chr12,R,124882086,124900419,80750849,18333,383081987,9423,3
105370052,LOC105370052,chr12,R,125079840,125083301,80754310,3461,383085448,9424,2
105370053,LOC105370053,chr12,F,125151513,125160922,80763719,9409,383094857,9425,2
105370054,LOC105370054,chr12,R,125272658,125281295,80772356,8637,383103494,9426,2
105370055,LOC105370055,chr12,F,125704485,125707819,80775690,3334,383106828,9427,2
105370056,LOC105370056,chr12,R,126015766,126034009,80793933,18243,383125071,9428,4
105370057,LOC105370057,chr12,F,125985711,126043480,80851702,57769,383182840,9429,12
105370058,LOC105370058,chr12,R,125994249,126002019,80859472,7770,383190610,9430,1
105370059,LOC105370059,chr12,F,126425957,126434206,80867721,8249,383198859,9431,3
105370060,LOC105370060,chr12,F,126688365,126720796,80900152,32431,383231290,9432,7
105370061,LOC105370061,chr12,F,126874800,126888692,80914044,13892,383245182,9433,5
105370062,LOC105370062,chr12,R,127150528,127163343,80926859,12815,383257997,9434,2
105370063,LOC105370063,chr12,F,126975913,127028040,80978986,52127,383310124,9435,8
105370065,LOC105370065,chr12,R,127274264,127284300,80989022,10036,383320160,9436,4
105370066,LOC105370066,chr12,F,127459953,127470411,80999480,10458,383330618,9437,3
105370067,LOC105370067,chr12,F,127486314,127507532,81020698,21218,383351836,9438,3
105370068,LOC105370068,chr12,R,127649226,127651340,81022812,2114,383353950,9439,1
105370069,LOC105370069,chr12,R,127719110,127721624,81025326,2514,383356464,9440,2
105370070,LOC105370070,chr12,R,128022364,128027172,81030134,4808,383361272,9441,3
105370071,LOC105370071,chr12,R,128072256,128074306,81032184,2050,383363322,9442,2
105370072,LOC105370072,chr12,F,128825679,128829350,81035855,3671,383366993,9443,2
105370073,LOC105370073,chr12,F,129021726,129028884,81043013,7158,383374151,9444,2
105370074,LOC105370074,chr12,F,129460603,129468602,81051012,7999,383382150,9445,4
105370076,LOC105370076,chr12,F,129957582,129975730,81069160,18148,383400298,9446,6
105370077,LOC105370077,chr12,R,130067242,130071281,81073199,4039,383404337,9447,6
105370078,LOC105370078,chr12,F,130071330,130072685,81074554,1355,383405692,9448,1
105370079,LOC105370079,chr12,F,130635786,130638233,81077001,2447,383408139,9449,2
105370081,LOC105370081,chr12,F,131028283,131031474,81080192,3191,383411330,9450,1
105370082,LOC105370082,chr12,R,131237946,131268678,81110924,30732,383442062,9451,4
105370083,LOC105370083,chr12,F,131298927,131300689,81112686,1762,383443824,9452,3
105370084,LOC105370084,chr12,R,131583581,131591794,81120899,8213,383452037,9453,2
105370085,LOC105370085,chr12,R,131641714,131648121,81127306,6407,383458444,9454,2
105370086,LOC105370086,chr12,R,131659473,131661886,81129719,2413,383460857,9455,3
105370087,LOC105370087,chr12,F,131677707,131681053,81133065,3346,383464203,9456,2
105370088,LOC105370088,chr12,R,131817182,131823034,81138917,5852,383470055,9457,3
105370089,LOC105370089,chr12,F,131808938,131817759,81147738,8821,383478876,9458,2
105370090,LOC105370090,chr12,R,132159625,132162970,81151083,3345,383482221,9459,2
105370091,LOC105370091,chr12,F,132199273,132205472,81157282,6199,383488420,9460,4
105370092,LOC105370092,chr12,R,132427419,132437437,81167300,10018,383498438,9461,4
105370093,LOC105370093,chr12,F,132608002,132610421,81169719,2419,383500857,9462,2
105370094,LOC105370094,chr12,F,132595536,132601788,81175971,6252,383507109,9463,3
105370095,LOC105370095,chr12,F,132762159,132768211,81182023,6052,383513161,9464,2
105370096,LOC105370096,chr12,R,133065539,133078646,81195130,13107,383526268,9465,3
105370097,LOC105370097,chr12,R,133106694,133110158,81198594,3464,383529732,9466,1
105376675,LOC105376675,chr12,R,10566989,10570094,81201699,3105,383532837,9467,1
105376676,LOC105376676,chr12,R,11095761,11124254,81230192,28493,383561330,9468,3
105376677,LOC105376677,chr12,F,34028663,34035296,81236825,6633,383567963,9469,1
105376678,LOC105376678,chr12,F,9448793,9503089,81291121,54296,383622259,9470,9
105378246,LOC105378246,chr12,F,39746007,39802611,81347725,56604,383678863,9471,3
105378247,LOC105378247,chr12,R,41979459,41989168,81357434,9709,383688572,9472,2
105378248,LOC105378248,chr12,F,46269110,46275520,81363844,6410,383694982,9473,2
105378249,LOC105378249,chr12,R,51839119,51846959,81371684,7840,383702822,9474,1
105378250,LOC105378250,chr12,F,53754356,53762272,81379600,7916,383710738,9475,2
105378251,LOC105378251,chr12,F,68185585,68196507,81390522,10922,383721660,9476,1
105378252,LOC105378252,chr12,R,80624015,80707218,81473725,83203,383804863,9477,2
105378253,LOC105378253,chr12,R,80497240,80514070,81490555,16830,383821693,9478,2
105378254,LOC105378254,chr12,F,80424258,80435269,81501566,11011,383832704,9479,3
105378255,LOC105378255,chr12,F,89222378,89230010,81509198,7632,383840336,9480,2
105378256,LOC105378256,chr12,F,108983754,109007750,81533194,23996,383864332,9481,2
105378257,LOC105378257,chr12,F,118381601,118383725,81535318,2124,383866456,9482,1
105378258,LOC105378258,chr12,R,121059289,121074209,81550238,14920,383881376,9483,2
105378259,LOC105378259,chr12,F,123384220,123385447,81551465,1227,383882603,9484,1
143,PARP4,chr13,R,24420929,24512993,92064,92064,383974667,9485,35
241,ALOX5AP,chr13,F,30713477,30764428,143015,50951,384025618,9486,7
479,ATP12A,chr13,F,24680410,24711785,174390,31375,384056993,9487,22
496,ATP4B,chr13,R,113648803,113658198,183785,9395,384066388,9488,6
540,ATP7B,chr13,R,51891085,52012099,304799,121014,384187402,9489,32
675,BRCA2,chr13,F,32314861,32399850,389788,84989,384272391,9490,27
688,KLF5,chr13,F,73054975,73077542,412355,22567,384294958,9491,4
690,BTF3P11,chr13,F,76928450,76929090,412995,640,384295598,9492,0
1024,CDK8,chr13,F,26254124,26405238,564109,151114,384446712,9493,15
1045,CDX2,chr13,R,27960056,27969368,573421,9312,384456024,9494,4
1102,RCBTB2,chr13,R,48488962,48533256,617715,44294,384500318,9495,15
1203,CLN5,chr13,F,76991923,77002517,628309,10594,384510912,9496,4
1282,COL4A1,chr13,R,110148957,110307157,786509,158200,384669112,9497,53
1284,COL4A2,chr13,F,110307283,110513027,992253,205744,384874856,9498,47
1361,CPB2,chr13,R,46053186,46105076,1044143,51890,384926746,9499,10
1602,DACH1,chr13,R,71437965,71869113,1475291,431148,385357894,9500,14
1638,DCT,chr13,R,94437303,94550265,1588253,112962,385470856,9501,12
1880,GPR183,chr13,R,99294534,99307495,1601214,12961,385483817,9502,1
1910,EDNRB,chr13,R,77895480,77975529,1681263,80049,385563866,9503,9
1948,EFNB2,chr13,R,106489730,106535040,1726573,45310,385609176,9504,4
1997,ELF1,chr13,R,40931918,41061378,1856033,129460,385738636,9505,13
2073,ERCC5,chr13,F,102845840,102876001,1886194,30161,385768797,9506,22
2098,ESD,chr13,R,46771255,46797681,1912620,26426,385795223,9507,12
2155,F7,chr13,F,113105787,113120681,1927514,14894,385810117,9508,9
2159,F10,chr13,F,113122798,113149529,1954245,26731,385836848,9509,7
2254,FGF9,chr13,F,21671075,21704501,1987671,33426,385870274,9510,3
2259,FGF14,chr13,R,101719783,102401774,2669662,681991,386552265,9511,6
2262,GPC5,chr13,F,91398618,92867237,4138281,1468619,388020884,9512,12
2308,FOXO1,chr13,R,40555663,40666660,4249278,110997,388131881,9513,6
2321,FLT1,chr13,R,28300345,28495128,4444061,194783,388326664,9514,32
2322,FLT3,chr13,R,28003273,28100592,4541380,97319,388423983,9515,26
2621,GAS6,chr13,R,113820548,113864103,4584935,43555,388467538,9516,14
2700,GJA3,chr13,R,20138254,20161385,4608066,23131,388490669,9517,2
2706,GJB2,chr13,R,20187462,20192975,4613579,5513,388496182,9518,2
2835,GPR12,chr13,R,26755199,26760785,4619165,5586,388501768,9519,1
2841,GPR18,chr13,R,99254712,99262448,4626901,7736,388509504,9520,4
2862,MLNR,chr13,F,49220337,49222377,4628941,2040,388511544,9521,1
2963,GTF2F2,chr13,F,45120463,45284889,4793367,164426,388675970,9522,9
2971,GTF3A,chr13,F,27424543,27435709,4804533,11166,388687136,9523,8
2974,GUCY1B2,chr13,R,50994510,51066157,4876180,71647,388758783,9524,16
3146,HMGB1,chr13,R,30458739,30465944,4883385,7205,388765988,9525,5
3356,HTR2A,chr13,R,46831541,46897076,4948920,65535,388831523,9526,3
3621,ING1,chr13,F,110712622,110721074,4957372,8452,388839975,9527,3
3651,PDX1,chr13,F,27919993,27926314,4963693,6321,388846296,9528,1
3839,KPNA3,chr13,R,49699306,49792921,5057308,93615,388939911,9529,16
3843,IPO5,chr13,F,97953637,98024296,5127967,70659,389010570,9530,30
3916,LAMP1,chr13,F,113297120,113323431,5154278,26311,389036881,9531,9
3936,LCP1,chr13,R,46125922,46182324,5210680,56402,389093283,9532,16
3981,LIG4,chr13,R,108207441,108218368,5221607,10927,389104210,9533,4
4008,LMO7,chr13,F,75620433,75859870,5461044,239437,389343647,9534,35
4081,MAB21L1,chr13,R,35473788,35476695,5463951,2907,389346554,9535,0
4093,SMAD9,chr13,R,36815913,36920721,5568759,104808,389451362,9536,9
4285,MIPEP,chr13,R,23730187,23889448,5728020,159261,389610623,9537,20
4752,NEK3,chr13,R,52132642,52159861,5755239,27219,389637842,9538,16
5042,PABPC3,chr13,F,25096137,25098567,5757669,2430,389640272,9539,0
5095,PCCA,chr13,F,100089014,100530437,6199092,441423,390081695,9540,26
5100,PCDH8,chr13,R,52843973,52848640,6203759,4667,390086362,9541,2
5101,PCDH9,chr13,R,66302833,67230336,7131262,927503,391013865,9542,6
5412,UBL3,chr13,R,29764404,29850683,7217541,86279,391100144,9543,5
5457,POU4F1,chr13,R,78599091,78603560,7222010,4469,391104613,9544,1
5611,DNAJC3,chr13,F,95677138,95794989,7339861,117851,391222464,9545,13
5911,RAP2A,chr13,F,97434220,97467998,7373639,33778,391256242,9546,1
5925,RB1,chr13,F,48303746,48481890,7551783,178144,391434386,9547,27
5983,RFC3,chr13,F,33818048,33973946,7707681,155898,391590284,9548,14
5994,RFXAP,chr13,F,36819201,36829603,7718083,10402,391600686,9549,2
6011,GRK1,chr13,F,113667278,113671659,7722464,4381,391605067,9550,2
6011,GRK1,chr13,F,113723072,113735664,7735056,12592,391617659,9551,3
6049,RNF6,chr13,R,26132114,26222559,7825501,90445,391708104,9552,5
6144,RPL21,chr13,F,27251554,27256568,7830515,5014,391713118,9553,5
6315,ATXN8OS,chr13,F,70107212,70139753,7863056,32541,391745659,9554,4
6445,SGCG,chr13,F,23160505,23325165,8027716,164660,391910319,9555,9
6541,SLC7A1,chr13,R,29509409,29595688,8113995,86279,391996598,9556,13
6555,SLC10A2,chr13,R,103043997,103066846,8136844,22849,392019447,9557,5
6564,SLC15A1,chr13,R,98683800,98752675,8205719,68875,392088322,9558,22
6656,SOX1,chr13,F,112067598,112071706,8209827,4108,392092430,9559,0
7027,TFDP1,chr13,F,113584687,113641473,8266613,56786,392149216,9560,13
7174,TPP2,chr13,F,102596935,102679174,8348852,82239,392231455,9561,31
7178,TPT1,chr13,R,45333470,45341284,8356666,7814,392239269,9562,5
7223,TRPC4,chr13,R,37633871,37869802,8592597,235931,392475200,9563,10
7278,TUBA3C,chr13,R,19173769,19181852,8600680,8083,392483283,9564,4
7347,UCHL3,chr13,F,75548866,75606020,8657834,57154,392540437,9565,10
7546,ZIC2,chr13,F,99981771,99986765,8662828,4994,392545431,9566,2
7750,ZMYM2,chr13,F,19957431,20091845,8797242,134414,392679845,9567,33
8100,IFT88,chr13,F,20566445,20691437,8922234,124992,392804837,9568,30
8428,STK24,chr13,R,98450198,98577151,9049187,126953,392931790,9569,13
8451,CUL4A,chr13,F,113208192,113265078,9106073,56886,392988676,9570,23
8600,TNFSF11,chr13,F,42562735,42608013,9151351,45278,393033954,9571,8
8660,IRS2,chr13,R,109753836,109786567,9184082,32731,393066685,9572,1
8796,SCEL,chr13,F,77535673,77645263,9293672,109590,393176275,9573,32
8803,SUCLA2,chr13,R,47942655,48001326,9352343,58671,393234946,9574,12
8847,DLEU2,chr13,R,49982551,50125541,9495333,142990,393377936,9575,10
8848,TSC22D1,chr13,R,44432142,44576565,9639756,144423,393522359,9576,8
8858,PROZ,chr13,F,113155060,113172386,9657082,17326,393539685,9577,10
8874,ARHGEF7,chr13,F,111115276,111305734,9847540,190458,393730143,9578,27
8881,CDC16,chr13,F,114234844,114272675,9885371,37831,393767974,9579,18
8900,CCNA1,chr13,F,36431029,36442882,9897224,11853,393779827,9580,10
9071,CLDN10,chr13,F,95433598,95579756,10043382,146158,393925985,9581,6
9107,MTMR6,chr13,R,25246200,25287566,10084748,41366,393967351,9582,15
9201,DCLK1,chr13,R,35768651,36132020,10448117,363369,394330720,9583,20
9205,ZMYM5,chr13,R,19823481,19863636,10488272,40155,394370875,9584,8
9358,ITGBL1,chr13,F,101452592,101720857,10756537,268265,394639140,9585,12
9365,KL,chr13,F,33016062,33066145,10806620,50083,394689223,9586,5
9375,TM9SF2,chr13,F,99501373,99564048,10869295,62675,394751898,9587,16
9445,ITM2B,chr13,F,48233137,48262096,10898254,28959,394780857,9588,5
9617,MTRF1,chr13,R,41216368,41263797,10945683,47429,394828286,9589,15
9724,UTP14C,chr13,F,52024690,52033600,10954593,8910,394837196,9590,1
9818,NUPL1,chr13,F,25301083,25349795,11003305,48712,394885908,9591,18
9882,TBC1D4,chr13,R,75284663,75482646,11201288,197983,395083891,9592,22
10082,GPC6,chr13,F,93226824,94408020,12382484,1181196,396265087,9593,9
10129,FRY,chr13,F,32031299,32297498,12648683,266199,396531286,9594,63
10150,MBNL2,chr13,F,97141819,97394120,12900984,252301,396783587,9595,10
10160,FARP1,chr13,F,98142561,98449773,13208196,307212,397090799,9596,29
10161,LPAR6,chr13,R,48411044,48444704,13241856,33660,397124459,9597,7
10166,SLC25A15,chr13,F,40789410,40812460,13264906,23050,397147509,9598,6
10186,LHFP,chr13,R,39342891,39603219,13525234,260328,397407837,9599,3
10206,TRIM13,chr13,F,49997006,50018467,13546695,21461,397429298,9600,2
10208,USPL1,chr13,F,30617692,30659557,13588560,41865,397471163,9601,9
10240,MRPS31,chr13,R,40729295,40771223,13630488,41928,397513091,9602,7
10253,SPRY2,chr13,R,80335975,80340951,13635464,4976,397518067,9603,3
10257,ABCC4,chr13,R,95019828,95301446,13917082,281618,397799685,9604,34
10284,SAP18,chr13,F,21140513,21149085,13925654,8572,397808257,9605,4
10301,DLEU1,chr13,F,50082168,50528643,14372129,446475,398254732,9606,7
10426,TUBGCP3,chr13,R,112485004,112606442,14493567,121438,398376170,9607,26
10443,N4BP2L2,chr13,R,32432487,32538885,14599965,106398,398482568,9608,14
10464,PIBF1,chr13,F,72782091,73016454,14834328,234363,398716931,9609,20
10562,OLFM4,chr13,F,53028740,53052061,14857649,23321,398740252,9610,4
10631,POSTN,chr13,R,37562581,37598844,14893912,36263,398776515,9611,22
10673,TNFSF13B,chr13,F,108269419,108308484,14932977,39065,398815580,9612,6
10804,GJB6,chr13,R,20221961,20232395,14943411,10434,398826014,9613,5
10808,HSPH1,chr13,R,31134973,31163109,14971547,28136,398854150,9614,17
10810,WASF3,chr13,F,26557702,26688945,15102790,131243,398985393,9615,12
10910,SUGT1,chr13,F,52652695,52688298,15138393,35603,399020996,9616,14
11061,LECT1,chr13,R,52703263,52739812,15174942,36549,399057545,9617,6
11166,SOX21,chr13,R,94709621,94712543,15177864,2922,399060467,9618,0
11193,WBP4,chr13,F,41061560,41084006,15200310,22446,399082913,9619,10
11215,AKAP11,chr13,F,42271480,42323267,15252097,51787,399134700,9620,14
11278,KLF12,chr13,R,73686011,74168169,15734255,482158,399616858,9621,15
11340,EXOSC8,chr13,F,37000372,37009614,15743497,9242,399626100,9622,11
22821,RASA3,chr13,R,113977782,114132620,15898335,154838,399780938,9623,27
22862,FNDC3A,chr13,F,48975911,49209779,16132203,233868,400014806,9624,29
22873,DZIP1,chr13,R,95578201,95644706,16198708,66505,400081311,9625,23
22894,DIS3,chr13,R,72755401,72782153,16225460,26752,400108063,9626,21
23026,MYO16,chr13,F,108495728,109208007,16937739,712279,400820342,9627,36
23047,PDS5B,chr13,F,32586426,32778020,17129333,191594,401011936,9628,35
23077,MYCBP2,chr13,R,77044656,77327042,17411719,282386,401294322,9629,88
23078,VWA8,chr13,R,41566824,41961103,17805998,394279,401688601,9630,46
23091,ZC3H13,chr13,R,45955683,46052761,17903076,97078,401785679,9631,20
23111,SPG20,chr13,R,36301637,36370180,17971619,68543,401854222,9632,13
23143,LRCH1,chr13,F,46553137,46753041,18171523,199904,402054126,9633,20
23250,ATP11A,chr13,F,112690048,112887168,18368643,197120,402251246,9634,33
23263,MCF2L,chr13,F,112894377,113099739,18574005,205362,402456608,9635,39
23281,MTUS2,chr13,F,28820347,29505947,19259605,685600,403142208,9636,18
23348,DOCK9,chr13,R,98793486,99088618,19554737,295132,403437340,9637,61
23483,TGDS,chr13,R,94574053,94596275,19576959,22222,403459562,9638,11
26050,SLITRK5,chr13,F,87671231,87679616,19585344,8385,403467947,9639,3
26080,FAM230C,chr13,F,18195296,18232016,19622064,36720,403504667,9640,7
26224,FBXL3,chr13,R,77001338,77027196,19647922,25858,403530525,9641,6
26278,SACS,chr13,R,23328822,23433728,19752828,104906,403635431,9642,11
26512,INTS6,chr13,R,51353861,51453236,19852203,99375,403734806,9643,20
26524,LATS2,chr13,R,20973035,21061583,19940751,88548,403823354,9644,9
26586,CKAP2,chr13,F,52455359,52476631,19962023,21272,403844626,9645,9
26747,NUFIP1,chr13,R,44939248,44989478,20012253,50230,403894856,9646,10
26771,SNORD102,chr13,F,27255063,27255135,20012325,72,403894928,9647,0
26960,NBEA,chr13,F,34942286,35672737,20742776,730451,404625379,9648,62
27199,OXGR1,chr13,R,96985718,96995826,20752884,10108,404635487,9649,4
27253,PCDH17,chr13,F,57630103,57729311,20852092,99208,404734695,9650,3
28984,RGCC,chr13,F,41457405,41470877,20865564,13472,404748167,9651,6
29079,MED4,chr13,R,48075727,48095141,20884978,19414,404767581,9652,6
29103,DNAJC15,chr13,F,43023225,43109170,20970923,85945,404853526,9653,5
29880,ALG5,chr13,R,36949769,36999367,21020521,49598,404903124,9654,10
51028,VPS36,chr13,R,52412601,52450678,21058598,38077,404941201,9655,14
51082,POLR1D,chr13,F,27620742,27667422,21105278,46680,404987881,9656,4
51084,CRYL1,chr13,R,20403666,20525873,21227485,122207,405110088,9657,9
51131,PHF11,chr13,F,49495609,49528987,21260863,33378,405143466,9658,13
51371,POMP,chr13,F,28659003,28678957,21280817,19954,405163420,9659,5
51569,UFM1,chr13,F,38349770,38363007,21294054,13237,405176657,9660,6
51761,ATP8A2,chr13,F,25372010,26025851,21947895,653841,405830498,9661,46
53342,IL17D,chr13,F,20702874,20723100,21968121,20226,405850724,9662,5
54602,NDFIP2,chr13,F,79480721,79556077,22043477,75356,405926080,9663,7
54737,MPHOSPH8,chr13,F,19633646,19673459,22083290,39813,405965893,9664,15
54841,BIVM,chr13,F,102799048,102841538,22125780,42490,406008383,9665,10
54937,SOHLH2,chr13,R,36168207,36214615,22172188,46408,406054791,9666,11
55002,TMCO3,chr13,F,113490992,113550229,22231425,59237,406114028,9667,21
55068,ENOX1,chr13,R,43213129,43786980,22805276,573851,406687879,9668,23
55082,ARGLU1,chr13,R,106543313,106568166,22830129,24853,406712732,9669,2
55208,DCUN1D2,chr13,R,113455818,113490709,22865020,34891,406747623,9670,7
55213,RCBTB1,chr13,R,49531943,49585606,22918683,53663,406801286,9671,15
55269,PSPC1,chr13,R,19674751,19783019,23026951,108268,406909554,9672,16
55270,NUDT15,chr13,F,48037566,48047222,23036607,9656,406919210,9673,2
55425,GPALPP1,chr13,F,44989537,45033611,23080681,44074,406963284,9674,9
55504,TNFRSF19,chr13,F,23570369,23676105,23186417,105736,407069020,9675,11
55578,SUPT20H,chr13,R,37009311,37059713,23236819,50402,407119422,9676,27
55608,ANKRD10,chr13,R,110878539,110915107,23273387,36568,407155990,9677,7
55647,RAB20,chr13,R,110523065,110561737,23312059,38672,407194662,9678,1
55739,CARKD,chr13,F,110615459,110639996,23336596,24537,407219199,9679,9
55757,UGGT2,chr13,R,95801579,96053482,23588499,251903,407471102,9680,43
55795,PCID2,chr13,R,113177538,113209466,23620427,31928,407503030,9681,15
55835,CENPJ,chr13,R,24882273,24922889,23661043,40616,407543646,9682,20
55901,THSD1,chr13,R,52377166,52406494,23690371,29328,407572974,9683,4
56163,RNF17,chr13,F,24747671,24889262,23831962,141591,407714565,9684,45
57105,CYSLTR2,chr13,F,48706814,48709362,23834510,2548,407717113,9685,0
57213,SPRYD7,chr13,R,49912701,49995962,23917771,83261,407800374,9686,10
57511,COG6,chr13,F,39655626,39791665,24053810,136039,407936413,9687,22
57626,KLHL1,chr13,R,69700592,70108493,24461711,407901,408344314,9688,10
64062,RBM26,chr13,R,79311826,79406258,24556143,94432,408438746,9689,24
64328,XPO4,chr13,R,20777328,20902774,24681589,125446,408564192,9690,25
64881,PCDH20,chr13,R,61409684,61415522,24687427,5838,408570030,9691,1
65110,UPF3A,chr13,F,114281583,114305817,24711661,24234,408594264,9692,12
78988,MRPL57,chr13,F,21176232,21179084,24714513,2852,408597116,9693,1
79024,SMIM2,chr13,R,44143150,44161257,24732620,18107,408615223,9694,2
79070,KDELC1,chr13,R,102784280,102799054,24747394,14774,408629997,9695,11
79587,CARS2,chr13,R,110641409,110713601,24819586,72192,408702189,9696,21
79596,RNF219,chr13,R,78614285,78659179,24864480,44894,408747083,9697,7
79612,NAA16,chr13,F,41311204,41377030,24930306,65826,408812909,9698,20
79621,RNASEH2B,chr13,F,50909677,50970462,24991091,60785,408873694,9699,15
79758,DHRS12,chr13,R,51767992,51804199,25027298,36207,408909901,9700,11
79774,GRTP1,chr13,R,113324163,113364148,25067283,39985,408949886,9701,10
79866,BORA,chr13,F,72727748,72756198,25095733,28450,408978336,9702,11
80183,KIAA0226L,chr13,R,46341999,46390042,25143776,48043,409026379,9703,16
80209,PROSER1,chr13,R,39009864,39038095,25172007,28231,409054610,9704,12
81550,TDRD3,chr13,F,60396456,60573879,25349430,177423,409232033,9705,17
81602,CDADC1,chr13,F,49247874,49293486,25395042,45612,409277645,9706,14
81617,CAB39L,chr13,R,49308646,49444134,25530530,135488,409413133,9707,14
81624,DIAPH3,chr13,R,59665582,60163985,26028933,498403,409911536,9708,38
83446,CCDC70,chr13,F,51861980,51866236,26033189,4256,409915792,9709,1
83548,COG3,chr13,F,45464894,45536698,26104993,71804,409987596,9710,23
83852,SETDB2,chr13,F,49444055,49495003,26155941,50948,410038544,9711,16
84056,KATNAL1,chr13,R,30202629,30307487,26260799,104858,410143402,9712,13
84078,KBTBD7,chr13,R,41191574,41194566,26263791,2992,410146394,9713,0
84189,SLITRK6,chr13,R,85792786,85799348,26270353,6562,410152956,9714,1
84650,EBPL,chr13,R,49660675,49691487,26301165,30812,410183768,9715,5
84899,TMTC4,chr13,R,100603835,100675089,26372419,71254,410255022,9716,21
84935,MEDAG,chr13,F,30906174,30925572,26391817,19398,410274420,9717,5
84945,ABHD13,chr13,F,108218414,108234255,26407658,15841,410290261,9718,2
85416,ZIC5,chr13,R,99963020,99971924,26416562,8904,410299165,9719,1
87769,GGACT,chr13,R,100530163,100588792,26475191,58629,410357794,9720,4
89890,KBTBD6,chr13,R,41127572,41132800,26480419,5228,410363022,9721,0
90627,STARD13,chr13,R,33103134,33676835,27054120,573701,410936723,9722,24
90634,N4BP2L1,chr13,R,32400722,32429614,27083012,28892,410965615,9723,10
93081,TEX30,chr13,R,102765887,102773821,27090946,7934,410973549,9724,8
93492,TPTE2,chr13,R,19422876,19561574,27229644,138698,411112247,9725,25
94240,EPSTI1,chr13,R,42886387,42992271,27335528,105884,411218131,9726,15
113622,ADPRHL1,chr13,R,113421939,113453524,27367113,31585,411249716,9727,7
114798,SLITRK1,chr13,R,83877204,83882393,27372302,5189,411254905,9728,0
115207,KCTD12,chr13,R,76880168,76886405,27378539,6237,411261142,9729,0
115761,ARL11,chr13,F,49628298,49633872,27384113,5574,411266716,9730,2
115825,WDFY2,chr13,F,51584193,51766799,27566719,182606,411449322,9731,13
116828,N4BP2L2-IT2,chr13,R,32504505,32509395,27571609,4890,411454212,9732,0
121793,TEX29,chr13,F,111316184,111344247,27599672,28063,411482275,9733,7
121838,LINC00284,chr13,F,44022334,44030463,27607801,8129,411490404,9734,2
121952,METTL21EP,chr13,F,102880098,102896033,27623736,15935,411506339,9735,3
122011,CSNK1A1L,chr13,R,37103259,37105664,27626141,2405,411508744,9736,0
122042,RXFP2,chr13,F,31739541,31802872,27689472,63331,411572075,9737,17
122046,TEX26,chr13,F,30932683,30975502,27732291,42819,411614894,9738,12
122060,SLAIN1,chr13,F,77697853,77764242,27798680,66389,411681283,9739,9
122183,PRR20A,chr13,F,57140917,57143939,27801702,3022,411684305,9740,2
122258,SPACA7,chr13,F,112375880,112434695,27860517,58815,411743120,9741,11
140432,RNF113B,chr13,R,98175784,98177267,27862000,1483,411744603,9742,1
144776,LINC00410,chr13,R,90890953,90926597,27897644,35644,411780247,9743,5
144809,FAM216B,chr13,F,42781549,42791549,27907644,10000,411790247,9744,3
144811,LACC1,chr13,F,43879283,43893933,27922294,14650,411804897,9745,8
144817,LINC00330,chr13,R,44799503,44809630,27932421,10127,411815024,9746,2
144920,LINC00343,chr13,F,105706829,105761796,27987388,54967,411869991,9747,5
144983,HNRNPA1L2,chr13,F,52617469,52643784,28013703,26315,411896306,9748,6
145165,ST13P4,chr13,F,50172017,50173616,28015302,1599,411897905,9749,0
145173,B3GALTL,chr13,F,31199974,31332276,28147604,132302,412030207,9750,17
160851,DGKH,chr13,F,42040035,42256584,28364153,216549,412246756,9751,37
160857,CCDC122,chr13,R,43823930,43879690,28419913,55760,412302516,9752,10
160897,GPR180,chr13,F,94601849,94634645,28452709,32796,412335312,9753,8
161003,STOML3,chr13,R,38965924,38990859,28477644,24935,412360247,9754,7
170622,COMMD6,chr13,R,75525213,75549439,28501870,24226,412384473,9755,6
171425,CLYBL,chr13,F,99606663,99909459,28804666,302796,412687269,9756,12
196541,METTL21C,chr13,R,102685746,102694521,28813441,8775,412696044,9757,3
196549,EEF1DP3,chr13,F,31846782,31959584,28926243,112802,412808846,9758,3
219287,AMER2,chr13,R,25161678,25172324,28936889,10646,412819492,9759,0
219333,USP12,chr13,R,27066149,27171896,29042636,105747,412925239,9760,9
219402,MTIF3,chr13,R,27435638,27450854,29057852,15216,412940455,9761,7
219409,GSX1,chr13,F,27792642,27793952,29059162,1310,412941765,9762,1
220081,ERICH6B,chr13,R,45541240,45615739,29133661,74499,413016264,9763,16
220082,SPERT,chr13,F,45702291,45714559,29145929,12268,413028532,9764,4
220107,DLEU7,chr13,R,50695549,50843933,29294313,148384,413176916,9765,4
220108,FAM124A,chr13,F,51222333,51284241,29356221,61908,413238824,9766,10
220115,TPTE2P3,chr13,F,52488992,52587090,29454319,98098,413336922,9767,23
220416,LRRC63,chr13,F,46211910,46276818,29519227,64908,413401830,9768,14
220429,CTAGE10P,chr13,F,49890408,49893380,29522199,2972,413404802,9769,0
221143,N6AMT2,chr13,R,20728930,20773956,29567225,45026,413449828,9770,5
221150,SKA3,chr13,R,21153594,21176602,29590233,23008,413472836,9771,8
221154,MICU2,chr13,R,21492688,21604216,29701761,111528,413584364,9772,11
221178,SPATA13,chr13,F,23979625,24307074,30029210,327449,413911813,9773,19
222484,LNX2,chr13,R,27545910,27620583,30103883,74673,413986486,9774,9
253512,SLC25A30,chr13,R,45393315,45418455,30129023,25140,414011626,9775,13
253832,ZDHHC20,chr13,R,21372570,21459370,30215823,86800,414098426,9776,17
255967,PAN3,chr13,F,28136716,28295338,30374445,158622,414257048,9777,24
259232,NALCN,chr13,R,101053775,101417205,30737875,363430,414620478,9778,44
266695,PHF2P1,chr13,R,19045348,19119662,30812189,74314,414694792,9779,14
266722,HS6ST3,chr13,F,96090535,96839562,31561216,749027,415443819,9780,7
267012,DAOA,chr13,F,105465866,105491034,31586384,25168,415468987,9781,5
282706,DAOA-AS1,chr13,R,105459054,105505681,31633011,46627,415515614,9782,6
283480,FGF14-IT1,chr13,R,102292319,102394519,31735211,102200,415617814,9783,3
283481,FGF14-AS2,chr13,F,102394577,102395705,31736339,1128,415618942,9784,0
283483,LINC00551,chr13,F,106617809,106631658,31750188,13849,415632791,9785,3
283487,LINC00346,chr13,R,110863986,110870308,31756510,6322,415639113,9786,0
283489,CHAMP1,chr13,F,114314489,114327328,31769349,12839,415651952,9787,2
283491,OR7E156P,chr13,F,63737434,63742568,31774483,5134,415657086,9788,3
283507,SUGT1P3,chr13,R,40911886,40921774,31784371,9888,415666974,9789,2
283514,SIAH3,chr13,R,45780269,45851711,31855813,71442,415738416,9790,1
283518,KCNRG,chr13,F,50015253,50020922,31861482,5669,415744085,9791,2
283521,LINC00282,chr13,R,51813346,51845150,31893286,31804,415775889,9792,4
283537,SLC46A3,chr13,R,28700079,28719013,31912220,18934,415794823,9793,5
284232,ANKRD20A9P,chr13,R,18834402,18871969,31949787,37567,415832390,9794,0
337867,UBAC2,chr13,F,99200424,99386499,32135862,186075,416018465,9795,13
338862,LINC00550,chr13,R,68861283,68885325,32159904,24042,416042507,9796,2
338864,LINC00347,chr13,F,74552842,74557120,32164182,4278,416046785,9797,2
338872,C1QTNF9,chr13,F,24307165,24322531,32179548,15366,416062151,9798,5
341640,FREM2,chr13,F,38687035,38887131,32379644,200096,416262247,9799,25
341676,NEK5,chr13,R,52036410,52130366,32473600,93956,416356203,9800,31
348013,TMEM255B,chr13,F,113759209,113813797,32528188,54588,416410791,9801,13
348021,LINC00442,chr13,F,19008258,19012634,32532564,4376,416415167,9802,3
374491,TPTE2P6,chr13,F,24580207,24597676,32550033,17469,416432636,9803,8
386618,KCTD4,chr13,R,45192852,45211102,32568283,18250,416450886,9804,4
387496,RASL11A,chr13,F,27270326,27273767,32571724,3441,416454327,9805,5
387911,C1QTNF9B,chr13,R,23891098,23898503,32579129,7405,416461732,9806,3
387914,SHISA2,chr13,R,26044596,26059587,32594120,14991,416476723,9807,5
387921,NHLRC3,chr13,F,39038310,39050109,32605919,11799,416488522,9808,6
387923,SERP2,chr13,F,44373841,44397714,32629792,23873,416512395,9809,2
387939,LOC387939,chr13,R,84592559,84611629,32648862,19070,416531465,9810,2
400110,ANKRD20A19P,chr13,R,23907283,23949315,32690894,42032,416573497,9811,4
400120,SERTM1,chr13,F,36673911,36697839,32714822,23928,416597425,9812,1
400121,LINC00547,chr13,F,37534939,37551536,32731419,16597,416614022,9813,4
400123,LINC00548,chr13,R,40194508,40220502,32757413,25994,416640016,9814,5
400128,TUSC8,chr13,R,44400249,44405984,32763148,5735,416645751,9815,1
400165,ATP11AUN,chr13,F,112647043,112684497,32800602,37454,416683205,9816,2
406948,MIR15A,chr13,R,50049118,50049201,32800685,83,416683288,9817,0
406950,MIR16-1,chr13,R,50048972,50049061,32800774,89,416683377,9818,0
406952,MIR17,chr13,F,91350604,91350688,32800858,84,416683461,9819,0
406953,MIR18A,chr13,F,91350750,91350821,32800929,71,416683532,9820,0
406979,MIR19A,chr13,F,91350890,91350972,32801011,82,416683614,9821,0
406980,MIR19B1,chr13,F,91351191,91351278,32801098,87,416683701,9822,0
406982,MIR20A,chr13,F,91351064,91351135,32801169,71,416683772,9823,0
407048,MIR92A1,chr13,F,91351313,91351391,32801247,78,416683850,9824,0
407975,MIR17HG,chr13,F,91347819,91354575,32808003,6756,416690606,9825,1
432369,ATP5EP2,chr13,F,27945205,27945573,32808371,368,416690974,9826,0
440131,LINC00544,chr13,F,29936530,29950488,32822329,13958,416704932,9827,4
440132,LINC00545,chr13,F,30882561,30883395,32823163,834,416705766,9828,1
440138,ALG11,chr13,F,52012386,52029648,32840425,17262,416723028,9829,3
440145,MZT1,chr13,R,72708356,72727800,32859869,19444,416742472,9830,2
542767,C1QTNF9B-AS1,chr13,F,23888888,23892103,32863084,3215,416745687,9831,4
619499,SNORA27,chr13,F,27255400,27255526,32863210,126,416745813,9832,0
641467,TSC22D1-AS1,chr13,F,44575895,44580432,32867747,4537,416750350,9833,2
642345,MIR4500HG,chr13,R,87443986,87670963,33094724,226977,416977327,9834,5
643365,LINC00452,chr13,F,113883716,113924812,33135820,41096,417018423,9835,14
643677,CCDC168,chr13,R,102729366,102759072,33165526,29706,417048129,9836,4
644623,TPTE2P2,chr13,R,52219333,52334284,33280477,114951,417163080,9837,28
646201,BASP1P1,chr13,R,22897029,22898181,33281629,1152,417164232,9838,0
646405,TPTE2P1,chr13,R,24928754,24968469,33321344,39715,417203947,9839,4
646625,URAD,chr13,R,27978105,27988637,33331876,10532,417214479,9840,1
646799,ZAR1L,chr13,R,32303718,32312582,33340740,8864,417223343,9841,3
646982,LINC00598,chr13,R,40347131,40481006,33474615,133875,417357218,9842,7
647166,LINC00371,chr13,R,51082847,51172388,33564156,89541,417446759,9843,5
647174,SERPINE3,chr13,F,51338518,51365454,33591092,26936,417473695,9844,7
647264,LOC647264,chr13,F,63746115,63747788,33592765,1673,417475368,9845,0
647288,CTAGE11P,chr13,R,75237752,75240381,33595394,2629,417477997,9846,0
650669,GAS6-AS1,chr13,F,113815609,113842841,33622626,27232,417505229,9847,4
650794,MIPEPP3,chr13,F,21298124,21392923,33717425,94799,417600028,9848,5
677814,SNORA31,chr13,R,45337479,45337609,33717555,130,417600158,9849,0
693206,MIR621,chr13,F,40810765,40810861,33717651,96,417600254,9850,0
693207,MIR622,chr13,F,90231181,90231277,33717747,96,417600350,9851,0
693208,MIR623,chr13,F,99356130,99356228,33717845,98,417600448,9852,0
728099,LOC728099,chr13,R,21348764,21361469,33730550,12705,417613153,9853,3
728192,LINC00460,chr13,F,106376562,106377792,33731780,1230,417614383,9854,2
728215,FAM155A,chr13,R,107168530,107867255,34430505,698725,418313108,9855,3
728591,CCDC169,chr13,R,36227041,36297855,34501319,70814,418383922,9856,15
729233,PRR20B,chr13,F,57147487,57150509,34504341,3022,418386944,9857,2
729240,PRR20C,chr13,F,57154060,57157082,34507363,3022,418389966,9858,2
729246,PRR20D,chr13,F,57160631,57163653,34510385,3022,418392988,9859,2
729250,PRR20E,chr13,F,57167196,57170218,34513407,3022,418396010,9860,2
729420,LMO7DN,chr13,F,75870570,75883812,34526649,13242,418409252,9861,4
730249,IRG1,chr13,F,76948558,76958659,34536750,10101,418419353,9862,6
100101938,ANKRD26P3,chr13,R,19262799,19344973,34618924,82174,418501527,9863,20
100129307,LOC100129307,chr13,R,77661373,77662803,34620354,1430,418502957,9864,0
100129597,LINC00462,chr13,R,48576973,48580901,34624282,3928,418506885,9865,2
100129836,COL4A2-AS2,chr13,R,110453465,110463641,34634458,10176,418517061,9866,4
100130386,LINC00552,chr13,R,113748510,113751089,34637037,2579,418519640,9867,0
100131561,FKSG29,chr13,F,99351419,99352027,34637645,608,418520248,9868,0
100188949,LINC00426,chr13,R,30340265,30373914,34671294,33649,418553897,9869,4
100189030,TRE-TTC2-1,chr13,R,44917926,44917998,34671366,72,418553969,9870,0
100189036,TRN-GTT2-4,chr13,R,30673963,30674037,34671440,74,418554043,9871,0
100189251,TRF-GAA1-3,chr13,R,94549649,94549722,34671513,73,418554116,9872,0
100189333,TRE-TTC1-1,chr13,R,41060737,41060809,34671585,72,418554188,9873,0
100190939,TPT1-AS1,chr13,F,45341344,45391483,34721724,50139,418604327,9874,10
100287114,LINC00421,chr13,F,19345048,19346749,34723425,1701,418606028,9875,1
100288730,PAN3-AS1,chr13,R,28136842,28139174,34725757,2332,418608360,9876,1
100289274,DNAJC3-AS1,chr13,R,95672632,95676960,34730085,4328,418612688,9877,1
100289373,UBAC2-AS1,chr13,R,99196373,99200757,34734469,4384,418617072,9878,1
100289410,MCF2L-AS1,chr13,R,112967483,112968638,34735624,1155,418618227,9879,0
100302187,MIR1297,chr13,R,54311971,54312048,34735701,77,418618304,9880,0
100302286,MIR1267,chr13,R,107531170,107531248,34735779,78,418618382,9881,0
100313778,MIR759,chr13,F,52810049,52810140,34735870,91,418618473,9882,0
100313842,MIR2276,chr13,F,24162415,24162504,34735959,89,418618562,9883,0
100313896,MIR320D1,chr13,R,40727827,40727875,34736007,48,418618610,9884,0
100422861,MIR4306,chr13,F,99643058,99643149,34736098,91,418618701,9885,0
100422878,MIR3168,chr13,R,41101018,41101100,34736180,82,418618783,9886,0
100422881,MIR3170,chr13,F,98208523,98208600,34736257,77,418618860,9887,0
100422940,MIR4305,chr13,R,39664033,39664135,34736359,102,418618962,9888,0
100422973,MIR3169,chr13,R,61199797,61199880,34736442,83,418619045,9889,0
100462953,MINOS1P1,chr13,R,32496205,32498492,34738729,2287,418621332,9890,0
100500861,MIR3665,chr13,R,77698011,77698116,34738834,105,418621437,9891,0
100500908,MIR3613,chr13,R,49996414,49996501,34738921,87,418621524,9892,0
100505518,EDNRB-AS1,chr13,F,77818936,77908442,34828427,89506,418711030,9893,6
100505538,RBM26-AS1,chr13,F,79406308,79424336,34846455,18028,418729058,9894,6
100505996,LINC00403,chr13,F,111972309,112108015,34982161,135706,418864764,9895,4
100506016,LOC100506016,chr13,R,112155156,112160710,34987715,5554,418870318,9896,1
100506394,GAS6-AS2,chr13,F,113864176,113866832,34990371,2656,418872974,9897,1
100506622,LINC00540,chr13,F,22210284,22276521,35056608,66237,418939211,9898,1
100506680,SACS-AS1,chr13,F,23418970,23428869,35066507,9899,418949110,9899,1
100506697,LINC00327,chr13,F,23469511,23487464,35084460,17953,418967063,9900,2
100506759,OR7E37P,chr13,F,41442563,41443766,35085663,1203,418968266,9901,0
100507064,TEX26-AS1,chr13,R,30882834,30932608,35135437,49774,419018040,9902,3
100507099,FRY-AS1,chr13,R,32024045,32031639,35143031,7594,419025634,9903,3
100507114,LINC00445,chr13,F,35697537,35699001,35144495,1464,419027098,9904,1
100507135,SPG20-AS1,chr13,F,36346430,36369735,35167800,23305,419050403,9905,5
100507240,VWA8-AS1,chr13,F,41961168,41981565,35188197,20397,419070800,9906,3
100507398,INTS6-AS1,chr13,F,51453344,51454716,35189569,1372,419072172,9907,1
100507428,LINC00458,chr13,R,54124323,54132871,35198117,8548,419080720,9908,3
100507533,SOX21-AS1,chr13,F,94712715,94715945,35201347,3230,419083950,9909,1
100507747,LOC100507747,chr13,R,113956425,113974083,35219005,17658,419101608,9910,7
100509894,CPB2-AS1,chr13,F,46052847,46101347,35267505,48500,419150108,9911,3
100526761,CCDC169-SOHLH2,chr13,R,36168207,36297855,35397153,129648,419279756,9912,15
100533467,BIVM-ERCC5,chr13,F,102807145,102876001,35466009,68856,419348612,9913,22
100616110,MIR2681,chr13,R,101967641,101967746,35466114,105,419348717,9914,0
100616137,MIR4501,chr13,F,96427228,96427292,35466178,64,419348781,9915,0
100616182,MIR4500,chr13,R,87618664,87618740,35466254,76,419348857,9916,0
100616205,MIR4704,chr13,F,66218249,66218324,35466329,75,419348932,9917,0
100616227,MIR4502,chr13,F,114273827,114273908,35466410,81,419349013,9918,0
100616239,MIR4705,chr13,R,102045933,102046004,35466481,71,419349084,9919,0
100616302,MIR548X2,chr13,R,65966329,65966429,35466581,100,419349184,9920,0
100616304,MIR4499,chr13,R,20433777,20433846,35466650,69,419349253,9921,0
100616423,MIR4703,chr13,F,51552588,51552667,35466729,79,419349332,9922,0
100616668,TPTE2P5,chr13,R,40796984,40921750,35591495,124766,419474098,9923,7
100652856,LINC00408,chr13,F,18905438,18926741,35612798,21303,419495401,9924,5
100652865,LINC00539,chr13,R,21303511,21344859,35654146,41348,419536749,9925,5
100846996,MIR5007,chr13,F,55174453,55174548,35654241,95,419536844,9926,0
100847003,MIR5693,chr13,R,51348566,51348639,35654314,73,419536917,9927,0
100847026,MIR5006,chr13,R,41568285,41568395,35654424,110,419537027,9928,0
100847035,MIR548AR,chr13,F,114244504,114244561,35654481,57,419537084,9929,0
100847092,MIR548AS,chr13,F,92490162,92490220,35654539,58,419537142,9930,0
100861541,DOCK9-AS2,chr13,F,99086722,99088625,35656442,1903,419539045,9931,0
100861542,LINC00554,chr13,R,99994898,99997909,35659453,3011,419542056,9932,0
100861544,LINC00557,chr13,F,94960040,94961319,35660732,1279,419543335,9933,0
100861546,LINC00564,chr13,R,81225864,81226983,35661851,1119,419544454,9934,0
100861549,LINC00562,chr13,R,47930152,47932622,35664321,2470,419546924,9935,0
100861550,PDX1-AS1,chr13,R,27829758,27921404,35755967,91646,419638570,9936,3
100861552,LINC00558,chr13,F,53815418,53876119,35816668,60701,419699271,9937,5
100861553,LINC00560,chr13,F,88626047,88630397,35821018,4350,419703621,9938,1
100861554,LINC00563,chr13,R,46296444,46297844,35822418,1400,419705021,9939,0
100861555,LINC00565,chr13,R,113926513,113928991,35824896,2478,419707499,9940,0
100861573,LINC00572,chr13,R,29918646,29926651,35832901,8005,419715504,9941,1
100862704,LINC00441,chr13,R,48296512,48303661,35840050,7149,419722653,9942,2
100873761,RNU6-52P,chr13,F,19142981,19143077,35840146,96,419722749,9943,0
100873762,RNU6-53P,chr13,R,28703701,28703807,35840252,106,419722855,9944,0
100873763,RNU6-55P,chr13,R,18869184,18869291,35840359,107,419722962,9945,0
100873764,RNU6-56P,chr13,F,38779423,38779516,35840452,93,419723055,9946,0
100873765,RNU6-57P,chr13,R,41354556,41354659,35840555,103,419723158,9947,0
100873766,RNU6-58P,chr13,R,23217431,23217534,35840658,103,419723261,9948,0
100873767,RNU6-59P,chr13,R,21551303,21551410,35840765,107,419723368,9949,0
100873768,RNU6-63P,chr13,F,27488137,27488232,35840860,95,419723463,9950,0
100873769,RNU6-64P,chr13,F,30281764,30281869,35840965,105,419723568,9951,0
100873770,RNU6-66P,chr13,R,73112914,73113018,35841069,104,419723672,9952,6
100873771,RNU6-67P,chr13,R,83298070,83298167,35841166,97,419723769,9953,0
100873772,RNU6-68P,chr13,F,46410453,46410557,35841270,104,419723873,9954,0
100873773,RNU6-69P,chr13,R,45137861,45137965,35841374,104,419723977,9955,0
100873774,RNU6-71P,chr13,F,36267167,36267274,35841481,107,419724084,9956,0
100873775,RNU6-72P,chr13,R,85584747,85584853,35841587,106,419724190,9957,0
100873776,RNU6-75P,chr13,R,90781765,90781869,35841691,104,419724294,9958,0
100873777,RNU6-76P,chr13,F,18880053,18880157,35841795,104,419724398,9959,0
100873778,RNU6-78P,chr13,F,25517118,25517225,35841902,107,419724505,9960,0
100873779,RNU6-79P,chr13,R,72881107,72881214,35842009,107,419724612,9961,0
100873780,RNU6-81P,chr13,F,63783800,63783904,35842113,104,419724716,9962,0
100873781,RNU6-82P,chr13,F,28232500,28232607,35842220,107,419724823,9963,0
100873782,RNU6-83P,chr13,F,99025233,99025345,35842332,112,419724935,9964,0
100873965,MED4-AS1,chr13,F,48077136,48079993,35845189,2857,419727792,9965,2
100873969,GPC5-AS1,chr13,R,92701388,92721614,35865415,20226,419748018,9966,4
100873970,GPC5-AS2,chr13,R,92339793,92352207,35877829,12414,419760432,9967,2
100873972,GPC6-AS1,chr13,R,94154192,94187991,35911628,33799,419794231,9968,3
100873973,GPC6-AS2,chr13,R,93818423,93858473,35951678,40050,419834281,9969,6
100874059,LINC00297,chr13,R,29872612,29888405,35967471,15793,419850074,9970,1
100874063,CLYBL-AS2,chr13,R,99690097,99690971,35968345,874,419850948,9971,1
100874064,PCDH9-AS2,chr13,F,66825168,66915031,36058208,89863,419940811,9972,5
100874068,GRTP1-AS1,chr13,F,113351672,113361868,36068404,10196,419951007,9973,2
100874069,STK24-AS1,chr13,F,98577197,98578842,36070049,1645,419952652,9974,1
100874070,USP12-AS1,chr13,F,27125532,27169135,36113652,43603,419996255,9975,2
100874071,USP12-AS2,chr13,F,27172258,27183503,36124897,11245,420007500,9976,1
100874073,FREM2-AS1,chr13,R,38821846,38830835,36133886,8989,420016489,9977,5
100874074,DLEU7-AS1,chr13,F,50807854,50849905,36175937,42051,420058540,9978,4
100874081,FGF14-AS1,chr13,F,102367529,102373666,36182074,6137,420064677,9979,1
100874082,HTR2A-AS1,chr13,F,46852139,46856299,36186234,4160,420068837,9980,2
100874086,PCDH9-AS3,chr13,F,66977388,66985776,36194622,8388,420077225,9981,2
100874087,PCDH9-AS4,chr13,F,66990885,67002000,36205737,11115,420088340,9982,2
100874096,DOCK9-AS1,chr13,F,98832083,98834629,36208283,2546,420090886,9983,2
100874107,MTUS2-AS1,chr13,R,29476514,29487750,36219519,11236,420102122,9984,2
100874126,LINC00331,chr13,R,78787318,78840050,36272251,52732,420154854,9985,4
100874127,LINC00332,chr13,F,40181808,40189030,36279473,7222,420162076,9986,3
100874128,LINC00333,chr13,F,84140601,84606768,36745640,466167,420628243,9987,6
100874130,ENOX1-AS2,chr13,F,43448851,43459488,36756277,10637,420638880,9988,3
100874137,LINC00351,chr13,F,85363602,85544662,36937337,181060,420819940,9989,3
100874139,LINC00353,chr13,R,89548793,89564413,36952957,15620,420835560,9990,3
100874143,LINC00358,chr13,R,62003524,62029548,36978981,26024,420861584,9991,1
100874145,LINC00364,chr13,F,67372386,67379994,36986589,7608,420869192,9992,2
100874146,LINC00365,chr13,R,30103180,30107930,36991339,4750,420873942,9993,1
100874147,LINC00366,chr13,F,38567723,38579516,37003132,11793,420885735,9994,3
100874150,LINC00379,chr13,R,91127612,91211698,37087218,84086,420969821,9995,3
100874151,LINC00381,chr13,F,74419172,74435159,37103205,15987,420985808,9996,4
100874155,LINC00392,chr13,F,73564243,73587879,37126841,23636,421009444,9997,2
100874156,LINC00393,chr13,R,73456898,73662021,37331964,205123,421214567,9998,10
100874157,LINC00395,chr13,R,63667681,63738018,37402301,70337,421284904,9999,3
100874158,LINC00398,chr13,F,30803205,30810645,37409741,7440,421292344,10000,1
100874159,LINC00400,chr13,F,43113164,43159466,37456043,46302,421338646,10001,2
100874161,LINC00411,chr13,R,100939519,100944364,37460888,4845,421343491,10002,2
100874164,LINC00417,chr13,R,18738099,18740099,37462888,2000,421345491,10003,2
100874167,LINC00423,chr13,R,32809189,32911652,37565351,102463,421447954,10004,4
100874168,LINC00433,chr13,F,88540828,88545509,37570032,4681,421452635,10005,2
100874169,LINC00434,chr13,R,60214346,60268104,37623790,53758,421506393,10006,2
100874172,LINC00440,chr13,F,89235290,89280240,37668740,44950,421551343,10007,3
100874173,LINC00443,chr13,F,106653879,106672180,37687041,18301,421569644,10008,2
100874175,LINC00446,chr13,F,78012882,78053595,37727754,40713,421610357,10009,5
100874176,LINC00448,chr13,R,62672284,62807359,37862829,135075,421745432,10010,9
100874178,LINC00454,chr13,R,113878627,113883404,37867606,4777,421750209,10011,1
100874179,LINC00457,chr13,R,34435449,34640685,38072842,205236,421955445,10012,2
100874182,LINC00424,chr13,R,21872795,21878160,38078207,5365,421960810,10013,1
100874187,LINC00559,chr13,R,90060246,90119717,38137678,59471,422020281,10014,5
100874188,LINC00571,chr13,R,38050816,38143232,38230094,92416,422112697,10015,5
100874194,CLDN10-AS1,chr13,R,95479443,95533910,38284561,54467,422167164,10016,3
100874195,DIAPH3-AS1,chr13,F,60012717,60044357,38316201,31640,422198804,10017,5
100874196,DIAPH3-AS2,chr13,F,60144697,60153505,38325009,8808,422207612,10018,2
100874203,COL4A2-AS1,chr13,R,110502575,110508179,38330613,5604,422213216,10019,2
100874205,ATP11A-AS1,chr13,R,112745448,112754731,38339896,9283,422222499,10020,1
100874208,NDFIP2-AS1,chr13,R,79477363,79481231,38343764,3868,422226367,10021,2
100874212,MYCBP2-AS1,chr13,F,77075513,77087776,38356027,12263,422238630,10022,3
100874222,RNF219-AS1,chr13,F,78054854,78617325,38918498,562471,422801101,10023,5
100874226,ARHGEF7-AS1,chr13,R,111144304,111148565,38922759,4261,422805362,10024,2
100874231,SPATA13-AS1,chr13,R,24252748,24254439,38924450,1691,422807053,10025,2
100874241,STARD13-AS,chr13,F,33277553,33281334,38928231,3781,422810834,10026,2
100874255,RNASEH2B-AS1,chr13,R,50882377,50910712,38956566,28335,422839169,10027,2
100874259,SLC25A30-AS1,chr13,F,45418161,45420371,38958776,2210,422841379,10028,1
100874375,FAM155A-IT1,chr13,R,107787360,107835458,39006874,48098,422889477,10029,1
100874377,SMIM2-IT1,chr13,R,44146469,44158222,39018627,11753,422901230,10030,2
100885777,PCCA-AS1,chr13,R,100464436,100481015,39035206,16579,422917809,10031,4
100885778,NALCN-AS1,chr13,F,100708324,101059286,39386168,350962,423268771,10032,7
100885781,LINC00348,chr13,F,71015140,71168417,39539445,153277,423422048,10033,3
100885782,MYO16-AS1,chr13,R,109163904,109167303,39542844,3399,423425447,10034,2
100887750,MRPS31P5,chr13,R,52167708,52194467,39569603,26759,423452206,10035,8
100887754,LINC00359,chr13,R,96941280,96984172,39612495,42892,423495098,10036,2
100996930,LINC00621,chr13,R,22859874,22896401,39649022,36527,423531625,10037,4
101060553,LOC101060553,chr13,R,111148196,111153577,39654403,5381,423537006,10038,1
101409253,LINC00676,chr13,F,109728273,109730034,39656164,1761,423538767,10039,2
101515984,LINC01080,chr13,F,80011076,80026663,39671751,15587,423554354,10040,1
101926897,LOC101926897,chr13,F,58165826,58209483,39715408,43657,423598011,10041,2
101926930,LINC00378,chr13,F,60672954,60695806,39738260,22852,423620863,10042,4
101926951,LOC101926951,chr13,R,61424688,61427946,39741518,3258,423624121,10043,1
101927016,LOC101927016,chr13,R,63832065,63833720,39743173,1655,423625776,10044,0
101927072,LOC101927072,chr13,F,68025811,68043675,39761037,17864,423643640,10045,3
101927121,LOC101927121,chr13,F,74288077,74408803,39881763,120726,423764366,10046,7
101927155,LMO7-AS1,chr13,R,75604699,75635994,39913058,31295,423795661,10047,3
101927176,LINC01069,chr13,R,77979765,77994773,39928066,15008,423810669,10048,2
101927195,LINC00382,chr13,F,79872585,79918036,39973517,45451,423856120,10049,5
101927216,LOC101927216,chr13,R,80041699,80075306,40007124,33607,423889727,10050,10
101927224,LINC01049,chr13,F,90493287,90535342,40049179,42055,423931782,10051,5
101927238,LOC101927238,chr13,R,80200055,80211350,40060474,11295,423943077,10052,2
101927248,LOC101927248,chr13,R,94704743,94708486,40064217,3743,423946820,10053,2
101927284,LOC101927284,chr13,F,94760940,94935410,40238687,174470,424121290,10054,4
101927308,LOC101927308,chr13,F,95590447,95603044,40251284,12597,424133887,10055,2
101927375,LOC101927375,chr13,F,24541662,24567321,40276943,25659,424159546,10056,8
101927385,LOC101927385,chr13,R,97235410,97298103,40339636,62693,424222239,10057,5
101927403,LOC101927403,chr13,R,33012923,33016442,40343155,3519,424225758,10058,2
101927437,LOC101927437,chr13,R,99740869,99957165,40559451,216296,424442054,10059,4
101927465,CLYBL-AS1,chr13,R,99725667,99729001,40562785,3334,424445388,10060,3
101927627,LOC101927627,chr13,F,109590319,109598832,40571298,8513,424453901,10061,3
101927646,LOC101927646,chr13,R,110036194,110056149,40591253,19955,424473856,10062,3
101927712,LOC101927712,chr13,R,110131506,110140218,40599965,8712,424482568,10063,2
101927802,LINC00368,chr13,F,111095837,111105902,40610030,10065,424492633,10064,2
101928616,LINC00354,chr13,F,111893377,111901176,40617829,7799,424500432,10065,4
101928697,LOC101928697,chr13,F,19182032,19187465,40623262,5433,424505865,10066,2
101928698,LINC01070,chr13,F,112197332,112201000,40626930,3668,424509533,10067,2
101928730,LOC101928730,chr13,R,112256724,112273000,40643206,16276,424525809,10068,8
101928752,LINC01043,chr13,F,112313057,112321766,40651915,8709,424534518,10069,1
101928764,LOC101928764,chr13,R,21287320,21298115,40662710,10795,424545313,10070,7
101928841,LOC101928841,chr13,R,113399609,113420858,40683959,21249,424566562,10071,6
101928922,LINC00463,chr13,R,25172823,25180001,40691137,7178,424573740,10072,3
101929077,LOC101929077,chr13,F,37934571,38065564,40822130,130993,424704733,10073,5
101929121,LINC00437,chr13,R,38531999,38686675,40976806,154676,424859409,10074,2
101929140,LOC101929140,chr13,F,41132927,41236686,41080565,103759,424963168,10075,3
101929212,SMIM2-AS1,chr13,F,44110548,44154079,41124096,43531,425006699,10076,5
101929259,LOC101929259,chr13,F,45106278,45113206,41131024,6928,425013627,10077,2
101929344,LINC01198,chr13,R,46455202,46466776,41142598,11574,425025201,10078,5
101929355,LOC101929355,chr13,F,114172977,114223074,41192695,50097,425075298,10079,8
101929410,SUCLA2-AS1,chr13,F,48001388,48002614,41193921,1226,425076524,10080,1
101929657,LOC101929657,chr13,F,52128894,52132723,41197750,3829,425080353,10081,1
101930747,LINC00380,chr13,R,91087253,91091439,41201936,4186,425084539,10082,2
101930748,LINC00367,chr13,R,20938563,20949428,41212801,10865,425095404,10083,5
101930749,LINC00397,chr13,R,87801042,87810520,41222279,9478,425104882,10084,3
102157400,LINC00384,chr13,R,30151885,30154897,41225291,3012,425107894,10085,1
102465872,MIR8073,chr13,F,110340957,110341029,41225363,72,425107966,10086,0
102465874,MIR8075,chr13,F,113262919,113262999,41225443,80,425108046,10087,0
102465876,MIR8079,chr13,R,44196128,44196200,41225515,72,425108118,10088,0
102723318,LINC01053,chr13,F,25181331,25190657,41234841,9326,425117444,10089,2
102723332,LINC00412,chr13,R,27236281,27237257,41235817,976,425118420,10090,1
102723345,LOC102723345,chr13,F,29647639,29655478,41243656,7839,425126259,10091,1
102723381,LOC102723381,chr13,F,30234955,30243660,41252361,8705,425134964,10092,4
102723392,LOC102723392,chr13,R,31052212,31056765,41256914,4553,425139517,10093,2
102723406,LOC102723406,chr13,F,33546742,33611975,41322147,65233,425204750,10094,6
102723490,LOC102723490,chr13,R,36664680,36789186,41446653,124506,425329256,10095,15
102723875,LINC01065,chr13,R,53131745,53151900,41466808,20155,425349411,10096,4
102723910,LOC102723910,chr13,F,61178640,61186738,41474906,8098,425357509,10097,2
102723968,LOC102723968,chr13,R,63828839,63844125,41490192,15286,425372795,10098,5
102724076,LINC01038,chr13,F,79804385,79805682,41491489,1297,425374092,10099,1
102724086,LOC102724086,chr13,R,90177445,90186789,41500833,9344,425383436,10100,3
102724139,LOC102724139,chr13,F,80896348,80902474,41506959,6126,425389562,10101,2
102724148,LOC102724148,chr13,F,18408126,18422796,41521629,14670,425404232,10102,8
102724149,LOC102724149,chr13,F,95300631,95310874,41531872,10243,425414475,10103,2
102724347,LOC102724347,chr13,R,108279360,108292727,41545239,13367,425427842,10104,2
102724442,LOC102724442,chr13,R,110309094,110315426,41551571,6332,425434174,10105,1
102724474,LOC102724474,chr13,R,113149632,113153986,41555925,4354,425438528,10106,2
102724489,LOC102724489,chr13,F,111669646,111672566,41558845,2920,425441448,10107,2
102724510,LOC102724510,chr13,F,111754560,111757470,41561755,2910,425444358,10108,2
102725228,LOC102725228,chr13,R,112686768,112689917,41564904,3149,425447507,10109,1
102725509,LINC01232,chr13,R,99486961,99499306,41577249,12345,425459852,10110,4
103191607,LOC103191607,chr13,F,52334294,52341883,41584838,7589,425467441,10111,2
103625683,LINC00456,chr13,R,97172381,97179622,41592079,7241,425474682,10112,1
103689843,LINC01046,chr13,F,21234567,21235204,41592716,637,425475319,10113,1
103689845,LINC01050,chr13,R,42810365,42812562,41594913,2197,425477516,10114,2
103689913,LINC00383,chr13,F,69222345,69322101,41694669,99756,425577272,10115,3
103689915,DLEU1-AS1,chr13,R,50520932,50527449,41701186,6517,425583789,10116,2
103695431,LINC01048,chr13,R,37481463,37484784,41704507,3321,425587110,10117,3
103724386,LINC00377,chr13,F,81018390,81044442,41730559,26052,425613162,10118,3
103724387,LINC01058,chr13,R,30419438,30422244,41733365,2806,425615968,10119,1
103724388,LINC01068,chr13,F,79566726,79571446,41738085,4720,425620688,10120,2
103752581,LINC01055,chr13,R,45681198,45701184,41758071,19986,425640674,10121,3
103752583,LINC01075,chr13,F,62212281,62249951,41795741,37670,425678344,10122,3
104266956,LINC01044,chr13,R,112322566,112331225,41804400,8659,425687003,10123,2
104326053,LINC00363,chr13,F,93045340,93057926,41816986,12586,425699589,10124,3
104326054,LINC00399,chr13,F,109400695,109401641,41817932,946,425700535,10125,1
104326189,LMO7DN-IT1,chr13,F,75876885,75881127,41822174,4242,425704777,10126,3
104326190,LINC01309,chr13,F,103425199,103427685,41824660,2486,425707263,10127,1
104355135,LINC00431,chr13,F,110966026,110990602,41849236,24576,425731839,10128,1
104355137,LINC01072,chr13,F,20102700,20103230,41849766,530,425732369,10129,1
104355140,LINC00375,chr13,R,85065086,85148057,41932737,82971,425815340,10130,5
104355146,LINC00396,chr13,F,110053284,110054952,41934405,1668,425817008,10131,3
104355147,LINC00428,chr13,R,42842411,42872744,41964738,30333,425847341,10132,5
104355149,LINC01039,chr13,F,99577111,99585995,41973622,8884,425856225,10133,3
104355150,LINC01054,chr13,R,114329756,114333948,41977814,4192,425860417,10134,2
104355293,LINC00376,chr13,R,63183100,63328094,42122808,144994,426005411,10135,6
104355296,SCEL-AS1,chr13,R,77599754,77606551,42129605,6797,426012208,10136,3
104413892,F10-AS1,chr13,R,113128154,113130046,42131497,1892,426014100,10137,2
105369198,LOC105369198,chr13,R,30357289,30358296,42132504,1007,426015107,10138,2
105370098,LOC105370098,chr13,R,18942474,18944377,42134407,1903,426017010,10139,1
105370100,LOC105370100,chr13,F,19561713,19562532,42135226,819,426017829,10140,1
105370101,LOC105370101,chr13,R,20105669,20119929,42149486,14260,426032089,10141,2
105370102,LOC105370102,chr13,F,20295705,20326221,42180002,30516,426062605,10142,2
105370103,LOC105370103,chr13,R,20550980,20566765,42195787,15785,426078390,10143,8
105370104,LOC105370104,chr13,F,21067531,21075623,42203879,8092,426086482,10144,3
105370105,LOC105370105,chr13,F,21280283,21293503,42217099,13220,426099702,10145,3
105370108,LOC105370108,chr13,F,22061696,22155392,42310795,93696,426193398,10146,4
105370109,LOC105370109,chr13,F,22903262,22909059,42316592,5797,426199195,10147,1
105370110,LOC105370110,chr13,F,22883884,22894490,42327198,10606,426209801,10148,1
105370111,LOC105370111,chr13,R,22975807,22978398,42329789,2591,426212392,10149,2
105370112,LOC105370112,chr13,R,23108589,23129899,42351099,21310,426233702,10150,2
105370113,LOC105370113,chr13,F,23715164,23738199,42374134,23035,426256737,10151,3
105370114,LOC105370114,chr13,R,23669191,23714932,42419875,45741,426302478,10152,1
105370115,LOC105370115,chr13,F,23954463,23969256,42434668,14793,426317271,10153,5
105370117,LOC105370117,chr13,F,24502340,24529087,42461415,26747,426344018,10154,5
105370118,LOC105370118,chr13,R,24723115,24738648,42476948,15533,426359551,10155,3
105370119,LOC105370119,chr13,R,25040199,25046959,42483708,6760,426366311,10156,2
105370120,LOC105370120,chr13,F,25095619,25119432,42507521,23813,426390124,10157,4
105370121,LOC105370121,chr13,R,25227263,25235663,42515921,8400,426398524,10158,2
105370122,LOC105370122,chr13,R,25975583,25977551,42517889,1968,426400492,10159,2
105370123,LOC105370123,chr13,F,26876605,26880941,42522225,4336,426404828,10160,2
105370124,LOC105370124,chr13,R,27046158,27055767,42531834,9609,426414437,10161,1
105370125,LOC105370125,chr13,R,27177691,27220649,42574792,42958,426457395,10162,9
105370126,LOC105370126,chr13,R,27368509,27375005,42581288,6496,426463891,10163,3
105370127,LOC105370127,chr13,F,27445437,27449185,42585036,3748,426467639,10164,1
105370128,LOC105370128,chr13,R,27667712,27680599,42597923,12887,426480526,10165,2
105370129,LOC105370129,chr13,F,27738703,27740133,42599353,1430,426481956,10166,1
105370130,LOC105370130,chr13,F,27901833,27903597,42601117,1764,426483720,10167,2
105370131,LOC105370131,chr13,F,27988598,27989785,42602304,1187,426484907,10168,1
105370132,LOC105370132,chr13,F,27980154,27988526,42610676,8372,426493279,10169,3
105370133,LOC105370133,chr13,R,28270872,28295819,42635623,24947,426518226,10170,4
105370134,LOC105370134,chr13,F,28312104,28329602,42653121,17498,426535724,10171,4
105370135,LOC105370135,chr13,F,28574987,28584344,42662478,9357,426545081,10172,2
105370136,LOC105370136,chr13,R,28659979,28668466,42670965,8487,426553568,10173,1
105370137,LOC105370137,chr13,F,28659194,28661269,42673040,2075,426555643,10174,2
105370138,LOC105370138,chr13,F,28721551,28727631,42679120,6080,426561723,10175,1
105370139,LOC105370139,chr13,F,29695212,29697815,42681723,2603,426564326,10176,2
105370140,LOC105370140,chr13,R,30062476,30072158,42691405,9682,426574008,10177,2
105370141,LOC105370141,chr13,F,30152601,30169342,42708146,16741,426590749,10178,4
105370142,LOC105370142,chr13,R,30392700,30399426,42714872,6726,426597475,10179,3
105370143,LOC105370143,chr13,F,30422603,30427567,42719836,4964,426602439,10180,2
105370144,LOC105370144,chr13,R,30613656,30617704,42723884,4048,426606487,10181,2
105370145,LOC105370145,chr13,R,30973072,30977640,42728452,4568,426611055,10182,2
105370146,LOC105370146,chr13,F,31020957,31023742,42731237,2785,426613840,10183,2
105370147,LOC105370147,chr13,F,31043220,31046693,42734710,3473,426617313,10184,2
105370148,LOC105370148,chr13,F,31162624,31171761,42743847,9137,426626450,10185,4
105370149,LOC105370149,chr13,R,31364331,31376313,42755829,11982,426638432,10186,2
105370150,LOC105370150,chr13,F,31419988,31470616,42806457,50628,426689060,10187,7
105370151,LOC105370151,chr13,R,32131823,32136896,42811530,5073,426694133,10188,2
105370152,LOC105370152,chr13,R,31796374,31848859,42864015,52485,426746618,10189,4
105370153,LOC105370153,chr13,F,33335442,33350068,42878641,14626,426761244,10190,3
105370154,LOC105370154,chr13,R,33333889,33335266,42880018,1377,426762621,10191,1
105370155,LOC105370155,chr13,R,33297007,33322956,42905967,25949,426788570,10192,2
105370156,LOC105370156,chr13,R,33983988,34000657,42922636,16669,426805239,10193,3
105370157,LOC105370157,chr13,R,33860280,33865163,42927519,4883,426810122,10194,2
105370158,LOC105370158,chr13,F,34347942,34616292,43195869,268350,427078472,10195,4
105370159,LOC105370159,chr13,R,34671005,34689431,43214295,18426,427096898,10196,2
105370160,LOC105370160,chr13,R,35288200,35292783,43218878,4583,427101481,10197,2
105370161,LOC105370161,chr13,R,35691353,35694680,43222205,3327,427104808,10198,1
105370162,LOC105370162,chr13,F,36074539,36083561,43231227,9022,427113830,10199,2
105370163,LOC105370163,chr13,F,35856835,35904240,43278632,47405,427161235,10200,2
105370164,LOC105370164,chr13,R,36134017,36146074,43290689,12057,427173292,10201,2
105370165,LOC105370165,chr13,F,37011558,37019746,43298877,8188,427181480,10202,1
105370166,LOC105370166,chr13,R,38184831,38206253,43320299,21422,427202902,10203,2
105370167,LOC105370167,chr13,R,38567065,38567643,43320877,578,427203480,10204,1
105370168,LOC105370168,chr13,R,39208770,39227906,43340013,19136,427222616,10205,3
105370169,LOC105370169,chr13,F,39081230,39091690,43350473,10460,427233076,10206,3
105370170,LOC105370170,chr13,F,39504029,39517130,43363574,13101,427246177,10207,3
105370171,LOC105370171,chr13,F,40063568,40064394,43364400,826,427247003,10208,1
105370172,LOC105370172,chr13,R,40081591,40480889,43763698,399298,427646301,10209,11
105370173,LOC105370173,chr13,F,41298775,41303914,43768837,5139,427651440,10210,2
105370174,LOC105370174,chr13,F,41517207,41564091,43815721,46884,427698324,10211,4
105370175,LOC105370175,chr13,R,41546885,41552202,43821038,5317,427703641,10212,2
105370176,LOC105370176,chr13,R,41974441,42013965,43860562,39524,427743165,10213,2
105370177,LOC105370177,chr13,F,42435204,42485956,43911314,50752,427793917,10214,3
105370178,LOC105370178,chr13,F,42927883,42963222,43946653,35339,427829256,10215,5
105370179,LOC105370179,chr13,F,43002935,43007338,43951056,4403,427833659,10216,3
105370180,LOC105370180,chr13,R,43072860,43077977,43956173,5117,427838776,10217,2
105370181,LOC105370181,chr13,F,43811789,43814816,43959200,3027,427841803,10218,1
105370182,LOC105370182,chr13,R,43984014,44014959,43990145,30945,427872748,10219,6
105370183,LOC105370183,chr13,R,44105445,44147930,44032630,42485,427915233,10220,7
105370184,LOC105370184,chr13,R,44425070,44428413,44035973,3343,427918576,10221,2
105370185,LOC105370185,chr13,R,44684508,44724311,44075776,39803,427958379,10222,2
105370186,LOC105370186,chr13,F,44651707,44668409,44092478,16702,427975081,10223,3
105370187,LOC105370187,chr13,R,44840894,44896666,44148250,55772,428030853,10224,6
105370188,LOC105370188,chr13,R,45046177,45048014,44150087,1837,428032690,10225,2
105370189,LOC105370189,chr13,R,45079347,45085072,44155812,5725,428038415,10226,2
105370190,LOC105370190,chr13,R,45224488,45243393,44174717,18905,428057320,10227,2
105370191,LOC105370191,chr13,F,45930403,45940838,44185152,10435,428067755,10228,4
105370192,LOC105370192,chr13,F,46187660,46194105,44191597,6445,428074200,10229,4
105370193,LOC105370193,chr13,R,46278462,46279841,44192976,1379,428075579,10230,2
105370194,LOC105370194,chr13,R,46276631,46321996,44238341,45365,428120944,10231,2
105370195,LOC105370195,chr13,F,47266125,47270340,44242556,4215,428125159,10232,1
105370196,LOC105370196,chr13,R,47696391,47705385,44251550,8994,428134153,10233,4
105370197,LOC105370197,chr13,F,47945441,47948275,44254384,2834,428136987,10234,1
105370198,LOC105370198,chr13,R,48108122,48166377,44312639,58255,428195242,10235,3
105370200,LOC105370200,chr13,R,48288914,48296177,44319902,7263,428202505,10236,1
105370201,LOC105370201,chr13,R,48567597,48569871,44322176,2274,428204779,10237,1
105370202,LOC105370202,chr13,F,48581178,48599508,44340506,18330,428223109,10238,2
105370203,LOC105370203,chr13,R,49203294,49247853,44385065,44559,428267668,10239,3
105370204,LOC105370204,chr13,R,49616231,49620615,44389449,4384,428272052,10240,3
105370205,LOC105370205,chr13,R,49635467,49640311,44394293,4844,428276896,10241,1
105370206,LOC105370206,chr13,R,51279051,51324734,44439976,45683,428322579,10242,2
105370207,LOC105370207,chr13,R,52344618,52346942,44442300,2324,428324903,10243,2
105370208,LOC105370208,chr13,R,52552096,52600372,44490576,48276,428373179,10244,2
105370209,LOC105370209,chr13,R,52759778,52768918,44499716,9140,428382319,10245,1
105370210,LOC105370210,chr13,F,53555959,53564303,44508060,8344,428390663,10246,2
105370211,LOC105370211,chr13,R,54097102,54105803,44516761,8701,428399364,10247,2
105370212,LOC105370212,chr13,R,54135879,54145515,44526397,9636,428409000,10248,2
105370213,LOC105370213,chr13,F,54800171,54841989,44568215,41818,428450818,10249,2
105370214,LOC105370214,chr13,R,56258460,56735485,45045240,477025,428927843,10250,7
105370215,LOC105370215,chr13,R,57137090,57137744,45045894,654,428928497,10251,1
105370216,LOC105370216,chr13,R,57213046,57216730,45049578,3684,428932181,10252,1
105370217,LOC105370217,chr13,R,57457460,57520231,45112349,62771,428994952,10253,2
105370218,LOC105370218,chr13,F,58627793,58643520,45128076,15727,429010679,10254,3
105370219,LOC105370219,chr13,R,58653120,58684724,45159680,31604,429042283,10255,2
105370220,LOC105370220,chr13,F,58715265,58764288,45208703,49023,429091306,10256,5
105370221,LOC105370221,chr13,R,59086002,59100873,45223574,14871,429106177,10257,3
105370222,LOC105370222,chr13,F,59280588,59290797,45233783,10209,429116386,10258,2
105370223,LOC105370223,chr13,R,59265904,59280406,45248285,14502,429130888,10259,2
105370224,LOC105370224,chr13,R,59119042,59292524,45421767,173482,429304370,10260,6
105370225,LOC105370225,chr13,R,59660655,59665267,45426379,4612,429308982,10261,2
105370226,LOC105370226,chr13,F,59659632,59685141,45451888,25509,429334491,10262,2
105370227,LOC105370227,chr13,F,60164075,60172615,45460428,8540,429343031,10263,1
105370228,LOC105370228,chr13,F,60328477,60381383,45513334,52906,429395937,10264,2
105370229,LOC105370229,chr13,R,60427787,60432411,45517958,4624,429400561,10265,2
105370230,LOC105370230,chr13,R,60616202,60618893,45520649,2691,429403252,10266,2
105370231,LOC105370231,chr13,F,61563602,61573889,45530936,10287,429413539,10267,2
105370232,LOC105370232,chr13,R,62539676,62574881,45566141,35205,429448744,10268,3
105370233,LOC105370233,chr13,R,62839133,62897413,45624421,58280,429507024,10269,2
105370234,LOC105370234,chr13,R,62897472,62911545,45638494,14073,429521097,10270,2
105370235,LOC105370235,chr13,F,63728290,63735437,45645641,7147,429528244,10271,2
105370236,LOC105370236,chr13,F,63593892,63673604,45725353,79712,429607956,10272,10
105370237,LOC105370237,chr13,R,63585462,63586255,45726146,793,429608749,10273,2
105370238,LOC105370238,chr13,R,64436660,64450363,45739849,13703,429622452,10274,2
105370239,LOC105370239,chr13,F,64691033,64702076,45750892,11043,429633495,10275,5
105370240,LOC105370240,chr13,F,64738014,64797734,45810612,59720,429693215,10276,2
105370241,LOC105370241,chr13,R,65835887,65865951,45840676,30064,429723279,10277,1
105370242,LOC105370242,chr13,F,65866046,65878058,45852688,12012,429735291,10278,2
105370243,LOC105370243,chr13,F,65902816,65914949,45864821,12133,429747424,10279,2
105370244,LOC105370244,chr13,F,65929613,65937161,45872369,7548,429754972,10280,3
105370245,LOC105370245,chr13,F,65995864,66090248,45966753,94384,429849356,10281,3
105370246,LOC105370246,chr13,R,67305410,67326132,45987475,20722,429870078,10282,2
105370247,LOC105370247,chr13,F,66560384,66660491,46087582,100107,429970185,10283,6
105370248,LOC105370248,chr13,R,67577619,67596213,46106176,18594,429988779,10284,4
105370249,LOC105370249,chr13,F,67596362,67649363,46159177,53001,430041780,10285,7
105370250,LOC105370250,chr13,F,67649901,67660310,46169586,10409,430052189,10286,3
105370251,LOC105370251,chr13,R,67783790,67858048,46243844,74258,430126447,10287,5
105370252,LOC105370252,chr13,F,67769401,67791191,46265634,21790,430148237,10288,2
105370253,LOC105370253,chr13,F,68878383,68894417,46281668,16034,430164271,10289,6
105370254,LOC105370254,chr13,R,68871069,68874765,46285364,3696,430167967,10290,3
105370255,LOC105370255,chr13,F,70765777,70827935,46347522,62158,430230125,10291,3
105370256,LOC105370256,chr13,F,73592400,73634420,46389542,42020,430272145,10292,11
105370257,LOC105370257,chr13,F,74158413,74161956,46393085,3543,430275688,10293,2
105370258,LOC105370258,chr13,R,73879779,73886129,46399435,6350,430282038,10294,4
105370259,LOC105370259,chr13,F,74254220,74258200,46403415,3980,430286018,10295,2
105370260,LOC105370260,chr13,R,74649388,74732799,46486826,83411,430369429,10296,3
105370261,LOC105370261,chr13,F,76267534,76281295,46500587,13761,430383190,10297,2
105370262,LOC105370262,chr13,R,76229513,76270904,46541978,41391,430424581,10298,2
105370263,LOC105370263,chr13,F,76459887,76527128,46609219,67241,430491822,10299,3
105370264,LOC105370264,chr13,R,76552094,76554739,46611864,2645,430494467,10300,2
105370265,LOC105370265,chr13,R,76712000,76806086,46705950,94086,430588553,10301,8
105370266,LOC105370266,chr13,F,76664124,76692312,46734138,28188,430616741,10302,2
105370267,LOC105370267,chr13,R,76668058,76689510,46755590,21452,430638193,10303,2
105370268,LOC105370268,chr13,F,76833796,76844819,46766613,11023,430649216,10304,2
105370269,LOC105370269,chr13,R,76932156,76942960,46777417,10804,430660020,10305,2
105370270,LOC105370270,chr13,F,77280148,77296165,46793434,16017,430676037,10306,2
105370271,LOC105370271,chr13,F,77462507,77465855,46796782,3348,430679385,10307,2
105370272,LOC105370272,chr13,R,78760825,78762918,46798875,2093,430681478,10308,2
105370273,LOC105370273,chr13,R,78963651,78983499,46818723,19848,430701326,10309,5
105370274,LOC105370274,chr13,R,79422602,79429381,46825502,6779,430708105,10310,3
105370275,LOC105370275,chr13,R,80121586,80166394,46870310,44808,430752913,10311,2
105370276,LOC105370276,chr13,F,80356931,80363131,46876510,6200,430759113,10312,2
105370278,LOC105370278,chr13,R,80695850,80706675,46887335,10825,430769938,10313,4
105370280,LOC105370280,chr13,F,81008052,81009261,46888544,1209,430771147,10314,2
105370281,LOC105370281,chr13,F,81298608,81302645,46892581,4037,430775184,10315,2
105370282,LOC105370282,chr13,F,81316400,81339808,46915989,23408,430798592,10316,3
105370283,LOC105370283,chr13,F,81539917,81592715,46968787,52798,430851390,10317,2
105370284,LOC105370284,chr13,F,81802359,81848750,47015178,46391,430897781,10318,4
105370285,LOC105370285,chr13,R,82350202,82396708,47061684,46506,430944287,10319,4
105370286,LOC105370286,chr13,R,83802387,83815806,47075103,13419,430957706,10320,2
105370287,LOC105370287,chr13,R,84064533,84085137,47095707,20604,430978310,10321,2
105370288,LOC105370288,chr13,F,83906572,84068784,47257919,162212,431140522,10322,10
105370289,LOC105370289,chr13,R,84411851,84571017,47417085,159166,431299688,10323,5
105370290,LOC105370290,chr13,R,84872098,84902431,47447418,30333,431330021,10324,9
105370291,LOC105370291,chr13,R,85111800,85205470,47541088,93670,431423691,10325,3
105370295,LOC105370295,chr13,R,24538601,24541913,47544400,3312,431427003,10326,3
105370296,LOC105370296,chr13,F,39601323,39640412,47583489,39089,431466092,10327,4
105370297,LOC105370297,chr13,R,44370117,44374008,47587380,3891,431469983,10328,2
105370299,LOC105370299,chr13,R,86402909,86414564,47599035,11655,431481638,10329,3
105370300,LOC105370300,chr13,F,86792443,86883286,47689878,90843,431572481,10330,2
105370301,LOC105370301,chr13,F,86984385,87051179,47756672,66794,431639275,10331,3
105370302,LOC105370302,chr13,F,87334028,87446308,47868952,112280,431751555,10332,5
105370303,LOC105370303,chr13,F,87679954,87692607,47881605,12653,431764208,10333,2
105370304,LOC105370304,chr13,F,87853959,87873712,47901358,19753,431783961,10334,2
105370305,LOC105370305,chr13,R,88119797,88138459,47920020,18662,431802623,10335,2
105370306,LOC105370306,chr13,F,88212366,88236076,47943730,23710,431826333,10336,2
105370307,LOC105370307,chr13,F,89035780,89087431,47995381,51651,431877984,10337,3
105370308,LOC105370308,chr13,R,89477607,89480111,47997885,2504,431880488,10338,1
105370309,LOC105370309,chr13,F,89551236,89559573,48006222,8337,431888825,10339,4
105370310,LOC105370310,chr13,F,90291246,90300470,48015446,9224,431898049,10340,2
105370311,LOC105370311,chr13,F,90880314,90896811,48031943,16497,431914546,10341,5
105370312,LOC105370312,chr13,F,91111763,91145449,48065629,33686,431948232,10342,2
105370313,LOC105370313,chr13,F,91241640,91251661,48075650,10021,431958253,10343,2
105370314,LOC105370314,chr13,F,91251692,91281078,48105036,29386,431987639,10344,2
105370315,LOC105370315,chr13,R,92610756,92677690,48171970,66934,432054573,10345,3
105370316,LOC105370316,chr13,R,92329271,92331227,48173926,1956,432056529,10346,2
105370317,LOC105370317,chr13,F,93032986,93034267,48175207,1281,432057810,10347,1
105370318,LOC105370318,chr13,R,93801686,93809266,48182787,7580,432065390,10348,2
105370319,LOC105370319,chr13,R,94488525,94490069,48184331,1544,432066934,10349,2
105370320,LOC105370320,chr13,F,95274006,95280235,48190560,6229,432073163,10350,2
105370321,LOC105370321,chr13,F,95403971,95405018,48191607,1047,432074210,10351,2
105370322,LOC105370322,chr13,R,95797082,95801060,48195585,3978,432078188,10352,1
105370323,LOC105370323,chr13,F,96670614,96678049,48203020,7435,432085623,10353,2
105370324,LOC105370324,chr13,R,97539219,97711044,48374845,171825,432257448,10354,5
105370325,LOC105370325,chr13,F,97539578,97550113,48385380,10535,432267983,10355,3
105370326,LOC105370326,chr13,R,98395607,98408327,48398100,12720,432280703,10356,1
105370327,LOC105370327,chr13,F,98328164,98333238,48403174,5074,432285777,10357,2
105370328,LOC105370328,chr13,R,98066311,98143991,48480854,77680,432363457,10358,4
105370330,LOC105370330,chr13,R,98755319,98758154,48483689,2835,432366292,10359,2
105370331,LOC105370331,chr13,R,99281275,99283698,48486112,2423,432368715,10360,1
105370332,LOC105370332,chr13,R,99594229,99606541,48498424,12312,432381027,10361,2
105370333,LOC105370333,chr13,R,100086227,100088973,48501170,2746,432383773,10362,1
105370334,LOC105370334,chr13,R,100494669,100506387,48512888,11718,432395491,10363,2
105370335,LOC105370335,chr13,R,100313327,100364942,48564503,51615,432447106,10364,9
105370336,LOC105370336,chr13,F,102692350,102693111,48565264,761,432447867,10365,2
105370337,LOC105370337,chr13,F,102760391,102768293,48573166,7902,432455769,10366,2
105370338,LOC105370338,chr13,F,103290968,103306424,48588622,15456,432471225,10367,3
105370339,LOC105370339,chr13,F,103392236,103396516,48592902,4280,432475505,10368,2
105370340,LOC105370340,chr13,F,104125898,104134288,48601292,8390,432483895,10369,2
105370341,LOC105370341,chr13,F,104366413,104368550,48603429,2137,432486032,10370,1
105370342,LOC105370342,chr13,F,104851738,104869164,48620855,17426,432503458,10371,2
105370343,LOC105370343,chr13,R,104946965,104969010,48642900,22045,432525503,10372,4
105370344,LOC105370344,chr13,F,105410674,105414224,48646450,3550,432529053,10373,1
105370345,LOC105370345,chr13,R,105571961,105706757,48781246,134796,432663849,10374,10
105370346,LOC105370346,chr13,R,106471746,106473920,48783420,2174,432666023,10375,1
105370347,LOC105370347,chr13,F,106479420,106484457,48788457,5037,432671060,10376,2
105370348,LOC105370348,chr13,F,106568250,106613835,48834042,45585,432716645,10377,4
105370349,LOC105370349,chr13,R,106773632,106787337,48847747,13705,432730350,10378,2
105370350,LOC105370350,chr13,R,107124861,107132924,48855810,8063,432738413,10379,2
105370351,LOC105370351,chr13,F,107120883,107135953,48870880,15070,432753483,10380,3
105370352,LOC105370352,chr13,F,107836229,107838396,48873047,2167,432755650,10381,1
105370353,LOC105370353,chr13,R,107465983,107468710,48875774,2727,432758377,10382,1
105370354,LOC105370354,chr13,F,108242989,108267801,48900586,24812,432783189,10383,2
105370355,LOC105370355,chr13,F,108328054,108365281,48937813,37227,432820416,10384,2
105370356,LOC105370356,chr13,R,109148532,109150642,48939923,2110,432822526,10385,2
105370357,LOC105370357,chr13,F,109282026,109287470,48945367,5444,432827970,10386,2
105370358,LOC105370358,chr13,R,109591739,109606748,48960376,15009,432842979,10387,2
105370359,LOC105370359,chr13,R,109371445,109731829,49320760,360384,433203363,10388,3
105370360,LOC105370360,chr13,F,109796974,109811425,49335211,14451,433217814,10389,2
105370361,LOC105370361,chr13,F,110121707,110125234,49338738,3527,433221341,10390,2
105370362,LOC105370362,chr13,F,110813202,110820209,49345745,7007,433228348,10391,1
105370363,LOC105370363,chr13,F,110822448,110839127,49362424,16679,433245027,10392,3
105370364,LOC105370364,chr13,R,110945455,110971654,49388623,26199,433271226,10393,3
105370365,LOC105370365,chr13,R,111317104,111320539,49392058,3435,433274661,10394,1
105370366,LOC105370366,chr13,R,111663398,111669523,49398183,6125,433280786,10395,2
105370367,LOC105370367,chr13,R,96086389,96090864,49402658,4475,433285261,10396,2
105370368,LOC105370368,chr13,F,100673258,100676985,49406385,3727,433288988,10397,4
105370369,LOC105370369,chr13,F,111623248,111642014,49425151,18766,433307754,10398,4
105370370,LOC105370370,chr13,R,112180488,112195688,49440351,15200,433322954,10399,8
105370371,LOC105370371,chr13,F,112183273,112184109,49441187,836,433323790,10400,2
105370372,LOC105370372,chr13,R,112378737,112476050,49538500,97313,433421103,10401,5
105370373,LOC105370373,chr13,R,112361612,112376268,49553156,14656,433435759,10402,2
105370374,LOC105370374,chr13,F,112736752,112738367,49554771,1615,433437374,10403,0
105370375,LOC105370375,chr13,R,112923549,112929527,49560749,5978,433443352,10404,2
105370376,LOC105370376,chr13,R,113165094,113171597,49567252,6503,433449855,10405,2
105370377,LOC105370377,chr13,F,113267503,113269306,49569055,1803,433451658,10406,2
105370380,LOC105370380,chr13,F,113817491,113820631,49572195,3140,433454798,10407,1
105370382,LOC105370382,chr13,F,114111298,114116622,49577519,5324,433460122,10408,1
105370384,LOC105370384,chr13,R,114244975,114281572,49614116,36597,433496719,10409,12
105376683,LOC105376683,chr13,F,105224973,105233332,49622475,8359,433505078,10410,2
105376684,LOC105376684,chr13,R,110710643,110714084,49625916,3441,433508519,10411,0
105376685,LOC105376685,chr13,R,94712306,94713712,49627322,1406,433509925,10412,1
105377804,LOC105377804,chr13,F,113752095,113754369,49629596,2274,433512199,10413,2
105377805,LOC105377805,chr13,R,113741874,113752839,49640561,10965,433523164,10414,2
105377806,LOC105377806,chr13,R,113936587,113945367,49649341,8780,433531944,10415,1
105377807,LOC105377807,chr13,F,113933164,113938181,49654358,5017,433536961,10416,2
105377808,LOC105377808,chr13,R,114007612,114009124,49655870,1512,433538473,10417,2
105377809,LOC105377809,chr13,R,113946083,113954544,49664331,8461,433546934,10418,1
105377814,LOC105377814,chr13,F,37233423,37238742,49669650,5319,433552253,10419,2
105377815,LOC105377815,chr13,F,63846956,63859179,49681873,12223,433564476,10420,2
105377816,LOC105377816,chr13,R,73523598,73526034,49684309,2436,433566912,10421,2
105377818,LOC105377818,chr13,F,80736069,80764232,49712472,28163,433595075,10422,3
105377819,LOC105377819,chr13,R,18962128,19019869,49770213,57741,433652816,10423,6
105378192,LOC105378192,chr13,R,112862585,112865576,49773204,2991,433655807,10424,0
105378193,LOC105378193,chr13,R,112013840,112036593,49795957,22753,433678560,10425,5
105379277,LOC105379277,chr13,R,18171510,18176697,49801144,5187,433683747,10426,2
105379278,LOC105379278,chr13,F,18339182,18348633,49810595,9451,433693198,10427,5
12,SERPINA3,chr14,F,94612376,94624053,11677,11677,433704875,10428,4
87,ACTN1,chr14,R,68874122,68979366,116921,105244,433810119,10429,23
97,ACYP1,chr14,R,75053220,75069483,133184,16263,433826382,10430,4
207,AKT1,chr14,R,104769348,104795743,159579,26395,433852777,10431,15
283,ANG,chr14,F,20684176,20694186,169589,10010,433862787,10432,2
328,APEX1,chr14,F,20455130,20457772,172231,2642,433865429,10433,4
382,ARF6,chr14,F,49893017,49897054,176268,4037,433869466,10434,1
384,ARG2,chr14,F,67619861,67651720,208127,31859,433901325,10435,7
394,ARHGAP5,chr14,F,32076457,32159728,291398,83271,433984596,10436,8
599,BCL2L2,chr14,F,23306761,23311759,296396,4998,433989594,10437,3
623,BDKRB1,chr14,F,96256209,96264763,304950,8554,433998148,10438,2
624,BDKRB2,chr14,F,96204797,96244329,344482,39532,434037680,10439,2
652,BMP4,chr14,R,53949735,53956836,351583,7101,434044781,10440,5
677,ZFP36L1,chr14,R,68787654,68796243,360172,8589,434053370,10441,2
801,CALM1,chr14,F,90396982,90408275,371465,11293,434064663,10442,6
866,SERPINA6,chr14,R,94304247,94323351,390569,19104,434083767,10443,4
957,ENTPD5,chr14,R,73959466,74019326,450429,59860,434143627,10444,21
1033,CDKN3,chr14,F,54396933,54420218,473714,23285,434166912,10445,8
1053,CEBPE,chr14,R,23117305,23119985,476394,2680,434169592,10446,2
1073,CFL2,chr14,R,34710381,34714823,480836,4442,434174034,10447,5
1112,FOXN3,chr14,R,89156171,89619150,943815,462979,434637013,10448,7
1113,CHGA,chr14,F,92922588,92935293,956520,12705,434649718,10449,8
1152,CKB,chr14,R,103519657,103522859,959722,3202,434652920,10450,7
1215,CMA1,chr14,R,24505345,24508690,963067,3345,434656265,10451,4
1241,LTB4R,chr14,F,24311498,24318036,969605,6538,434662803,10452,2
1396,CRIP1,chr14,F,105486919,105488789,971475,1870,434664673,10453,5
1397,CRIP2,chr14,F,105472937,105480170,978708,7233,434671906,10454,10
1511,CTSG,chr14,R,24573517,24576260,981451,2743,434674649,10455,4
1603,DAD1,chr14,R,22564906,22589237,1005782,24331,434698980,10456,2
1690,COCH,chr14,F,30874534,30895079,1026327,20545,434719525,10457,11
1734,DIO2,chr14,R,80197524,80231054,1059857,33530,434753055,10458,5
1735,DIO3,chr14,F,101561350,101563452,1061959,2102,434755157,10459,0
1743,DLST,chr14,F,74881890,74903747,1083816,21857,434777014,10460,14
1778,DYNC1H1,chr14,F,101964527,102050798,1170087,86271,434863285,10461,77
1965,EIF2S1,chr14,F,67360316,67386516,1196287,26200,434889485,10462,7
1983,EIF5,chr14,F,103334001,103345025,1207311,11024,434900509,10463,12
2003,ELK2AP,chr14,R,105669576,105672807,1210542,3231,434903740,10464,2
2009,EML1,chr14,F,99737721,99942060,1414881,204339,435108079,10465,26
2079,ERH,chr14,R,69380122,69398304,1433063,18182,435126261,10466,3
2100,ESR2,chr14,R,64172924,64338550,1598689,165626,435291887,10467,18
2103,ESRRB,chr14,F,76371298,76501839,1729230,130541,435422428,10468,15
2287,FKBP3,chr14,R,45115598,45134529,1748161,18931,435441359,10469,7
2290,FOXG1,chr14,F,28767071,28770277,1751367,3206,435444565,10470,0
2342,FNTB,chr14,F,64986788,65062652,1827231,75864,435520429,10471,11
2353,FOS,chr14,F,75278777,75282234,1830688,3457,435523886,10472,3
2530,FUT8,chr14,F,65410591,65744121,2164218,333530,435857416,10473,12
2581,GALC,chr14,R,87933013,87993665,2224870,60652,435918068,10474,18
2643,GCH1,chr14,R,54842004,54902885,2285751,60881,435978949,10475,6
2764,GMFB,chr14,R,54474483,54489067,2300335,14584,435993533,10476,7
2856,GPR33,chr14,R,31482943,31487945,2305337,5002,435998535,10477,1
2877,GPX2,chr14,R,64939151,64942905,2309091,3754,436002289,10478,3
2954,GSTZ1,chr14,F,77320886,77331597,2319802,10711,436013000,10479,10
2957,GTF2A1,chr14,R,81175451,81221231,2365582,45780,436058780,10480,10
2972,BRF1,chr14,R,105209285,105315577,2471874,106292,436165072,10481,22
2999,GZMH,chr14,R,24606479,24609774,2475169,3295,436168367,10482,4
3002,GZMB,chr14,R,24630947,24634226,2478448,3279,436171646,10483,4
3091,HIF1A,chr14,F,61695400,61748259,2531307,52859,436224505,10484,15
3169,FOXA1,chr14,R,37589551,37595120,2536876,5569,436230074,10485,1
3183,HNRNPC,chr14,R,21209135,21269479,2597220,60344,436290418,10486,9
3306,HSPA2,chr14,F,64540467,64543237,2599990,2770,436293188,10487,0
3320,HSP90AA1,chr14,R,102080737,102139759,2659012,59022,436352210,10488,12
3429,IFI27,chr14,F,94110732,94116699,2664979,5967,436358177,10489,5
3705,ITPK1,chr14,R,92936913,93115918,2843984,179005,436537182,10490,11
3714,JAG2,chr14,R,105140980,105168824,2871828,27844,436565026,10491,25
3831,KLC1,chr14,F,103629187,103701551,2944192,72364,436637390,10492,17
3895,KTN1,chr14,F,55580206,55684584,3048570,104378,436741768,10493,47
3958,LGALS3,chr14,F,55129216,55145430,3064784,16214,436757982,10494,5
4053,LTBP2,chr14,R,74498182,74618609,3185211,120427,436878409,10495,37
4140,MARK3,chr14,F,103385363,103503831,3303679,118468,436996877,10496,19
4149,MAX,chr14,R,65006100,65102695,3400274,96595,437093472,10497,8
4247,MGAT2,chr14,F,49620770,49623481,3402985,2711,437096183,10498,0
4253,CTAGE5,chr14,F,39265271,39351193,3488907,85922,437182105,10499,29
4287,ATXN3,chr14,R,92058551,92106621,3536977,48070,437230175,10500,12
4293,MAP3K9,chr14,R,70722525,70809269,3623721,86744,437316919,10501,16
4323,MMP14,chr14,F,22836532,22847600,3634789,11068,437327987,10502,9
4329,ALDH6A1,chr14,R,74057661,74084493,3661621,26832,437354819,10503,11
4331,MNAT1,chr14,F,60734740,60968680,3895561,233940,437588759,10504,8
4522,MTHFD1,chr14,F,64388040,64460007,3967528,71967,437660726,10505,27
4624,MYH6,chr14,R,23381989,23408277,3993816,26288,437687014,10506,38
4625,MYH7,chr14,R,23412737,23435686,4016765,22949,437709963,10507,40
4707,NDUFB1,chr14,R,92116122,92121809,4022452,5687,437715650,10508,2
4738,NEDD8,chr14,R,24216850,24232370,4037972,15520,437731170,10509,3
4776,NFATC4,chr14,F,24366910,24379604,4050666,12694,437743864,10510,10
4792,NFKBIA,chr14,R,35401509,35404754,4053911,3245,437747109,10511,5
4857,NOVA1,chr14,R,26445882,26597754,4205783,151872,437898981,10512,6
4860,PNP,chr14,F,20469378,20478006,4214411,8628,437907609,10513,5
4901,NRL,chr14,R,24078692,24114802,4250521,36110,437943719,10514,7
4990,SIX6,chr14,F,60509219,60511807,4253109,2588,437946307,10515,1
5015,OTX2,chr14,R,56800706,56810476,4262879,9770,437956077,10516,3
5018,OXA1L,chr14,F,22766521,22771789,4268147,5268,437961345,10517,9
5083,PAX9,chr14,F,36657567,36677807,4288387,20240,437981585,10518,4
5104,SERPINA5,chr14,F,94581368,94593120,4300139,11752,437993337,10519,5
5106,PCK2,chr14,F,24094130,24104132,4310141,10002,438003339,10520,9
5228,PGF,chr14,R,74941829,74955764,4324076,13935,438017274,10521,6
5265,SERPINA1,chr14,R,94376746,94390692,4338022,13946,438031220,10522,5
5267,SERPINA4,chr14,F,94561419,94569913,4346516,8494,438039714,10523,4
5283,PIGH,chr14,R,67589305,67600300,4357511,10995,438050709,10524,4
5411,PNN,chr14,F,39175182,39183218,4365547,8036,438058745,10525,8
5427,POLE2,chr14,R,49643551,49688417,4410413,44866,438103611,10526,19
5494,PPM1A,chr14,F,60245751,60299087,4463749,53336,438156947,10527,16
5527,PPP2R5C,chr14,F,101760572,101927992,4631169,167420,438324367,10528,24
5529,PPP2R5E,chr14,R,63372478,63543361,4802052,170883,438495250,10529,14
5583,PRKCH,chr14,F,61321442,61550980,5031590,229538,438724788,10530,17
5587,PRKD1,chr14,R,29576478,29927693,5382805,351215,439076003,10531,21
5641,LGMN,chr14,R,92703806,92748702,5427701,44896,439120899,10532,14
5663,PSEN1,chr14,F,73136434,73223691,5514958,87257,439208156,10533,13
5684,PSMA3,chr14,F,58244804,58272009,5542163,27205,439235361,10534,10
5687,PSMA6,chr14,F,35278557,35317479,5581085,38922,439274283,10535,7
5693,PSMB5,chr14,R,23016542,23035220,5599763,18678,439292961,10536,4
5700,PSMC1,chr14,F,90256549,90272622,5615836,16073,439309034,10537,10
5706,PSMC6,chr14,F,52707162,52727998,5636672,20836,439329870,10538,14
5720,PSME1,chr14,F,24136157,24138967,5639482,2810,439332680,10539,9
5721,PSME2,chr14,R,24143364,24147316,5643434,3952,439336632,10540,10
5729,PTGDR,chr14,F,52267255,52276724,5652903,9469,439346101,10541,2
5732,PTGER2,chr14,F,52314297,52328606,5667212,14309,439360410,10542,1
5826,ABCD4,chr14,R,74285276,74303064,5685000,17788,439378198,10543,18
5836,PYGL,chr14,R,50905216,50944530,5724314,39314,439417512,10544,19
5875,RABGGTA,chr14,R,24265537,24271627,5730404,6090,439423602,10545,15
5890,RAD51B,chr14,F,67819778,68683210,6593836,863432,440287034,10546,20
5891,MOK,chr14,R,102224449,102305200,6674587,80751,440367785,10547,16
5926,ARID4A,chr14,F,58298384,58373995,6750198,75611,440443396,10548,25
6029,RN7SL1,chr14,F,49586579,49586878,6750497,299,440443695,10549,0
6035,RNASE1,chr14,R,20801355,20802877,6752019,1522,440445217,10550,2
6036,RNASE2,chr14,F,20955470,20956435,6752984,965,440446182,10551,1
6037,RNASE3,chr14,F,20891402,20892348,6753930,946,440447128,10552,1
6038,RNASE4,chr14,F,20684212,20700602,6770320,16390,440463518,10553,3
6039,RNASE6,chr14,F,20781050,20782467,6771737,1417,440464935,10554,1
6166,RPL36AL,chr14,R,49618687,49620685,6773735,1998,440466933,10555,1
6235,RPS29,chr14,R,49576671,49586416,6783480,9745,440476678,10556,3
6252,RTN1,chr14,R,59595975,59870839,7058344,274864,440751542,10557,10
6297,SALL2,chr14,R,21521079,21537216,7074481,16137,440767679,10558,2
6400,SEL1L,chr14,R,81471546,81533861,7136796,62315,440829994,10559,20
6430,SRSF5,chr14,F,69767094,69772005,7141707,4911,440834905,10560,7
6495,SIX1,chr14,R,60644698,60649437,7146446,4739,440839644,10561,1
6547,SLC8A3,chr14,R,70044216,70223612,7325842,179396,441019040,10562,13
6554,SLC10A1,chr14,R,69775834,69797289,7347297,21455,441040495,10563,4
6617,SNAPC1,chr14,F,61762356,61796428,7381369,34072,441074567,10564,9
6655,SOS2,chr14,R,50117127,50231878,7496120,114751,441189318,10565,24
6710,SPTB,chr14,R,64746282,64879893,7629731,133611,441322929,10566,36
6729,SRP54,chr14,F,34982694,35029567,7676604,46873,441369802,10567,16
6751,SSTR1,chr14,F,38207998,38213063,7681669,5065,441374867,10568,2
6815,STYX,chr14,F,52730164,52774989,7726494,44825,441419692,10569,11
7011,TEP1,chr14,R,20365666,20414645,7775473,48979,441468671,10570,54
7043,TGFB3,chr14,R,75958096,75982991,7800368,24895,441493566,10571,7
7051,TGM1,chr14,R,24249113,24263210,7814465,14097,441507663,10572,14
7080,NKX2-1,chr14,R,36516396,36520225,7818294,3829,441511492,10573,2
7127,TNFAIP2,chr14,F,103121146,103137439,7834587,16293,441527785,10574,13
7187,TRAF3,chr14,F,102777474,102911500,7968613,134026,441661811,10575,12
7207,TRL-AAG2-1,chr14,F,20610131,20610213,7968695,82,441661893,10576,0
7217,TRP-AGG2-3,chr14,R,20609335,20609407,7968767,72,441661965,10577,0
7218,TRP-AGG2-4,chr14,R,20613400,20613472,7968839,72,441662037,10578,0
7237,TRT-TGT3-1,chr14,R,20613789,20613862,7968912,73,441662110,10579,0
7253,TSHR,chr14,F,80954988,81146302,8160226,191314,441853424,10580,11
7443,VRK1,chr14,F,96797346,96881614,8244494,84268,441937692,10581,13
7453,WARS,chr14,R,100333787,100376343,8287050,42556,441980248,10582,13
7517,XRCC3,chr14,R,103697607,103715486,8304929,17879,441998127,10583,9
7528,YY1,chr14,F,100238764,100279034,8345199,40270,442038397,10584,4
7597,ZBTB25,chr14,R,64449105,64505213,8401307,56108,442094505,10585,10
8106,PABPN1,chr14,F,23320187,23326185,8407305,5998,442100503,10586,6
8110,DPF3,chr14,R,72609031,72894116,8692390,285085,442385588,10587,19
8111,GPR68,chr14,R,91232531,91270790,8730649,38259,442423847,10588,10
8115,TCL1A,chr14,R,95709966,95714196,8734879,4230,442428077,10589,4
8477,GPR65,chr14,F,88005123,88014811,8744567,9688,442437765,10590,1
8487,GEMIN2,chr14,F,39114283,39136973,8767257,22690,442460455,10591,10
8650,NUMB,chr14,R,73275153,73458582,8950686,183429,442643884,10592,13
8747,ADAM21,chr14,F,70452156,70459905,8958435,7749,442651633,10593,1
8748,ADAM20,chr14,R,70520876,70557701,8995260,36825,442688458,10594,6
8755,ADAM6,chr14,R,105969728,105972269,8997801,2541,442690999,10595,1
8788,DLK1,chr14,F,100726864,100735130,9006067,8266,442699265,10596,4
8812,CCNK,chr14,F,99481401,99511515,9036181,30114,442729379,10597,11
8814,CDKL1,chr14,R,50329403,50397404,9104182,68001,442797380,10598,12
8816,DCAF5,chr14,R,69050919,69153393,9206656,102474,442899854,10599,12
8846,ALKBH1,chr14,R,77672405,77708032,9242283,35627,442935481,10600,5
8892,EIF2B2,chr14,F,75002908,75009591,9248966,6683,442942164,10601,7
8906,AP1G2,chr14,R,23559562,23569545,9258949,9983,442952147,10602,20
9056,SLC7A7,chr14,R,22773221,22819811,9305539,46590,442998737,10603,10
9112,MTA1,chr14,F,105419848,105470729,9356420,50881,443049618,10604,23
9147,NEMF,chr14,R,49783277,49853073,9426216,69796,443119414,10605,36
9240,PNMA1,chr14,R,73711782,73714425,9428859,2643,443122057,10606,0
9252,RPS6KA5,chr14,R,90868121,91060649,9621387,192528,443314585,10607,17
9321,TRIP11,chr14,R,91965990,92040140,9695537,74150,443388735,10608,21
9362,CPNE6,chr14,F,24070836,24078100,9702801,7264,443395999,10609,17
9369,NRXN3,chr14,F,78021757,79868290,11549334,1846533,445242532,10610,29
9472,AKAP6,chr14,F,32329272,32833999,12054061,504727,445747259,10611,19
9495,AKAP5,chr14,F,64465498,64474503,12063066,9005,445756264,10612,1
9517,SPTLC2,chr14,R,77505996,77616768,12173838,110772,445867036,10613,12
9529,BAG5,chr14,R,103556543,103562814,12180109,6271,445873307,10614,2
9556,C14orf2,chr14,R,103912287,103921566,12189388,9279,445882586,10615,4
9578,CDC42BPB,chr14,R,102932378,103057405,12314415,125027,446007613,10616,38
9623,TCL1B,chr14,F,95686416,95692643,12320642,6227,446013840,10617,3
9628,RGS6,chr14,F,71932099,72566530,12955073,634431,446648271,10618,31
9692,KIAA0391,chr14,F,35121282,35274078,13107869,152796,446801067,10619,8
9766,SUSD6,chr14,F,69611592,69715144,13211421,103552,446904619,10620,7
9786,KIAA0586,chr14,F,58427384,58548831,13332868,121447,447026066,10621,35
9787,DLGAP5,chr14,R,55148115,55191678,13376431,43563,447069629,10622,20
9834,KIAA0125,chr14,F,105917978,105932642,13391095,14664,447084293,10623,5
9870,AREL1,chr14,R,74661251,74713115,13442959,51864,447136157,10624,20
9878,TOX4,chr14,F,21477175,21499177,13464961,22002,447158159,10625,8
9895,TECPR2,chr14,F,102362962,102502481,13604480,139519,447297678,10626,20
9950,GOLGA5,chr14,F,92794230,92839963,13650213,45733,447343411,10627,12
9985,REC8,chr14,F,24171852,24180408,13658769,8556,447351967,10628,17
10001,MED6,chr14,R,70583220,70600690,13676239,17470,447369437,10629,7
10038,PARP2,chr14,F,20343613,20357910,13690536,14297,447383734,10630,14
10175,CNIH1,chr14,R,54426928,54441430,13705038,14502,447398236,10631,4
10202,DHRS2,chr14,F,23630114,23645639,13720563,15525,447413761,10632,12
10243,GPHN,chr14,F,66507406,67181808,14394965,674402,448088163,10633,27
10278,EFS,chr14,R,23356399,23365633,14404199,9234,448097397,10634,5
10379,IRF9,chr14,F,24161212,24166565,14409552,5353,448102750,10635,8
10419,PRMT5,chr14,R,22920510,22929585,14418627,9075,448111825,10636,16
10484,SEC23A,chr14,R,39031918,39103243,14489952,71325,448183150,10637,21
10490,VTI1B,chr14,R,67651148,67674885,14513689,23737,448206887,10638,5
10516,FBLN5,chr14,R,91869410,91947702,14591981,78292,448285179,10639,13
10538,BATF,chr14,F,75522440,75546992,14616533,24552,448309731,10640,2
10548,TM9SF1,chr14,R,24189142,24195736,14623127,6594,448316325,10641,5
10572,SIVA1,chr14,F,104752419,104759659,14630367,7240,448323565,10642,4
10577,NPC2,chr14,R,74479939,74493381,14643809,13442,448337007,10643,4
10598,AHSA1,chr14,F,77457874,77469472,14655407,11598,448348605,10644,9
10640,EXOC5,chr14,R,57202475,57268899,14721831,66424,448415029,10645,17
10668,CGRRF1,chr14,F,54509868,54539309,14751272,29441,448444470,10646,6
10858,CYP46A1,chr14,F,99684261,99727321,14794332,43060,448487530,10647,16
10876,EDDM3A,chr14,F,20745939,20748380,14796773,2441,448489971,10648,1
10901,DHRS4,chr14,F,23953734,23969279,14812318,15545,448505516,10649,8
10914,PAPOLA,chr14,F,96502375,96567116,14877059,64741,448570257,10650,19
10965,ACOT2,chr14,F,73567619,73575658,14885098,8039,448578296,10651,3
10972,TMED10,chr14,R,75131467,75176646,14930277,45179,448623475,10652,4
10979,FERMT2,chr14,R,52857270,52951097,15024104,93827,448717302,10653,17
11035,RIPK3,chr14,R,24336020,24340036,15028120,4016,448721318,10654,9
11099,PTPN21,chr14,R,88465777,88554779,15117122,89002,448810320,10655,21
11154,AP4S1,chr14,F,31025105,31096450,15188467,71345,448881665,10656,10
11161,C14orf1,chr14,R,75650889,75661195,15198773,10306,448891971,10657,4
11169,WDHD1,chr14,R,54938937,55027101,15286937,88164,448980135,10658,25
11177,BAZ1A,chr14,R,34752730,34875647,15409854,122917,449103052,10659,28
11183,MAP4K5,chr14,R,50418479,50561126,15552501,142647,449245699,10660,36
11198,SUPT16H,chr14,R,21351471,21384639,15585669,33168,449278867,10661,26
22795,NID2,chr14,R,52004801,52069231,15650099,64430,449343297,10662,20
22846,VASH1,chr14,F,76761891,76783022,15671230,21131,449364428,10663,10
22863,ATG14,chr14,R,55366390,55411880,15716720,45490,449409918,10664,11
22890,ZBTB1,chr14,F,64503949,64533690,15746461,29741,449439659,10665,6
22938,SNW1,chr14,R,77717598,77761218,15790081,43620,449483279,10666,12
22985,ACIN1,chr14,R,23058563,23095614,15827132,37051,449520330,10667,21
22990,PCNX,chr14,F,70907404,71115382,16035110,207978,449728308,10668,38
23002,DAAM1,chr14,F,59188610,59371405,16217905,182795,449911103,10669,25
23034,SAMD4A,chr14,F,54567611,54793315,16443609,225704,450136807,10670,13
23093,TTLL5,chr14,F,75661207,75955082,16737484,293875,450430682,10671,31
23116,FAM179B,chr14,F,44962212,45074431,16849703,112219,450542901,10672,21
23186,RCOR1,chr14,F,102592638,102730576,16987641,137938,450680839,10673,12
23224,SYNE2,chr14,F,63852585,64226449,17361505,373864,451054703,10674,119
23241,PACS2,chr14,F,105300810,105398147,17458842,97337,451152040,10675,26
23256,SCFD1,chr14,F,30622253,30735828,17572417,113575,451265615,10676,26
23351,KHNYN,chr14,F,24423170,24441342,17590589,18172,451283787,10677,11
23357,ANGEL1,chr14,R,76787242,76828473,17631820,41231,451325018,10678,11
23368,PPP1R13B,chr14,R,103733750,103848967,17747037,115217,451440235,10679,20
23405,DICER1,chr14,R,95086227,95158010,17818820,71783,451512018,10680,33
23428,SLC7A8,chr14,R,23125294,23183660,17877186,58366,451570384,10681,12
23503,ZFYVE26,chr14,R,67729568,67816611,17964229,87043,451657427,10682,44
23508,TTC9,chr14,F,70641786,70675360,17997803,33574,451691001,10683,2
23588,KLHDC2,chr14,F,49767588,49785660,18015875,18072,451709073,10684,14
23768,FLRT2,chr14,F,85530104,85628696,18114467,98592,451807665,10685,7
25831,HECTD1,chr14,R,31100114,31208060,18222413,107946,451915611,10686,44
25938,HEATR5A,chr14,R,31291787,31420582,18351208,128795,452044406,10687,35
25983,NGDN,chr14,F,23469627,23478193,18359774,8566,452052972,10688,9
26020,LRP10,chr14,F,22871612,22881580,18369742,9968,452062940,10689,6
26030,PLEKHG3,chr14,F,64704412,64746905,18412235,42493,452105433,10690,20
26037,SIPA1L1,chr14,F,71321395,71741229,18832069,419834,452525267,10691,31
26094,DCAF4,chr14,F,72926331,72962098,18867836,35767,452561034,10692,18
26153,KIF26A,chr14,F,104138722,104180898,18910012,42176,452603210,10693,14
26175,TMEM251,chr14,F,93184950,93187086,18912148,2136,452605346,10694,1
26257,NKX2-8,chr14,R,36580010,36582581,18914719,2571,452607917,10695,1
26277,TINF2,chr14,R,24234402,24243027,18923344,8625,452616542,10696,6
26499,PLEK2,chr14,R,67385658,67412174,18949860,26516,452643058,10697,9
26520,TIMM9,chr14,R,58408493,58427614,18968981,19121,452662179,10698,5
26533,OR10G3,chr14,R,21569802,21570744,18969923,942,452663121,10699,0
26534,OR10G2,chr14,R,21633835,21634940,18971028,1105,452664226,10700,0
26686,OR4E2,chr14,F,21665082,21666024,18971970,942,452665168,10701,0
26865,RNU1-27P,chr14,F,34546713,34546877,18972134,164,452665332,10702,0
26866,RNU1-28P,chr14,R,34556225,34556389,18972298,164,452665496,10703,0
27004,TCL6,chr14,F,95651177,95673452,18994573,22275,452687771,10704,7
27030,MLH3,chr14,R,75013763,75051532,19032342,37769,452725540,10705,13
27109,ATP5S,chr14,F,50312328,50326715,19046729,14387,452739927,10706,9
27133,KCNH5,chr14,R,62706572,63045256,19385413,338684,453078611,10707,10
27141,CIDEB,chr14,R,24305186,24311377,19391604,6191,453084802,10708,7
29018,FOXN3-AS2,chr14,F,89576215,89577477,19392866,1262,453086064,10709,0
29082,CHMP4A,chr14,R,24209580,24213830,19397116,4250,453090314,10710,5
29091,STXBP6,chr14,R,24809653,25050297,19637760,240644,453330958,10711,10
29933,GPR132,chr14,R,105049388,105065550,19653922,16162,453347120,10712,4
29954,POMT2,chr14,R,77274955,77320884,19699851,45929,453393049,10713,23
29966,STRN3,chr14,R,30893778,31026528,19832601,132750,453525799,10714,18
29986,SLC39A2,chr14,F,20999254,21001875,19835222,2621,453528420,10715,3
30001,ERO1L,chr14,R,52639914,52695931,19891239,56017,453584437,10716,15
51004,COQ6,chr14,F,73949933,73963112,19904418,13179,453597616,10717,13
51016,EMC9,chr14,R,24138964,24141588,19907042,2624,453600240,10718,4
51062,ATL1,chr14,F,50533081,50633068,20007029,99987,453700227,10719,14
51077,FCF1,chr14,F,74713116,74736691,20030604,23575,453723802,10720,7
51109,RDH11,chr14,R,67676799,67695793,20049598,18994,453742796,10721,6
51156,SERPINA10,chr14,R,94283312,94293271,20059557,9959,453752755,10722,5
51199,NIN,chr14,R,50719762,50831165,20170960,111403,453864158,10723,34
51218,GLRX5,chr14,F,95534985,95544718,20180693,9733,453873891,10724,1
51222,ZNF219,chr14,R,21090045,21104704,20195352,14659,453888550,10725,9
51241,COX16,chr14,R,70325080,70359731,20230003,34651,453923201,10726,3
51292,GMPR2,chr14,F,24232421,24239242,20236824,6821,453930022,10727,9
51310,SLC22A17,chr14,R,23346310,23354976,20245490,8666,453938688,10728,9
51339,DACT1,chr14,F,58634067,58648321,20259744,14254,453952942,10729,5
51382,ATP6V1D,chr14,R,67337863,67360003,20281884,22140,453975082,10730,8
51466,EVL,chr14,F,100019386,100144236,20406734,124850,454099932,10731,18
51527,GSKIP,chr14,F,96363451,96387290,20430573,23839,454123771,10732,4
51528,JKAMP,chr14,F,59484442,59505407,20451538,20965,454144736,10733,6
51550,CINP,chr14,R,102348281,102362916,20466173,14635,454159371,10734,5
51562,MBIP,chr14,R,36298557,36320676,20488292,22119,454181490,10735,9
51635,DHRS7,chr14,R,60144777,60165493,20509008,20716,454202206,10736,6
51637,C14orf166,chr14,F,51989509,52004702,20524201,15193,454217399,10737,7
51676,ASB2,chr14,R,93934152,93976786,20566835,42634,454260033,10738,11
51804,SIX4,chr14,R,60709537,60724321,20581619,14784,454274817,10739,3
53349,ZFYVE1,chr14,R,72969444,73027212,20639387,57768,454332585,10740,13
53981,CPSF2,chr14,F,92121953,92164199,20681633,42246,454374831,10741,15
54207,KCNK10,chr14,R,88180107,88326912,20828438,146805,454521636,10742,9
54331,GNG2,chr14,F,51847130,51969800,20951108,122670,454644306,10743,6
54813,KLHL28,chr14,R,44924318,44978290,21005080,53972,454698278,10744,8
54916,TMEM260,chr14,F,56579790,56651884,21077174,72094,454770372,10745,22
54930,HAUS4,chr14,R,22946227,22957142,21088089,10915,454781287,10746,9
55012,PPP2R3C,chr14,R,35085471,35122501,21125119,37030,454818317,10747,13
55015,PRPF39,chr14,F,45084098,45115601,21156622,31503,454849820,10748,13
55017,C14orf119,chr14,F,23095473,23100456,21161605,4983,454854803,10749,1
55030,FBXO34,chr14,F,55271302,55353611,21243914,82309,454937112,10750,4
55038,CDCA4,chr14,R,105009572,105021088,21255430,11516,454948628,10751,1
55051,NRDE2,chr14,R,90278053,90332137,21309514,54084,455002712,10752,14
55072,RNF31,chr14,F,24147449,24160661,21322726,13212,455015924,10753,20
55102,ATG2B,chr14,R,96281257,96363341,21404810,82084,455098008,10754,44
55147,RBM23,chr14,R,22900644,22919187,21423353,18543,455116551,10755,18
55148,UBR7,chr14,F,93207055,93229215,21445513,22160,455138711,10756,10
55172,DNAAF2,chr14,R,49625173,49635230,21455570,10057,455148768,10757,2
55195,C14orf105,chr14,R,57469299,57493891,21480162,24592,455173360,10758,8
55218,EXD2,chr14,F,69191476,69244020,21532706,52544,455225904,10759,12
55237,VRTN,chr14,F,74303075,74360008,21589639,56933,455282837,10760,5
55320,MIS18BP1,chr14,R,45203189,45253402,21639852,50213,455333050,10761,17
55333,SYNJ2BP,chr14,R,70366495,70417090,21690447,50595,455383645,10762,6
55334,SLC39A9,chr14,F,69398378,69468403,21760472,70025,455453670,10763,9
55384,MEG3,chr14,F,100826107,100861026,21795391,34919,455488589,10764,12
55449,DHRS4-AS1,chr14,R,23938730,23955112,21811773,16382,455504971,10765,2
55632,G2E3,chr14,F,30559122,30619840,21872491,60718,455565689,10766,15
55640,FLVCR2,chr14,F,75578596,75648169,21942064,69573,455635262,10767,10
55644,OSGEP,chr14,R,20447047,20455108,21950125,8061,455643323,10768,10
55668,GPATCH2L,chr14,F,76151884,76214473,22012714,62589,455705912,10769,13
55671,SMEK1,chr14,R,91457480,91510554,22065788,53074,455758986,10770,17
55701,ARHGEF40,chr14,F,21070225,21090248,22085811,20023,455779009,10771,24
55727,BTBD7,chr14,R,93237549,93333092,22181354,95543,455874552,10772,12
55745,AP5M1,chr14,F,57268887,57298742,22211209,29855,455904407,10773,8
55775,TDP1,chr14,F,89954934,90044764,22301039,89830,455994237,10774,21
55778,ZNF839,chr14,F,102317376,102343174,22326837,25798,456020035,10775,13
55812,SPATA7,chr14,F,88385637,88470350,22411550,84713,456104748,10776,14
55837,EAPP,chr14,R,34515928,34539737,22435359,23809,456128557,10777,5
55860,ACTR10,chr14,F,58200114,58235636,22470881,35522,456164079,10778,12
56252,YLPM1,chr14,F,74763321,74837310,22544870,73989,456238068,10779,22
56339,METTL3,chr14,R,21498130,21511375,22558115,13245,456251313,10780,10
56413,LTB4R2,chr14,F,24310150,24312053,22560018,1903,456253216,10781,1
56659,KCNK13,chr14,F,90061764,90185857,22684111,124093,456377309,10782,1
56936,CCDC177,chr14,R,69569813,69574883,22689181,5070,456382379,10783,1
56948,SDR39U1,chr14,R,24439765,24442905,22692321,3140,456385519,10784,6
56967,C14orf132,chr14,F,96039323,96093971,22746969,54648,456440167,10785,3
57062,DDX24,chr14,R,94050921,94081212,22777260,30291,456470458,10786,8
57096,RPGRIP1,chr14,F,21287961,21351301,22840600,63340,456533798,10787,24
57143,ADCK1,chr14,F,77800064,77933954,22974490,133890,456667688,10788,14
57156,TMEM63C,chr14,F,77181758,77259495,23052227,77737,456745425,10789,23
57161,PELI2,chr14,F,56118322,56301581,23235486,183259,456928684,10790,9
57381,RHOJ,chr14,F,63204361,63293512,23324637,89151,457017835,10791,6
57447,NDRG2,chr14,R,21016762,21070872,23378747,54110,457071945,10792,22
57452,GALNT16,chr14,F,69259545,69379904,23499106,120359,457192304,10793,18
57475,PLEKHH1,chr14,F,67533198,67589538,23555446,56340,457248644,10794,31
57523,NYNRIN,chr14,F,24398785,24419288,23575949,20503,457269147,10795,9
57544,TXNDC16,chr14,R,52430589,52552583,23697943,121994,457391141,10796,22
57570,TRMT5,chr14,R,60971440,60981170,23707673,9730,457400871,10797,4
57578,UNC79,chr14,F,93333218,93707878,24082333,374660,457775531,10798,55
57594,HOMEZ,chr14,R,23273634,23286100,24094799,12466,457787997,10799,1
57596,BEGAIN,chr14,R,100537146,100587404,24145057,50258,457838255,10800,11
57680,CHD8,chr14,R,21385193,21437298,24197162,52105,457890360,10801,38
57697,FANCM,chr14,F,45135932,45200890,24262120,64958,457955318,10802,23
57718,PPP4R4,chr14,F,94174311,94279755,24367564,105444,458060762,10803,28
57820,CCNB1IP1,chr14,R,20311367,20333312,24389509,21945,458082707,10804,7
57862,ZNF410,chr14,F,73886614,73932288,24435183,45674,458128381,10805,14
58157,NGB,chr14,R,77265490,77271312,24441005,5822,458134203,10806,3
58517,RBM25,chr14,F,73058435,73121368,24503938,62933,458197136,10807,20
58533,SNX6,chr14,R,34561408,34630160,24572690,68752,458265888,10808,13
60485,SAV1,chr14,R,50633579,50668357,24607468,34778,458300666,10809,6
60686,C14orf93,chr14,R,22986900,23010201,24630769,23301,458323967,10810,9
63874,ABHD4,chr14,F,22598237,22612923,24645455,14686,458338653,10811,7
63894,VIPAS39,chr14,R,77426674,77457640,24676421,30966,458369619,10812,19
64067,NPAS3,chr14,F,32934908,33804176,25545689,869268,459238887,10813,15
64093,SMOC1,chr14,F,69879387,70032366,25698668,152979,459391866,10814,11
64112,MOAP1,chr14,R,93182195,93184904,25701377,2709,459394575,10815,2
64150,DIO3OS,chr14,R,101552222,101555676,25704831,3454,459398029,10816,0
64184,EDDM3B,chr14,F,20768426,20770948,25707353,2522,459400551,10817,1
64207,IRF2BPL,chr14,R,77024542,77028699,25711510,4157,459404708,10818,0
64398,MPP5,chr14,F,67241294,67336061,25806277,94767,459499475,10819,16
64403,CDH24,chr14,R,23047060,23057619,25816836,10559,459510034,10820,13
64423,INF2,chr14,F,104689605,104719610,25846841,30005,459540039,10821,24
64430,PCNXL4,chr14,F,60091826,60134814,25889829,42988,459583027,10822,11
64582,GPR135,chr14,R,59452772,59465396,25902453,12624,459595651,10823,5
64745,METTL17,chr14,F,20989805,20997035,25909683,7230,459602881,10824,12
64806,IL25,chr14,F,23372808,23376403,25913278,3595,459606476,10825,1
64841,GNPNAT1,chr14,R,52775192,52791668,25929754,16476,459622952,10826,7
64919,BCL11B,chr14,R,99169286,99271713,26032181,102427,459725379,10827,4
78990,OTUB2,chr14,F,94016094,94048930,26065017,32836,459758215,10828,10
79038,ZFYVE21,chr14,F,103715743,103733668,26082942,17925,459776140,10829,7
79104,MEG8,chr14,F,100894769,100906968,26095141,12199,459788339,10830,3
79178,THTPA,chr14,F,23511759,23559581,26142963,47822,459836161,10831,5
79317,OR4K5,chr14,F,19920606,19921578,26143935,972,459837133,10832,0
79334,OR11H2,chr14,R,19712903,19714332,26145364,1429,459838562,10833,1
79446,WDR25,chr14,F,100376416,100530303,26299251,153887,459992449,10834,9
79544,OR4K1,chr14,F,19920252,19936736,26315735,16484,460008933,10835,2
79609,VCPKMT,chr14,R,50108631,50116579,26323683,7948,460016881,10836,6
79686,LINC00341,chr14,R,95407265,95410090,26326508,2825,460019706,10837,0
79696,ZC2HC1C,chr14,F,75069231,75079987,26337264,10756,460030462,10838,3
79697,C14orf169,chr14,F,73490933,73493401,26339732,2468,460032930,10839,0
79711,IPO4,chr14,R,24180218,24188918,26348432,8700,460041630,10840,29
79789,CLMN,chr14,R,95181938,95319908,26486402,137970,460179600,10841,14
79820,CATSPERB,chr14,R,91580773,91732086,26637715,151313,460330913,10842,26
79882,ZC3H14,chr14,F,88562908,88613509,26688316,50601,460381514,10843,19
79890,RIN3,chr14,F,92513780,92688994,26863530,175214,460556728,10844,11
79944,L2HGDH,chr14,R,50242433,50312389,26933486,69956,460626684,10845,14
80017,C14orf159,chr14,F,91114012,91225396,27044870,111384,460738068,10846,18
80127,CCDC176,chr14,F,74019349,74078351,27103872,59002,460797070,10847,14
80224,NUBPL,chr14,F,31561384,31861224,27403712,299840,461096910,10848,16
80344,DCAF11,chr14,F,24114696,24125242,27414258,10546,461107456,10849,13
80757,TMEM121,chr14,F,105526030,105530202,27418430,4172,461111628,10850,3
80821,DDHD1,chr14,R,53036739,53153328,27535019,116589,461228217,10851,14
81127,OR4K15,chr14,F,19975518,19976565,27536066,1047,461229264,10852,0
81537,SGPP1,chr14,R,63684215,63728095,27579946,43880,461273144,10853,2
81542,TMX1,chr14,F,51240167,51257655,27597434,17488,461290632,10854,7
81693,AMN,chr14,F,102922547,102930847,27605734,8300,461298932,10855,12
81892,SLIRP,chr14,F,77708070,77717598,27615262,9528,461308460,10856,4
83544,DNAL1,chr14,F,73644874,73703728,27674116,58854,461367314,10857,9
83694,RPS6KL1,chr14,R,74902848,74923282,27694550,20434,461387748,10858,12
83851,SYT16,chr14,F,61812728,62117043,27998865,304315,461692063,10859,20
83982,IFI27L2,chr14,R,94127780,94129620,28000705,1840,461693903,10860,3
84075,FSCB,chr14,R,44504148,44507296,28003853,3148,461697051,10861,0
84193,SETD3,chr14,R,99397745,99481418,28087526,83673,461780724,10862,15
84312,BRMS1L,chr14,F,35826317,35871963,28133172,45646,461826370,10863,10
84334,APOPT1,chr14,F,103562956,103592187,28162403,29231,461855601,10864,7
84439,HHIPL1,chr14,F,99604437,99680569,28238535,76132,461931733,10865,11
84502,JPH4,chr14,R,23568034,23578800,28249301,10766,461942499,10866,6
84520,C14orf142,chr14,R,93202891,93207114,28253524,4223,461946722,10867,1
84659,RNASE7,chr14,F,21042225,21044233,28255532,2008,461948730,10868,1
84684,INSM2,chr14,F,35534041,35537054,28258545,3013,461951743,10869,0
84837,ARHGAP5-AS1,chr14,R,32075418,32076699,28259826,1281,461953024,10870,0
84932,RAB2B,chr14,R,21459019,21476973,28277780,17954,461970978,10871,10
84962,AJUBA,chr14,R,22971173,22982642,28289249,11469,461982447,10872,8
85439,STON2,chr14,R,81260649,81427404,28456004,166755,462149202,10873,8
85446,ZFHX2,chr14,R,23520854,23555939,28491089,35085,462184287,10874,16
85457,CIPC,chr14,F,77098234,77117287,28510142,19053,462203340,10875,3
85495,RPPH1,chr14,R,20343070,20343411,28510483,341,462203681,10876,0
89874,SLC25A21,chr14,R,36677317,37172660,29005826,495343,462699024,10877,12
89932,PAPLN,chr14,F,73235842,73274640,29044624,38798,462737822,10878,29
90050,FAM181A,chr14,F,93918893,93929608,29055339,10715,462748537,10879,4
90135,BTBD6,chr14,F,105248541,105251093,29057891,2552,462751089,10880,4
90141,EFCAB11,chr14,R,89794983,89954777,29217685,159794,462910883,10881,7
90668,LRRC16B,chr14,F,24051996,24069728,29235417,17732,462928615,10882,40
90673,PPP1R3E,chr14,R,23295920,23302848,29242345,6928,462935543,10883,4
90809,TMEM55B,chr14,R,20457852,20461612,29246105,3760,462939303,10884,6
91612,CHURC1,chr14,F,64914360,64935368,29267113,21008,462960311,10885,3
91748,ELMSAN1,chr14,R,73715121,73790285,29342277,75164,463035475,10886,14
91750,LIN52,chr14,F,74084835,74200414,29457856,115579,463151054,10887,8
91754,NEK9,chr14,R,75082114,75127075,29502817,44961,463196015,10888,21
91828,EXOC3L4,chr14,F,103094409,103110562,29518970,16153,463212168,10889,17
91833,WDR20,chr14,F,102139841,102224839,29603968,84998,463297166,10890,14
91875,TTC5,chr14,R,20289130,20305994,29620832,16864,463314030,10891,9
93487,MAPK1IP1L,chr14,F,55051643,55070194,29639383,18551,463332581,10892,4
112399,EGLN3,chr14,R,33924214,33951083,29666252,26869,463359450,10893,4
112487,DTD2,chr14,R,31446035,31457474,29677691,11439,463370889,10894,2
112752,IFT43,chr14,F,75985752,76084073,29776012,98321,463469210,10895,10
112840,WDR89,chr14,R,63597038,63641923,29820897,44885,463514095,10896,5
112849,L3HYPDH,chr14,R,59465510,59484438,29839825,18928,463533023,10897,5
113146,AHNAK2,chr14,R,104937252,104978357,29880930,41105,463574128,10898,7
114088,TRIM9,chr14,R,50975260,51095704,30001374,120444,463694572,10899,12
115708,TRMT61A,chr14,F,103529171,103537073,30009276,7902,463702474,10900,3
115817,DHRS1,chr14,R,24290597,24299833,30018512,9236,463711710,10901,9
116173,CMTM5,chr14,F,23376807,23379772,30021477,2965,463714675,10902,5
117153,MIA2,chr14,F,39233920,39253371,30040928,19451,463734126,10903,5
122402,TDRD9,chr14,F,103928437,104052667,30165158,124230,463858356,10904,40
122416,ANKRD9,chr14,R,102503648,102509791,30171301,6143,463864499,10905,3
122481,AK7,chr14,F,96392110,96489427,30268618,97317,463961816,10906,18
122509,IFI27L1,chr14,F,94081292,94102714,30290040,21422,463983238,10907,6
122525,C14orf28,chr14,F,44897303,44907257,30299994,9954,463993192,10908,5
122553,TRAPPC6B,chr14,R,39147810,39170430,30322614,22620,464015812,10909,6
122616,C14orf79,chr14,F,104986278,105000307,30336643,14029,464029841,10910,6
122618,PLD4,chr14,F,104924820,104937788,30349611,12968,464042809,10911,11
122622,ADSSL1,chr14,F,104724196,104747325,30372740,23129,464065938,10912,15
122651,RNASE11,chr14,R,20582891,20590258,30380107,7367,464073305,10913,2
122664,TPPP2,chr14,F,21030185,21036352,30386274,6167,464079472,10914,6
122665,RNASE8,chr14,F,21057821,21058455,30386908,634,464080106,10915,0
122704,MRPL52,chr14,F,22829850,22835037,30392095,5187,464085293,10916,4
122706,PSMB11,chr14,F,23042166,23044060,30393989,1894,464087187,10917,0
122740,OR4K14,chr14,R,20014260,20015193,30394922,933,464088120,10918,0
122742,OR4L1,chr14,F,20060044,20060983,30395861,939,464089059,10919,0
122748,OR11H6,chr14,F,20223709,20224702,30396854,993,464090052,10920,0
122769,LRR1,chr14,F,49598696,49614672,30412830,15976,464106028,10921,6
122773,KLHDC1,chr14,F,49693104,49753152,30472878,60048,464166076,10922,13
122786,FRMD6,chr14,F,51489099,51730727,30714506,241628,464407704,10923,17
122809,SOCS4,chr14,F,55027125,55049489,30736870,22364,464430068,10924,2
122830,NAA30,chr14,F,57390552,57412748,30759066,22196,464452264,10925,4
122876,GPHB5,chr14,R,63312834,63318879,30765111,6045,464458309,10926,2
122945,NOXRED1,chr14,R,77394020,77426011,30797102,31991,464490300,10927,7
122953,JDP2,chr14,F,75427805,75472701,30841998,44896,464535196,10928,7
122961,ISCA2,chr14,F,74493719,74495568,30843847,1849,464537045,10929,3
122970,ACOT4,chr14,F,73591705,73595766,30847908,4061,464541106,10930,2
123016,TTC8,chr14,F,88824152,88877996,30901752,53844,464594950,10931,17
123036,TC2N,chr14,R,91779750,91867536,30989538,87786,464682736,10932,12
123041,SLC24A4,chr14,F,92322580,92501481,31168439,178901,464861637,10933,25
123096,SLC25A29,chr14,R,100279176,100306547,31195810,27371,464889008,10934,8
123099,DEGS2,chr14,R,100146415,100166882,31216277,20467,464909475,10935,4
123103,KLHL33,chr14,R,20427650,20436310,31224937,8660,464918135,10936,4
140801,RPL10L,chr14,R,46651012,46651825,31225750,813,464918948,10937,0
145200,LINC00239,chr14,F,101730436,101732525,31227839,2089,464921037,10938,3
145216,LINC00637,chr14,F,103847720,103858049,31238168,10329,464931366,10939,2
145226,RDH12,chr14,F,67701885,67734451,31270734,32566,464963932,10940,8
145241,ADAM21P1,chr14,R,70245752,70247801,31272783,2049,464965981,10941,0
145249,LINC00618,chr14,F,96943578,96945394,31274599,1816,464967797,10942,2
145258,GSC,chr14,R,94768222,94770162,31276539,1940,464969737,10943,2
145264,SERPINA12,chr14,R,94481650,94517844,31312733,36194,465005931,10944,8
145270,PRIMA1,chr14,R,93718297,93789035,31383471,70738,465076669,10945,5
145282,MIPOL1,chr14,F,37197912,37578857,31764416,380945,465457614,10946,24
145376,PPP1R36,chr14,F,64549901,64589386,31803901,39485,465497099,10947,12
145389,SLC38A6,chr14,F,60981113,61083733,31906521,102620,465599719,10948,21
145407,C14orf37,chr14,R,57993530,58152239,32065230,158709,465758428,10949,10
145438,FRMD6-AS1,chr14,R,51649515,51651744,32067459,2229,465760657,10950,0
145447,ABHD12B,chr14,F,50872089,50904970,32100340,32881,465793538,10951,15
145474,LOC145474,chr14,F,71487860,71489714,32102194,1854,465795392,10952,0
145482,PTGR2,chr14,F,73851830,73885465,32135829,33635,465829027,10953,9
145483,FAM161B,chr14,R,73932030,73950414,32154213,18384,465847411,10954,9
145497,LRRC74A,chr14,F,76826375,76870302,32198140,43927,465891338,10955,16
145501,ISM2,chr14,R,77474393,77498867,32222614,24474,465915812,10956,7
145508,CEP128,chr14,R,80476987,80959501,32705128,482514,466398326,10957,30
145553,MDP1,chr14,R,24213936,24216070,32707262,2134,466400460,10958,5
145567,TTC7B,chr14,R,90540587,90816479,32983154,275892,466676352,10959,22
145581,LRFN5,chr14,F,41607560,41904549,33280143,296989,466973341,10960,6
161142,FAM71D,chr14,F,67189392,67228550,33319301,39158,467012499,10961,13
161145,TMEM229B,chr14,R,67470265,67533739,33382775,63474,467075973,10962,6
161159,ACTN1-AS1,chr14,F,68979681,68987463,33390557,7782,467083755,10963,3
161176,SYNE3,chr14,R,95416082,95516668,33491143,100586,467184341,10964,22
161198,CLEC14A,chr14,R,38253999,38256370,33493514,2371,467186712,10965,0
161247,FITM1,chr14,F,24131465,24132849,33494898,1384,467188096,10966,1
161253,REM2,chr14,F,22883164,22887680,33499414,4516,467192612,10967,4
161291,TMEM30B,chr14,R,61277369,61281812,33503857,4443,467197055,10968,0
161357,MDGA2,chr14,R,46839622,47675334,34339569,835712,468032767,10969,22
161394,SAMD15,chr14,F,77377418,77391244,34353395,13826,468046593,10970,2
161424,NOP9,chr14,F,24299853,24309126,34362668,9273,468055866,10971,10
161436,EML5,chr14,R,88612430,88792752,34542990,180322,468236188,10972,47
171546,SPTSSA,chr14,R,34432937,34462262,34572315,29325,468265513,10973,1
196872,LINC00638,chr14,F,104821200,104823718,34574833,2518,468268031,10974,0
196883,ADCY4,chr14,R,24318348,24335071,34591556,16723,468284754,10975,24
196913,C14orf183,chr14,R,50083650,50092643,34600549,8993,468293747,10976,4
253959,RALGAPA1,chr14,R,35538351,35809304,34871502,270953,468564700,10977,45
253970,SFTA3,chr14,R,36473287,36513785,34912000,40498,468605198,10978,3
254028,LOC254028,chr14,F,20588223,20607221,34930998,18998,468624196,10979,4
254170,FBXO33,chr14,R,39396372,39432500,34967126,36128,468660324,10980,3
256281,NUDT14,chr14,R,105172936,105181323,34975513,8387,468668711,10981,5
256369,LINC00521,chr14,F,93997269,94011695,34989939,14426,468683137,10982,15
256394,SERPINA11,chr14,R,94442463,94452850,35000326,10387,468693524,10983,4
280655,IGBP1P1,chr14,F,34939921,34940496,35000901,575,468694099,10984,0
283547,LINC00639,chr14,R,38749338,38916882,35168445,167544,468861643,10985,4
283551,LINC01588,chr14,R,49981668,50007520,35194297,25852,468887495,10986,6
283553,LINC00640,chr14,F,51333392,51365557,35226462,32165,468919660,10987,4
283554,GPR137C,chr14,F,52553147,52637713,35311028,84566,469004226,10988,6
283571,PROX2,chr14,R,74852805,74876419,35334642,23614,469027840,10989,6
283575,LOC283575,chr14,F,77041048,77069503,35363097,28455,469056295,10990,3
283576,ZDHHC22,chr14,R,77131269,77144268,35376096,12999,469069294,10991,5
283578,TMED8,chr14,R,77335020,77377053,35418129,42033,469111327,10992,5
283579,C14orf178,chr14,F,77760829,77769742,35427042,8913,469120240,10993,2
283585,LOC283585,chr14,F,86905777,86922755,35444020,16978,469137218,10994,4
283587,LINC01146,chr14,F,88024549,88087346,35506817,62797,469200015,10995,3
283592,FAM181A-AS1,chr14,R,93904729,93926372,35528460,21643,469221658,10996,10
283596,SNHG10,chr14,R,95532911,95534872,35530421,1961,469223619,10997,0
283598,C14orf177,chr14,F,98711612,98717766,35536575,6154,469229773,10998,3
283600,SLC25A47,chr14,F,100323341,100330378,35543612,7037,469236810,10999,5
283601,LINC00523,chr14,F,100657267,100672744,35559089,15477,469252287,11000,1
283624,LINC00641,chr14,R,21200078,21206900,35565911,6822,469259109,11001,1
283629,TSSK4,chr14,F,24205529,24208248,35568630,2719,469261828,11002,3
283635,FAM177A1,chr14,F,35044906,35083383,35607107,38477,469300305,11003,6
283638,CEP170B,chr14,F,104865312,104896770,35638565,31458,469331763,11004,21
283643,C14orf80,chr14,F,105489854,105499248,35647959,9394,469341157,11005,10
317749,DHRS4L2,chr14,F,23969873,24006408,35684494,36535,469377692,11006,9
317760,ADAM20P1,chr14,R,70468875,70483756,35699375,14881,469392573,11007,1
317761,C14orf39,chr14,R,60353121,60486069,35832323,132948,469525521,11008,31
317762,CCDC85C,chr14,R,99511265,99604390,35925448,93125,469618646,11009,7
319085,ITPK1-AS1,chr14,F,93067451,93072152,35930149,4701,469623347,11010,0
319089,TTC6,chr14,F,37595198,37842628,36177579,247430,469870777,11011,35
319103,SNORD8,chr14,R,21397292,21397401,36177688,109,469870886,11012,0
319139,SNORD56B,chr14,F,71398336,71398407,36177759,71,469870957,11013,0
327657,SERPINA9,chr14,R,94462720,94476333,36191372,13613,469884570,11014,5
338002,LINC00524,chr14,R,101405986,101407922,36193308,1936,469886506,11015,1
338004,LINC00226,chr14,F,106287673,106288372,36194007,699,469887205,11016,1
338005,LINC00221,chr14,F,106482438,106495515,36207084,13077,469900282,11017,2
338879,RNASE10,chr14,F,20510471,20511122,36207735,651,469900933,11018,0
338917,VSX2,chr14,F,74239471,74262738,36231002,23267,469924200,11019,4
341799,OR6S1,chr14,R,20640695,20641691,36231998,996,469925196,11020,0
341880,SLC35F4,chr14,R,57563921,57982274,36650351,418353,470343549,11021,18
341883,LRRC9,chr14,F,59919712,60063559,36794198,143847,470487396,11022,32
341947,COX8C,chr14,F,93347190,93348354,36795362,1164,470488560,11023,1
374569,ASPG,chr14,F,104085669,104112761,36822454,27092,470515652,11024,18
376267,RAB15,chr14,R,64945813,64972290,36848931,26477,470542129,11025,7
378706,RN7SL2,chr14,R,49862550,49862849,36849230,299,470542428,11026,0
378881,MIR381HG,chr14,F,101045156,101051795,36855869,6639,470549067,11027,2
379025,PSMA3-AS1,chr14,R,58265364,58298137,36888642,32773,470581840,11028,4
387332,TBPL2,chr14,R,55414209,55440545,36914978,26336,470608176,11029,6
387978,LINC01551,chr14,F,28772703,28794794,36937069,22091,470630267,11030,4
387990,TOMM20L,chr14,F,58395925,58417080,36958224,21155,470651422,11031,5
388007,SERPINA13P,chr14,F,94640724,94646994,36964494,6270,470657692,11032,4
388011,LINC01550,chr14,R,97925609,97978124,37017009,52515,470710207,11033,2
388015,RTL1,chr14,R,100880654,100884847,37021202,4193,470714400,11034,0
388021,TMEM179,chr14,R,104590863,104604787,37035126,13924,470728324,11035,7
388022,LOC388022,chr14,F,104719712,104722537,37037951,2825,470731149,11036,0
390429,OR4N2,chr14,F,19797292,19828973,37069632,31681,470762830,11037,2
390431,OR4K2,chr14,F,19876118,19877303,37070817,1185,470764015,11038,1
390433,OR4K13,chr14,R,20033843,20034758,37071732,915,470764930,11039,0
390436,OR4K17,chr14,F,20117406,20118438,37072764,1032,470765962,11040,0
390437,OR4N5,chr14,F,20143735,20144662,37073691,927,470766889,11041,0
390439,OR11G2,chr14,F,20197335,20198373,37074729,1038,470767927,11042,0
390442,OR11H4,chr14,F,20242791,20243766,37075704,975,470768902,11043,0
390443,RNASE9,chr14,R,20556092,20560931,37080543,4839,470773741,11044,4
390445,OR5AU1,chr14,R,21154936,21156025,37081632,1089,470774830,11045,0
390502,SERPINA2,chr14,R,94364317,94366702,37084017,2385,470777215,11046,1
399671,HEATR4,chr14,R,73478483,73558947,37164481,80464,470857679,11047,19
400212,LOC400212,chr14,R,50946793,50962002,37179690,15209,470872888,11048,3
400221,FLJ22447,chr14,F,61570539,61654713,37263864,84174,470957062,11049,2
400224,PLEKHD1,chr14,F,69484753,69529327,37308438,44574,471001636,11050,14
400236,FOXN3-AS1,chr14,F,89417353,89419793,37310878,2440,471004076,11051,1
400238,LINC00642,chr14,F,90455229,90458905,37314554,3676,471007752,11052,3
400242,DICER1-AS1,chr14,F,95157687,95179933,37336800,22246,471029998,11053,3
400258,C14orf180,chr14,F,104579683,104589847,37346964,10164,471040162,11054,5
404785,POTEG,chr14,R,19402763,19434341,37378542,31578,471071740,11055,11
406914,MIR127,chr14,F,100882978,100883075,37378639,97,471071837,11056,0
406924,MIR134,chr14,F,101054686,101054759,37378712,73,471071910,11057,0
406927,MIR136,chr14,F,100884701,100884783,37378794,82,471071992,11058,0
406946,MIR154,chr14,F,101059754,101059838,37378878,84,471072076,11059,0
406986,MIR203A,chr14,F,104117404,104117514,37378988,110,471072186,11060,0
406990,MIR208A,chr14,R,23388595,23388666,37379059,71,471072257,11061,0
407023,MIR299,chr14,F,101023793,101023856,37379122,63,471072320,11062,0
414763,BMS1P18,chr14,R,19083133,19093337,37389326,10204,471082524,11063,2
440153,OR11H12,chr14,F,18601116,18602097,37390307,981,471083505,11064,0
440163,RNASE13,chr14,R,21032819,21034785,37392273,1966,471085471,11065,1
440184,LINC00238,chr14,F,66486370,66498553,37404456,12183,471097654,11066,10
440193,CCDC88C,chr14,R,91271322,91417844,37550978,146522,471244176,11067,33
441669,OR4Q3,chr14,F,19747427,19748369,37551920,942,471245118,11068,0
441670,OR4M1,chr14,F,19780322,19781264,37552862,942,471246060,11069,0
441687,TEX21P,chr14,R,64345472,64347611,37555001,2139,471248199,11070,1
442897,MIR323A,chr14,F,101025731,101025817,37555087,86,471248285,11071,0
442905,MIR337,chr14,F,100874492,100874585,37555180,93,471248378,11072,0
442909,MIR342,chr14,F,100109654,100109753,37555279,99,471248477,11073,0
442910,MIR345,chr14,F,100307858,100307956,37555377,98,471248575,11074,0
442913,MIR376C,chr14,F,101039689,101039755,37555443,66,471248641,11075,0
442914,MIR369,chr14,F,101065597,101065667,37555513,70,471248711,11076,0
442915,MIR370,chr14,F,100911138,100911213,37555588,75,471248786,11077,0
493901,RNASE12,chr14,R,20590079,20590823,37556332,744,471249530,11078,0
494325,MIR376A1,chr14,F,101040781,101040849,37556400,68,471249598,11079,0
494326,MIR377,chr14,F,101062049,101062118,37556469,69,471249667,11080,0
494328,MIR379,chr14,F,101022065,101022132,37556536,67,471249734,11081,0
494329,MIR380,chr14,F,101025016,101025077,37556597,61,471249795,11082,0
494330,MIR381,chr14,F,101045919,101045994,37556672,75,471249870,11083,0
494331,MIR382,chr14,F,101054305,101054381,37556748,76,471249946,11084,0
503639,DUXAP10,chr14,R,19294784,19337674,37599638,42890,471292836,11085,7
574034,MIR433,chr14,F,100881885,100881978,37599731,93,471292929,11086,0
574038,MIR431,chr14,F,100881006,100881120,37599845,114,471293043,11087,0
574408,MIR329-1,chr14,F,101026784,101026864,37599925,80,471293123,11088,0
574409,MIR329-2,chr14,F,101027099,101027183,37600009,84,471293207,11089,0
574410,MIR323B,chr14,F,101056218,101056300,37600091,82,471293289,11090,0
574413,MIR409,chr14,F,101065299,101065378,37600170,79,471293368,11091,0
574433,MIR412,chr14,F,101065446,101065537,37600261,91,471293459,11092,0
574434,MIR410,chr14,F,101065911,101065991,37600341,80,471293539,11093,0
574435,MIR376B,chr14,F,101040435,101040535,37600441,100,471293639,11094,0
574436,MIR485,chr14,F,101055418,101055491,37600514,73,471293712,11095,0
574450,MIR493,chr14,F,100869059,100869148,37600603,89,471293801,11096,0
574451,MIR432,chr14,F,100884482,100884576,37600697,94,471293895,11097,0
574452,MIR494,chr14,F,101029633,101029714,37600778,81,471293976,11098,0
574453,MIR495,chr14,F,101033754,101033836,37600860,82,471294058,11099,0
574454,MIR496,chr14,F,101060572,101060674,37600962,102,471294160,11100,0
619555,MIR487A,chr14,F,101052445,101052525,37601042,80,471294240,11101,0
641371,ACOT1,chr14,F,73493233,73543799,37651608,50566,471344806,11102,6
641372,ACOT6,chr14,F,73612295,73619908,37659221,7613,471352419,11103,2
641455,POTEM,chr14,F,18967433,19003752,37695540,36319,471388738,11104,10
642426,LOC642426,chr14,R,18630535,18633634,37698639,3099,471391837,11105,2
642477,LINC01296,chr14,F,19062376,19107497,37743760,45121,471436958,11106,8
643332,ECRP,chr14,F,20919340,20920176,37744596,836,471437794,11107,1
643382,TMEM253,chr14,F,21098936,21103724,37749384,4788,471442582,11108,7
643866,CBLN3,chr14,R,24426531,24429525,37752378,2994,471445576,11109,2
644919,LOC644919,chr14,F,40954710,41141048,37938716,186338,471631914,11110,4
645431,FUT8-AS1,chr14,R,65410591,65412617,37940742,2026,471633940,11111,0
645683,RPL13AP3,chr14,F,55766244,55767717,37942215,1473,471635413,11112,0
645687,LINC00520,chr14,R,55781134,55796674,37957755,15540,471650953,11113,3
646113,LINC00643,chr14,F,62117356,62134186,37974585,16830,471667783,11114,3
646658,SYNDIG1L,chr14,R,74405892,74437631,38006324,31739,471699522,11115,4
647286,RD3L,chr14,R,103940425,103942308,38008207,1883,471701405,11116,2
647310,TEX22,chr14,F,105398582,105413859,38023484,15277,471716682,11117,4
664612,MIR539,chr14,F,101047320,101047398,38023562,78,471716760,11118,0
664613,MIR544A,chr14,F,101048657,101048748,38023653,91,471716851,11119,0
664615,MIR376A2,chr14,F,101040068,101040148,38023733,80,471716931,11120,0
664616,MIR487B,chr14,F,101046454,101046538,38023817,84,471717015,11121,0
677768,SCARNA13,chr14,R,95533354,95533629,38024092,275,471717290,11122,0
677811,SNORA28,chr14,F,103337848,103337974,38024218,126,471717416,11123,0
677845,SNORA79,chr14,R,81202694,81202834,38024358,140,471717556,11124,0
692053,SNORD9,chr14,R,21392150,21392253,38024461,103,471717659,11125,0
692215,SNORD112,chr14,F,100897919,100897996,38024538,77,471717736,11126,0
693121,MIR411,chr14,F,101023324,101023420,38024634,96,471717832,11127,0
693209,MIR624,chr14,R,31014645,31014742,38024731,97,471717929,11128,0
693210,MIR625,chr14,F,65471101,65471186,38024816,85,471718014,11129,0
724024,MIR654,chr14,F,101040218,101040299,38024897,81,471718095,11130,0
724025,MIR655,chr14,F,101049549,101049646,38024994,97,471718192,11131,0
724026,MIR656,chr14,F,101066723,101066801,38025072,78,471718270,11132,0
728635,DHRS4L1,chr14,F,24007008,24051377,38069441,44369,471762639,11133,8
728755,LOC728755,chr14,R,27317382,27673221,38425280,355839,472118478,11134,2
729451,LOC729451,chr14,R,54671067,54687918,38442131,16851,472135329,11135,2
729665,CCDC175,chr14,R,59505066,59582114,38519179,77048,472212377,11136,24
730202,LOC730202,chr14,R,96501647,96502326,38519858,679,472213056,11137,0
731223,LINC01220,chr14,F,75294403,75296410,38521865,2007,472215063,11138,2
767561,SNORD113-1,chr14,F,100924820,100924890,38521935,70,472215133,11139,0
767562,SNORD113-2,chr14,F,100927341,100927412,38522006,71,472215204,11140,0
767563,SNORD113-3,chr14,F,100929918,100929989,38522077,71,472215275,11141,0
767564,SNORD113-4,chr14,F,100936490,100936564,38522151,74,472215349,11142,0
767565,SNORD113-5,chr14,F,100938186,100938263,38522228,77,472215426,11143,0
767566,SNORD113-6,chr14,F,100939555,100939629,38522302,74,472215500,11144,0
767567,SNORD113-7,chr14,F,100941125,100941201,38522378,76,472215576,11145,0
767568,SNORD113-8,chr14,F,100943450,100943523,38522451,73,472215649,11146,0
767569,SNORD113-9,chr14,F,100945648,100945719,38522522,71,472215720,11147,0
767577,SNORD114-1,chr14,F,100949832,100949903,38522593,71,472215791,11148,0
767578,SNORD114-2,chr14,F,100951855,100951932,38522670,77,472215868,11149,0
767579,SNORD114-3,chr14,F,100953348,100953422,38522744,74,472215942,11150,0
767580,SNORD114-4,chr14,F,100954343,100954447,38522848,104,472216046,11151,0
767581,SNORD114-5,chr14,F,100955369,100955438,38522917,69,472216115,11152,0
767582,SNORD114-6,chr14,F,100957165,100957236,38522988,71,472216186,11153,0
767583,SNORD114-7,chr14,F,100963053,100963129,38523064,76,472216262,11154,0
767584,SNORD114-8,chr14,F,100964780,100964851,38523135,71,472216333,11155,0
767585,SNORD114-9,chr14,F,100966028,100966099,38523206,71,472216404,11156,0
767588,SNORD114-10,chr14,F,100967051,100967122,38523277,71,472216475,11157,0
767589,SNORD114-11,chr14,F,100968110,100968184,38523351,74,472216549,11158,0
767590,SNORD114-12,chr14,F,100968947,100969021,38523425,74,472216623,11159,0
767591,SNORD114-13,chr14,F,100969878,100969951,38523498,73,472216696,11160,0
767592,SNORD114-14,chr14,F,100972102,100972176,38523572,74,472216770,11161,0
767593,SNORD114-15,chr14,F,100972669,100972740,38523643,71,472216841,11162,0
767594,SNORD114-16,chr14,F,100973594,100973663,38523712,69,472216910,11163,0
767595,SNORD114-17,chr14,F,100974805,100974879,38523786,74,472216984,11164,0
767596,SNORD114-18,chr14,F,100975824,100975895,38523857,71,472217055,11165,0
767597,SNORD114-19,chr14,F,100976476,100976550,38523931,74,472217129,11166,0
767598,SNORD114-20,chr14,F,100981003,100981074,38524002,71,472217200,11167,0
767599,SNORD114-21,chr14,F,100981974,100982045,38524073,71,472217271,11168,0
767600,SNORD114-22,chr14,F,100982925,100982996,38524144,71,472217342,11169,0
767603,SNORD114-23,chr14,F,100983875,100983946,38524215,71,472217413,11170,0
767604,SNORD114-24,chr14,F,100984776,100984847,38524286,71,472217484,11171,0
767605,SNORD114-25,chr14,F,100986056,100986127,38524357,71,472217555,11172,0
767606,SNORD114-26,chr14,F,100987045,100987116,38524428,71,472217626,11173,0
767608,SNORD114-27,chr14,F,100988160,100988229,38524497,69,472217695,11174,0
767609,SNORD114-28,chr14,F,100989129,100989200,38524568,71,472217766,11175,0
767610,SNORD114-29,chr14,F,100990090,100990159,38524637,69,472217835,11176,0
767611,SNORD114-30,chr14,F,100991918,100991989,38524708,71,472217906,11177,0
767612,SNORD114-31,chr14,F,100993235,100993309,38524782,74,472217980,11178,0
768212,MIR758,chr14,F,101026019,101026107,38524870,88,472218068,11179,0
768214,MIR668,chr14,F,101055257,101055323,38524936,66,472218134,11180,0
768222,MIR770,chr14,F,100852389,100852487,38525034,98,472218232,11181,0
100009601,TRY-GTA7-1,chr14,R,20659957,20660051,38525128,94,472218326,11182,1
100009602,TRY-GTA5-2,chr14,R,20663191,20663285,38525222,94,472218420,11183,1
100113389,SNORD127,chr14,F,45110874,45110975,38525323,101,472218521,11184,0
100113391,SNORD126,chr14,R,20326440,20326539,38525422,99,472218620,11185,0
100124539,SNORA11B,chr14,F,91126425,91126552,38525549,127,472218747,11186,0
100126297,MIR300,chr14,F,101041362,101041445,38525632,83,472218830,11187,0
100126308,MIR541,chr14,F,101064494,101064578,38525716,84,472218914,11188,0
100126315,MIR665,chr14,F,100875032,100875104,38525788,72,472218986,11189,0
100126335,MIR543,chr14,F,101031986,101032064,38525866,78,472219064,11190,0
100126336,MIR208B,chr14,R,23417986,23418063,38525943,77,472219141,11191,0
100126345,MIR889,chr14,F,101047900,101047979,38526022,79,472219220,11192,0
100128233,LOC100128233,chr14,R,65212892,65222347,38535477,9455,472228675,11193,3
100128908,LOC100128908,chr14,R,23100212,23105804,38541069,5592,472234267,11194,11
100128927,ZBTB42,chr14,F,104800595,104804712,38545186,4117,472238384,11195,1
100129075,KTN1-AS1,chr14,R,55576156,55580092,38549122,3936,472242320,11196,2
100129345,LOC100129345,chr14,R,97632646,97686658,38603134,54012,472296332,11197,3
100129794,SLC25A21-AS1,chr14,F,37172025,37173794,38604903,1769,472298101,11198,0
100131366,LINC00605,chr14,R,103187220,103189028,38606711,1808,472299909,11199,2
100189001,TRY-GTA5-3,chr14,F,20683272,20683361,38606800,89,472299998,11200,1
100189088,TRP-TGG3-1,chr14,F,20684015,20684087,38606872,72,472300070,11201,0
100189107,TRK-CTT1-1,chr14,R,58239894,58239967,38606945,73,472300143,11202,0
100189151,TRL-TAG2-1,chr14,F,20625369,20625451,38607027,82,472300225,11203,0
100189243,TRR-ACG1-1,chr14,F,22929700,22929773,38607100,73,472300298,11204,0
100189263,TRT-TGT5-1,chr14,F,20681689,20681762,38607173,73,472300371,11205,0
100189275,TRI-AAT5-1,chr14,F,102317091,102317165,38607247,74,472300445,11206,0
100189286,TRP-TGG1-1,chr14,F,20633005,20633077,38607319,72,472300517,11207,0
100189359,TRC-GCA8-1,chr14,F,72962970,72963042,38607391,72,472300589,11208,0
100189405,TRY-GTA4-1,chr14,R,20657463,20657557,38607485,94,472300683,11209,1
100189419,TRT-TGT4-1,chr14,R,20631159,20631232,38607558,73,472300756,11210,0
100189424,TRY-GTA5-1,chr14,R,20653098,20653192,38607652,94,472300850,11211,1
100288846,LOC100288846,chr14,R,39265702,39267061,38609011,1359,472302209,11212,0
100289511,LOC100289511,chr14,R,69766282,69767713,38610442,1431,472303640,11213,0
100302145,MIR1247,chr14,R,101560286,101560422,38610578,136,472303776,11214,0
100302157,MIR1185-1,chr14,F,101042976,101043062,38610664,86,472303862,11215,0
100302209,MIR1185-2,chr14,F,101044197,101044283,38610750,86,472303948,11216,0
100302236,MIR1260A,chr14,F,77266217,77266290,38610823,73,472304021,11217,0
100302250,MIR1197,chr14,F,101025563,101025651,38610911,88,472304109,11218,0
100309464,OTX2-AS1,chr14,F,56813182,56930833,38728562,117651,472421760,11219,3
100313830,MIR548H1,chr14,R,64095023,64095125,38728664,102,472421862,11220,0
100422830,MIR3171,chr14,R,27633204,27633278,38728738,74,472421936,11221,0
100422837,MIR1193,chr14,F,101030051,101030129,38728816,78,472422014,11222,0
100422954,MIR4309,chr14,F,102539643,102539726,38728899,83,472422097,11223,0
100422981,MIR3173,chr14,R,95137918,95137986,38728967,68,472422165,11224,0
100422984,MIR4308,chr14,R,54878112,54878193,38729048,81,472422246,11225,0
100423019,MIR4307,chr14,F,26908641,26908725,38729132,84,472422330,11226,0
100500919,MIR548Y,chr14,R,47760994,47761104,38729242,110,472422440,11227,0
100505758,PRMT5-AS1,chr14,F,22919455,22923407,38733194,3952,472426392,11228,1
100505967,LINC00645,chr14,F,27612587,27639636,38760243,27049,472453441,11229,4
100506071,LOC100506071,chr14,R,30876178,30889808,38773873,13630,472467071,11230,4
100506157,SRP54-AS1,chr14,R,34916378,34982609,38840104,66231,472533302,11231,12
100506237,NKX2-1-AS1,chr14,F,36519277,36523016,38843843,3739,472537041,11232,1
100506321,LOC100506321,chr14,F,65089917,65094311,38848237,4394,472541435,11233,2
100506358,LOC100506358,chr14,F,69811439,69815967,38852765,4528,472545963,11234,1
100506411,LOC100506411,chr14,F,70809198,70816048,38859615,6850,472552813,11235,2
100506412,LINC00871,chr14,F,46064158,46501903,39297360,437745,472990558,11236,7
100506433,LINC00648,chr14,R,47764952,47795014,39327422,30062,473020620,11237,2
100506446,LOC100506446,chr14,R,49919813,49961960,39369569,42147,473062767,11238,5
100506476,LOC100506476,chr14,F,73787359,73803628,39385838,16269,473079036,11239,2
100506498,LOC100506498,chr14,R,73822558,73830285,39393565,7727,473086763,11240,1
100506499,LOC100506499,chr14,R,50007312,50039884,39426137,32572,473119335,11241,5
100506603,LOC100506603,chr14,R,76781732,76786724,39431129,4992,473124327,11242,2
100506700,LOC100506700,chr14,R,81441986,81450157,39439300,8171,473132498,11243,2
100506731,LOC100506731,chr14,R,85524431,85530319,39445188,5888,473138386,11244,1
100506999,LOC100506999,chr14,F,95573553,95582449,39454084,8896,473147282,11245,3
100507043,TUNAR,chr14,F,95876771,95925571,39502884,48800,473196082,11246,1
100507257,MEG9,chr14,F,101069910,101072937,39505911,3027,473199109,11247,1
100507277,LOC100507277,chr14,F,101442078,101444315,39508148,2237,473201346,11248,1
100507437,LOC100507437,chr14,R,105417580,105419739,39510307,2159,473203505,11249,2
100507513,LOC100507513,chr14,R,20870236,20936309,39576380,66073,473269578,11250,3
100507650,RNF212B,chr14,F,23185333,23274285,39665332,88952,473358530,11251,20
100508046,LOC100508046,chr14,R,18976747,18980793,39669378,4046,473362576,11252,1
100528064,NEDD8-MDP1,chr14,R,24213936,24232370,39687812,18434,473381010,11253,3
100529063,BCL2L2-PABPN1,chr14,F,23306761,23326185,39707236,19424,473400434,11254,6
100529257,SYNJ2BP-COX16,chr14,R,70325080,70417090,39799246,92010,473492444,11255,6
100529261,CHURC1-FNTB,chr14,F,64914360,65062655,39947541,148295,473640739,11256,13
100616135,MIR4507,chr14,R,105858123,105858175,39947593,52,473640791,11257,0
100616140,MIR4506,chr14,R,93948225,93948302,39947670,77,473640868,11258,0
100616158,MIR4505,chr14,F,73758746,73758819,39947743,73,473640941,11259,0
100616173,MIR203B,chr14,R,104117417,104117503,39947829,86,473641027,11260,0
100616176,MIR4708,chr14,R,65335116,65335183,39947896,67,473641094,11261,0
100616211,MIR4709,chr14,R,74480132,74480204,39947968,72,473641166,11262,0
100616247,MIR151B,chr14,R,100109418,100109514,39948064,96,473641262,11263,0
100616261,MIR4504,chr14,R,50299854,50299946,39948156,92,473641354,11264,0
100616276,MIR4538,chr14,R,105858164,105858242,39948234,78,473641432,11265,0
100616280,MIR4503,chr14,R,36952308,36952391,39948317,83,473641515,11266,0
100616300,MIR4710,chr14,R,104677693,104677749,39948373,56,473641571,11267,0
100616374,MIR4539,chr14,R,105857512,105857572,39948433,60,473641631,11268,0
100616422,MIR4537,chr14,R,105859483,105859553,39948503,70,473641701,11269,0
100616424,MIR4707,chr14,R,22956949,22957029,39948583,80,473641781,11270,0
100616490,MIR4706,chr14,F,65044687,65044769,39948665,82,473641863,11271,0
100616495,MIR2392,chr14,F,100814490,100814574,39948749,84,473641947,11272,0
100628307,DIO2-AS1,chr14,F,80211418,80455467,40192798,244049,473885996,11273,8
100750246,HIF1A-AS1,chr14,R,61681040,61695823,40207581,14783,473900779,11274,1
100750247,HIF1A-AS2,chr14,R,61747038,61749089,40209632,2051,473902830,11275,0
100847062,MIR5195,chr14,R,106850884,106850999,40209747,115,473902945,11276,0
100847064,MIR5694,chr14,R,67441854,67441930,40209823,76,473903021,11277,0
100847076,MIR5580,chr14,R,53948426,53948484,40209881,58,473903079,11278,0
100847088,MIR5586,chr14,R,59646961,59647020,40209940,59,473903138,11279,0
100874185,FRMD6-AS2,chr14,R,51454511,51599952,40355381,145441,474048579,11280,4
100886964,PTCSC3,chr14,R,36135709,36176651,40396323,40942,474089521,11281,3
100996280,LINC00911,chr14,F,85393878,85420074,40422519,26196,474115717,11282,3
100996664,LOC100996664,chr14,R,68605296,68686949,40504172,81653,474197370,11283,14
101101773,LINC00609,chr14,F,36070426,36165288,40599034,94862,474292232,11284,2
101101776,BMS1P17,chr14,F,19306689,19316914,40609259,10225,474302457,11285,2
101926933,LOC101926933,chr14,F,22929608,22954692,40634343,25084,474327541,11286,2
101927029,LOC101927029,chr14,F,90048133,90061730,40647940,13597,474341138,11287,2
101927045,LOC101927045,chr14,F,24442952,24502197,40707185,59245,474400383,11288,2
101927062,LOC101927062,chr14,R,26775494,26822120,40753811,46626,474447009,11289,3
101927081,LOC101927081,chr14,F,26873132,26914743,40795422,41611,474488620,11290,3
101927124,LOC101927124,chr14,F,31420757,31452883,40827548,32126,474520746,11291,3
101927178,LOC101927178,chr14,F,35081080,35113130,40859598,32050,474552796,11292,4
101927199,LOC101927199,chr14,F,36194204,36235362,40900756,41158,474593954,11293,3
101927351,LOC101927351,chr14,R,44390678,44798431,41308509,407753,475001707,11294,11
101927418,LOC101927418,chr14,R,44898907,44911917,41321519,13010,475014717,11295,2
101927483,LOC101927483,chr14,F,48194122,48228207,41355604,34085,475048802,11296,9
101927598,LOC101927598,chr14,F,51763238,51825019,41417385,61781,475110583,11297,10
101927620,LOC101927620,chr14,F,53153353,53157528,41421560,4175,475114758,11298,2
101927690,LOC101927690,chr14,F,56514350,56551309,41458519,36959,475151717,11299,1
101927702,LOC101927702,chr14,R,60240414,60245670,41463775,5256,475156973,11300,2
101927729,LOC101927729,chr14,F,60305561,60323907,41482121,18346,475175319,11301,3
101927756,LOC101927756,chr14,R,61031226,61049674,41500569,18448,475193767,11302,3
101927780,LOC101927780,chr14,R,61556271,61570653,41514951,14382,475208149,11303,5
101927856,LOC101927856,chr14,R,64703754,64704260,41515457,506,475208655,11304,1
101927878,LOC101927878,chr14,R,66089210,66096903,41523150,7693,475216348,11305,2
101927971,LOC101927971,chr14,R,68395301,68404259,41532108,8958,475225306,11306,3
101928046,LOC101928046,chr14,F,70256151,70315231,41591188,59080,475284386,11307,8
101928075,LOC101928075,chr14,R,70608797,70641298,41623689,32501,475316887,11308,2
101928123,LOC101928123,chr14,R,73244017,73246001,41625673,1984,475318871,11309,1
101928143,LOC101928143,chr14,R,73458990,73463642,41630325,4652,475323523,11310,3
101928352,LOC101928352,chr14,F,74613184,74614048,41631189,864,475324387,11311,1
101928377,LOC101928377,chr14,R,75425466,75427690,41633413,2224,475326611,11312,1
101928462,LOC101928462,chr14,R,81052777,81172005,41752641,119228,475445839,11313,13
101928504,LOC101928504,chr14,F,81220874,81222462,41754229,1588,475447427,11314,2
101928559,LINC01467,chr14,R,81605346,81623061,41771944,17715,475465142,11315,2
101928599,LOC101928599,chr14,F,82642573,82746724,41876095,104151,475569293,11316,8
101928767,LOC101928767,chr14,F,85934677,86129778,42071196,195101,475764394,11317,3
101928791,LOC101928791,chr14,R,88018604,88026312,42078904,7708,475772102,11318,2
101928817,LOC101928817,chr14,F,89350088,89365008,42093824,14920,475787022,11319,1
101928909,LOC101928909,chr14,F,90642628,90648891,42100087,6263,475793285,11320,4
101928957,LOC101928957,chr14,R,91520515,91577822,42157394,57307,475850592,11321,4
101929002,LOC101929002,chr14,R,92905696,92907548,42159246,1852,475852444,11322,1
101929080,LOC101929080,chr14,F,95329583,95335504,42165167,5921,475858365,11323,2
101929107,LOC101929107,chr14,F,95515385,95518599,42168381,3214,475861579,11324,1
101929241,LOC101929241,chr14,F,97458815,97581383,42290949,122568,475984147,11325,6
101929369,SNHG24,chr14,F,100967651,100986650,42309948,18999,476003146,11326,11
101929422,LOC101929422,chr14,F,101120761,101123545,42312732,2784,476005930,11327,1
101929572,LOC101929572,chr14,F,19421025,19424584,42316291,3559,476009489,11328,1
101929634,LOC101929634,chr14,R,104661119,104665618,42320790,4499,476013988,11329,1
101929718,LOC101929718,chr14,R,20995836,20999163,42324117,3327,476017315,11330,3
101930294,LOC101930294,chr14,R,90450752,90455219,42328584,4467,476021782,11331,4
101954204,LINC00644,chr14,R,62134148,62139973,42334409,5825,476027607,11332,1
101954275,RNU6-7,chr14,F,32202044,32202151,42334516,107,476027714,11333,0
101954278,RNU6-8,chr14,R,32203162,32203269,42334623,107,476027821,11334,0
102464828,MIR6076,chr14,F,49966398,49966511,42334736,113,476027934,11335,0
102465428,MIR6717,chr14,R,21023313,21023386,42334809,73,476028007,11336,0
102465458,MIR6765,chr14,R,105150777,105150864,42334896,87,476028094,11337,0
102465753,MIR7641-2,chr14,F,75604208,75604261,42334949,53,476028147,11338,0
102465801,MIR7703,chr14,R,24143488,24143565,42335026,77,476028224,11339,0
102465832,MIR7843,chr14,F,72516819,72516898,42335105,79,476028303,11340,0
102465841,MIR7855,chr14,R,64785625,64785686,42335166,61,476028364,11341,0
102465871,MIR8071-1,chr14,F,105621115,105621180,42335231,65,476028429,11342,0
102466730,MIR6764,chr14,F,100277356,100277417,42335292,61,476028490,11343,0
102466889,MIR8071-2,chr14,F,105640167,105640232,42335357,65,476028555,11344,0
102723306,LOC102723306,chr14,R,34541233,34543429,42337553,2196,476030751,11345,1
102723319,LOC102723319,chr14,F,34553933,34562381,42346001,8448,476039199,11346,2
102723342,LOC102723342,chr14,F,104767966,104770123,42348158,2157,476041356,11347,1
102723354,LOC102723354,chr14,F,105094146,105099496,42353508,5350,476046706,11348,5
102723418,LOC102723418,chr14,F,36273319,36476196,42556385,202877,476249583,11349,11
102723503,LOC102723503,chr14,F,38256228,38386634,42686791,130406,476379989,11350,10
102723516,LOC102723516,chr14,F,38951672,38973826,42708945,22154,476402143,11351,4
102723604,LOC102723604,chr14,R,51916144,51918571,42711372,2427,476404570,11352,2
102723670,LOC102723670,chr14,F,55943649,55962935,42730658,19286,476423856,11353,5
102723682,LOC102723682,chr14,R,56117315,56118631,42731974,1316,476425172,11354,1
102723699,LOC102723699,chr14,F,56317458,56342597,42757113,25139,476450311,11355,7
102723725,LOC102723725,chr14,F,58748749,58750153,42758517,1404,476451715,11356,3
102723742,LINC01500,chr14,F,58828287,59017328,42947558,189041,476640756,11357,5
102723809,LOC102723809,chr14,R,64514150,64540368,42973776,26218,476666974,11358,3
102724015,LOC102724015,chr14,R,71292714,71322339,43003401,29625,476696599,11359,7
102724153,LOC102724153,chr14,R,75574900,75579588,43008089,4688,476701287,11360,2
102724190,LOC102724190,chr14,R,77069179,77076191,43015101,7012,476708299,11361,2
102724294,LOC102724294,chr14,R,81734401,81743753,43024453,9352,476717651,11362,3
102724338,LOC102724338,chr14,R,83903457,83915360,43036356,11903,476729554,11363,2
102724380,LOC102724380,chr14,R,86007098,86062957,43092215,55859,476785413,11364,7
102724423,LOC102724423,chr14,R,89348085,89349210,43093340,1125,476786538,11365,1
102724444,LOC102724444,chr14,F,90613392,90630842,43110790,17450,476803988,11366,4
102724682,LOC102724682,chr14,R,99940997,99949285,43119078,8288,476812276,11367,5
102724814,LOC102724814,chr14,F,23561096,23568076,43126058,6980,476819256,11368,3
102724845,LOC102724845,chr14,R,23838473,23933924,43221509,95451,476914707,11369,4
102724890,LOC102724890,chr14,F,26809347,26820703,43232865,11356,476926063,11370,5
102724917,LOC102724917,chr14,F,28830247,28968386,43371004,138139,477064202,11371,13
102724934,LOC102724934,chr14,R,29211070,29274989,43434923,63919,477128121,11372,4
102724945,LOC102724945,chr14,R,33958773,34203705,43679855,244932,477373053,11373,7
102725044,LOC102725044,chr14,F,24271227,24298653,43707281,27426,477400479,11374,4
102725045,LOC102725045,chr14,F,26598404,26806980,43915857,208576,477609055,11375,19
103695363,FOXG1-AS1,chr14,R,28725241,28765319,43955935,40078,477649133,11376,6
103695436,LINC01269,chr14,F,70698697,70712153,43969391,13456,477662589,11377,3
104548971,SALRNA1,chr14,F,60639215,60640416,43970592,1201,477663790,11378,0
104564225,MHRT,chr14,F,23415449,23417595,43972738,2146,477665936,11379,5
105369173,LOC105369173,chr14,F,91216592,91222539,43978685,5947,477671883,11380,1
105370386,LOC105370386,chr14,F,18590020,18616881,44005546,26861,477698744,11381,2
105370389,LOC105370389,chr14,F,19389306,19392749,44008989,3443,477702187,11382,2
105370390,LOC105370390,chr14,F,18920138,18946272,44035123,26134,477728321,11383,7
105370393,LOC105370393,chr14,R,19902460,19948734,44081397,46274,477774595,11384,4
105370394,LOC105370394,chr14,F,20305886,20306811,44082322,925,477775520,11385,1
105370395,LOC105370395,chr14,F,20518747,20521984,44085559,3237,477778757,11386,2
105370396,LOC105370396,chr14,F,20652859,20664117,44096817,11258,477790015,11387,2
105370397,LOC105370397,chr14,F,20791138,20810050,44115729,18912,477808927,11388,4
105370398,LOC105370398,chr14,R,21046477,21049742,44118994,3265,477812192,11389,3
105370399,LOC105370399,chr14,F,22556952,22559793,44121835,2841,477815033,11390,2
105370400,LOC105370400,chr14,R,22556310,22557062,44122587,752,477815785,11391,1
105370401,LOC105370401,chr14,R,22461267,22484675,44145995,23408,477839193,11392,5
105370402,LOC105370402,chr14,R,22379818,22432760,44198937,52942,477892135,11393,8
105370403,LOC105370403,chr14,R,22167737,22175228,44206428,7491,477899626,11394,1
105370404,LOC105370404,chr14,R,22702610,22766506,44270324,63896,477963522,11395,2
105370405,LOC105370405,chr14,R,22695938,22702320,44276706,6382,477969904,11396,3
105370406,LOC105370406,chr14,R,23195227,23214034,44295513,18807,477988711,11397,4
105370407,LOC105370407,chr14,F,23660500,23665222,44300235,4722,477993433,11398,3
105370408,LOC105370408,chr14,F,23692766,23698934,44306403,6168,477999601,11399,1
105370409,LOC105370409,chr14,R,23699820,23729741,44336324,29921,478029522,11400,8
105370410,LOC105370410,chr14,F,23699475,23704396,44341245,4921,478034443,11401,3
105370411,LOC105370411,chr14,R,23927913,23929673,44343005,1760,478036203,11402,1
105370412,LOC105370412,chr14,R,24066783,24068184,44344406,1401,478037604,11403,1
105370413,LOC105370413,chr14,F,24638650,24645234,44350990,6584,478044188,11404,4
105370414,LOC105370414,chr14,R,25092853,25156313,44414450,63460,478107648,11405,13
105370415,LOC105370415,chr14,F,25246569,25262931,44430812,16362,478124010,11406,7
105370416,LOC105370416,chr14,F,25827780,25830174,44433206,2394,478126404,11407,2
105370417,LOC105370417,chr14,F,25918407,25920501,44435300,2094,478128498,11408,2
105370418,LOC105370418,chr14,R,26382229,26397318,44450389,15089,478143587,11409,3
105370419,LOC105370419,chr14,F,26952545,26970939,44468783,18394,478161981,11410,4
105370420,LOC105370420,chr14,F,27077235,27105768,44497316,28533,478190514,11411,2
105370421,LOC105370421,chr14,R,27213311,27220776,44504781,7465,478197979,11412,4
105370422,LOC105370422,chr14,R,28590807,28613626,44527600,22819,478220798,11413,3
105370423,LOC105370423,chr14,R,28792017,28830166,44565749,38149,478258947,11414,8
105370424,LOC105370424,chr14,R,28783490,28785798,44568057,2308,478261255,11415,1
105370425,LOC105370425,chr14,R,28975732,29064973,44657298,89241,478350496,11416,11
105370427,LOC105370427,chr14,R,29378315,29391835,44670818,13520,478364016,11417,2
105370428,LOC105370428,chr14,F,29427311,29436412,44679919,9101,478373117,11418,1
105370429,LOC105370429,chr14,F,29928110,29936050,44687859,7940,478381057,11419,2
105370430,LOC105370430,chr14,F,30379186,30383630,44692303,4444,478385501,11420,3
105370431,LOC105370431,chr14,R,30411882,30553405,44833826,141523,478527024,11421,12
105370432,LOC105370432,chr14,F,30503437,30513381,44843770,9944,478536968,11422,2
105370433,LOC105370433,chr14,F,30472437,30485239,44856572,12802,478549770,11423,2
105370434,LOC105370434,chr14,R,30559278,30577650,44874944,18372,478568142,11424,2
105370435,LOC105370435,chr14,F,31210781,31266718,44930881,55937,478624079,11425,2
105370436,LOC105370436,chr14,F,31271955,31279128,44938054,7173,478631252,11426,3
105370437,LOC105370437,chr14,R,31553354,31561331,44946031,7977,478639229,11427,2
105370438,LOC105370438,chr14,F,31489955,31558407,45014483,68452,478707681,11428,6
105370439,LOC105370439,chr14,F,31943454,31960678,45031707,17224,478724905,11429,2
105370440,LOC105370440,chr14,F,32043835,32057375,45045247,13540,478738445,11430,3
105370441,LOC105370441,chr14,R,32656262,32660566,45049551,4304,478742749,11431,2
105370442,LOC105370442,chr14,R,33511482,33547810,45085879,36328,478779077,11432,8
105370443,LOC105370443,chr14,R,33221915,33227649,45091613,5734,478784811,11433,1
105370444,LOC105370444,chr14,R,34095840,34098491,45094264,2651,478787462,11434,1
105370445,LOC105370445,chr14,F,34039983,34060069,45114350,20086,478807548,11435,2
105370446,LOC105370446,chr14,F,33959081,33964147,45119416,5066,478812614,11436,1
105370447,LOC105370447,chr14,F,34539748,34541706,45121374,1958,478814572,11437,1
105370448,LOC105370448,chr14,F,34556668,34559003,45123709,2335,478816907,11438,2
105370449,LOC105370449,chr14,R,34551457,34557133,45129385,5676,478822583,11439,2
105370450,LOC105370450,chr14,R,35475929,35482810,45136266,6881,478829464,11440,2
105370451,LOC105370451,chr14,R,36084013,36090032,45142285,6019,478835483,11441,2
105370452,LOC105370452,chr14,R,36047719,36067486,45162052,19767,478855250,11442,2
105370453,LOC105370453,chr14,F,36523118,36596897,45235831,73779,478929029,11443,4
105370454,LOC105370454,chr14,F,36491301,36498241,45242771,6940,478935969,11444,1
105370455,LOC105370455,chr14,R,36649194,36661690,45255267,12496,478948465,11445,2
105370456,LOC105370456,chr14,R,38002645,38038590,45291212,35945,478984410,11446,4
105370457,LOC105370457,chr14,F,38878701,38919201,45331712,40500,479024910,11447,4
105370458,LOC105370458,chr14,F,39103139,39103924,45332497,785,479025695,11448,1
105370459,LOC105370459,chr14,R,39109816,39114815,45337496,4999,479030694,11449,4
105370460,LOC105370460,chr14,F,39474846,39480342,45342992,5496,479036190,11450,1
105370461,LOC105370461,chr14,F,39432610,39583099,45493481,150489,479186679,11451,10
105370462,LOC105370462,chr14,F,40318352,40390545,45565674,72193,479258872,11452,5
105370463,LOC105370463,chr14,R,40230338,40348046,45683382,117708,479376580,11453,6
105370464,LOC105370464,chr14,F,40217925,40249746,45715203,31821,479408401,11454,2
105370465,LOC105370465,chr14,F,40399267,40447295,45763231,48028,479456429,11455,3
105370466,LOC105370466,chr14,R,40573117,40629697,45819811,56580,479513009,11456,5
105370467,LOC105370467,chr14,F,40767817,40902216,45954210,134399,479647408,11457,7
105370468,LOC105370468,chr14,F,41062890,41093821,45985141,30931,479678339,11458,3
105370469,LOC105370469,chr14,R,41588080,41607111,46004172,19031,479697370,11459,2
105370470,LOC105370470,chr14,F,43308680,43335865,46031357,27185,479724555,11460,5
105370471,LOC105370471,chr14,R,43990664,44049473,46090166,58809,479783364,11461,2
105370472,LOC105370472,chr14,R,44587159,44590415,46093422,3256,479786620,11462,2
105370473,LOC105370473,chr14,F,44507361,44568002,46154063,60641,479847261,11463,7
105370474,LOC105370474,chr14,R,45082426,45083991,46155628,1565,479848826,11464,2
105370475,LOC105370475,chr14,F,45369150,45389286,46175764,20136,479868962,11465,4
105370476,LOC105370476,chr14,F,45568000,45569061,46176825,1061,479870023,11466,2
105370477,LOC105370477,chr14,F,45622642,45626357,46180540,3715,479873738,11467,2
105370478,LOC105370478,chr14,F,45744034,45793230,46229736,49196,479922934,11468,5
105370479,LOC105370479,chr14,R,45706257,45716018,46239497,9761,479932695,11469,3
105370480,LOC105370480,chr14,F,46578547,46583457,46244407,4910,479937605,11470,3
105370481,LOC105370481,chr14,R,46596161,46660347,46308593,64186,480001791,11471,8
105370482,LOC105370482,chr14,R,48234198,48253153,46327548,18955,480020746,11472,2
105370483,LOC105370483,chr14,R,48400410,48429248,46356386,28838,480049584,11473,2
105370484,LOC105370484,chr14,R,49544142,49550135,46362379,5993,480055577,11474,2
105370485,LOC105370485,chr14,F,49987874,49990483,46364988,2609,480058186,11475,1
105370486,LOC105370486,chr14,F,50174566,50230822,46421244,56256,480114442,11476,3
105370487,LOC105370487,chr14,F,50396328,50406548,46431464,10220,480124662,11477,2
105370488,LOC105370488,chr14,F,50668446,50670138,46433156,1692,480126354,11478,1
105370489,LOC105370489,chr14,F,50821861,50823513,46434808,1652,480128006,11479,1
105370490,LOC105370490,chr14,F,50744323,50746052,46436537,1729,480129735,11480,1
105370491,LOC105370491,chr14,R,50838282,50860250,46458505,21968,480151703,11481,2
105370492,LOC105370492,chr14,F,50944562,50946699,46460642,2137,480153840,11482,1
105370493,LOC105370493,chr14,F,51089236,51091288,46462694,2052,480155892,11483,2
105370494,LOC105370494,chr14,F,51130105,51198011,46530600,67906,480223798,11484,2
105370495,LOC105370495,chr14,R,51333398,51348521,46545723,15123,480238921,11485,4
105370496,LOC105370496,chr14,R,51391699,51393703,46547727,2004,480240925,11486,2
105370497,LOC105370497,chr14,R,51982519,51987547,46552755,5028,480245953,11487,1
105370498,LOC105370498,chr14,R,52111173,52126619,46568201,15446,480261399,11488,2
105370499,LOC105370499,chr14,R,52415824,52430046,46582423,14222,480275621,11489,3
105370500,LOC105370500,chr14,F,52791802,52930234,46720855,138432,480414053,11490,2
105370502,LOC105370502,chr14,F,53168871,53187311,46739295,18440,480432493,11491,3
105370503,LOC105370503,chr14,R,53685006,53850837,46905126,165831,480598324,11492,7
105370504,LOC105370504,chr14,F,53369448,53883349,47419027,513901,481112225,11493,8
105370505,LOC105370505,chr14,F,54114814,54116076,47420289,1262,481113487,11494,2
105370506,LOC105370506,chr14,R,54113338,54114688,47421639,1350,481114837,11495,2
105370507,LOC105370507,chr14,R,54043864,54188479,47566254,144615,481259452,11496,7
105370508,LOC105370508,chr14,F,55191725,55196037,47570566,4312,481263764,11497,1
105370509,LOC105370509,chr14,R,55262230,55272091,47580427,9861,481273625,11498,5
105370510,LOC105370510,chr14,F,55709811,55715100,47585716,5289,481278914,11499,2
105370511,LOC105370511,chr14,R,55899410,55900801,47587107,1391,481280305,11500,2
105370512,LOC105370512,chr14,F,56005323,56046068,47627852,40745,481321050,11501,3
105370513,LOC105370513,chr14,R,56095848,56109398,47641402,13550,481334600,11502,3
105370514,LOC105370514,chr14,F,56389313,56428250,47680339,38937,481373537,11503,3
105370515,LOC105370515,chr14,R,56633248,56639338,47686429,6090,481379627,11504,1
105370516,LOC105370516,chr14,R,57320607,57344016,47709838,23409,481403036,11505,2
105370517,LOC105370517,chr14,F,57491528,57509906,47728216,18378,481421414,11506,2
105370518,LOC105370518,chr14,F,57578743,57581514,47730987,2771,481424185,11507,2
105370519,LOC105370519,chr14,F,57569946,57578282,47739323,8336,481432521,11508,2
105370520,LOC105370520,chr14,F,57550476,57569888,47758735,19412,481451933,11509,2
105370521,LOC105370521,chr14,R,58399133,58408330,47767932,9197,481461130,11510,2
105370522,LOC105370522,chr14,R,58369612,58395848,47794168,26236,481487366,11511,2
105370523,LOC105370523,chr14,R,58634188,58645715,47805695,11527,481498893,11512,1
105370524,LOC105370524,chr14,R,59969149,60091780,47928326,122631,481621524,11513,6
105370525,LOC105370525,chr14,R,61534279,61546566,47940613,12287,481633811,11514,2
105370526,LOC105370526,chr14,R,61708703,61751097,47983007,42394,481676205,11515,5
105370527,LOC105370527,chr14,R,62114600,62117234,47985641,2634,481678839,11516,2
105370528,LOC105370528,chr14,R,62487475,62492624,47990790,5149,481683988,11517,2
105370529,LOC105370529,chr14,F,62357918,62505769,48138641,147851,481831839,11518,2
105370530,LOC105370530,chr14,F,63178246,63179993,48140388,1747,481833586,11519,1
105370531,LOC105370531,chr14,R,63123045,63219108,48236451,96063,481929649,11520,5
105370532,LOC105370532,chr14,F,63642070,63651508,48245889,9438,481939087,11521,1
105370533,LOC105370533,chr14,R,64552799,64658022,48351112,105223,482044310,11522,2
105370534,LOC105370534,chr14,R,64880648,64902128,48372592,21480,482065790,11523,3
105370535,LOC105370535,chr14,F,64940476,64942310,48374426,1834,482067624,11524,1
105370536,LOC105370536,chr14,R,65242017,65318761,48451170,76744,482144368,11525,3
105370537,LOC105370537,chr14,F,65374865,65378384,48454689,3519,482147887,11526,3
105370538,LOC105370538,chr14,R,67072419,67189354,48571624,116935,482264822,11527,6
105370539,LOC105370539,chr14,F,66127002,66128773,48573395,1771,482266593,11528,2
105370540,LOC105370540,chr14,F,66111227,66127003,48589171,15776,482282369,11529,9
105370541,LOC105370541,chr14,R,67259862,67337302,48666611,77440,482359809,11530,5
105370542,LOC105370542,chr14,R,67461845,67468687,48673453,6842,482366651,11531,2
105370543,LOC105370543,chr14,F,67600809,67611030,48683674,10221,482376872,11532,3
105370544,LOC105370544,chr14,F,68652591,68662833,48693916,10242,482387114,11533,2
105370545,LOC105370545,chr14,R,68559609,68565235,48699542,5626,482392740,11534,2
105370546,LOC105370546,chr14,R,68124900,68167516,48742158,42616,482435356,11535,4
105370548,LOC105370548,chr14,R,68801293,68828141,48769006,26848,482462204,11536,5
105370549,LOC105370549,chr14,R,69297673,69300959,48772292,3286,482465490,11537,2
105370550,LOC105370550,chr14,R,69183017,69260467,48849742,77450,482542940,11538,8
105370551,LOC105370551,chr14,R,69479601,69484436,48854577,4835,482547775,11539,1
105370552,LOC105370552,chr14,R,70244093,70257866,48868350,13773,482561548,11540,2
105370553,LOC105370553,chr14,F,70223258,70252008,48897100,28750,482590298,11541,10
105370554,LOC105370554,chr14,F,70344945,70347628,48899783,2683,482592981,11542,1
105370555,LOC105370555,chr14,R,70417194,70460964,48943553,43770,482636751,11543,4
105370556,LOC105370556,chr14,F,70525555,70538883,48956881,13328,482650079,11544,2
105370557,LOC105370557,chr14,R,70932063,70965423,48990241,33360,482683439,11545,4
105370558,LOC105370558,chr14,F,71867396,71910831,49033676,43435,482726874,11546,3
105370559,LOC105370559,chr14,R,72382394,72420819,49072101,38425,482765299,11547,5
105370560,LOC105370560,chr14,R,73027699,73060061,49104463,32362,482797661,11548,3
105370561,LOC105370561,chr14,F,73462578,73464213,49106098,1635,482799296,11549,1
105370562,LOC105370562,chr14,F,73737265,73747724,49116557,10459,482809755,11550,2
105370563,LOC105370563,chr14,R,74096494,74140657,49160720,44163,482853918,11551,2
105370564,LOC105370564,chr14,R,74208079,74217771,49170412,9692,482863610,11552,4
105370565,LOC105370565,chr14,R,74450033,74476547,49196926,26514,482890124,11553,2
105370566,LOC105370566,chr14,F,74513798,74519450,49202578,5652,482895776,11554,2
105370567,LOC105370567,chr14,R,74654526,74657674,49205726,3148,482898924,11555,1
105370568,LOC105370568,chr14,F,74858005,74859435,49207156,1430,482900354,11556,1
105370569,LOC105370569,chr14,F,74839302,74842149,49210003,2847,482903201,11557,1
105370571,LOC105370571,chr14,F,75258136,75269717,49221584,11581,482914782,11558,2
105370572,LOC105370572,chr14,F,75515338,75517779,49224025,2441,482917223,11559,2
105370573,LOC105370573,chr14,R,76079435,76082288,49226878,2853,482920076,11560,1
105370574,LOC105370574,chr14,R,76475400,76563075,49314553,87675,483007751,11561,2
105370575,LOC105370575,chr14,R,76226768,76232694,49320479,5926,483013677,11562,2
105370576,LOC105370576,chr14,R,76590679,76596082,49325882,5403,483019080,11563,3
105370577,LOC105370577,chr14,R,76706059,76726801,49346624,20742,483039822,11564,4
105370578,LOC105370578,chr14,F,76959578,76969939,49356985,10361,483050183,11565,4
105370579,LOC105370579,chr14,R,77032367,77034940,49359558,2573,483052756,11566,1
105370580,LOC105370580,chr14,R,77081148,77086696,49365106,5548,483058304,11567,2
105370581,LOC105370581,chr14,F,77966161,77968049,49366994,1888,483060192,11568,3
105370582,LOC105370582,chr14,R,79874220,79917104,49409878,42884,483103076,11569,2
105370583,LOC105370583,chr14,R,79593694,79633227,49449411,39533,483142609,11570,7
105370584,LOC105370584,chr14,R,79248877,79255231,49455765,6354,483148963,11571,2
105370585,LOC105370585,chr14,R,79247063,79248675,49457377,1612,483150575,11572,2
105370586,LOC105370586,chr14,F,79199981,79201636,49459032,1655,483152230,11573,1
105370587,LOC105370587,chr14,R,79154929,79197864,49501967,42935,483195165,11574,7
105370588,LOC105370588,chr14,R,79077159,79091590,49516398,14431,483209596,11575,4
105370589,LOC105370589,chr14,R,78703590,78709969,49522777,6379,483215975,11576,4
105370590,LOC105370590,chr14,R,79972367,79987108,49537518,14741,483230716,11577,6
105370591,LOC105370591,chr14,F,80147499,80153683,49543702,6184,483236900,11578,2
105370592,LOC105370592,chr14,F,80176784,80184480,49551398,7696,483244596,11579,2
105370593,LOC105370593,chr14,R,80167413,80188858,49572843,21445,483266041,11580,2
105370594,LOC105370594,chr14,F,81168155,81171831,49576519,3676,483269717,11581,1
105370595,LOC105370595,chr14,R,81153630,81154080,49576969,450,483270167,11582,1
105370596,LOC105370596,chr14,R,81013557,81025299,49588711,11742,483281909,11583,1
105370597,LOC105370597,chr14,F,80941386,80941981,49589306,595,483282504,11584,1
105370598,LOC105370598,chr14,R,81811519,81820061,49597848,8542,483291046,11585,3
105370599,LOC105370599,chr14,F,82420190,82428634,49606292,8444,483299490,11586,2
105370600,LOC105370600,chr14,R,83012205,83039601,49633688,27396,483326886,11587,4
105370601,LOC105370601,chr14,F,83286825,83307472,49654335,20647,483347533,11588,3
105370602,LOC105370602,chr14,R,83963371,83974872,49665836,11501,483359034,11589,3
105370603,LOC105370603,chr14,R,84216547,84299016,49748305,82469,483441503,11590,5
105370604,LOC105370604,chr14,R,85148644,85194702,49794363,46058,483487561,11591,5
105370605,LOC105370605,chr14,F,85387176,85388765,49795952,1589,483489150,11592,2
105370606,LOC105370606,chr14,F,85979532,86007621,49824041,28089,483517239,11593,3
105370607,LOC105370607,chr14,F,86331569,86357640,49850112,26071,483543310,11594,3
105370609,LOC105370609,chr14,F,87164529,87180479,49866062,15950,483559260,11595,2
105370610,LOC105370610,chr14,R,87345524,87613463,50134001,267939,483827199,11596,16
105370611,LOC105370611,chr14,R,87633874,87655294,50155421,21420,483848619,11597,2
105370612,LOC105370612,chr14,F,88160636,88180198,50174983,19562,483868181,11598,2
105370613,LOC105370613,chr14,R,88156116,88161181,50180048,5065,483873246,11599,1
105370614,LOC105370614,chr14,F,88500877,88515502,50194673,14625,483887871,11600,3
105370615,LOC105370615,chr14,F,89040489,89075424,50229608,34935,483922806,11601,3
105370616,LOC105370616,chr14,R,89628920,89642079,50242767,13159,483935965,11602,2
105370617,LOC105370617,chr14,F,89619316,89643614,50267065,24298,483960263,11603,5
105370618,LOC105370618,chr14,F,90364432,90368921,50271554,4489,483964752,11604,1
105370619,LOC105370619,chr14,R,90515805,90517226,50272975,1421,483966173,11605,1
105370620,LOC105370620,chr14,R,90524567,90537115,50285523,12548,483978721,11606,6
105370621,LOC105370621,chr14,F,90812030,90815908,50289401,3878,483982599,11607,2
105370622,LOC105370622,chr14,F,90697357,90699374,50291418,2017,483984616,11608,1
105370623,LOC105370623,chr14,R,90819439,90828175,50300154,8736,483993352,11609,4
105370624,LOC105370624,chr14,R,91378639,91400786,50322301,22147,484015499,11610,2
105370625,LOC105370625,chr14,F,91418208,91437633,50341726,19425,484034924,11611,3
105370626,LOC105370626,chr14,F,91450011,91458195,50349910,8184,484043108,11612,1
105370627,LOC105370627,chr14,F,92304413,92319650,50365147,15237,484058345,11613,2
105370628,LOC105370628,chr14,F,92514492,92515507,50366162,1015,484059360,11614,1
105370629,LOC105370629,chr14,F,92890508,92893792,50369446,3284,484062644,11615,3
105370630,LOC105370630,chr14,F,93295444,93296187,50370189,743,484063387,11616,1
105370631,LOC105370631,chr14,F,93880425,93885404,50375168,4979,484068366,11617,2
105370632,LOC105370632,chr14,F,93939859,93947342,50382651,7483,484075849,11618,2
105370633,LOC105370633,chr14,R,93994703,93997180,50385128,2477,484078326,11619,2
105370634,LOC105370634,chr14,R,94144632,94157298,50397794,12666,484090992,11620,3
105370635,LOC105370635,chr14,F,94460116,94462642,50400320,2526,484093518,11621,2
105370636,LOC105370636,chr14,R,94558171,94561340,50403489,3169,484096687,11622,2
105370637,LOC105370637,chr14,R,95326168,95328014,50405335,1846,484098533,11623,1
105370638,LOC105370638,chr14,R,95361345,95362280,50406270,935,484099468,11624,1
105370639,LOC105370639,chr14,R,95389763,95393846,50410353,4083,484103551,11625,2
105370640,LOC105370640,chr14,R,95396169,95405078,50419262,8909,484112460,11626,2
105370641,LOC105370641,chr14,R,95463142,95465924,50422044,2782,484115242,11627,0
105370643,LOC105370643,chr14,F,95587665,95590990,50425369,3325,484118567,11628,3
105370644,LOC105370644,chr14,R,95771575,95774954,50428748,3379,484121946,11629,2
105370645,LOC105370645,chr14,F,96663791,96681736,50446693,17945,484139891,11630,2
105370647,LOC105370647,chr14,F,97027716,97049357,50468334,21641,484161532,11631,2
105370648,LOC105370648,chr14,F,97154856,97158822,50472300,3966,484165498,11632,1
105370649,LOC105370649,chr14,R,97660792,97662502,50474010,1710,484167208,11633,2
105370650,LOC105370650,chr14,F,97662736,97688570,50499844,25834,484193042,11634,4
105370651,LOC105370651,chr14,F,97706181,97797717,50591380,91536,484284578,11635,6
105370652,LOC105370652,chr14,F,98136009,98165347,50620718,29338,484313916,11636,2
105370653,LOC105370653,chr14,F,98093305,98116667,50644080,23362,484337278,11637,4
105370654,LOC105370654,chr14,R,98087980,98093197,50649297,5217,484342495,11638,2
105370655,LOC105370655,chr14,R,98079599,98167999,50737697,88400,484430895,11639,3
105370656,LOC105370656,chr14,F,98214004,98242774,50766467,28770,484459665,11640,2
105370657,LOC105370657,chr14,F,98546278,98550388,50770577,4110,484463775,11641,2
105370658,LOC105370658,chr14,R,98820552,98823816,50773841,3264,484467039,11642,3
105370659,LOC105370659,chr14,R,99123700,99137560,50787701,13860,484480899,11643,2
105370660,LOC105370660,chr14,R,99285173,99287474,50790002,2301,484483200,11644,2
105370661,LOC105370661,chr14,F,99536096,99539001,50792907,2905,484486105,11645,2
105370662,LOC105370662,chr14,R,100166925,100172241,50798223,5316,484491421,11646,2
105370663,LOC105370663,chr14,F,100453754,100455640,50800109,1886,484493307,11647,2
105370664,LOC105370664,chr14,F,100407325,100408399,50801183,1074,484494381,11648,1
105370665,LOC105370665,chr14,F,100573316,100578891,50806758,5575,484499956,11649,3
105370666,LOC105370666,chr14,F,100539126,100540488,50808120,1362,484501318,11650,2
105370667,LOC105370667,chr14,R,100663246,100664612,50809486,1366,484502684,11651,1
105370668,LOC105370668,chr14,F,100683781,100692321,50818026,8540,484511224,11652,4
105370669,LOC105370669,chr14,F,100709066,100709751,50818711,685,484511909,11653,1
105370670,LOC105370670,chr14,R,101072829,101077652,50823534,4823,484516732,11654,5
105370671,LOC105370671,chr14,F,101357037,101360242,50826739,3205,484519937,11655,1
105370672,LOC105370672,chr14,R,101464152,101477652,50840239,13500,484533437,11656,4
105370673,LOC105370673,chr14,R,101519516,101545328,50866051,25812,484559249,11657,5
105370674,LOC105370674,chr14,F,101545861,101547964,50868154,2103,484561352,11658,2
105370675,LOC105370675,chr14,R,101566436,101567849,50869567,1413,484562765,11659,2
105370676,LOC105370676,chr14,R,101628348,101731306,50972525,102958,484665723,11660,4
105370677,LOC105370677,chr14,R,102203882,102205172,50973815,1290,484667013,11661,1
105370678,LOC105370678,chr14,R,102368627,102395545,51000733,26918,484693931,11662,4
105370679,LOC105370679,chr14,F,102510111,102514323,51004945,4212,484698143,11663,2
105370680,LOC105370680,chr14,F,102517415,102531291,51018821,13876,484712019,11664,3
105370681,LOC105370681,chr14,F,102545228,102589559,51063152,44331,484756350,11665,5
105370682,LOC105370682,chr14,R,102770046,102775040,51068146,4994,484761344,11666,2
105370683,LOC105370683,chr14,R,103120848,103123405,51070703,2557,484763901,11667,1
105370684,LOC105370684,chr14,F,103139111,103140121,51071713,1010,484764911,11668,1
105370685,LOC105370685,chr14,F,103164193,103175421,51082941,11228,484776139,11669,2
105370686,LOC105370686,chr14,R,103294073,103317179,51106047,23106,484799245,11670,2
105370688,LOC105370688,chr14,R,103627501,103629141,51107687,1640,484800885,11671,2
105370689,LOC105370689,chr14,F,103872105,103880378,51115960,8273,484809158,11672,5
105370690,LOC105370690,chr14,R,103869378,103879407,51125989,10029,484819187,11673,2
105370691,LOC105370691,chr14,F,104079940,104084033,51130082,4093,484823280,11674,2
105370693,LOC105370693,chr14,F,104223583,104288671,51195170,65088,484888368,11675,2
105370694,LOC105370694,chr14,R,104353098,104365561,51207633,12463,484900831,11676,2
105370695,LOC105370695,chr14,R,104459796,104460799,51208636,1003,484901834,11677,1
105370696,LOC105370696,chr14,R,104735053,104737974,51211557,2921,484904755,11678,2
105370697,LOC105370697,chr14,F,105531642,105534318,51214233,2676,484907431,11679,1
105370698,LOC105370698,chr14,F,105549484,105559756,51224505,10272,484917703,11680,3
105370699,LOC105370699,chr14,F,106374913,106376542,51226134,1629,484919332,11681,3
105370700,LOC105370700,chr14,F,106202389,106207786,51231531,5397,484924729,11682,2
105370701,LOC105370701,chr14,F,106193826,106196813,51234518,2987,484927716,11683,1
105370702,LOC105370702,chr14,F,105812419,105831600,51253699,19181,484946897,11684,2
105370705,LOC105370705,chr14,F,23056022,23058476,51256153,2454,484949351,11685,2
105370706,LOC105370706,chr14,R,71216319,71228231,51268065,11912,484961263,11686,1
105370707,LOC105370707,chr14,R,92508773,92514640,51273932,5867,484967130,11687,3
105370708,LOC105370708,chr14,R,104134782,104138629,51277779,3847,484970977,11688,3
105378171,LOC105378171,chr14,F,19042917,19051808,51286670,8891,484979868,11689,1
105378172,LOC105378172,chr14,R,19454757,19481801,51313714,27044,485006912,11690,8
105378173,LOC105378173,chr14,R,19365096,19382340,51330958,17244,485024156,11691,3
105378174,LOC105378174,chr14,R,19348215,19357099,51339842,8884,485033040,11692,1
105378175,LOC105378175,chr14,R,21135382,21135857,51340317,475,485033515,11693,1
105378176,LOC105378176,chr14,F,23298915,23307276,51348678,8361,485041876,11694,2
105378177,LOC105378177,chr14,F,45855371,45857042,51350349,1671,485043547,11695,1
105378178,LOC105378178,chr14,R,49055642,49151927,51446634,96285,485139832,11696,3
105378179,LOC105378179,chr14,R,49860973,49868143,51453804,7170,485147002,11697,2
105378180,LOC105378180,chr14,F,52069333,52074144,51458615,4811,485151813,11698,1
105378181,LOC105378181,chr14,R,52982576,53024708,51500747,42132,485193945,11699,6
105378182,LOC105378182,chr14,F,61113518,61122877,51510106,9359,485203304,11700,2
105378183,LOC105378183,chr14,F,103317256,103318539,51511389,1283,485204587,11701,1
105378184,LOC105378184,chr14,F,105754185,105760351,51517555,6166,485210753,11702,2
105378185,LOC105378185,chr14,F,105680282,105681852,51519125,1570,485212323,11703,1
105378186,LOC105378186,chr14,F,105648458,105676881,51547548,28423,485240746,11704,2
105378187,LOC105378187,chr14,F,105655023,105663100,51555625,8077,485248823,11705,3
105378188,LOC105378188,chr14,F,105609311,105619188,51565502,9877,485258700,11706,2
105378189,LOC105378189,chr14,R,60575032,60643945,51634415,68913,485327613,11707,3
105378190,LOC105378190,chr14,F,104216109,104218144,51636450,2035,485329648,11708,2
105378191,LOC105378191,chr14,F,105481768,105486591,51641273,4823,485334471,11709,3
70,ACTC1,chr15,R,34788095,34795726,7631,7631,485342102,11710,6
102,ADAM10,chr15,R,58595203,58749978,162406,154775,485496877,11711,15
176,ACAN,chr15,F,88803441,88875354,234319,71913,485568790,11712,18
220,ALDH1A3,chr15,F,100879691,100916626,271254,36935,485605725,11713,12
290,ANPEP,chr15,R,89784894,89814854,301214,29960,485635685,11714,20
302,ANXA2,chr15,R,60347150,60397986,352050,50836,485686521,11715,16
321,APBA2,chr15,F,28885993,29118315,584372,232322,485918843,11716,20
366,AQP9,chr15,F,58138208,58185911,632075,47703,485966546,11717,5
567,B2M,chr15,F,44711486,44718159,638748,6673,485973219,11718,3
585,BBS4,chr15,F,72686178,72738476,691046,52298,486025517,11719,16
597,BCL2A1,chr15,R,79960889,79971301,701458,10412,486035929,11720,2
606,NBEAP1,chr15,R,20669467,20756151,788142,86684,486122613,11721,2
641,BLM,chr15,F,90717326,90815462,886278,98136,486220749,11722,24
646,BNC1,chr15,R,83255883,83284716,915111,28833,486249582,11723,6
663,BNIP2,chr15,R,59659145,59689529,945495,30384,486279966,11724,11
701,BUB1B,chr15,F,40161008,40221136,1005623,60128,486340094,11725,22
771,CA12,chr15,R,63323530,63382110,1064203,58580,486398674,11726,10
825,CAPN3,chr15,F,42359499,42412317,1117021,52818,486451492,11727,25
1106,CHD2,chr15,F,92900320,93028007,1244708,127687,486579179,11728,38
1133,CHRM5,chr15,F,33968244,34065094,1341558,96850,486676029,11729,3
1136,CHRNA3,chr15,R,78593051,78621295,1369802,28244,486704273,11730,9
1138,CHRNA5,chr15,F,78565519,78595269,1399552,29750,486734023,11731,5
1139,CHRNA7,chr15,F,32030482,32172521,1541591,142039,486876062,11732,12
1143,CHRNB4,chr15,R,78623296,78655586,1573881,32290,486908352,11733,17
1159,CKMT1B,chr15,F,43592861,43599406,1580426,6545,486914897,11734,9
1198,CLK3,chr15,F,74598475,74645418,1627369,46943,486961840,11735,19
1381,CRABP1,chr15,F,78340323,78348230,1635276,7907,486969747,11736,3
1445,CSK,chr15,F,74782083,74803198,1656391,21115,486990862,11737,13
1464,CSPG4,chr15,R,75674321,75712848,1694918,38527,487029389,11738,9
1512,CTSH,chr15,R,78921749,78945089,1718258,23340,487052729,11739,12
1543,CYP1A1,chr15,R,74719541,74725610,1724327,6069,487058798,11740,6
1544,CYP1A2,chr15,F,74748842,74756600,1732085,7758,487066556,11741,6
1583,CYP11A1,chr15,R,74337761,74367740,1762064,29979,487096535,11742,9
1588,CYP19A1,chr15,R,51208056,51338598,1892606,130542,487227077,11743,12
1854,DUT,chr15,F,48331099,48343373,1904880,12274,487239351,11744,7
2038,EPB42,chr15,R,43197226,43225861,1933515,28635,487267986,11745,14
2108,ETFA,chr15,R,76216286,76311469,2028698,95183,487363169,11746,12
2184,FAH,chr15,F,80152890,80186582,2062390,33692,487396861,11747,13
2200,FBN1,chr15,R,48408305,48645788,2299873,237483,487634344,11748,65
2242,FES,chr15,F,90884434,90895776,2311215,11342,487645686,11749,18
2252,FGF7,chr15,F,49423177,49487326,2375364,64149,487709835,11750,3
2553,GABPB1,chr15,R,50277191,50355408,2453581,78217,487788052,11751,11
2558,GABRA5,chr15,F,26866718,26949210,2536073,82492,487870544,11752,12
2562,GABRB3,chr15,R,26543545,26773788,2766316,230243,488100787,11753,17
2567,GABRG3,chr15,F,26971281,27533895,3328930,562614,488663401,11754,11
2585,GALK2,chr15,F,49155758,49367894,3541066,212136,488875537,11755,16
2595,GANC,chr15,F,42273657,42353666,3621075,80009,488955546,11756,27
2628,GATM,chr15,R,45361123,45397043,3656995,35920,488991466,11757,11
2644,GCHFR,chr15,F,40764086,40767713,3660622,3627,488995093,11758,2
2923,PDIA3,chr15,F,43746391,43772606,3686837,26215,489021308,11759,12
2958,GTF2A2,chr15,R,59638061,59657539,3706315,19478,489040786,11760,6
3067,HDC,chr15,R,50241944,50266091,3730462,24147,489064933,11761,13
3073,HEXA,chr15,R,72343436,72376179,3763205,32743,489097676,11762,13
3175,ONECUT1,chr15,R,52756962,52790277,3796520,33315,489130991,11763,5
3418,IDH2,chr15,R,90083977,90102554,3815097,18577,489149568,11764,11
3419,IDH3A,chr15,F,78149361,78170542,3836278,21181,489170749,11765,11
3480,IGF1R,chr15,F,98648538,98964530,4152270,315992,489486741,11766,23
3603,IL16,chr15,F,81182599,81312763,4282434,130164,489616905,11767,20
3653,IPW,chr15,F,25116544,25122476,4288366,5932,489622837,11768,2
3658,IREB2,chr15,F,78438175,78501456,4351647,63281,489686118,11769,21
3669,ISG20,chr15,F,88635621,88656344,4372370,20723,489706841,11770,7
3671,ISLR,chr15,F,74173745,74176871,4375496,3126,489709967,11771,2
3706,ITPKA,chr15,F,41493857,41503559,4385198,9702,489719669,11772,7
3712,IVD,chr15,F,40405484,40435948,4415662,30464,489750133,11773,15
3990,LIPC,chr15,F,58410753,58568874,4573783,158121,489908254,11774,12
4016,LOXL1,chr15,F,73926447,73952137,4599473,25690,489933944,11775,8
4058,LTK,chr15,R,41503636,41513887,4609724,10251,489944195,11776,20
4088,SMAD3,chr15,F,67065626,67195195,4739293,129569,490073764,11777,12
4091,SMAD6,chr15,F,66702099,66782000,4819194,79901,490153665,11778,6
4122,MAN2A2,chr15,F,90902217,90922585,4839562,20368,490174033,11779,25
4123,MAN2C1,chr15,R,75355791,75369114,4852885,13323,490187356,11780,25
4130,MAP1A,chr15,F,43517607,43531620,4866898,14013,490201369,11781,5
4205,MEF2A,chr15,F,99565532,99716483,5017849,150951,490352320,11782,23
4212,MEIS2,chr15,R,36891020,37101334,5228163,210314,490562634,11783,15
4236,MFAP1,chr15,R,43804534,43824753,5248382,20219,490582853,11784,8
4240,MFGE8,chr15,R,88898682,88913454,5263154,14772,490597625,11785,9
4308,TRPM1,chr15,R,31001060,31161273,5423367,160213,490757838,11786,28
4351,MPI,chr15,F,74890010,74899457,5432814,9447,490767285,11787,7
4643,MYO1E,chr15,R,59135968,59372872,5669718,236904,491004189,11788,27
4644,MYO5A,chr15,R,52307282,52529050,5891486,221768,491225957,11789,43
4649,MYO9A,chr15,R,71822290,72118464,6187660,296174,491522131,11790,47
4692,NDN,chr15,R,23685406,23687303,6189557,1897,491524028,11791,0
4734,NEDD4,chr15,R,55826916,55993746,6356387,166830,491690858,11792,32
4756,NEO1,chr15,F,73051714,73305206,6609879,253492,491944350,11793,29
4828,NMB,chr15,R,84655128,84658571,6613322,3443,491947793,11794,2
4916,NTRK3,chr15,R,87874998,88256796,6995120,381798,492329591,11795,29
4947,OAZ2,chr15,R,64687573,64703281,7010828,15708,492345299,11796,4
4948,OCA2,chr15,R,27754872,28099340,7355296,344468,492689767,11797,28
5045,FURIN,chr15,F,90868591,90883458,7370163,14867,492704634,11798,17
5046,PCSK6,chr15,R,101303927,101489984,7556220,186057,492890691,11799,23
5151,PDE8A,chr15,F,84980512,85139145,7714853,158633,493049324,11800,25
5315,PKM,chr15,R,72199028,72231812,7747637,32784,493082108,11801,14
5330,PLCB2,chr15,R,40284259,40307973,7771351,23714,493105822,11802,34
5346,PLIN1,chr15,R,89664364,89679417,7786404,15053,493120875,11803,9
5371,PML,chr15,F,73994672,74047819,7839551,53147,493174022,11804,8
5428,POLG,chr15,R,89316304,89334795,7858042,18491,493192513,11805,22
5479,PPIB,chr15,R,64155814,64163155,7865383,7341,493199854,11806,4
5597,MAPK6,chr15,F,52004264,52066265,7927384,62001,493261855,11807,8
5604,MAP2K1,chr15,F,66386872,66491544,8032056,104672,493366527,11808,11
5607,MAP2K5,chr15,F,67542605,67807117,8296568,264512,493631039,11809,26
5685,PSMA4,chr15,F,78540404,78549220,8305384,8816,493639855,11810,8
5780,PTPN9,chr15,R,75467120,75579291,8417555,112171,493752026,11811,12
5873,RAB27A,chr15,R,55202965,55289828,8504418,86863,493838889,11812,11
5888,RAD51,chr15,F,40694773,40732158,8541803,37385,493876274,11813,12
5923,RASGRF1,chr15,R,78959946,79090873,8672730,130927,494007201,11814,30
5955,RCN2,chr15,F,76931620,76950260,8691370,18640,494025841,11815,7
6017,RLBP1,chr15,R,89209866,89221909,8703413,12043,494037884,11816,9
6095,RORA,chr15,R,60488283,61229303,9444433,741020,494778904,11817,22
6124,RPL4,chr15,R,66499314,66504855,9449974,5541,494784445,11818,9
6176,RPLP1,chr15,F,69452819,69455545,9452700,2726,494787171,11819,3
6218,RPS17,chr15,R,82536749,82540544,9456495,3795,494790966,11820,4
6263,RYR3,chr15,F,33310782,33866103,10011816,555321,495346287,11821,104
6447,SCG5,chr15,F,32641668,32697097,10067245,55429,495401716,11822,5
6457,SH3GL3,chr15,F,83447122,83618743,10238866,171621,495573337,11823,16
6557,SLC12A1,chr15,F,48206300,48304078,10336644,97778,495671115,11824,28
6627,SNRPA1,chr15,R,101281509,101295277,10350412,13768,495684883,11825,8
6638,SNRPN,chr15,F,24823646,24978582,10505348,154936,495839819,11826,14
6642,SNX1,chr15,F,64094075,64144234,10555507,50159,495889978,11827,15
6652,SORD,chr15,F,45023103,45075089,10607493,51986,495941964,11828,8
6692,SPINT1,chr15,F,40844017,40857655,10621131,13638,495955602,11829,10
6727,SRP14,chr15,R,40035689,40039188,10624630,3499,495959101,11830,5
6938,TCF12,chr15,F,56918288,57291129,10997471,372841,496331942,11831,24
7026,NR2F2,chr15,F,96325927,96340263,11011807,14336,496346278,11832,5
7057,THBS1,chr15,F,39581078,39597467,11028196,16389,496362667,11833,21
7082,TJP1,chr15,R,29699366,29968799,11297629,269433,496632100,11834,34
7090,TLE3,chr15,R,70047789,70097935,11347775,50146,496682246,11835,22
7158,TP53BP1,chr15,R,43403063,43510728,11455440,107665,496789911,11836,32
7168,TPM1,chr15,F,63042638,63071915,11484717,29277,496819188,11837,13
7190,HSP90B2P,chr15,F,99257524,99260276,11487469,2752,496821940,11838,0
7301,TYRO3,chr15,F,41557870,41579338,11508937,21468,496843408,11839,20
7302,TYRO3P,chr15,R,76259288,76260152,11509801,864,496844272,11840,0
7337,UBE3A,chr15,R,25337233,25439043,11611611,101810,496946082,11841,16
7681,MKRN3,chr15,F,23565306,23568020,11614325,2714,496948796,11842,0
7782,SLC30A4,chr15,R,45482477,45523669,11655517,41192,496989988,11843,8
8120,AP3B2,chr15,R,82659280,82709908,11706145,50628,497040616,11844,26
8123,PWAR5,chr15,F,24984859,24988232,11709518,3373,497043989,11845,0
8125,ANP32A,chr15,R,68778534,68820922,11751906,42388,497086377,11846,6
8128,ST8SIA2,chr15,F,92393909,92468728,11826725,74819,497161196,11847,5
8482,SEMA7A,chr15,R,74409288,74433958,11851395,24670,497185866,11848,14
8483,CILP,chr15,R,65195998,65211502,11866899,15504,497201370,11849,8
8554,PIAS1,chr15,F,68054233,68191459,12004125,137226,497338596,11850,17
8669,EIF3J,chr15,F,44537067,44562803,12029861,25736,497364332,11851,7
8681,JMJD7-PLA2G4B,chr15,F,41828084,41848148,12049925,20064,497384396,11852,19
8766,RAB11A,chr15,F,65869458,65891991,12072458,22533,497406929,11853,4
8773,SNAP23,chr15,F,42491243,42533061,12114276,41818,497448747,11854,10
8800,PEX11A,chr15,R,89681530,89690784,12123530,9254,497458001,11855,2
8826,IQGAP1,chr15,F,90388240,90502243,12237533,114003,497572004,11856,38
8854,ALDH1A2,chr15,R,57953423,58065923,12350033,112500,497684504,11857,13
8924,HERC2,chr15,R,28111036,28322172,12561169,211136,497895640,11858,96
8925,HERC1,chr15,R,63608617,63833949,12786501,225332,498120972,11859,82
8926,SNURF,chr15,F,24954922,24978582,12810161,23660,498144632,11860,14
9051,PSTPIP1,chr15,F,76995123,77037337,12852375,42214,498186846,11861,18
9055,PRC1,chr15,R,90966037,90994651,12880989,28614,498215460,11862,14
9101,USP8,chr15,F,50424376,50501083,12957696,76707,498292167,11863,20
9133,CCNB2,chr15,F,59105084,59125045,12977657,19961,498312128,11864,8
9153,SLC28A2,chr15,F,45252065,45275934,13001526,23869,498335997,11865,17
9154,SLC28A1,chr15,F,84884576,84975651,13092601,91075,498427072,11866,28
9187,SLC24A1,chr15,F,65611404,65661242,13142439,49838,498476910,11867,14
9236,CCPG1,chr15,R,55355222,55408510,13195727,53288,498530198,11868,7
9245,GCNT3,chr15,F,59611782,59620011,13203956,8229,498538427,11869,2
9318,COPS2,chr15,R,49125273,49155657,13234340,30384,498568811,11870,12
9325,TRIP4,chr15,F,64387803,64455303,13301840,67500,498636311,11871,12
9333,TGM5,chr15,R,43232594,43267023,13336269,34429,498670740,11872,14
9377,COX5A,chr15,R,74920274,74938154,13354149,17880,498688620,11873,4
9399,STOML1,chr15,R,73983217,73994622,13365554,11405,498700025,11874,8
9455,HOMER2,chr15,R,82836945,82986161,13514770,149216,498849241,11875,13
9488,PIGB,chr15,F,55318864,55355648,13551554,36784,498886025,11876,12
9493,KIF23,chr15,F,69414245,69448427,13585736,34182,498920207,11877,25
9543,IGDCC3,chr15,R,65327126,65378040,13636650,50914,498971121,11878,17
9640,ZNF592,chr15,F,84748560,84806432,13694522,57872,499028993,11879,12
9677,PPIP5K1,chr15,R,43533461,43590272,13751333,56811,499085804,11880,33
9716,AQR,chr15,R,34856350,34969794,13864777,113444,499199248,11881,34
9728,SECISBP2L,chr15,R,48988637,49046563,13922703,57926,499257174,11882,17
9768,KIAA0101,chr15,R,64364993,64387687,13945397,22694,499279868,11883,4
9824,ARHGAP11A,chr15,F,32613732,32639949,13971614,26217,499306085,11884,14
9836,LCMT2,chr15,R,43327775,43330622,13974461,2847,499308932,11885,0
9899,SV2B,chr15,F,91099720,91301309,14176050,201589,499510521,11886,16
9915,ARNT2,chr15,F,80404349,80597937,14369638,193588,499704109,11887,18
9960,USP3,chr15,F,63504510,63594640,14459768,90130,499794239,11888,17
9990,SLC12A6,chr15,R,34229995,34338064,14567837,108069,499902308,11889,27
10002,NR2E3,chr15,F,71807196,71818666,14579307,11470,499913778,11890,8
10017,BCL2L10,chr15,R,52109268,52113042,14583081,3774,499917552,11891,1
10021,HCN4,chr15,R,73319858,73369264,14632487,49406,499966958,11892,8
10066,SCAMP2,chr15,R,74843729,74873365,14662123,29636,499996594,11893,10
10073,SNUPN,chr15,R,75598082,75626378,14690419,28296,500024890,11894,9
10081,PDCD7,chr15,R,65117378,65133836,14706877,16458,500041348,11895,4
10099,TSPAN3,chr15,R,77044016,77071228,14734089,27212,500068560,11896,6
10116,FEM1B,chr15,F,68277755,68295865,14752199,18110,500086670,11897,1
10125,RASGRP1,chr15,R,38488100,38564806,14828905,76706,500163376,11898,16
10169,SERF2,chr15,F,43777095,43796089,14847899,18994,500182370,11899,4
10239,AP3S2,chr15,R,89830598,89894385,14911686,63787,500246157,11900,6
10260,DENND4A,chr15,R,65659122,65792293,15044857,133171,500379328,11901,37
10302,SNAPC5,chr15,R,66490327,66497808,15052338,7481,500386809,11902,3
10363,HMG20A,chr15,F,77420650,77485603,15117291,64953,500451762,11903,10
10391,CORO2B,chr15,F,68559274,68727806,15285823,168532,500620294,11904,16
10509,SEMA4B,chr15,F,90184919,90229664,15330568,44745,500665039,11905,14
10518,CIB2,chr15,R,78104605,78131721,15357684,27116,500692155,11906,6
10519,CIB1,chr15,R,90230244,90265759,15393199,35515,500727670,11907,7
10588,MTHFS,chr15,R,79843546,79897285,15446938,53739,500781409,11908,3
10620,ARID3B,chr15,F,74541176,74598131,15503893,56955,500838364,11909,8
10681,GNB5,chr15,R,52120925,52191368,15574336,70443,500908807,11910,14
10776,ARPP19,chr15,R,52547186,52569221,15596371,22035,500930842,11911,4
10845,CLPX,chr15,R,65150445,65185404,15631330,34959,500965801,11912,13
10933,MORF4L1,chr15,F,78872780,78897739,15656289,24959,500990760,11913,12
11001,SLC27A2,chr15,F,50182195,50236392,15710486,54197,501044957,11914,9
11057,ABHD2,chr15,F,89088149,89202360,15824697,114211,501159168,11915,15
11173,ADAMTS7,chr15,R,78759202,78811464,15876959,52262,501211430,11916,24
11214,AKAP13,chr15,F,85380615,85749358,16245702,368743,501580173,11917,38
11245,GPR176,chr15,R,39799021,39920892,16367573,121871,501702044,11918,9
11261,CHP1,chr15,F,41231148,41281887,16418312,50739,501752783,11919,7
11339,OIP5,chr15,R,41309267,41332729,16441774,23462,501776245,11920,4
22801,ITGA11,chr15,R,68297427,68432160,16576507,134733,501910978,11921,30
22856,CHSY1,chr15,R,101175722,101251932,16652717,76210,501987188,11922,5
22893,BAHD1,chr15,F,40439720,40468242,16681239,28522,502015710,11923,8
22909,FAN1,chr15,F,30903851,30943108,16720496,39257,502054967,11924,17
22995,CEP152,chr15,R,48662533,48811918,16869881,149385,502204352,11925,37
23005,MAPKBP1,chr15,F,41774433,41827855,16923303,53422,502257774,11926,33
23015,GOLGA8A,chr15,R,34379067,34437466,16981702,58399,502316173,11927,23
23060,ZNF609,chr15,F,64460742,64686068,17207028,225326,502541499,11928,9
23102,TBC1D2B,chr15,R,77994984,78077667,17289711,82683,502624182,11929,15
23168,RTF1,chr15,F,41417103,41483563,17356171,66460,502690642,11930,17
23184,MESDC2,chr15,R,80947325,80989878,17398724,42553,502733195,11931,4
23191,CYFIP1,chr15,R,22869464,22980419,17509679,110955,502844150,11932,31
23205,ACSBG1,chr15,R,78170844,78234707,17573542,63863,502908013,11933,18
23251,KIAA1024,chr15,F,79413493,79472304,17632353,58811,502966824,11934,9
23269,MGA,chr15,F,41621231,41769943,17781065,148712,503115536,11935,28
23312,DMXL2,chr15,R,51447723,51622833,17956175,175110,503290646,11936,45
23336,SYNM,chr15,F,99105079,99135595,17986691,30516,503321162,11937,3
23339,VPS39,chr15,R,42158700,42208326,18036317,49626,503370788,11938,26
23359,FAM189A1,chr15,R,29120251,29570723,18486789,450472,503821260,11939,11
23423,TMED3,chr15,F,79311061,79384721,18560449,73660,503894920,11940,4
23431,AP4E1,chr15,F,50908624,51005900,18657725,97276,503992196,11941,23
23478,SEC11A,chr15,R,84669536,84716460,18704649,46924,504039120,11942,8
23582,CCNDBP1,chr15,F,43185117,43197177,18716709,12060,504051180,11943,11
23604,DAPK2,chr15,R,63907035,64046455,18856129,139420,504190600,11944,16
23741,EID1,chr15,F,48878092,48880183,18858220,2091,504192691,11945,0
23742,NPAP1,chr15,F,24675393,24683446,18866273,8053,504200744,11946,0
23766,GABARAPL3,chr15,R,90346526,90349447,18869194,2921,504203665,11947,1
25764,HYPK,chr15,F,43800420,43802589,18871363,2169,504205834,11948,5
25820,ARIH1,chr15,F,72474281,72586560,18983642,112279,504318113,11949,14
25942,SIN3A,chr15,R,75369378,75455815,19070079,86437,504404550,11950,25
25963,TMEM87A,chr15,R,42210451,42274526,19134154,64075,504468625,11951,22
25989,ULK3,chr15,R,74836115,74843211,19141250,7096,504475721,11952,15
26015,RPAP1,chr15,R,41517175,41544277,19168352,27102,504502823,11953,25
26035,GLCE,chr15,F,69160559,69272207,19280000,111648,504614471,11954,6
26082,DKFZP434L187,chr15,F,30196035,30214540,19298505,18505,504632976,11955,2
26108,PYGO1,chr15,R,55538883,55588852,19348474,49969,504682945,11956,3
26258,BLOC1S6,chr15,F,45587218,45609711,19370967,22493,504705438,11957,4
26263,FBXO22,chr15,F,75903858,75935268,19402377,31410,504736848,11958,7
26276,VPS33B,chr15,R,90998415,91022621,19426583,24206,504761054,11959,24
26585,GREM1,chr15,F,32717973,32734669,19443279,16696,504777750,11960,1
26589,MRPL46,chr15,R,88459477,88467402,19451204,7925,504785675,11961,3
26682,OR4F4,chr15,R,101922141,101923059,19452122,918,504786593,11962,0
26827,RNU6-1,chr15,R,67839939,67840045,19452228,106,504786699,11963,0
26831,RNU5A-1,chr15,F,65296050,65296167,19452345,117,504786816,11964,0
26832,RNU5B-1,chr15,F,65304676,65304793,19452462,117,504786933,11965,0
27020,NPTN,chr15,R,73560002,73633412,19525872,73410,504860343,11966,11
27023,FOXB1,chr15,F,60004221,60005943,19527594,1722,504862065,11967,1
27079,RPUSD2,chr15,F,40569292,40574706,19533008,5414,504867479,11968,2
27229,TUBGCP4,chr15,F,43371058,43407095,19569045,36037,504903516,11969,18
28232,SLCO3A1,chr15,F,91853707,92172435,19887773,318728,505222244,11970,14
29106,SCG3,chr15,F,51681352,51721026,19927447,39674,505261918,11971,11
29766,TMOD3,chr15,F,51829627,51912138,20009958,82511,505344429,11972,9
29767,TMOD2,chr15,F,51751560,51816363,20074761,64803,505409232,11973,9
30844,EHD4,chr15,R,41899439,41972557,20147879,73118,505482350,11974,5
49855,SCAPER,chr15,R,76348184,76905455,20705150,557271,506039621,11975,38
50506,DUOX2,chr15,R,45092652,45114161,20726659,21509,506061130,11976,33
50804,MYEF2,chr15,R,48139427,48178400,20765632,38973,506100103,11977,18
50810,HDGFRP3,chr15,R,83115375,83208018,20858275,92643,506192746,11978,6
51065,RPS27L,chr15,R,63153339,63157542,20862478,4203,506196949,11979,3
51103,NDUFAF1,chr15,R,41387348,41402554,20877684,15206,506212155,11980,5
51187,RSL24D1,chr15,R,55181313,55197033,20893404,15720,506227875,11981,5
51203,NUSAP1,chr15,F,41332693,41381050,20941761,48357,506276232,11982,10
51234,EMC4,chr15,F,34224996,34230165,20946930,5169,506281401,11983,4
51285,RASL12,chr15,R,65045581,65076670,20978019,31089,506312490,11984,9
51324,SPG21,chr15,R,64963020,64989946,21004945,26926,506339416,11985,12
51332,SPTBN5,chr15,R,41848145,41894077,21050877,45932,506385348,11986,67
51335,NGRN,chr15,F,90265662,90272211,21057426,6549,506391897,11987,1
51458,RHCG,chr15,R,89471406,89496613,21082633,25207,506417104,11988,10
51495,HACD3,chr15,F,65530488,65578355,21130500,47867,506464971,11989,11
51496,CTDSPL2,chr15,F,44427328,44527257,21230429,99929,506564900,11990,15
51621,KLF13,chr15,F,31326854,31435665,21339240,108811,506673711,11991,2
51762,RAB8B,chr15,F,63189528,63267776,21417488,78248,506751959,11992,10
53339,BTBD1,chr15,R,83016422,83067434,21468500,51012,506802971,11993,8
53346,TM6SF1,chr15,F,83107474,83138015,21499041,30541,506833512,11994,12
53905,DUOX1,chr15,F,45129991,45165578,21534628,35587,506869099,11995,34
53944,CSNK1G1,chr15,R,64165516,64356243,21725355,190727,507059826,11996,11
54469,ZFAND6,chr15,F,80059567,80138393,21804181,78826,507138652,11997,13
54551,MAGEL2,chr15,R,23643548,23647846,21808479,4298,507142950,11998,0
54567,DLL4,chr15,F,40929332,40939060,21818207,9728,507152678,11999,10
54581,SCAND2P,chr15,F,84631459,84642463,21829211,11004,507163682,12000,4
54617,INO80,chr15,R,40978879,41116354,21966686,137475,507301157,12001,36
54629,FAM63B,chr15,F,58771193,58861900,22057393,90707,507391864,12002,11
54778,RNF111,chr15,F,58987665,59097419,22167147,109754,507501618,12003,16
54816,ZNF280D,chr15,R,56630175,56734086,22271058,103911,507605529,12004,28
54822,TRPM7,chr15,R,50557157,50686815,22400716,129658,507735187,12005,39
54832,VPS13C,chr15,R,61852388,62060465,22608793,208077,507943264,12006,87
54839,LRRC49,chr15,F,70853238,71050097,22805652,196859,508140123,12007,19
54852,PAQR5,chr15,F,69298901,69407637,22914388,108736,508248859,12008,16
54866,PPP1R14D,chr15,R,40815444,40828709,22927653,13265,508262124,12009,4
54878,DPP8,chr15,R,65442466,65517702,23002889,75236,508337360,12010,21
54893,MTMR10,chr15,R,30919763,30991604,23074730,71841,508409201,12011,19
54913,RPP25,chr15,R,74955101,74957434,23077063,2333,508411534,12012,0
54939,COMMD4,chr15,F,75335995,75341927,23082995,5932,508417466,12013,8
54956,PARP16,chr15,R,65234463,65286884,23135416,52421,508469887,12014,7
54962,TIPIN,chr15,R,66336190,66386737,23185963,50547,508520434,12015,11
54982,CLN6,chr15,R,68206991,68229742,23208714,22751,508543185,12016,6
54989,ZNF770,chr15,R,34978340,34988296,23218670,9956,508553141,12017,2
54993,ZSCAN2,chr15,F,84600985,84623718,23241403,22733,508575874,12018,6
55055,ZWILCH,chr15,F,66505082,66549485,23285806,44403,508620277,12019,18
55056,FLJ10038,chr15,R,50348935,50354879,23291750,5944,508626221,12020,0
55070,DET1,chr15,R,88511481,88546698,23326967,35217,508661438,12021,8
55075,UACA,chr15,R,70654553,70763511,23435925,108958,508770396,12022,21
55142,HAUS2,chr15,F,42548812,42569994,23457107,21182,508791578,12023,5
55177,RMDN3,chr15,R,40735883,40755336,23476560,19453,508811031,12024,13
55180,LINS,chr15,R,100569222,100602240,23509578,33018,508844049,12025,7
55192,DNAJC17,chr15,R,40767866,40807478,23549190,39612,508883661,12026,11
55215,FANCI,chr15,F,89243947,89317131,23622374,73184,508956845,12027,43
55272,IMP3,chr15,R,75639084,75640323,23623613,1239,508958084,12028,0
55323,LARP6,chr15,R,70831523,70854265,23646355,22742,508980826,12029,4
55329,MNS1,chr15,R,56428730,56465137,23682762,36407,509017233,12030,9
55466,DNAJA4,chr15,F,78264144,78282196,23700814,18052,509035285,12031,9
55505,NOP10,chr15,R,34341715,34343161,23702260,1446,509036731,12032,1
55784,MCTP2,chr15,F,94231537,94483952,23954675,252415,509289146,12033,28
55829,VIMP,chr15,R,101270908,101277520,23961287,6612,509295758,12034,6
55889,GOLGA6B,chr15,F,72608555,72667397,24020129,58842,509354600,12035,20
55897,MESP1,chr15,R,89749866,89751309,24021572,1443,509356043,12036,1
55898,UNC45A,chr15,F,90930007,90954093,24045658,24086,509380129,12037,22
55930,MYO5C,chr15,R,52192317,52295798,24149139,103481,509483610,12038,40
56160,NDNL2,chr15,R,29268148,29269816,24150807,1668,509485278,12039,0
56204,FAM214A,chr15,R,52581320,52709817,24279304,128497,509613775,12040,15
56851,EMC7,chr15,R,34084021,34101852,24297135,17831,509631606,12041,4
56905,C15orf39,chr15,F,75198886,75212169,24310418,13283,509644889,12042,3
56906,THAP10,chr15,R,70881341,70892433,24321510,11092,509655981,12043,2
56924,PAK6,chr15,F,40217427,40277487,24381570,60060,509716041,12044,11
56963,RGMA,chr15,R,93043405,93089214,24427379,45809,509761850,12045,6
56964,WDR93,chr15,F,89690084,89743790,24481085,53706,509815556,12046,20
56965,PARP6,chr15,R,72241180,72272583,24512488,31403,509846959,12047,27
56986,DTWD1,chr15,F,49620979,49654448,24545957,33469,509880428,12048,10
57082,CASC5,chr15,F,40594248,40662683,24614392,68435,509948863,12049,26
57099,AVEN,chr15,R,33866226,34074458,24822624,208232,510157095,12050,10
57184,FAM219B,chr15,R,74899986,74907307,24829945,7321,510164416,12051,5
57188,ADAMTSL3,chr15,F,83654085,84039842,25215702,385757,510550173,12052,32
57194,ATP10A,chr15,R,25666793,25865158,25414067,198365,510748538,12053,25
57214,CEMIP,chr15,F,80779342,80951662,25586387,172320,510920858,12054,29
57369,GJD2,chr15,R,34752440,34754581,25588528,2141,510922999,12055,1
57519,STARD9,chr15,F,42575633,42720998,25733893,145365,511068364,12056,34
57538,ALPK3,chr15,F,84816679,84873482,25790696,56803,511125167,12057,13
57611,ISLR2,chr15,F,74128202,74141841,25804335,13639,511138806,12058,7
57617,VPS18,chr15,F,40894429,40903975,25813881,9546,511148352,12059,6
57722,IGDCC4,chr15,R,65381479,65423072,25855474,41593,511189945,12060,20
58472,SQRDL,chr15,F,45631147,45691294,25915621,60147,511250092,12061,11
58489,ABHD17C,chr15,F,80695310,80755621,25975932,60311,511310403,12062,2
59274,MESDC1,chr15,F,81000953,81004004,25978983,3051,511313454,12063,0
60490,PPCDC,chr15,F,75023554,75050726,26006155,27172,511340626,12064,5
60677,CELF6,chr15,R,72284726,72320184,26041613,35458,511376084,12065,13
64220,STRA6,chr15,R,74179465,74212259,26074407,32794,511408878,12066,23
64397,ZNF106,chr15,R,42412436,42491197,26153168,78761,511487639,12067,21
64410,KLHL25,chr15,R,85759325,85794958,26188801,35633,511523272,12068,2
64506,CPEB1,chr15,R,82543200,82648016,26293617,104816,511628088,12069,12
64782,AEN,chr15,F,88604680,88632281,26321218,27601,511655689,12070,6
64784,CRTC3,chr15,F,90529885,90645345,26436678,115460,511771149,12071,14
64799,IQCH,chr15,F,67254773,67506612,26688517,251839,512022988,12072,26
64843,ISL2,chr15,F,76335941,76342476,26695052,6535,512029523,12073,7
64864,RFX7,chr15,R,56090532,56243536,26848056,153004,512182527,12074,12
64927,TTC23,chr15,R,99136322,99251226,26962960,114904,512297431,12075,19
64963,MRPS11,chr15,F,88467452,88478630,26974138,11178,512308609,12076,6
79029,SPATA5L1,chr15,F,45402272,45421419,26993285,19147,512327756,12077,8
79094,CHAC1,chr15,F,40953437,40956519,26996367,3082,512330838,12078,2
79400,NOX5,chr15,F,68930499,69057161,27123029,126662,512457500,12079,17
79631,EFTUD1,chr15,R,82130219,82262763,27255573,132544,512590044,12080,20
79661,NEIL1,chr15,F,75346648,75355251,27264176,8603,512598647,12081,12
79664,ICE2,chr15,R,60419608,60479160,27323728,59552,512658199,12082,19
79705,LRRK1,chr15,F,100919214,101070112,27474626,150898,512809097,12083,36
79719,AAGAB,chr15,R,67200674,67255198,27529150,54524,512863621,12084,12
79748,LMAN1L,chr15,F,74812852,74825758,27542056,12906,512876527,12085,13
79768,KATNBL1,chr15,R,34140673,34210096,27611479,69423,512945950,12086,13
79811,SLTM,chr15,R,58879044,58934313,27666748,55269,513001219,12087,21
79834,PEAK1,chr15,R,77100828,77420104,27986024,319276,513320495,12088,18
79856,SNX22,chr15,F,64151697,64157481,27991808,5784,513326279,12089,6
79875,THSD4,chr15,F,71115627,71783383,28659564,667756,513994035,12090,21
79895,ATP8B4,chr15,R,49858237,50181793,28983120,323556,514317591,12091,49
79968,WDR76,chr15,F,43826913,43868419,29024626,41506,514359097,12092,13
80021,TMEM62,chr15,F,43133143,43185147,29076630,52004,514411101,12093,14
80031,SEMA6D,chr15,F,47184100,47774223,29666753,590123,515001224,12094,23
80035,ANP32A-IT1,chr15,R,68803820,68807101,29670034,3281,515004505,12095,0
80072,HEXA-AS1,chr15,F,72376112,72378788,29672710,2676,515007181,12096,0
80119,PIF1,chr15,R,64815629,64827154,29684235,11525,515018706,12097,14
80125,CCDC33,chr15,F,74217196,74336472,29803511,119276,515137982,12098,25
80153,EDC3,chr15,R,74630557,74696045,29868999,65488,515203470,12099,11
80154,GOLGA2P10,chr15,R,82471476,82513999,29911522,42523,515245993,12100,7
80208,SPG11,chr15,R,44562695,44663678,30012505,100983,515346976,12101,39
80213,TM2D3,chr15,R,101633225,101652391,30031671,19166,515366142,12102,6
80237,ELL3,chr15,R,43772599,43777304,30036376,4705,515370847,12103,10
80301,PLEKHO2,chr15,F,64841882,64868002,30062496,26120,515396967,12104,5
80349,WDR61,chr15,R,78283232,78299726,30078990,16494,515413461,12105,10
80381,CD276,chr15,F,73684280,73714518,30109228,30238,515443699,12106,11
80765,STARD5,chr15,R,81312665,81324183,30120746,11518,515455217,12107,5
81488,POLR2M,chr15,F,57706520,57717557,30131783,11037,515466254,12108,19
81556,VWA9,chr15,R,65578756,65611289,30164316,32533,515498787,12109,11
81614,NIPA2,chr15,F,22838640,22868384,30194060,29744,515528531,12110,10
81698,LINC00597,chr15,R,77223892,77225404,30195572,1512,515530043,12111,0
83440,ADPGK,chr15,R,72751293,72783785,30228064,32492,515562535,12112,7
83464,APH1B,chr15,F,63277518,63309126,30259672,31608,515594143,12113,6
83640,FAM103A1,chr15,F,82986202,82991057,30264527,4855,515598998,12114,3
83660,TLN2,chr15,F,62390574,62844631,30718584,454057,516053055,12115,66
84191,FAM96A,chr15,R,64072558,64094008,30740034,21450,516074505,12116,4
84206,MEX3B,chr15,R,82041777,82046143,30744400,4366,516078871,12117,1
84419,C15orf48,chr15,F,45430528,45433449,30747321,2921,516081792,12118,3
84465,MEGF11,chr15,R,65895295,66253737,31105763,358442,516440234,12119,27
84529,C15orf41,chr15,F,36579602,36810260,31336421,230658,516670892,12120,17
84888,SPPL2A,chr15,R,50707532,50766158,31395047,58626,516729518,12121,16
84894,LINGO1,chr15,R,77613023,77820900,31602924,207877,516937395,12122,15
84936,ZFYVE19,chr15,F,40807075,40814569,31610418,7494,516944889,12123,12
84942,WDR73,chr15,R,84641494,84654343,31623267,12849,516957738,12124,6
84952,CGNL1,chr15,F,57376504,57550727,31797490,174223,517131961,12125,23
84978,FRMD5,chr15,R,43870760,44195577,32122307,324817,517456778,12126,17
84993,UBL7,chr15,R,74445976,74461188,32137519,15212,517471990,12127,11
85455,DISP2,chr15,F,40354358,40371055,32154216,16697,517488687,12128,8
89832,CHRFAM7A,chr15,R,30357769,30393849,32190296,36080,517524767,12129,11
89837,ULK4P3,chr15,F,30103731,30131748,32218313,28017,517552784,12130,4
89838,ULK4P1,chr15,R,32406610,32435049,32246752,28439,517581223,12131,4
89839,ARHGAP11B,chr15,F,30626130,30638810,32259432,12680,517593903,12132,7
89978,DPH6,chr15,R,35304892,35546222,32500762,241330,517835233,12133,13
90381,TICRR,chr15,F,89575437,89628023,32553348,52586,517887819,12134,21
90416,C15orf57,chr15,R,40531340,40565057,32587065,33717,517921536,12135,4
90417,KNSTRN,chr15,F,40382720,40394288,32598633,11568,517933104,12136,8
90427,BMF,chr15,R,40087889,40108884,32619628,20995,517954099,12137,6
90525,SHF,chr15,R,45167213,45201329,32653744,34116,517988215,12138,11
90527,DUOXA1,chr15,R,45117365,45129938,32666317,12573,518000788,12139,9
91380,SNORD107,chr15,F,24981993,24982068,32666392,75,518000863,12140,0
91433,RCCD1,chr15,F,90954694,90963543,32675241,8849,518009712,12141,9
91450,LOC91450,chr15,R,77993232,77994225,32676234,993,518010705,12142,0
91860,CALML4,chr15,R,68190704,68206110,32691640,15406,518026111,12143,4
91947,ARRDC4,chr15,F,97960702,97973838,32704776,13136,518039247,12144,7
91948,LINC00923,chr15,R,97742615,97874429,32836590,131814,518171061,12145,2
92483,LDHAL6B,chr15,F,59206815,59208588,32838363,1773,518172834,12146,0
92912,UBE2Q2,chr15,F,75843285,75901047,32896125,57762,518230596,12147,14
113189,CHST14,chr15,F,40470960,40473158,32898323,2198,518232794,12148,0
113201,CASC4,chr15,F,44288615,44415761,33025469,127146,518359940,12149,10
114294,LACTB,chr15,F,63121799,63142065,33045735,20266,518380206,12150,6
114791,TUBGCP5,chr15,R,22991676,23039673,33093732,47997,518428203,12151,23
115752,DIS3L,chr15,F,66293255,66333898,33134375,40643,518468846,12152,19
116179,TGM7,chr15,R,43276280,43302255,33160350,25975,518494821,12153,13
117155,CATSPER2,chr15,R,43630561,43648845,33178634,18284,518513105,12154,12
123169,LEO1,chr15,R,51938024,51971801,33212411,33777,518546882,12155,12
123207,C15orf40,chr15,R,82988307,83012298,33236402,23991,518570873,12156,10
123228,SENP8,chr15,F,72114257,72140970,33263115,26713,518597586,12157,4
123263,MTFMT,chr15,R,65001511,65029639,33291243,28128,518625714,12158,9
123264,SLC51B,chr15,F,65045369,65053396,33299270,8027,518633741,12159,4
123283,TARSL2,chr15,R,101653751,101724442,33369961,70691,518704432,12160,20
123346,HIGD2B,chr15,R,72675781,72686149,33380329,10368,518714800,12161,2
123355,LRRC28,chr15,F,99251361,99386309,33515277,134948,518849748,12162,15
123591,C15orf27,chr15,F,76059945,76204963,33660295,145018,518994766,12163,12
123606,NIPA1,chr15,F,22786224,22829789,33703860,43565,519038331,12164,5
123624,AGBL1,chr15,F,86079786,87031178,34655252,951392,519989723,12165,26
123688,HYKK,chr15,F,78507563,78537373,34685062,29810,520019533,12166,6
123720,WHAMM,chr15,F,82808168,82834861,34711755,26693,520046226,12167,12
123722,FSD2,chr15,R,82755364,82806211,34762602,50847,520097073,12168,14
123745,PLA2G4E,chr15,R,41981581,42050703,34831724,69122,520166195,12169,22
140460,ASB7,chr15,F,100602549,100651701,34880876,49152,520215347,12170,5
140691,TRIM69,chr15,F,44736361,44767829,34912344,31468,520246815,12171,6
145624,PWAR1,chr15,F,25135641,25138053,34914756,2412,520249227,12172,0
145645,C15orf43,chr15,F,44956632,44979223,34937347,22591,520271818,12173,7
145694,LOC145694,chr15,R,69396903,69414476,34954920,17573,520289391,12174,2
145741,C2CD4A,chr15,F,62066976,62070917,34958861,3941,520293332,12175,1
145748,LYSMD4,chr15,R,99716803,99733458,34975516,16655,520309987,12176,8
145773,FAM81A,chr15,F,59402275,59523552,35096793,121277,520431264,12177,14
145781,GCOM1,chr15,F,57591903,57717557,35222447,125654,520556918,12178,19
145783,LOC145783,chr15,R,56886169,56918499,35254777,32330,520589248,12179,3
145788,C15orf65,chr15,F,55408524,55418712,35264965,10188,520599436,12180,1
145814,PGPEP1L,chr15,R,98968229,99007795,35304531,39566,520639002,12181,7
145820,LINC00924,chr15,F,95433092,95507847,35379286,74755,520713757,12182,6
145837,LOC145837,chr15,F,69561719,69571440,35389007,9721,520723478,12183,4
145845,LOC145845,chr15,R,36864442,36886533,35411098,22091,520745569,12184,6
145853,C15orf61,chr15,F,67521183,67527303,35417218,6120,520751689,12185,1
145858,C15orf32,chr15,F,92471653,92501117,35446682,29464,520781153,12186,4
145864,HAPLN3,chr15,R,88877287,88895626,35465021,18339,520799492,12187,6
145873,MESP2,chr15,F,89776357,89778754,35467418,2397,520801889,12188,1
145942,TMCO5A,chr15,F,37934603,37995033,35527848,60430,520862319,12189,14
145946,SPATA8,chr15,F,96783406,96785615,35530057,2209,520864528,12190,2
145957,NRG4,chr15,R,75941972,76012444,35600529,70472,520935000,12191,5
145978,LINC00052,chr15,F,87576928,87579686,35603287,2758,520937758,12192,2
146050,ZSCAN29,chr15,R,43358171,43370648,35615764,12477,520950235,12193,5
146057,TTBK2,chr15,R,42738733,42921007,35798038,182274,521132509,12194,18
146059,CDAN1,chr15,R,42723556,42737219,35811701,13663,521146172,12195,27
161497,STRC,chr15,R,43599242,43711486,35923945,112244,521258416,12196,35
161502,C15orf26,chr15,F,81099407,81149175,35973713,49768,521308184,12197,9
161514,TBC1D21,chr15,F,73873574,73909783,36009922,36209,521344393,12198,14
161582,DYX1C1,chr15,R,55417754,55508234,36100402,90480,521434873,12199,10
161635,CSNK1A1P1,chr15,R,36799099,36818506,36119809,19407,521454280,12200,3
161725,OTUD7A,chr15,R,31481681,31870685,36508813,389004,521843284,12201,14
161742,SPRED1,chr15,F,38252086,38357249,36613976,105163,521948447,12202,10
161753,ODF3L1,chr15,F,75723943,75727688,36617721,3745,521952192,12203,3
161779,PGBD4,chr15,F,34102072,34104390,36620039,2318,521954510,12204,0
161823,ADAL,chr15,F,43330355,43354555,36644239,24200,521978710,12205,12
161829,EXD1,chr15,R,41182727,41231074,36692586,48347,522027057,12206,15
161835,FSIP1,chr15,R,39599528,39782838,36875896,183310,522210367,12207,16
170691,ADAMTS17,chr15,R,99971437,100342087,37246546,370650,522581017,12208,23
171177,RHOV,chr15,R,40872213,40874289,37248622,2076,522583093,12209,2
192683,SCAMP5,chr15,F,74995534,75021495,37274583,25961,522609054,12210,10
196951,FAM227B,chr15,R,49328392,49620931,37567122,292539,522901593,12211,25
196968,DNM1P46,chr15,R,99790155,99806927,37583894,16772,522918365,12212,4
196993,CT62,chr15,R,71110243,71115500,37589151,5257,522923622,12213,3
196996,GRAMD2,chr15,R,72159805,72197795,37627141,37990,522961612,12214,17
197003,MGC15885,chr15,R,62637171,62645181,37635151,8010,522969622,12215,2
197021,LCTL,chr15,R,66547467,66565979,37653663,18512,522988134,12216,13
197131,UBR1,chr15,R,42942896,43106088,37816855,163192,523151326,12217,46
197135,PATL2,chr15,R,44665731,44711392,37862516,45661,523196987,12218,21
204219,CERS3,chr15,R,100400394,100544786,38006908,144392,523341379,12219,15
246777,SPESP1,chr15,F,68930499,68946811,38023220,16312,523357691,12220,1
253044,LINGO1-AS1,chr15,F,77641763,77649240,38030697,7477,523365168,12221,2
254531,LPCAT4,chr15,R,34358887,34367196,38039006,8309,523373477,12222,15
254559,LINC00925,chr15,F,89378041,89398487,38059452,20446,523393923,12223,6
255180,GOLGA2P11,chr15,R,62230983,62252380,38080849,21397,523415320,12224,16
255189,PLA2G4F,chr15,R,42141133,42156641,38096357,15508,523430828,12225,20
255252,LRRC57,chr15,R,42528443,42548804,38116718,20361,523451189,12226,7
256586,LYSMD2,chr15,R,51723063,51751453,38145108,28390,523479579,12227,3
256646,NUTM1,chr15,F,34343250,34357737,38159595,14487,523494066,12228,7
256764,WDR72,chr15,R,53513740,53762878,38408733,249138,523743204,12229,24
257364,SNX33,chr15,F,75649006,75658627,38418354,9621,523752825,12230,1
283651,HMGN2P46,chr15,F,45511135,45556730,38463949,45595,523798420,12231,5
283652,SLC24A5,chr15,F,48120971,48142392,38485370,21421,523819841,12232,8
283659,PRTG,chr15,R,55611539,55743649,38617480,132110,523951951,12233,21
283663,LINC00926,chr15,F,57300364,57307769,38624885,7405,523959356,12234,2
283673,EWSAT1,chr15,F,69080849,69095824,38639860,14975,523974331,12235,3
283677,REC114,chr15,F,73376208,73560013,38823665,183805,524158136,12236,9
283682,LINC01579,chr15,R,93718541,93900777,39005901,182236,524340372,12237,12
283683,LOC283683,chr15,F,22757856,22778737,39026782,20881,524361253,12238,4
283685,GOLGA6L2,chr15,R,23439385,23447243,39034640,7858,524369111,12239,7
283687,ST20-AS1,chr15,F,79922770,79924854,39036724,2084,524371195,12240,0
283688,LINC00927,chr15,R,80263067,80341805,39115462,78738,524449933,12241,2
283692,CPEB1-AS1,chr15,F,82647769,82692820,39160513,45051,524494984,12242,3
283693,ACTG1P17,chr15,R,82725879,82739780,39174414,13901,524508885,12243,2
283694,OR4N4,chr15,F,22094430,22095864,39175848,1434,524510319,12244,0
283710,LOC283710,chr15,R,31221812,31230847,39184883,9035,524519354,12245,3
283726,SAXO2,chr15,F,82262810,82284927,39207000,22117,524541471,12246,2
283731,LOC283731,chr15,R,74126372,74129278,39209906,2906,524544377,12247,1
283738,NTRK3-AS1,chr15,F,88252729,88271066,39228243,18337,524562714,12248,3
283742,FAM98B,chr15,F,38454126,38487710,39261827,33584,524596298,12249,7
283748,PLA2G4D,chr15,R,42067564,42094559,39288822,26995,524623293,12250,20
283755,HERC2P3,chr15,R,20408395,20506180,39386607,97785,524721078,12251,25
283761,LINC00928,chr15,R,89504929,89524034,39405712,19105,524740183,12252,3
283767,GOLGA6L1,chr15,R,23127065,23136822,39415469,9757,524749940,12253,8
283768,GOLGA8G,chr15,R,28519610,28532997,39428856,13387,524763327,12254,17
283777,FAM169B,chr15,R,98437161,98514382,39506077,77221,524840548,12255,6
283796,GOLGA8IP,chr15,R,22610352,22617854,39513579,7502,524848050,12256,11
283807,FBXL22,chr15,F,63594829,63602428,39521178,7599,524855649,12257,1
338427,SNORD108,chr15,F,24986924,24986993,39521247,69,524855718,12258,0
338428,SNORD109A,chr15,F,25041973,25042040,39521314,67,524855785,12259,0
338429,SNORD109B,chr15,F,25278342,25278409,39521381,67,524855852,12260,0
338433,SNORD115-1,chr15,F,25170722,25170804,39521463,82,524855934,12261,0
338949,TMEM202,chr15,F,72398100,72408367,39531730,10267,524866201,12262,5
338963,LOC338963,chr15,R,82710470,82713993,39535253,3523,524869724,12263,3
339005,WHAMMP3,chr15,F,22664738,22685368,39555883,20630,524890354,12264,10
342035,GLDN,chr15,F,51341515,51408013,39622381,66498,524956852,12265,10
342096,GOLGA6A,chr15,R,74067653,74082747,39637475,15094,524971946,12266,17
342125,TMC3,chr15,R,81332418,81374077,39679134,41659,525013605,12267,21
342132,ZNF774,chr15,F,90352244,90361483,39688373,9239,525022844,12268,3
342184,FMN1,chr15,R,32765543,33194784,40117614,429241,525452085,12269,29
347686,SNORD64,chr15,F,24985099,24985166,40117681,67,525452152,12270,0
347745,PWAR4,chr15,F,25211691,25212033,40118023,342,525452494,12271,0
347746,PWARSN,chr15,F,24981993,24983790,40119820,1797,525454291,12272,0
348093,RBPMS2,chr15,R,64739893,64775571,40155498,35678,525489969,12273,7
348094,ANKDD1A,chr15,F,64911901,64958700,40202297,46799,525536768,12274,14
348110,ARPIN,chr15,R,89896531,89912990,40218756,16459,525553227,12275,9
348120,LINC01193,chr15,F,20940437,20993304,40271623,52867,525606094,12276,4
359821,MRPL42P5,chr15,R,40531883,40532550,40272290,667,525606761,12277,0
373509,USP50,chr15,R,50493680,50547439,40326049,53759,525660520,12278,12
374618,TEX9,chr15,F,56244084,56459738,40541703,215654,525876174,12279,17
374650,GOLGA6L5P,chr15,R,84506167,84516847,40552383,10680,525886854,12280,9
374654,KIF7,chr15,R,89608912,89663074,40606545,54162,525941016,12281,23
374655,ZNF710,chr15,F,89999045,90082200,40689700,83155,526024171,12282,9
374659,HDDC3,chr15,R,90930917,90932569,40691352,1652,526025823,12283,3
374666,WASH3P,chr15,F,101960812,101976605,40707145,15793,526041616,12284,10
388077,IGHV1OR15-1,chr15,R,22160287,22160934,40707792,647,526042263,12285,1
388115,C15orf52,chr15,R,40331451,40340967,40717308,9516,526051779,12286,10
388121,TNFAIP8L3,chr15,R,51056595,51105276,40765989,48681,526100460,12287,5
388125,C2CD4B,chr15,R,62163537,62165283,40767735,1746,526102206,12288,1
388135,C15orf59,chr15,R,73735430,73753187,40785492,17757,526119963,12289,2
388152,GOLGA2P7,chr15,R,84198847,84230168,40816813,31321,526151284,12290,6
388165,UBE2Q2P1,chr15,R,84527195,84570795,40860413,43600,526194884,12291,5
388182,SPATA41,chr15,R,100344456,100350718,40866675,6262,526201146,12292,1
390535,GOLGA8EP,chr15,R,22424672,22438026,40880029,13354,526214500,12293,17
390538,OR4M2,chr15,F,22080526,22081610,40881113,1084,526215584,12294,0
390539,OR4N3P,chr15,F,22125510,22126447,40882050,937,526216521,12295,0
390561,HERC2P10,chr15,F,30818035,30827783,40891798,9748,526226269,12296,4
390594,KBTBD13,chr15,F,65076815,65079938,40894921,3123,526229392,12297,0
390595,UBAP1L,chr15,R,65092759,65106647,40908809,13888,526243280,12298,4
390598,SKOR1,chr15,F,67819703,67834561,40923667,14858,526258138,12299,12
390616,ANKRD34C,chr15,F,79282803,79298239,40939103,15436,526273574,12300,2
390637,GDPGP1,chr15,F,90234254,90242080,40946929,7826,526281400,12301,4
390648,OR4F6,chr15,F,101805719,101806658,40947868,939,526282339,12302,0
390649,OR4F15,chr15,F,101818186,101819125,40948807,939,526283278,12303,0
390651,OR4F13P,chr15,F,101842118,101850324,40957013,8206,526291484,12304,4
390660,ADAMTS7P1,chr15,F,82293282,82334561,40998292,41279,526332763,12305,23
399694,SHC4,chr15,R,48823736,48963444,41138000,139708,526472471,12306,13
399697,CTXN2,chr15,F,48178354,48203754,41163400,25400,526497871,12307,5
400322,HERC2P2,chr15,F,22494836,22590831,41259395,95995,526593866,12308,34
400359,C15orf53,chr15,F,38696597,38700038,41262836,3441,526597307,12309,1
400360,C15orf54,chr15,F,39250668,39254845,41267013,4177,526601484,12310,1
400410,ST20,chr15,R,79898839,79923754,41291928,24915,526626399,12311,4
400451,FAM174B,chr15,R,92617447,92812338,41486819,194891,526821290,12312,14
400456,LINC01197,chr15,R,95279287,95327100,41534632,47813,526869103,12313,3
400464,LOC400464,chr15,F,99807788,99881880,41608724,74092,526943195,12314,7
405753,DUOXA2,chr15,F,45114324,45118106,41612506,3782,526946977,12315,5
406960,MIR184,chr15,F,79209787,79209871,41612590,84,526947061,12316,0
406965,MIR190A,chr15,F,62823956,62824041,41612675,85,526947146,12317,0
406993,MIR211,chr15,R,31065031,31065141,41612785,110,526947256,12318,0
407044,MIR7-2,chr15,F,88611824,88611934,41612895,110,526947366,12319,0
407051,MIR9-3,chr15,F,89368016,89368106,41612985,90,526947456,12320,0
414926,LINC00593,chr15,F,69835233,69842967,41620719,7734,526955190,12321,4
440225,NF1P2,chr15,R,21927656,21940278,41633341,12622,526967812,12322,7
440243,GOLGA6L22,chr15,F,22458902,22468026,41642465,9124,526976936,12323,9
440248,HERC2P9,chr15,F,28654441,28685264,41673288,30823,527007759,12324,13
440253,WHAMMP2,chr15,F,28737582,28758362,41694068,20780,527028539,12325,8
440270,GOLGA8B,chr15,R,34525275,34583651,41752444,58376,527086915,12326,24
440275,EIF2AK4,chr15,F,39934123,40035596,41853917,101473,527188388,12327,38
440278,CATSPER2P1,chr15,R,43735933,43746298,41864282,10365,527198753,12328,3
440279,UNC13C,chr15,F,53978202,54628608,42514688,650406,527849159,12329,32
440288,UBL7-AS1,chr15,F,74461264,74481292,42534716,20028,527869187,12330,4
440292,LOC440292,chr15,R,77941392,77944561,42537885,3169,527872356,12331,4
440295,GOLGA6L9,chr15,F,82417677,82439387,42559595,21710,527894066,12332,13
440299,DNM1P41,chr15,R,84166546,84170984,42564033,4438,527898504,12333,0
440300,LOC440300,chr15,F,84191847,84209294,42581480,17447,527915951,12334,7
440307,TTLL13P,chr15,F,90249531,90259088,42591037,9557,527925508,12335,9
440311,LOC440311,chr15,F,94855362,94857066,42592741,1704,527927212,12336,0
441728,LOC441728,chr15,F,75775329,75789719,42607131,14390,527941602,12337,17
441733,PRKXP1,chr15,R,100547751,100559283,42618663,11532,527953134,12338,0
494334,MIR422A,chr15,R,63870929,63871019,42618753,90,527953224,12339,0
503519,LINC00929,chr15,F,26115812,26133037,42635978,17225,527970449,12340,6
548596,CKMT1A,chr15,F,43692885,43699222,42642315,6337,527976786,12341,9
594855,CPLX3,chr15,F,74826609,74831795,42647501,5186,527981972,12342,2
595097,SNORD16,chr15,R,66502810,66502910,42647601,100,527982072,12343,0
595098,SNORD18A,chr15,R,66503244,66503314,42647671,70,527982142,12344,0
595099,SNORD18B,chr15,R,66502021,66502091,42647741,70,527982212,12345,0
595100,SNORD18C,chr15,R,66501251,66501318,42647808,67,527982279,12346,0
619189,SERINC4,chr15,R,43794173,43800097,42653732,5924,527988203,12347,11
642131,LOC642131,chr15,R,22177501,22185491,42661722,7990,527996193,12348,2
642402,GOLGA6L17P,chr15,F,82519589,82526484,42668617,6895,528003088,12349,8
642423,LOC642423,chr15,R,85204675,85205287,42669229,612,528003700,12350,0
643338,C15orf62,chr15,F,40769960,40772449,42671718,2489,528006189,12351,0
643699,GOLGA8N,chr15,F,32587327,32607310,42691701,19983,528026172,12352,20
643707,GOLGA6L4,chr15,F,84235772,84245368,42701297,9596,528035768,12353,8
644192,NR2F2-AS1,chr15,R,96127359,96327361,42901299,200002,528235770,12354,11
644809,C15orf56,chr15,R,40250663,40252909,42903545,2246,528238016,12355,1
644844,PHGR1,chr15,F,40351032,40356434,42908947,5402,528243418,12356,3
645202,LOC645202,chr15,R,28349389,28358086,42917644,8697,528252115,12357,10
645212,EIF3J-AS1,chr15,R,44534504,44536923,42920063,2419,528254534,12358,1
645752,LOC645752,chr15,R,77914216,77926846,42932693,12630,528267164,12359,17
646096,CHEK2P2,chr15,F,20282743,20291558,42941508,8815,528275979,12360,5
646214,LOC646214,chr15,R,21289603,21297829,42949734,8226,528284205,12361,0
646243,CXADRP2,chr15,R,21371492,21373968,42952210,2476,528286681,12362,0
646278,PDCD6IPP2,chr15,F,28789833,28856574,43018951,66741,528353422,12363,13
646370,IGHV1OR15-3,chr15,R,21735636,21736005,43019320,369,528353791,12364,1
646396,REREP3,chr15,F,22258613,22282880,43043587,24267,528378058,12365,2
646670,LOC646670,chr15,F,72637064,72649548,43056071,12484,528390542,12366,9
646892,SH2D7,chr15,F,78077804,78104051,43082318,26247,528416789,12367,13
646938,LOC646938,chr15,F,78752036,78753392,43083674,1356,528418145,12368,1
647042,GOLGA6L10,chr15,R,82339992,82349475,43093157,9483,528427628,12369,8
648809,EFTUD1P1,chr15,F,84080186,84126601,43139572,46415,528474043,12370,9
653061,GOLGA8S,chr15,F,23354747,23368324,43153149,13577,528487620,12371,17
653073,GOLGA8J,chr15,F,30082374,30096701,43167476,14327,528501947,12372,20
653075,GOLGA8T,chr15,F,30135786,30147192,43178882,11406,528513353,12373,16
653125,GOLGA8K,chr15,R,32389584,32403292,43192590,13708,528527061,12374,18
653641,GOLGA6C,chr15,F,75258557,75273455,43207488,14898,528541959,12375,17
653643,GOLGA6D,chr15,F,75282840,75295807,43220455,12967,528554926,12376,17
653720,GOLGA8M,chr15,R,28698694,28718510,43240271,19816,528574742,12377,20
664618,HSP90AB4P,chr15,R,58690472,58693607,43243406,3135,528577877,12378,0
677778,SCARNA15,chr15,F,82755944,82756071,43243533,127,528578004,12379,0
692149,SCARNA14,chr15,R,66347205,66347342,43243670,137,528578141,12380,0
692224,FBXO22-AS1,chr15,R,75932682,75933130,43244118,448,528578589,12381,0
693132,MIR549A,chr15,R,80841977,80842073,43244214,96,528578685,12382,0
693211,MIR626,chr15,F,41691584,41691678,43244308,94,528578779,12383,0
693212,MIR627,chr15,R,42199569,42199666,43244405,97,528578876,12384,0
693213,MIR628,chr15,R,55372939,55373034,43244500,95,528578971,12385,0
693214,MIR629,chr15,R,70079371,70079468,43244597,97,528579068,12386,0
693215,MIR630,chr15,F,72587216,72587313,43244694,97,528579165,12387,0
693216,MIR631,chr15,R,75353610,75353685,43244769,75,528579240,12388,0
723972,ANP32AP1,chr15,F,35237325,35238063,43245507,738,528579978,12389,0
727708,SNORD116-19,chr15,F,25086525,25086619,43245601,94,528580072,12390,0
727832,GOLGA6L6,chr15,R,20531855,20541800,43255546,9945,528590017,12391,8
727915,AGBL1-AS1,chr15,R,86296832,86316968,43275682,20136,528610153,12392,3
727924,LOC727924,chr15,F,21552794,21640521,43363409,87727,528697880,12393,10
728047,GOLGA8O,chr15,R,32441913,32456324,43377820,14411,528712291,12394,20
728310,GOLGA6L7P,chr15,R,28844960,28848675,43381535,3715,528716006,12395,5
728498,GOLGA8H,chr15,F,30545869,30617827,43453493,71958,528787964,12396,21
728619,ASB9P1,chr15,F,92795483,92797108,43455118,1625,528789589,12397,0
728758,PIN4P1,chr15,R,43875805,43878171,43457484,2366,528791955,12398,0
729082,OIP5-AS1,chr15,F,41284002,41299597,43473079,15595,528807550,12399,3
729739,LOC729739,chr15,F,74361551,74362041,43473569,490,528808040,12400,0
729786,GOLGA8CP,chr15,F,20562348,20575703,43486924,13355,528821395,12401,17
729911,ANKRD34C-AS1,chr15,R,79191706,79283945,43579163,92239,528913634,12402,1
732265,LOC732265,chr15,R,74088445,74100467,43591185,12022,528925656,12403,7
791114,PWRN1,chr15,F,24558156,24587780,43620809,29624,528955280,12404,8
791115,PWRN2,chr15,R,24164778,24169906,43625937,5128,528960408,12405,0
100033413,SNORD116-1,chr15,F,25051475,25051572,43626034,97,528960505,12406,0
100033414,SNORD116-2,chr15,F,25054208,25054305,43626131,97,528960602,12407,0
100033415,SNORD116-3,chr15,F,25056858,25056955,43626228,97,528960699,12408,0
100033416,SNORD116-4,chr15,F,25059536,25059634,43626326,98,528960797,12409,0
100033417,SNORD116-5,chr15,F,25062331,25062428,43626423,97,528960894,12410,0
100033418,SNORD116-6,chr15,F,25065024,25065122,43626521,98,528960992,12411,0
100033419,SNORD116-7,chr15,F,25067786,25067883,43626618,97,528961089,12412,0
100033420,SNORD116-8,chr15,F,25070430,25070527,43626715,97,528961186,12413,0
100033421,SNORD116-9,chr15,F,25073105,25073202,43626812,97,528961283,12414,0
100033422,SNORD116-10,chr15,F,25074112,25074216,43626916,104,528961387,12415,0
100033423,SNORD116-11,chr15,F,25075927,25076021,43627010,94,528961481,12416,0
100033424,SNORD116-12,chr15,F,25077049,25077143,43627104,94,528961575,12417,0
100033425,SNORD116-13,chr15,F,25079056,25079150,43627198,94,528961669,12418,0
100033426,SNORD116-14,chr15,F,25080140,25080234,43627292,94,528961763,12419,0
100033427,SNORD116-15,chr15,F,25081285,25081379,43627386,94,528961857,12420,0
100033428,SNORD116-16,chr15,F,25082766,25082860,43627480,94,528961951,12421,0
100033429,SNORD116-17,chr15,F,25083586,25083680,43627574,94,528962045,12422,0
100033430,SNORD116-18,chr15,F,25085383,25085477,43627668,94,528962139,12423,0
100033431,SNORD116-20,chr15,F,25087660,25087754,43627762,94,528962233,12424,0
100033432,SNORD116-21,chr15,F,25088802,25088896,43627856,94,528962327,12425,0
100033433,SNORD116-22,chr15,F,25089921,25090015,43627950,94,528962421,12426,0
100033434,SNORD116-23,chr15,F,25091784,25091878,43628044,94,528962515,12427,0
100033435,SNORD116-24,chr15,F,25094035,25094129,43628138,94,528962609,12428,0
100033436,SNORD116-25,chr15,F,25097661,25097755,43628232,94,528962703,12429,0
100033437,SNORD115-2,chr15,F,25172634,25172716,43628314,82,528962785,12430,0
100033438,SNORD116-26,chr15,F,25099497,25099595,43628412,98,528962883,12431,0
100033439,SNORD116-27,chr15,F,25101573,25101667,43628506,94,528962977,12432,0
100033440,SNORD115-3,chr15,F,25174926,25175008,43628588,82,528963059,12433,0
100033441,SNORD115-4,chr15,F,25176831,25176913,43628670,82,528963141,12434,0
100033442,SNORD115-5,chr15,F,25178737,25178819,43628752,82,528963223,12435,0
100033443,SNORD115-6,chr15,F,25180496,25180578,43628834,82,528963305,12436,0
100033444,SNORD115-7,chr15,F,25182384,25182466,43628916,82,528963387,12437,0
100033445,SNORD115-8,chr15,F,25184305,25184387,43628998,82,528963469,12438,0
100033446,SNORD115-9,chr15,F,25185630,25185712,43629080,82,528963551,12439,0
100033447,SNORD115-10,chr15,F,25187535,25187616,43629161,81,528963632,12440,0
100033448,SNORD115-11,chr15,F,25189413,25189495,43629243,82,528963714,12441,0
100033449,SNORD115-12,chr15,F,25191415,25191497,43629325,82,528963796,12442,0
100033450,SNORD115-13,chr15,F,25193320,25193402,43629407,82,528963878,12443,0
100033451,SNORD115-14,chr15,F,25194920,25195001,43629488,81,528963959,12444,0
100033453,SNORD115-15,chr15,F,25197575,25197656,43629569,81,528964040,12445,0
100033454,SNORD115-16,chr15,F,25199447,25199529,43629651,82,528964122,12446,0
100033455,SNORD115-17,chr15,F,25201322,25201404,43629733,82,528964204,12447,0
100033456,SNORD115-18,chr15,F,25203226,25203308,43629815,82,528964286,12448,0
100033458,SNORD115-19,chr15,F,25204356,25204438,43629897,82,528964368,12449,0
100033460,SNORD115-20,chr15,F,25206261,25206343,43629979,82,528964450,12450,0
100033603,SNORD115-21,chr15,F,25208082,25208163,43630060,81,528964531,12451,0
100033799,SNORD115-22,chr15,F,25209917,25209999,43630142,82,528964613,12452,0
100033800,SNORD115-23,chr15,F,25211795,25211877,43630224,82,528964695,12453,0
100033801,SNORD115-25,chr15,F,25215540,25215622,43630306,82,528964777,12454,0
100033802,SNORD115-26,chr15,F,25218616,25218698,43630388,82,528964859,12455,0
100033803,SNORD115-29,chr15,F,25223245,25223327,43630470,82,528964941,12456,0
100033804,SNORD115-30,chr15,F,25225202,25225284,43630552,82,528965023,12457,0
100033805,SNORD115-31,chr15,F,25227108,25227190,43630634,82,528965105,12458,0
100033806,SNORD115-32,chr15,F,25228966,25229048,43630716,82,528965187,12459,0
100033807,SNORD115-33,chr15,F,25230837,25230919,43630798,82,528965269,12460,0
100033808,SNORD115-34,chr15,F,25232386,25232468,43630880,82,528965351,12461,0
100033809,SNORD115-35,chr15,F,25234246,25234328,43630962,82,528965433,12462,0
100033810,SNORD115-36,chr15,F,25236084,25236166,43631044,82,528965515,12463,0
100033811,SNORD115-37,chr15,F,25237985,25238067,43631126,82,528965597,12464,0
100033812,SNORD115-38,chr15,F,25239837,25239919,43631208,82,528965679,12465,0
100033813,SNORD115-39,chr15,F,25241745,25241827,43631290,82,528965761,12466,0
100033814,SNORD115-40,chr15,F,25243613,25243695,43631372,82,528965843,12467,0
100033815,SNORD115-41,chr15,F,25245477,25245559,43631454,82,528965925,12468,0
100033816,SNORD115-42,chr15,F,25247344,25247426,43631536,82,528966007,12469,0
100033817,SNORD115-43,chr15,F,25249197,25249279,43631618,82,528966089,12470,0
100033818,SNORD115-44,chr15,F,25250858,25250940,43631700,82,528966171,12471,0
100033820,SNORD116-28,chr15,F,25104640,25104733,43631793,93,528966264,12472,0
100033821,SNORD116-29,chr15,F,25106519,25106604,43631878,85,528966349,12473,0
100033822,SNORD115-48,chr15,F,25269782,25269858,43631954,76,528966425,12474,0
100036563,SNORD115-24,chr15,F,25213658,25213729,43632025,71,528966496,12475,0
100036564,SNORD115-27,chr15,F,25220502,25220578,43632101,76,528966572,12476,0
100036565,SNORD115-28,chr15,F,25222353,25222427,43632175,74,528966646,12477,0
100036566,SNORD115-45,chr15,F,25264526,25264579,43632228,53,528966699,12478,0
100036567,SNORD115-47,chr15,F,25268516,25268549,43632261,33,528966732,12479,0
100124412,FAM138E,chr15,F,101954884,101956355,43633732,1471,528968203,12480,2
100126311,MIR147B,chr15,F,45433049,45433129,43633812,80,528968283,12481,0
100128108,LOC100128108,chr15,R,101724663,101747827,43656976,23164,528991447,12482,8
100128285,DNM1P35,chr15,R,75727669,75740077,43669384,12408,529003855,12483,4
100128714,LOC100128714,chr15,F,25902359,26053120,43820145,150761,529154616,12484,4
100129387,GABPB1-AS1,chr15,F,50354173,50358312,43824284,4139,529158755,12485,0
100129973,LOC100129973,chr15,F,52180025,52205879,43850138,25854,529184609,12486,2
100130111,LOC100130111,chr15,F,29674988,29681183,43856333,6195,529190804,12487,2
100130855,USP3-AS1,chr15,R,63587709,63600827,43869451,13118,529203922,12488,2
100131089,SRP14-AS1,chr15,F,40039310,40067509,43897650,28199,529232121,12489,5
100131244,ANKRD63,chr15,R,40278368,40282987,43902269,4619,529236740,12490,1
100131315,LOC100131315,chr15,R,32718100,32718865,43903034,765,529237505,12491,1
100132101,HERC2P7,chr15,R,22479152,22482374,43906256,3222,529240727,12492,2
100132565,GOLGA8F,chr15,F,28378637,28391266,43918885,12629,529253356,12493,17
100132724,DCAF13P3,chr15,F,50944128,50946573,43921330,2445,529255801,12494,0
100132979,GOLGA8DP,chr15,F,23157339,23170783,43934774,13444,529269245,12495,17
100133220,GOLGA6L3,chr15,F,85240409,85247187,43941552,6778,529276023,12496,9
100134869,UBE2Q2P2,chr15,F,82355135,82415611,44002028,60476,529336499,12497,4
100137047,JMJD7,chr15,F,41828084,41837587,44011531,9503,529346002,12498,7
100137049,PLA2G4B,chr15,F,41838812,41848148,44020867,9336,529355338,12499,19
100144604,LINC00930,chr15,R,92567817,92572263,44025313,4446,529359784,12500,3
100188986,TRH-GTG1-5,chr15,R,45198605,45198677,44025385,72,529359856,12501,0
100188988,TRH-GTG1-6,chr15,R,45200412,45200484,44025457,72,529359928,12502,0
100189013,TRK-CTT1-2,chr15,F,78860561,78860634,44025530,73,529360001,12503,0
100189063,TRE-TTC2-2,chr15,R,26082233,26082305,44025602,72,529360073,12504,0
100189065,TRH-GTG1-7,chr15,F,45201150,45201222,44025674,72,529360145,12505,0
100189155,TRC-GCA5-1,chr15,F,79744654,79744727,44025747,73,529360218,12506,0
100189229,TRS-GCT4-1,chr15,R,40593824,40593906,44025829,82,529360300,12507,0
100189264,TRR-TCG1-1,chr15,F,89335072,89335145,44025902,73,529360373,12508,0
100189317,TRQ-CTG1-1,chr15,R,65869061,65869133,44025974,72,529360445,12509,0
100287128,IGHV1OR15-2,chr15,R,19972756,19973271,44026489,515,529360960,12510,1
100287399,POTEB2,chr15,R,20835371,20866431,44057549,31060,529392020,12511,11
100287559,ADPGK-AS1,chr15,F,72782834,72798199,44072914,15365,529407385,12512,2
100287616,LOXL1-AS1,chr15,R,73917467,73928248,44083695,10781,529418166,12513,4
100288380,ULK4P2,chr15,F,30572554,30600708,44111849,28154,529446320,12514,4
100288486,DDX11L9,chr15,R,101976557,101979093,44114385,2536,529448856,12515,2
100288615,WHAMMP1,chr15,R,32519847,32533741,44128279,13894,529462750,12516,6
100288637,LOC100288637,chr15,F,30646114,30773009,44255174,126895,529589645,12517,6
100289656,LOC100289656,chr15,F,28788242,28789392,44256324,1150,529590795,12518,1
100302121,MIR1276,chr15,R,85770495,85770578,44256407,83,529590878,12519,0
100302160,MIR1233-1,chr15,R,34382068,34382150,44256489,82,529590960,12520,0
100302184,MIR1272,chr15,R,64762386,64762515,44256618,129,529591089,12521,0
100302202,MIR1266,chr15,R,52277116,52277200,44256702,84,529591173,12522,0
100302233,MIR1268A,chr15,R,22225277,22225329,44256754,52,529591225,12523,0
100302235,MIR1179,chr15,F,88608106,88608197,44256845,91,529591316,12524,0
100302254,MIR1282,chr15,R,43793658,43793759,44256946,101,529591417,12525,0
100302258,MIR1469,chr15,F,96333260,96333307,44256993,47,529591464,12526,0
100306975,NDUFAF4P1,chr15,F,49156297,49158625,44259321,2328,529593792,12527,0
100313796,PIRC76,chr15,F,92573125,92581675,44267871,8550,529602342,12528,1
100313865,PIRC66,chr15,F,51037583,51322397,44552685,284814,529887156,12529,10
100313886,MIR2116,chr15,R,59171182,59171262,44552765,80,529887236,12530,0
100419583,LOC100419583,chr15,F,44728987,44732851,44556629,3864,529891100,12531,1
100422556,LOC100422556,chr15,R,51918962,51924120,44561787,5158,529896258,12532,2
100422834,MIR1302-10,chr15,R,101960458,101960596,44561925,138,529896396,12533,0
100422841,MIR3174,chr15,F,90006754,90006841,44562012,87,529896483,12534,0
100422844,MIR3118-3,chr15,F,21406384,21406459,44562087,75,529896558,12535,0
100422845,MIR1233-2,chr15,R,34528289,34528371,44562169,82,529896640,12536,0
100422905,MIR4311,chr15,F,66040232,66040332,44562269,100,529896740,12537,0
100422935,MIR3118-4,chr15,F,21843749,21843824,44562344,75,529896815,12538,0
100422949,MIR3118-2,chr15,F,20832794,20832869,44562419,75,529896890,12539,0
100422971,MIR4312,chr15,R,68801849,68801925,44562495,76,529896966,12540,0
100422995,MIR3175,chr15,F,92904398,92904475,44562572,77,529897043,12541,0
100423013,MIR4310,chr15,R,41866494,41866551,44562629,57,529897100,12542,0
100423035,MIR4313,chr15,R,75762214,75762315,44562730,101,529897201,12543,0
100500855,MIR3713,chr15,F,76586646,76586691,44562775,45,529897246,12544,0
100500904,MIR3942,chr15,R,35372255,35372364,44562884,109,529897355,12545,0
100505534,LOC100505534,chr15,F,39921024,39925880,44567740,4856,529902211,12546,1
100505573,INAFM2,chr15,F,40324036,40326715,44570419,2679,529904890,12547,0
100505616,SNHG21,chr15,F,82750563,82757206,44577062,6643,529911533,12548,3
100505648,RAD51-AS1,chr15,R,40693733,40695105,44578434,1372,529912905,12549,1
100505679,UBE2Q2L,chr15,F,84172489,84182233,44588178,9744,529922649,12550,2
100506530,LOC100506530,chr15,F,61729849,61731389,44589718,1540,529924189,12551,1
100506686,IQCH-AS1,chr15,R,67403610,67521844,44707952,118234,530042423,12552,9
100506874,LINC00933,chr15,F,84570648,84580181,44717485,9533,530051956,12553,4
100507118,PRC1-AS1,chr15,F,90966368,90988624,44739741,22256,530074212,12554,3
100507217,LINC01578,chr15,F,92882842,92898747,44755646,15905,530090117,12555,6
100507466,DPH6-AS1,chr15,F,35546194,35859001,45068453,312807,530402924,12556,2
100507472,LOC100507472,chr15,R,101307250,101309304,45070507,2054,530404978,12557,0
100507480,LOC100507480,chr15,F,36045899,36049529,45074137,3630,530408608,12558,1
100526783,C15orf38-AP3S2,chr15,R,89830598,89912990,45156529,82392,530491000,12559,9
100528021,ST20-MTHFS,chr15,R,79843546,79923106,45236089,79560,530570560,12560,3
100529067,SERF2-C15ORF63,chr15,F,43791975,43802589,45246703,10614,530581174,12561,5
100533483,DYX1C1-CCPG1,chr15,R,55355222,55498584,45390065,143362,530724536,12562,15
100616149,MIR4512,chr15,R,66496957,66497034,45390142,77,530724613,12563,0
100616181,MIR4514,chr15,R,80997416,80997473,45390199,57,530724670,12564,0
100616183,MIR4513,chr15,R,74788671,74788757,45390285,86,530724756,12565,0
100616223,MIR4509-1,chr15,F,23197826,23197920,45390379,94,530724850,12566,0
100616228,MIR4509-2,chr15,F,28426490,28426584,45390473,94,530724944,12567,0
100616238,MIR3529,chr15,R,88611846,88611924,45390551,78,530725022,12568,0
100616275,MIR4508,chr15,R,23562061,23562131,45390621,70,530725092,12569,0
100616293,MIR4510,chr15,F,35926855,35926923,45390689,68,530725160,12570,0
100616332,MIR4716,chr15,R,49169069,49169153,45390773,84,530725244,12571,0
100616369,MIR4713,chr15,F,51242189,51242264,45390848,75,530725319,12572,0
100616379,MIR4511,chr15,R,65719245,65719332,45390935,87,530725406,12573,0
100616382,MIR4509-3,chr15,R,28490751,28490845,45391029,94,530725500,12574,0
100616396,MIR4712,chr15,F,50360328,50360410,45391111,82,530725582,12575,0
100616404,MIR4515,chr15,F,83067334,83067415,45391192,81,530725663,12576,0
100616432,MIR4714,chr15,F,98784425,98784502,45391269,77,530725740,12577,0
100616474,MIR4715,chr15,R,25848746,25848825,45391348,79,530725819,12578,0
100652749,SPATA8-AS1,chr15,R,96772004,96783337,45402681,11333,530737152,12579,4
100652857,TMCO5B,chr15,R,33236475,33247555,45413761,11080,530748232,12580,8
100653133,LOC100653133,chr15,R,32489199,32491804,45416366,2605,530750837,12581,3
100820829,MYZAP,chr15,F,57591903,57685364,45509827,93461,530844298,12582,12
100846993,MIR5009,chr15,R,89883930,89884030,45509927,100,530844398,12583,0
100847005,MIR5701-2,chr15,F,21513958,21514040,45510009,82,530844480,12584,0
100847042,MIR5572,chr15,F,80581102,80581239,45510146,137,530844617,12585,0
100847059,MIR5094,chr15,R,89850636,89850721,45510231,85,530844702,12586,0
100847060,MIR5701-1,chr15,F,20940251,20940333,45510313,82,530844784,12587,0
100847084,MIR548AP,chr15,F,85825634,85825730,45510409,96,530844880,12588,0
100873754,RNU6-19P,chr15,R,65553080,65553187,45510516,107,530844987,12589,0
100873856,SNORD116-30,chr15,F,25108267,25108352,45510601,85,530845072,12590,0
100873857,SNORD115-46,chr15,F,25266590,25266661,45510672,71,530845143,12591,0
100996255,LOC100996255,chr15,F,32536758,32580609,45554523,43851,530888994,12592,2
100996331,POTEB,chr15,R,21846328,21877396,45585591,31068,530920062,12593,11
100996379,LOC100996379,chr15,F,20515747,20520710,45590554,4963,530925025,12594,3
100996492,LINC01314,chr15,R,80195478,80252261,45647337,56783,530981808,12595,2
100996738,HERC2P11,chr15,R,28574939,28589267,45661665,14328,530996136,12596,6
100996876,RORA-AS2,chr15,F,60681568,60687249,45667346,5681,531001817,12597,2
101059918,GOLGA8R,chr15,R,30400561,30414260,45681045,13699,531015516,12598,18
101060569,LOC101060569,chr15,F,30515861,30518467,45683651,2606,531018122,12599,3
101241892,NPTN-IT1,chr15,R,73566937,73569543,45686257,2606,531020728,12600,0
101926895,CRTC3-AS1,chr15,R,90620008,90717140,45783389,97132,531117860,12601,3
101926911,LOC101926911,chr15,F,91022621,91031139,45791907,8518,531126378,12602,3
101926928,LOC101926928,chr15,F,91463338,91494850,45823419,31512,531157890,12603,3
101926958,LOC101926958,chr15,R,21386699,21404921,45841641,18222,531176112,12604,4
101927025,LOC101927025,chr15,F,93089402,93170550,45922789,81148,531257260,12605,5
101927079,LOC101927079,chr15,F,21990079,22095613,46028323,105534,531362794,12606,9
101927112,LINC01581,chr15,R,93905402,94107938,46230859,202536,531565330,12607,8
101927129,LINC01580,chr15,F,93900700,93984150,46314309,83450,531648780,12608,4
101927153,LOC101927153,chr15,F,93856559,93878356,46336106,21797,531670577,12609,3
101927263,LOC101927263,chr15,F,96354349,96395016,46376773,40667,531711244,12610,4
101927286,LOC101927286,chr15,R,97370370,97521811,46528214,151441,531862685,12611,4
101927310,LOC101927310,chr15,R,97553283,97560698,46535629,7415,531870100,12612,3
101927332,LINC01582,chr15,R,98082978,98088753,46541404,5775,531875875,12613,3
101927505,LOC101927505,chr15,R,101605512,101614339,46550231,8827,531884702,12614,2
101927579,LOC101927579,chr15,R,30539462,30625778,46636547,86316,531971018,12615,14
101927628,LOC101927628,chr15,F,101758393,101762342,46640496,3949,531974967,12616,1
101927751,LOC101927751,chr15,R,100917249,100918889,46642136,1640,531976607,12617,2
101927788,LOC101927788,chr15,F,30403804,30407268,46645600,3464,531980071,12618,2
101928039,LOC101928039,chr15,R,22194637,22258112,46709075,63475,532043546,12619,14
101928042,LOC101928042,chr15,R,32573957,32614746,46749864,40789,532084335,12620,9
101928134,LOC101928134,chr15,R,33303656,33310659,46756867,7003,532091338,12621,3
101928174,LOC101928174,chr15,F,34755083,34812923,46814707,57840,532149178,12622,2
101928227,LOC101928227,chr15,F,38040392,38062340,46836655,21948,532171126,12623,3
101928363,EHD4-AS1,chr15,F,41921416,41929286,46844525,7870,532178996,12624,3
101928388,PLA2G4E-AS1,chr15,F,41972762,41999094,46870857,26332,532205328,12625,3
101928414,LOC101928414,chr15,R,45251580,45279222,46898499,27642,532232970,12626,4
101928442,LINC01491,chr15,R,47803383,47846236,46941352,42853,532275823,12627,4
101928472,LOC101928472,chr15,F,48782906,48787102,46945548,4196,532280019,12628,3
101928499,LOC101928499,chr15,R,52800165,52806418,46951801,6253,532286272,12629,6
101928611,LINC01413,chr15,F,57319137,57325039,46957703,5902,532292174,12630,4
101928635,LOC101928635,chr15,R,58213534,58332001,47076170,118467,532410641,12631,14
101928668,LOC101928668,chr15,F,58521310,58523371,47078231,2061,532412702,12632,1
101928694,LOC101928694,chr15,R,58434900,58498735,47142066,63835,532476537,12633,2
101928725,LOC101928725,chr15,R,58768071,58771114,47145109,3043,532479580,12634,1
101928784,RORA-AS1,chr15,F,60479177,60630639,47296571,151462,532631042,12635,9
101928792,LOC101928792,chr15,F,24164162,24357981,47490390,193819,532824861,12636,26
101928818,LOC101928818,chr15,F,24358023,24412219,47544586,54196,532879057,12637,14
101928840,PWRN3,chr15,F,24441126,24447967,47551427,6841,532885898,12638,3
101928850,LOC101928850,chr15,F,61598513,61605241,47558155,6728,532892626,12639,1
101928869,GABRG3-AS1,chr15,R,27157734,27161319,47561740,3585,532896211,12640,2
101928907,LOC101928907,chr15,F,62060502,62061278,47562516,776,532896987,12641,1
101928955,LOC101928955,chr15,F,62894680,62899543,47567379,4863,532901850,12642,1
101928972,LOC101928972,chr15,R,63178033,63189457,47578803,11424,532913274,12643,3
101928988,LOC101928988,chr15,F,63928273,63935953,47586483,7680,532920954,12644,3
101929047,LOC101929047,chr15,F,28589491,28618260,47615252,28769,532949723,12645,5
101929076,LOC101929076,chr15,R,67834307,67838879,47619824,4572,532954295,12646,2
101929129,LOC101929129,chr15,R,69972476,70025507,47672855,53031,533007326,12647,5
101929151,LOC101929151,chr15,R,70570957,70586644,47688542,15687,533023013,12648,1
101929173,THSD4-AS2,chr15,R,71688700,71691539,47691381,2839,533025852,12649,2
101929196,THSD4-AS1,chr15,R,71166811,71189059,47713629,22248,533048100,12650,3
101929221,C15orf59-AS1,chr15,F,73768085,73769802,47715346,1717,533049817,12651,3
101929333,LOC101929333,chr15,R,74478067,74490944,47728223,12877,533062694,12652,1
101929408,LOC101929408,chr15,F,75758347,75763322,47733198,4975,533067669,12653,4
101929439,LOC101929439,chr15,R,76174890,76181486,47739794,6596,533074265,12654,2
101929457,LOC101929457,chr15,F,77525925,77534104,47747973,8179,533082444,12655,1
101929478,LINGO1-AS2,chr15,F,77660050,77668074,47755997,8024,533090468,12656,2
101929479,LOC101929479,chr15,R,85205388,85234795,47785404,29407,533119875,12657,8
101929560,LOC101929560,chr15,R,80344852,80362464,47803016,17612,533137487,12658,3
101929586,LOC101929586,chr15,R,80554608,80562944,47811352,8336,533145823,12659,2
101929655,TMC3-AS1,chr15,F,81324332,81443076,47930096,118744,533264567,12660,6
101929679,LOC101929679,chr15,R,85754940,85758725,47933881,3785,533268352,12661,5
101929690,LINC01583,chr15,F,82088593,82097694,47942982,9101,533277453,12662,5
101929701,LINC01584,chr15,R,86083344,86116717,47976355,33373,533310826,12663,5
101929743,LINC01586,chr15,R,88585570,88605110,47995895,19540,533330366,12664,3
101929765,LINC01585,chr15,F,90660233,90664954,48000616,4721,533335087,12665,2
101929988,LOC101929988,chr15,R,33852063,33865133,48013686,13070,533348157,12666,3
101930091,LOC101930091,chr15,R,64519142,64637840,48132384,118698,533466855,12667,8
102464834,MIR6085,chr15,F,62343028,62343138,48132494,110,533466965,12668,0
102465530,MIR6881,chr15,R,74411356,74411432,48132570,76,533467041,12669,0
102465531,MIR6882,chr15,R,74840641,74840707,48132636,66,533467107,12670,0
102465803,MIR7706,chr15,F,85380595,85380662,48132703,67,533467174,12671,0
102465855,MIR7973-2,chr15,R,51314031,51314107,48132779,76,533467250,12672,0
102465869,MIR8067,chr15,R,62304657,62304734,48132856,77,533467327,12673,0
102465910,MIR6859-3,chr15,F,101973523,101973591,48132924,68,533467395,12674,0
102466250,MIR7973-1,chr15,F,51314033,51314109,48133000,76,533467471,12675,0
102466875,MIR8063,chr15,R,36972820,36972901,48133081,81,533467552,12676,0
102466983,MIR6766,chr15,R,89326738,89326810,48133153,72,533467624,12677,0
102723165,LINC01169,chr15,F,66582189,66685798,48236762,103609,533571233,12678,4
102723320,CERS3-AS1,chr15,F,100372938,100437914,48301738,64976,533636209,12679,4
102723335,LOC102723335,chr15,F,100558676,100559798,48302860,1122,533637331,12680,1
102723344,LOC102723344,chr15,F,63390229,63437536,48350167,47307,533684638,12681,6
102723394,LOC102723394,chr15,R,101581252,101596474,48365389,15222,533699860,12682,3
102723464,LOC102723464,chr15,R,65617957,65622769,48370201,4812,533704672,12683,2
102723481,LOC102723481,chr15,R,66931538,66942154,48380817,10616,533715288,12684,1
102723493,LOC102723493,chr15,R,66984105,67064182,48460894,80077,533795365,12685,12
102723534,LOC102723534,chr15,R,23289203,23303537,48475228,14334,533809699,12686,6
102723548,LOC102723548,chr15,R,69262911,69298808,48511125,35897,533845596,12687,6
102723564,LOC102723564,chr15,F,23303716,23313129,48520538,9413,533855009,12688,6
102723623,LOC102723623,chr15,R,23325738,23334275,48529075,8537,533863546,12689,8
102723640,LOC102723640,chr15,R,72599672,72636941,48566344,37269,533900815,12690,4
102723657,LOC102723657,chr15,R,73864591,73873526,48575279,8935,533909750,12691,7
102723714,LOC102723714,chr15,F,74503128,74512628,48584779,9500,533919250,12692,3
102723749,LOC102723749,chr15,R,24340745,24343720,48587754,2975,533922225,12693,3
102723750,LOC102723750,chr15,R,74598918,74615079,48603915,16161,533938386,12694,9
102723985,LOC102723985,chr15,R,81614939,81663201,48652177,48262,533986648,12695,5
102724001,LOC102724001,chr15,R,81914889,81967179,48704467,52290,534038938,12696,6
102724034,LOC102724034,chr15,R,82443331,82444869,48706005,1538,534040476,12697,2
102724055,LOC102724055,chr15,F,30322576,30365882,48749311,43306,534083782,12698,7
102724078,LOC102724078,chr15,R,32164870,32207981,48792422,43111,534126893,12699,6
102724093,LOC102724093,chr15,F,84350346,84359422,48801498,9076,534135969,12700,8
102724117,LOC102724117,chr15,R,84428358,84437807,48810947,9449,534145418,12701,8
102724135,LOC102724135,chr15,F,84442433,84472780,48841294,30347,534175765,12702,6
102724191,LOC102724191,chr15,R,84473891,84488064,48855467,14173,534189938,12703,6
102724214,LOC102724214,chr15,F,36106914,36180989,48929542,74075,534264013,12704,3
102724253,LOC102724253,chr15,R,38754949,38757380,48931973,2431,534266444,12705,4
102724283,LOC102724283,chr15,F,39383778,39394120,48942315,10342,534276786,12706,3
102724328,LOC102724328,chr15,F,40073790,40079701,48948226,5911,534282697,12707,2
102724362,LOC102724362,chr15,R,40835992,40844268,48956502,8276,534290973,12708,4
102724393,LOC102724393,chr15,F,85349343,85373931,48981090,24588,534315561,12709,6
102724452,LOC102724452,chr15,R,86938796,86939766,48982060,970,534316531,12710,1
102724465,LOC102724465,chr15,R,87429903,87501807,49053964,71904,534388435,12711,4
102724513,LOC102724513,chr15,F,88546505,88547315,49054774,810,534389245,12712,2
102724553,LOC102724553,chr15,R,47960310,48046612,49141076,86302,534475547,12713,5
102724566,LOC102724566,chr15,F,89041026,89082888,49182938,41862,534517409,12714,4
102724587,LOC102724587,chr15,F,49877103,49883527,49189362,6424,534523833,12715,3
102724610,LOC102724610,chr15,R,21464752,21498922,49223532,34170,534558003,12716,6
102724631,POTEB3,chr15,R,21408963,21440429,49254998,31466,534589469,12717,12
102724648,LOC102724648,chr15,F,56156519,56160704,49259183,4185,534593654,12718,2
102724683,LOC102724683,chr15,R,58145549,58166735,49280369,21186,534614840,12719,5
102724766,LOC102724766,chr15,R,58343020,58431352,49368701,88332,534703172,12720,3
102724790,LOC102724790,chr15,F,61181125,61212432,49400008,31307,534734479,12721,6
102724802,LOC102724802,chr15,F,60856534,60879565,49423039,23031,534757510,12722,5
102724835,LOC102724835,chr15,R,22178233,22178602,49423408,369,534757879,12723,1
102724872,LOC102724872,chr15,F,96341201,96353520,49435727,12319,534770198,12724,2
102724938,LOC102724938,chr15,F,62267322,62278860,49447265,11538,534781736,12725,1
102724971,LOC102724971,chr15,R,21742068,21742898,49448095,830,534782566,12726,1
102724973,LOC102724973,chr15,F,99928451,99974003,49493647,45552,534828118,12727,5
102725022,LOC102725022,chr15,F,31214221,31219598,49499024,5377,534833495,12728,3
102725165,LOC102725165,chr15,R,24376764,24385452,49507712,8688,534842183,12729,2
103171574,LOC103171574,chr15,F,84422518,84425882,49511076,3364,534845547,12730,3
103504741,MIR5701-3,chr15,F,21951241,21951323,49511158,82,534845629,12731,0
104472713,PCAT29,chr15,F,69592199,69695750,49614709,103551,534949180,12732,6
104472848,IRAIN,chr15,R,98645862,98651221,49620068,5359,534954539,12733,0
104548972,SALRNA3,chr15,F,70615546,70616567,49621089,1021,534955560,12734,0
104548973,SALRNA2,chr15,F,70635248,70637314,49623155,2066,534957626,12735,0
104564224,LUNAR1,chr15,F,99014703,99031050,49639502,16347,534973973,12736,3
104613533,LOC104613533,chr15,R,92470232,92471546,49640816,1314,534975287,12737,1
105369152,LOC105369152,chr15,R,44859707,44882614,49663723,22907,534998194,12738,2
105369153,LOC105369153,chr15,R,45232944,45275437,49706216,42493,535040687,12739,4
105369179,LOC105369179,chr15,R,20731054,20754369,49729531,23315,535064002,12740,2
105369196,LOC105369196,chr15,F,74485673,74491505,49735363,5832,535069834,12741,3
105369201,LOC105369201,chr15,F,100855306,100877011,49757068,21705,535091539,12742,8
105369203,LOC105369203,chr15,R,94064378,94099378,49792068,35000,535126539,12743,3
105369212,LOC105369212,chr15,R,96081410,96152989,49863647,71579,535198118,12744,9
105369274,LOC105369274,chr15,F,21638502,21652911,49878056,14409,535212527,12745,1
105370714,LOC105370714,chr15,R,21267004,21273998,49885050,6994,535219521,12746,3
105370715,LOC105370715,chr15,F,21263161,21270762,49892651,7601,535227122,12747,2
105370717,LOC105370717,chr15,R,21151415,21154404,49895640,2989,535230111,12748,2
105370719,LOC105370719,chr15,R,20282014,20284930,49898556,2916,535233027,12749,2
105370721,LOC105370721,chr15,F,22290063,22294417,49902910,4354,535237381,12750,2
105370726,LOC105370726,chr15,R,23361465,23365069,49906514,3604,535240985,12751,2
105370727,LOC105370727,chr15,F,23381807,23386759,49911466,4952,535245937,12752,1
105370728,LOC105370728,chr15,F,23403861,23407335,49914940,3474,535249411,12753,1
105370729,LOC105370729,chr15,F,23475533,23483289,49922696,7756,535257167,12754,2
105370730,LOC105370730,chr15,R,23527057,23541404,49937043,14347,535271514,12755,2
105370731,LOC105370731,chr15,F,23974654,24087770,50050159,113116,535384630,12756,6
105370732,LOC105370732,chr15,R,24142464,24193786,50101481,51322,535435952,12757,2
105370733,LOC105370733,chr15,F,24101608,24150495,50150368,48887,535484839,12758,10
105370734,LOC105370734,chr15,R,24098026,24101511,50153853,3485,535488324,12759,2
105370735,LOC105370735,chr15,F,24412262,24425453,50167044,13191,535501515,12760,2
105370737,LOC105370737,chr15,R,25500933,25578792,50244903,77859,535579374,12761,5
105370738,LOC105370738,chr15,F,25865283,25877228,50256848,11945,535591319,12762,3
105370739,LOC105370739,chr15,R,26089630,26142998,50310216,53368,535644687,12763,5
105370740,LOC105370740,chr15,R,26403749,26477905,50384372,74156,535718843,12764,8
105370741,LOC105370741,chr15,R,27418795,27421743,50387320,2948,535721791,12765,1
105370742,LOC105370742,chr15,R,27039077,27072198,50420441,33121,535754912,12766,4
105370743,LOC105370743,chr15,R,29685000,29686956,50422397,1956,535756868,12767,3
105370744,LOC105370744,chr15,F,29760036,29762429,50424790,2393,535759261,12768,1
105370745,LOC105370745,chr15,R,30004971,30033557,50453376,28586,535787847,12769,3
105370746,LOC105370746,chr15,R,30169984,30179938,50463330,9954,535797801,12770,2
105370747,LOC105370747,chr15,F,30180035,30182290,50465585,2255,535800056,12771,2
105370748,LOC105370748,chr15,F,30799308,30800017,50466294,709,535800765,12772,0
105370750,LOC105370750,chr15,F,30534177,30538421,50470538,4244,535805009,12773,2
105370751,LOC105370751,chr15,F,30365901,30372969,50477606,7068,535812077,12774,2
105370752,LOC105370752,chr15,F,31026205,31037481,50488882,11276,535823353,12775,4
105370753,LOC105370753,chr15,F,31507846,31526340,50507376,18494,535841847,12776,2
105370754,LOC105370754,chr15,R,32157790,32164852,50514438,7062,535848909,12777,2
105370756,LOC105370756,chr15,R,32686861,32691697,50519274,4836,535853745,12778,1
105370757,LOC105370757,chr15,R,32655729,32673137,50536682,17408,535871153,12779,3
105370758,LOC105370758,chr15,F,32784450,32818061,50570293,33611,535904764,12780,2
105370759,LOC105370759,chr15,F,33194896,33211952,50587349,17056,535921820,12781,3
105370761,LOC105370761,chr15,R,34498929,34513743,50602163,14814,535936634,12782,1
105370762,LOC105370762,chr15,R,34651683,34671056,50621536,19373,535956007,12783,3
105370763,LOC105370763,chr15,R,35003514,35015337,50633359,11823,535967830,12784,2
105370764,LOC105370764,chr15,F,34989689,35011182,50654852,21493,535989323,12785,5
105370765,LOC105370765,chr15,R,35079810,35100420,50675462,20610,536009933,12786,1
105370766,LOC105370766,chr15,F,35919919,35940910,50696453,20991,536030924,12787,2
105370767,LOC105370767,chr15,R,36310254,36361476,50747675,51222,536082146,12788,3
105370768,LOC105370768,chr15,F,36446705,36485034,50786004,38329,536120475,12789,2
105370769,LOC105370769,chr15,R,36437592,36447487,50795899,9895,536130370,12790,3
105370770,LOC105370770,chr15,F,36485083,36507209,50818025,22126,536152496,12791,3
105370771,LOC105370771,chr15,R,36668897,36674358,50823486,5461,536157957,12792,2
105370772,LOC105370772,chr15,R,37364192,37426756,50886050,62564,536220521,12793,3
105370773,LOC105370773,chr15,F,37672768,37679682,50892964,6914,536227435,12794,2
105370774,LOC105370774,chr15,F,38502435,38515819,50906348,13384,536240819,12795,4
105370775,LOC105370775,chr15,F,38671774,38689146,50923720,17372,536258191,12796,2
105370776,LOC105370776,chr15,R,38729742,38732505,50926483,2763,536260954,12797,3
105370777,LOC105370777,chr15,R,38864805,38881739,50943417,16934,536277888,12798,3
105370778,LOC105370778,chr15,R,39300167,39310815,50954065,10648,536288536,12799,1
105370779,LOC105370779,chr15,F,39213775,39231074,50971364,17299,536305835,12800,2
105370780,LOC105370780,chr15,F,39167739,39180457,50984082,12718,536318553,12801,6
105370781,LOC105370781,chr15,F,39019179,39027446,50992349,8267,536326820,12802,2
105370782,LOC105370782,chr15,R,38885145,38894736,51001940,9591,536336411,12803,2
105370783,LOC105370783,chr15,F,39473242,39493031,51021729,19789,536356200,12804,7
105370784,LOC105370784,chr15,R,39512405,39519937,51029261,7532,536363732,12805,3
105370785,LOC105370785,chr15,F,39628408,39650632,51051485,22224,536385956,12806,3
105370786,LOC105370786,chr15,F,39821490,39826901,51056896,5411,536391367,12807,2
105370787,LOC105370787,chr15,R,40075942,40082302,51063256,6360,536397727,12808,2
105370789,LOC105370789,chr15,F,40962502,40974961,51075715,12459,536410186,12809,3
105370790,LOC105370790,chr15,R,41479206,41486369,51082878,7163,536417349,12810,2
105370791,LOC105370791,chr15,R,41609413,41621165,51094630,11752,536429101,12811,3
105370792,LOC105370792,chr15,F,41892761,41895946,51097815,3185,536432286,12812,1
105370793,LOC105370793,chr15,F,42042826,42044590,51099579,1764,536434050,12813,2
105370794,LOC105370794,chr15,R,42384559,42386160,51101180,1601,536435651,12814,2
105370795,LOC105370795,chr15,F,42208379,42231192,51123993,22813,536458464,12815,4
105370796,LOC105370796,chr15,R,44243910,44286336,51166419,42426,536500890,12816,2
105370797,LOC105370797,chr15,F,44423036,44426317,51169700,3281,536504171,12817,2
105370798,LOC105370798,chr15,F,44854558,44856774,51171916,2216,536506387,12818,1
105370799,LOC105370799,chr15,F,45174446,45188930,51186400,14484,536520871,12819,2
105370800,LOC105370800,chr15,R,45449694,45454415,51191121,4721,536525592,12820,1
105370801,LOC105370801,chr15,R,45664234,45677733,51204620,13499,536539091,12821,2
105370802,LOC105370802,chr15,F,45926828,45931069,51208861,4241,536543332,12822,2
105370803,LOC105370803,chr15,F,46607793,46638995,51240063,31202,536574534,12823,3
105370804,LOC105370804,chr15,R,47599569,47607012,51247506,7443,536581977,12824,5
105370805,LOC105370805,chr15,F,47884364,48005833,51368975,121469,536703446,12825,6
105370806,LOC105370806,chr15,R,48227183,48230436,51372228,3253,536706699,12826,2
105370807,LOC105370807,chr15,R,48188110,48191796,51375914,3686,536710385,12827,4
105370808,LOC105370808,chr15,F,48526254,48532376,51382036,6122,536716507,12828,2
105370809,LOC105370809,chr15,F,48645950,48652016,51388102,6066,536722573,12829,1
105370810,LOC105370810,chr15,F,48938241,48947379,51397240,9138,536731711,12830,2
105370811,LOC105370811,chr15,F,49490016,49557758,51464982,67742,536799453,12831,3
105370812,LOC105370812,chr15,R,49812604,49854022,51506400,41418,536840871,12832,2
105370813,LOC105370813,chr15,R,50807547,50810059,51508912,2512,536843383,12833,2
105370815,LOC105370815,chr15,F,51094592,51096596,51510916,2004,536845387,12834,2
105370816,LOC105370816,chr15,R,51624308,51655706,51542314,31398,536876785,12835,4
105370817,LOC105370817,chr15,R,51693345,51715875,51564844,22530,536899315,12836,6
105370818,LOC105370818,chr15,F,51915876,51947295,51596263,31419,536930734,12837,6
105370819,LOC105370819,chr15,F,52292023,52304500,51608740,12477,536943211,12838,3
105370820,LOC105370820,chr15,F,52225500,52237475,51620715,11975,536955186,12839,2
105370821,LOC105370821,chr15,F,52679429,52690175,51631461,10746,536965932,12840,4
105370822,LOC105370822,chr15,F,52804515,53194054,52021000,389539,537355471,12841,7
105370823,LOC105370823,chr15,F,53082850,53103770,52041920,20920,537376391,12842,4
105370824,LOC105370824,chr15,F,52790461,52795850,52047309,5389,537381780,12843,2
105370825,LOC105370825,chr15,F,53548748,53554537,52053098,5789,537387569,12844,4
105370826,LOC105370826,chr15,F,53445720,53514089,52121467,68369,537455938,12845,3
105370827,LOC105370827,chr15,R,53902598,53910971,52129840,8373,537464311,12846,2
105370828,LOC105370828,chr15,F,53837627,53916058,52208271,78431,537542742,12847,4
105370829,LOC105370829,chr15,F,55056746,55092173,52243698,35427,537578169,12848,1
105370830,LOC105370830,chr15,R,55192839,55196799,52247658,3960,537582129,12849,2
105370831,LOC105370831,chr15,R,56479586,56483837,52251909,4251,537586380,12850,4
105370832,LOC105370832,chr15,R,56492179,56605536,52365266,113357,537699737,12851,8
105370833,LOC105370833,chr15,F,56884854,56888219,52368631,3365,537703102,12852,1
105370834,LOC105370834,chr15,F,57732420,57775324,52411535,42904,537746006,12853,4
105370835,LOC105370835,chr15,F,58264734,58278968,52425769,14234,537760240,12854,1
105370836,LOC105370836,chr15,F,58212812,58244327,52457284,31515,537791755,12855,4
105370837,LOC105370837,chr15,R,58919882,58921815,52459217,1933,537793688,12856,1
105370838,LOC105370838,chr15,F,60029651,60041899,52471465,12248,537805936,12857,4
105370839,LOC105370839,chr15,F,60166938,60255832,52560359,88894,537894830,12858,6
105370840,LOC105370840,chr15,F,60305916,60309400,52563843,3484,537898314,12859,3
105370841,LOC105370841,chr15,R,61219546,61222257,52566554,2711,537901025,12860,2
105370842,LOC105370842,chr15,F,60883415,60895643,52578782,12228,537913253,12861,2
105370843,LOC105370843,chr15,R,60848757,60852954,52582979,4197,537917450,12862,2
105370844,LOC105370844,chr15,F,60763074,60765317,52585222,2243,537919693,12863,1
105370845,LOC105370845,chr15,F,60655229,60665460,52595453,10231,537929924,12864,3
105370846,LOC105370846,chr15,F,60632229,60648209,52611433,15980,537945904,12865,4
105370847,LOC105370847,chr15,F,61404196,61411242,52618479,7046,537952950,12866,1
105370848,LOC105370848,chr15,F,61834699,61880589,52664369,45890,537998840,12867,2
105370849,LOC105370849,chr15,R,62249532,62256938,52671775,7406,538006246,12868,4
105370850,LOC105370850,chr15,R,62271342,62302390,52702823,31048,538037294,12869,3
105370851,LOC105370851,chr15,R,62267157,62268411,52704077,1254,538038548,12870,1
105370852,LOC105370852,chr15,R,62257099,62264954,52711932,7855,538046403,12871,2
105370854,LOC105370854,chr15,R,62833636,62838155,52716451,4519,538050922,12872,3
105370855,LOC105370855,chr15,R,62657906,62688118,52746663,30212,538081134,12873,4
105370856,LOC105370856,chr15,R,62379225,62390495,52757933,11270,538092404,12874,2
105370858,LOC105370858,chr15,F,63320323,63323792,52761402,3469,538095873,12875,1
105370859,LOC105370859,chr15,F,63317987,63345458,52788873,27471,538123344,12876,2
105370860,LOC105370860,chr15,R,64063164,64072025,52797734,8861,538132205,12877,2
105370861,LOC105370861,chr15,R,64444746,64460587,52813575,15841,538148046,12878,2
105370862,LOC105370862,chr15,R,65083035,65089961,52820501,6926,538154972,12879,1
105370863,LOC105370863,chr15,F,65188994,65196677,52828184,7683,538162655,12880,1
105370864,LOC105370864,chr15,F,65287008,65293493,52834669,6485,538169140,12881,2
105370866,LOC105370866,chr15,F,65792377,65860476,52902768,68099,538237239,12882,4
105370867,LOC105370867,chr15,R,66019390,66020589,52903967,1199,538238438,12883,1
105370868,LOC105370868,chr15,R,66278501,66293552,52919018,15051,538253489,12884,2
105370869,LOC105370869,chr15,R,66841299,66842469,52920188,1170,538254659,12885,1
105370870,LOC105370870,chr15,R,67830197,67832597,52922588,2400,538257059,12886,3
105370871,LOC105370871,chr15,R,68182813,68183623,52923398,810,538257869,12887,1
105370872,LOC105370872,chr15,R,68271010,68277926,52930314,6916,538264785,12888,2
105370873,LOC105370873,chr15,R,68483201,68488241,52935354,5040,538269825,12889,3
105370874,LOC105370874,chr15,R,69071394,69073189,52937149,1795,538271620,12890,2
105370875,LOC105370875,chr15,F,69278314,69284443,52943278,6129,538277749,12891,2
105370876,LOC105370876,chr15,R,69459529,69462776,52946525,3247,538280996,12892,4
105370877,LOC105370877,chr15,R,70079655,70084024,52950894,4369,538285365,12893,1
105370878,LOC105370878,chr15,R,70296243,70297922,52952573,1679,538287044,12894,1
105370880,LOC105370880,chr15,R,70503906,70505995,52954662,2089,538289133,12895,1
105370881,LOC105370881,chr15,R,70692815,70695010,52956857,2195,538291328,12896,1
105370882,LOC105370882,chr15,R,71428692,71432186,52960351,3494,538294822,12897,1
105370883,LOC105370883,chr15,R,71290572,71294862,52964641,4290,538299112,12898,1
105370884,LOC105370884,chr15,R,71253870,71262976,52973747,9106,538308218,12899,6
105370885,LOC105370885,chr15,R,71226284,71241439,52988902,15155,538323373,12900,2
105370886,LOC105370886,chr15,R,71091406,71093078,52990574,1672,538325045,12901,2
105370887,LOC105370887,chr15,F,72274679,72284233,53000128,9554,538334599,12902,2
105370888,LOC105370888,chr15,R,72407764,72421603,53013967,13839,538348438,12903,3
105370889,LOC105370889,chr15,R,72464586,72471996,53021377,7410,538355848,12904,1
105370890,LOC105370890,chr15,F,73335241,73343376,53029512,8135,538363983,12905,4
105370891,LOC105370891,chr15,F,73636587,73655020,53047945,18433,538382416,12906,3
105370892,LOC105370892,chr15,R,73806732,73810299,53051512,3567,538385983,12907,3
105370893,LOC105370893,chr15,R,74232123,74236224,53055613,4101,538390084,12908,2
105370894,LOC105370894,chr15,F,74381529,74393827,53067911,12298,538402382,12909,2
105370896,LOC105370896,chr15,R,74797565,74798234,53068580,669,538403051,12910,1
105370897,LOC105370897,chr15,F,74828131,74829701,53070150,1570,538404621,12911,1
105370898,LOC105370898,chr15,F,74907216,74911178,53074112,3962,538408583,12912,2
105370901,LOC105370901,chr15,F,75451493,75454466,53077085,2973,538411556,12913,2
105370902,LOC105370902,chr15,F,75470762,75503039,53109362,32277,538443833,12914,4
105370903,LOC105370903,chr15,R,76107201,76127865,53130026,20664,538464497,12915,2
105370904,LOC105370904,chr15,F,76972903,76983228,53140351,10325,538474822,12916,3
105370905,LOC105370905,chr15,F,77041610,77046378,53145119,4768,538479590,12917,1
105370906,LOC105370906,chr15,F,77568857,77573031,53149293,4174,538483764,12918,2
105370907,LOC105370907,chr15,F,77787151,77789400,53151542,2249,538486013,12919,2
105370908,LOC105370908,chr15,R,77957442,77964006,53158106,6564,538492577,12920,2
105370910,LOC105370910,chr15,R,78274513,78278720,53162313,4207,538496784,12921,1
105370911,LOC105370911,chr15,R,78252625,78264144,53173832,11519,538508303,12922,5
105370912,LOC105370912,chr15,F,78375311,78409612,53208133,34301,538542604,12923,5
105370913,LOC105370913,chr15,R,78692825,78728055,53243363,35230,538577834,12924,4
105370914,LOC105370914,chr15,R,78755162,78757709,53245910,2547,538580381,12925,1
105370915,LOC105370915,chr15,F,78860862,78863611,53248659,2749,538583130,12926,2
105370916,LOC105370916,chr15,F,78920936,78921993,53249716,1057,538584187,12927,1
105370917,LOC105370917,chr15,F,78998772,79011931,53262875,13159,538597346,12928,2
105370918,LOC105370918,chr15,R,79463779,79475148,53274244,11369,538608715,12929,4
105370919,LOC105370919,chr15,F,79494427,79520597,53300414,26170,538634885,12930,4
105370920,LOC105370920,chr15,R,81403930,81409170,53305654,5240,538640125,12931,2
105370921,LOC105370921,chr15,F,81667010,81689650,53328294,22640,538662765,12932,2
105370922,LOC105370922,chr15,R,81978658,82013691,53363327,35033,538697798,12933,3
105370923,LOC105370923,chr15,R,82026118,82030058,53367267,3940,538701738,12934,2
105370924,LOC105370924,chr15,F,82096581,82099672,53370358,3091,538704829,12935,2
105370925,LOC105370925,chr15,F,82347639,82349718,53372437,2079,538706908,12936,1
105370926,LOC105370926,chr15,F,82487782,82493706,53378361,5924,538712832,12937,1
105370928,LOC105370928,chr15,F,82892801,82944060,53429620,51259,538764091,12938,4
105370929,LOC105370929,chr15,F,83207432,83227217,53449405,19785,538783876,12939,3
105370930,LOC105370930,chr15,F,83179122,83186582,53456865,7460,538791336,12940,2
105370931,LOC105370931,chr15,R,83096604,83114828,53475089,18224,538809560,12941,3
105370932,LOC105370932,chr15,F,83283479,83318631,53510241,35152,538844712,12942,3
105370933,LOC105370933,chr15,F,83345641,83350586,53515186,4945,538849657,12943,2
105370934,LOC105370934,chr15,R,83365010,83368757,53518933,3747,538853404,12944,3
105370935,LOC105370935,chr15,R,83944102,83945909,53520740,1807,538855211,12945,2
105370936,LOC105370936,chr15,F,84329663,84335458,53526535,5795,538861006,12946,1
105370937,LOC105370937,chr15,R,84180882,84189179,53534832,8297,538869303,12947,1
105370939,LOC105370939,chr15,F,31391502,31404730,53548060,13228,538882531,12948,4
105370940,LOC105370940,chr15,R,32028534,32030596,53550122,2062,538884593,12949,2
105370941,LOC105370941,chr15,F,39782414,39785617,53553325,3203,538887796,12950,0
105370943,LOC105370943,chr15,F,40904921,40908532,53556936,3611,538891407,12951,3
105370945,LOC105370945,chr15,F,78129037,78143173,53571072,14136,538905543,12952,2
105370946,LOC105370946,chr15,R,84452693,84458486,53576865,5793,538911336,12953,1
105370947,LOC105370947,chr15,R,84603900,84616345,53589310,12445,538923781,12954,2
105370948,LOC105370948,chr15,F,85219729,85225519,53595100,5790,538929571,12955,1
105370949,LOC105370949,chr15,R,85248947,85251088,53597241,2141,538931712,12956,1
105370950,LOC105370950,chr15,R,85620184,85632904,53609961,12720,538944432,12957,3
105370951,LOC105370951,chr15,R,85382848,85384484,53611597,1636,538946068,12958,2
105370952,LOC105370952,chr15,F,85837290,85841114,53615421,3824,538949892,12959,2
105370954,LOC105370954,chr15,F,86932814,86946290,53628897,13476,538963368,12960,2
105370955,LOC105370955,chr15,F,87121593,87178557,53685861,56964,539020332,12961,2
105370956,LOC105370956,chr15,R,87352178,87422830,53756513,70652,539090984,12962,7
105370957,LOC105370957,chr15,F,88277151,88279983,53759345,2832,539093816,12963,3
105370958,LOC105370958,chr15,F,88291459,88322277,53790163,30818,539124634,12964,2
105370959,LOC105370959,chr15,F,88344941,88364656,53809878,19715,539144349,12965,2
105370960,LOC105370960,chr15,R,88796464,88799055,53812469,2591,539146940,12966,2
105370962,LOC105370962,chr15,F,89334779,89336161,53813851,1382,539148322,12967,1
105370963,LOC105370963,chr15,F,89461157,89469729,53822423,8572,539156894,12968,1
105370964,LOC105370964,chr15,R,89454011,89469224,53837636,15213,539172107,12969,2
105370965,LOC105370965,chr15,F,89821448,89825989,53842177,4541,539176648,12970,2
105370966,LOC105370966,chr15,F,90102683,90137945,53877439,35262,539211910,12971,4
105370967,LOC105370967,chr15,R,90630598,90631447,53878288,849,539212759,12972,1
105370968,LOC105370968,chr15,R,90593761,90604378,53888905,10617,539223376,12973,3
105370969,LOC105370969,chr15,F,90839593,90853629,53902941,14036,539237412,12974,3
105370970,LOC105370970,chr15,F,91010553,91013670,53906058,3117,539240529,12975,1
105370971,LOC105370971,chr15,R,91270021,91272820,53908857,2799,539243328,12976,1
105370972,LOC105370972,chr15,R,91238994,91254887,53924750,15893,539259221,12977,4
105370973,LOC105370973,chr15,R,91643212,91649301,53930839,6089,539265310,12978,2
105370975,LOC105370975,chr15,F,92645517,92646744,53932066,1227,539266537,12979,1
105370976,LOC105370976,chr15,F,92623129,92628100,53937037,4971,539271508,12980,2
105370977,LOC105370977,chr15,F,92612225,92618839,53943651,6614,539278122,12981,2
105370978,LOC105370978,chr15,R,92591620,92611049,53963080,19429,539297551,12982,4
105370979,LOC105370979,chr15,F,93041406,93043253,53964927,1847,539299398,12983,2
105370980,LOC105370980,chr15,F,93206193,93206739,53965473,546,539299944,12984,0
105370981,LOC105370981,chr15,F,93212133,93219778,53973118,7645,539307589,12985,2
105370982,LOC105370982,chr15,F,93553619,93593361,54012860,39742,539347331,12986,5
105370983,LOC105370983,chr15,F,93228783,93541186,54325263,312403,539659734,12987,8
105370984,LOC105370984,chr15,R,94196778,94206890,54335375,10112,539669846,12988,1
105370985,LOC105370985,chr15,R,94583557,94589215,54341033,5658,539675504,12989,2
105370986,LOC105370986,chr15,F,94677566,94679693,54343160,2127,539677631,12990,2
105370987,LOC105370987,chr15,R,94724932,94726513,54344741,1581,539679212,12991,1
105370988,LOC105370988,chr15,R,94764749,94791174,54371166,26425,539705637,12992,2
105370989,LOC105370989,chr15,R,95001368,95018127,54387925,16759,539722396,12993,1
105370990,LOC105370990,chr15,R,95132611,95150549,54405863,17938,539740334,12994,4
105370991,LOC105370991,chr15,F,95018800,95172194,54559257,153394,539893728,12995,13
105370993,LOC105370993,chr15,R,95463591,95469889,54565555,6298,539900026,12996,2
105370994,LOC105370994,chr15,R,95209092,95214013,54570476,4921,539904947,12997,2
105370995,LOC105370995,chr15,F,95564366,95592086,54598196,27720,539932667,12998,1
105370996,LOC105370996,chr15,F,95610008,95825249,54813437,215241,540147908,12999,2
105370997,LOC105370997,chr15,F,96170824,96173957,54816570,3133,540151041,13000,1
105370998,LOC105370998,chr15,R,96044556,96053241,54825255,8685,540159726,13001,3
105370999,LOC105370999,chr15,R,96422920,96438474,54840809,15554,540175280,13002,2
105371000,LOC105371000,chr15,F,96444336,96447875,54844348,3539,540178819,13003,3
105371001,LOC105371001,chr15,R,96537557,96551697,54858488,14140,540192959,13004,4
105371002,LOC105371002,chr15,R,96699277,96704866,54864077,5589,540198548,13005,2
105371003,LOC105371003,chr15,F,97065638,97070507,54868946,4869,540203417,13006,2
105371004,LOC105371004,chr15,R,97071051,97102856,54900751,31805,540235222,13007,9
105371005,LOC105371005,chr15,R,97106063,97119146,54913834,13083,540248305,13008,3
105371006,LOC105371006,chr15,R,97272208,97319366,54960992,47158,540295463,13009,4
105371007,LOC105371007,chr15,F,97539145,97576622,54998469,37477,540332940,13010,10
105371008,LOC105371008,chr15,F,98000656,98022201,55020014,21545,540354485,13011,3
105371009,LOC105371009,chr15,R,97994814,98018694,55043894,23880,540378365,13012,1
105371010,LOC105371010,chr15,R,98111502,98131668,55064060,20166,540398531,13013,2
105371012,LOC105371012,chr15,R,98520257,98553223,55097026,32966,540431497,13014,2
105371013,LOC105371013,chr15,F,99005697,99010169,55101498,4472,540435969,13015,2
105371014,LOC105371014,chr15,R,98831621,98840393,55110270,8772,540444741,13016,2
105371015,LOC105371015,chr15,R,98772628,98780294,55117936,7666,540452407,13017,2
105371016,LOC105371016,chr15,R,99090903,99107995,55135028,17092,540469499,13018,3
105371017,LOC105371017,chr15,F,99397395,99417208,55154841,19813,540489312,13019,5
105371018,LOC105371018,chr15,R,99394356,99401465,55161950,7109,540496421,13020,2
105371019,LOC105371019,chr15,R,99498491,99509820,55173279,11329,540507750,13021,3
105371020,LOC105371020,chr15,F,99737424,99774638,55210493,37214,540544964,13022,3
105371021,LOC105371021,chr15,F,100349605,100352140,55213028,2535,540547499,13023,2
105371022,LOC105371022,chr15,F,99976480,99981726,55218274,5246,540552745,13024,1
105371023,LOC105371023,chr15,F,99952764,99953693,55219203,929,540553674,13025,2
105371024,LOC105371024,chr15,F,100716051,100832535,55335687,116484,540670158,13026,6
105371025,LOC105371025,chr15,F,101162703,101164792,55337776,2089,540672247,13027,1
105371026,LOC105371026,chr15,R,101050700,101151837,55438913,101137,540773384,13028,9
105371028,LOC105371028,chr15,R,101494804,101501769,55445878,6965,540780349,13029,3
105371029,LOC105371029,chr15,R,101621472,101626482,55450888,5010,540785359,13030,1
105371030,LOC105371030,chr15,F,101772693,101799800,55477995,27107,540812466,13031,2
105371031,LOC105371031,chr15,F,89399900,89437853,55515948,37953,540850419,13032,2
105376698,LOC105376698,chr15,R,23338744,23341887,55519091,3143,540853562,13033,2
105376699,LOC105376699,chr15,R,24258647,24260606,55521050,1959,540855521,13034,2
105376700,LOC105376700,chr15,F,24158945,24164138,55526243,5193,540860714,13035,3
105376701,LOC105376701,chr15,R,25841491,25862117,55546869,20626,540881340,13036,2
105376702,LOC105376702,chr15,F,27271526,27285057,55560400,13531,540894871,13037,1
105376703,LOC105376703,chr15,R,30486292,30489311,55563419,3019,540897890,13038,1
105376704,LOC105376704,chr15,R,30427813,30471009,55606615,43196,540941086,13039,2
105376705,LOC105376705,chr15,F,30418623,30423814,55611806,5191,540946277,13040,1
105376707,LOC105376707,chr15,F,31344871,31348801,55615736,3930,540950207,13041,1
105376708,LOC105376708,chr15,F,32358728,32368362,55625370,9634,540959841,13042,2
105376709,LOC105376709,chr15,R,32356370,32358631,55627631,2261,540962102,13043,2
105376710,LOC105376710,chr15,R,32462965,32473443,55638109,10478,540972580,13044,3
105376711,LOC105376711,chr15,F,32459270,32465194,55644033,5924,540978504,13045,1
105376713,LOC105376713,chr15,F,40998994,41011952,55656991,12958,540991462,13046,2
105376714,LOC105376714,chr15,F,45448409,45469925,55678507,21516,541012978,13047,1
105376715,LOC105376715,chr15,R,55221282,55223274,55680499,1992,541014970,13048,1
105376716,LOC105376716,chr15,R,55311734,55314050,55682815,2316,541017286,13049,1
105376718,LOC105376718,chr15,F,66858572,66864416,55688659,5844,541023130,13050,1
105376720,LOC105376720,chr15,F,72609001,72624335,55703993,15334,541038464,13051,2
105376721,LOC105376721,chr15,F,84436867,84438089,55705215,1222,541039686,13052,1
105376722,LOC105376722,chr15,F,84389016,84392007,55708206,2991,541042677,13053,2
105376723,LOC105376723,chr15,R,84235490,84236712,55709428,1222,541043899,13054,1
105376724,LOC105376724,chr15,F,84215101,84220891,55715218,5790,541049689,13055,1
105376726,LOC105376726,chr15,R,85273165,85274158,55716211,993,541050682,13056,1
105376727,LOC105376727,chr15,R,85336831,85359284,55738664,22453,541073135,13057,2
105376728,LOC105376728,chr15,F,96460728,96463149,55741085,2421,541075556,13058,2
105376730,LOC105376730,chr15,F,101871866,101873791,55743010,1925,541077481,13059,1
105376731,LOC105376731,chr15,R,75225895,75232485,55749600,6590,541084071,13060,5
105376732,LOC105376732,chr15,R,89087560,89094089,55756129,6529,541090600,13061,6
105376734,LOC105376734,chr15,F,101755719,101758532,55758942,2813,541093413,13062,1
105379202,LOC105379202,chr15,F,20012240,20014711,55761413,2471,541095884,13063,3
105379203,LOC105379203,chr15,R,20120873,20128834,55769374,7961,541103845,13064,4
105379204,LOC105379204,chr15,R,20144880,20147794,55772288,2914,541106759,13065,2
105379205,LOC105379205,chr15,F,21179911,21191753,55784130,11842,541118601,13066,2
105379206,LOC105379206,chr15,R,21127479,21134735,55791386,7256,541125857,13067,3
105379207,LOC105379207,chr15,R,21832294,21842313,55801405,10019,541135876,13068,2
105379208,LOC105379208,chr15,R,21752747,21759926,55808584,7179,541143055,13069,3
105379209,LOC105379209,chr15,R,21574614,21579838,55813808,5224,541148279,13070,3
105379211,LOC105379211,chr15,F,20339368,20351652,55826092,12284,541160563,13071,5
105379261,LOC105379261,chr15,R,22768434,22769121,55826779,687,541161250,13072,3
16,AARS,chr16,R,70252294,70289550,37256,37256,541198506,13073,20
18,ABAT,chr16,F,8674586,8784575,147245,109989,541308495,13074,18
21,ABCA3,chr16,R,2275877,2340746,212114,64869,541373364,13075,32
113,ADCY7,chr16,F,50244748,50318135,285501,73387,541446751,13076,30
115,ADCY9,chr16,R,3953386,4116185,448300,162799,541609550,13077,11
164,AP1G1,chr16,R,71728999,71809073,528374,80074,541689624,13078,23
172,AFG3L1P,chr16,F,89972579,90000787,556582,28208,541717832,13079,13
181,AGRP,chr16,R,67482570,67484083,558095,1513,541719345,13080,4
226,ALDOA,chr16,F,30053089,30070420,575426,17331,541736676,13081,16
267,AMFR,chr16,R,56361451,56425538,639513,64087,541800763,13082,15
343,AQP8,chr16,F,25216915,25228932,651530,12017,541812780,13083,5
353,APRT,chr16,R,88809468,88811934,653996,2466,541815246,13084,4
368,ABCC6,chr16,R,16149564,16223673,728105,74109,541889355,13085,32
398,ARHGDIG,chr16,F,280605,283003,730503,2398,541891753,13086,5
463,ZFHX3,chr16,R,72782884,73058635,1006254,275751,542167504,13087,10
487,ATP2A1,chr16,F,28878487,28904509,1032276,26022,542193526,13088,23
527,ATP6V0C,chr16,F,2513725,2520223,1038774,6498,542200024,13089,3
583,BBS2,chr16,R,56470388,56520096,1088482,49708,542249732,13090,18
608,TNFRSF17,chr16,F,11965106,11968068,1091444,2962,542252694,13091,2
750,GAS8-AS1,chr16,R,90028907,90029901,1092438,994,542253688,13092,0
763,CA5A,chr16,R,87888018,87936569,1140989,48551,542302239,13093,9
766,CA7,chr16,F,66844378,66854149,1150760,9771,542312010,13094,7
794,CALB2,chr16,F,71358712,71390438,1182486,31726,542343736,13095,10
863,CBFA2T3,chr16,R,88874854,88977199,1284831,102345,542446081,13096,15
865,CBFB,chr16,F,67029146,67101058,1356743,71912,542517993,13097,5
869,CBLN1,chr16,R,49277916,49281831,1360658,3915,542521908,13098,2
899,CCNF,chr16,F,2429393,2458858,1390123,29465,542551373,13099,16
930,CD19,chr16,F,28931915,28939347,1397555,7432,542558805,13100,14
999,CDH1,chr16,F,68737291,68835542,1495806,98251,542657056,13101,17
1001,CDH3,chr16,F,68644247,68727577,1579136,83330,542740386,13102,17
1003,CDH5,chr16,F,66366621,66404786,1617301,38165,542778551,13103,11
1006,CDH8,chr16,R,61647243,62037035,2007093,389792,543168343,13104,13
1009,CDH11,chr16,R,64945225,65126112,2187980,180887,543349230,13105,17
1012,CDH13,chr16,F,82626793,83796610,3357797,1169817,544519047,13106,19
1013,CDH15,chr16,F,89171754,89195492,3381535,23738,544542785,13107,13
1014,CDH16,chr16,R,66908121,66918984,3392398,10863,544553648,13108,17
1039,CDR2,chr16,R,22345935,22374617,3421080,28682,544582330,13109,4
1066,CES1,chr16,R,55802850,55833186,3451416,30336,544612666,13110,14
1071,CETP,chr16,F,56961922,56983844,3473338,21922,544634588,13111,16
1186,CLCN7,chr16,R,1444932,1475084,3503490,30152,544664740,13112,25
1201,CLN3,chr16,R,28466652,28492302,3529140,25650,544690390,13113,15
1258,CNGB1,chr16,R,57882339,57979295,3626096,96956,544787346,13114,36
1327,COX4I1,chr16,F,85799566,85807002,3633532,7436,544794782,13115,5
1339,COX6A2,chr16,R,31427730,31428428,3634230,698,544795480,13116,2
1387,CREBBP,chr16,R,3725053,3880120,3789297,155067,544950547,13117,33
1428,CRYM,chr16,R,21258517,21303136,3833916,44619,544995166,13118,9
1459,CSNK2A2,chr16,R,58157906,58197878,3873888,39972,545035138,13119,11
1489,CTF1,chr16,F,30895827,30903560,3881621,7733,545042871,13120,3
1504,CTRB1,chr16,F,75218985,75224924,3887560,5939,545048810,13121,6
1506,CTRL,chr16,R,67929569,67931875,3889866,2306,545051116,13122,6
1535,CYBA,chr16,R,88643288,88651085,3897663,7797,545058913,13123,6
1540,CYLD,chr16,F,50742049,50801936,3957550,59887,545118800,13124,19
1632,ECI1,chr16,R,2239871,2251601,3969280,11730,545130530,13125,6
1723,DHODH,chr16,F,72008743,72025417,3985954,16674,545147204,13126,10
1728,NQO1,chr16,R,69709400,69726668,4003222,17268,545164472,13127,5
1731,SEPT1,chr16,R,30378132,30382850,4007940,4718,545169190,13128,11
1773,DNASE1,chr16,F,3611744,3662875,4059071,51131,545220321,13129,12
1775,DNASE1L2,chr16,F,2236251,2238711,4061531,2460,545222781,13130,6
1783,DYNC1LI2,chr16,R,66720892,66751622,4092261,30730,545253511,13131,13
1800,DPEP1,chr16,F,89613307,89640862,4119816,27555,545281066,13132,15
1874,E2F4,chr16,F,67192164,67198918,4126570,6754,545287820,13133,9
1877,E4F1,chr16,F,2223487,2235742,4138825,12255,545300075,13134,13
2013,EMP2,chr16,R,10528421,10580682,4191086,52261,545352336,13135,5
2072,ERCC4,chr16,F,13920144,13952348,4223290,32204,545384540,13136,13
2175,FANCA,chr16,R,89737550,89816658,4302398,79108,545463648,13137,43
2294,FOXF1,chr16,F,86510526,86514464,4306336,3938,545467586,13138,1
2300,FOXL1,chr16,F,86578508,86581698,4309526,3190,545470776,13139,0
2303,FOXC2,chr16,F,86567250,86568933,4311209,1683,545472459,13140,0
2521,FUS,chr16,F,31179703,31194871,4326377,15168,545487627,13141,14
2588,GALNS,chr16,R,88813733,88856966,4369610,43233,545530860,13142,15
2622,GAS8,chr16,F,90019628,90044971,4394953,25343,545556203,13143,14
2653,GCSH,chr16,R,81081946,81096375,4409382,14429,545570632,13144,4
2671,GFER,chr16,F,1984148,1987749,4412983,3601,545574233,13145,2
2734,GLG1,chr16,R,74447426,74607144,4572701,159718,545733951,13146,26
2775,GNAO1,chr16,F,56191338,56357444,4738807,166106,545900057,13147,11
2806,GOT2,chr16,R,58707130,58734357,4766034,27227,545927284,13148,9
2813,GP2,chr16,R,20309573,20327820,4784281,18247,545945531,13149,11
2903,GRIN2A,chr16,R,9753403,10183364,5214242,429961,546375492,13150,19
2935,GSPT1,chr16,R,11868127,11916662,5262777,48535,546424027,13151,15
2975,GTF3C1,chr16,R,27460612,27549930,5352095,89318,546513345,13152,36
3029,HAGH,chr16,R,1809102,1827194,5370187,18092,546531437,13153,9
3038,HAS3,chr16,F,69105563,69118719,5383343,13156,546544593,13154,7
3039,HBA1,chr16,F,176650,177522,5384215,872,546545465,13155,2
3040,HBA2,chr16,F,172846,173710,5385079,864,546546329,13156,2
3042,HBM,chr16,F,165973,166768,5385874,795,546547124,13157,2
3049,HBQ1,chr16,F,180333,181179,5386720,846,546547970,13158,2
3050,HBZ,chr16,F,142052,154505,5399173,12453,546560423,13159,3
3051,HBZP1,chr16,F,161198,165526,5403501,4328,546564751,13160,4
3163,HMOX2,chr16,F,4474702,4510347,5439146,35645,546600396,13161,11
3240,HP,chr16,F,72054608,72061056,5445594,6448,546606844,13162,6
3250,HPR,chr16,F,72063225,72077246,5459615,14021,546620865,13163,6
3281,HSBP1,chr16,F,83807902,83813002,5464715,5100,546625965,13164,3
3291,HSD11B2,chr16,F,67431132,67437553,5471136,6421,546632386,13165,4
3294,HSD17B2,chr16,F,82035236,82098534,5534434,63298,546695684,13166,5
3299,HSF4,chr16,F,67163384,67169945,5540995,6561,546702245,13167,14
3394,IRF8,chr16,F,85899167,85922606,5564434,23439,546725684,13168,8
3483,IGFALS,chr16,R,1790412,1794908,5568930,4496,546730180,13169,3
3566,IL4R,chr16,F,27313667,27364778,5620041,51111,546781291,13170,15
3681,ITGAD,chr16,F,31393240,31426513,5653314,33273,546814564,13171,31
3683,ITGAL,chr16,F,30472661,30523185,5703838,50524,546865088,13172,30
3684,ITGAM,chr16,F,31259966,31332892,5776764,72926,546938014,13173,29
3687,ITGAX,chr16,F,31355133,31382997,5804628,27864,546965878,13174,29
3735,KARS,chr16,R,75627723,75647687,5824592,19964,546985842,13175,14
3801,KIFC3,chr16,R,57758216,57863053,5929429,104837,547090679,13176,30
3835,KIF22,chr16,F,29790061,29805385,5944753,15324,547106003,13177,15
3931,LCAT,chr16,R,67939883,67944112,5948982,4229,547110232,13178,5
4094,MAF,chr16,R,79212771,79600786,6336997,388015,547498247,13179,2
4150,MAZ,chr16,F,29806082,29811183,6342098,5101,547503348,13180,7
4157,MC1R,chr16,F,89917878,89920977,6345197,3099,547506447,13181,0
4166,CHST6,chr16,R,75473123,75495434,6367508,22311,547528758,13182,4
4210,MEFV,chr16,R,3242027,3256627,6382108,14600,547543358,13183,9
4261,CIITA,chr16,F,10866211,10941449,6457346,75238,547618596,13184,27
4313,MMP2,chr16,F,55478829,55506691,6485208,27862,547646458,13185,16
4324,MMP15,chr16,F,58025377,58046901,6506732,21524,547667982,13186,9
4350,MPG,chr16,F,77018,85851,6515565,8833,547676815,13187,5
4363,ABCC1,chr16,F,15949576,16143074,6709063,193498,547870313,13188,32
4489,MT1A,chr16,F,56638665,56640087,6710485,1422,547871735,13189,2
4490,MT1B,chr16,F,56651898,56653204,6711791,1306,547873041,13190,2
4493,MT1E,chr16,F,56625672,56627112,6713231,1440,547874481,13191,2
4494,MT1F,chr16,F,56657942,56659303,6714592,1361,547875842,13192,2
4495,MT1G,chr16,R,56666734,56668065,6715923,1331,547877173,13193,2
4496,MT1H,chr16,F,56669813,56671129,6717239,1316,547878489,13194,2
4498,MT1JP,chr16,F,56635738,56637086,6718587,1348,547879837,13195,2
4499,MT1M,chr16,F,56632621,56633986,6719952,1365,547881202,13196,2
4500,MT1L,chr16,F,56617460,56618818,6721310,1358,547882560,13197,2
4501,MT1X,chr16,F,56682469,56684196,6723037,1727,547884287,13198,2
4502,MT2A,chr16,F,56608565,56609497,6723969,932,547885219,13199,2
4504,MT3,chr16,F,56589354,56591088,6725703,1734,547886953,13200,2
4597,MVD,chr16,R,88651934,88663157,6736926,11223,547898176,13201,13
4629,MYH11,chr16,R,15703134,15857033,6890825,153899,548052075,13202,42
4682,NUBP1,chr16,F,10743320,10769351,6916856,26031,548078106,13203,10
4706,NDUFAB1,chr16,R,23581013,23596341,6932184,15328,548093434,13204,5
4716,NDUFB10,chr16,F,1959515,1961975,6934644,2460,548095894,13205,3
4775,NFATC3,chr16,F,68085365,68229259,7078538,143894,548239788,13206,11
4832,NME3,chr16,R,1770319,1771758,7079977,1439,548241227,13207,4
4833,NME4,chr16,F,396754,400754,7083977,4000,548245227,13208,7
4913,NTHL1,chr16,R,2039814,2047866,7092029,8052,548253279,13209,5
4917,NTN3,chr16,F,2471498,2474145,7094676,2647,548255926,13210,5
4992,OR1F1,chr16,F,3191094,3205344,7108926,14250,548270176,13211,3
4993,OR2C1,chr16,F,3355888,3356924,7109962,1036,548271212,13212,0
5073,PARN,chr16,R,14435699,14630275,7304538,194576,548465788,13213,26
5119,CHMP1A,chr16,R,89644430,89657785,7317893,13355,548479143,13214,8
5170,PDPK1,chr16,F,2537963,2603191,7383121,65228,548544371,13215,17
5257,PHKB,chr16,F,47461267,47701523,7623377,240256,548784627,13216,33
5261,PHKG2,chr16,F,30748298,30761176,7636255,12878,548797505,13217,9
5310,PKD1,chr16,R,2088707,2135898,7683446,47191,548844696,13218,52
5336,PLCG2,chr16,F,81779257,81962693,7866882,183436,549028132,13219,34
5347,PLK1,chr16,F,23678821,23690367,7878428,11546,549039678,13220,9
5373,PMM2,chr16,F,8797812,8855197,7935813,57385,549097063,13221,9
5432,POLR2C,chr16,F,57462286,57472009,7945536,9723,549106786,13222,8
5493,PPL,chr16,R,4882506,4937135,8000165,54629,549161415,13223,22
5531,PPP4C,chr16,F,30075975,30085377,8009567,9402,549170817,13224,8
5579,PRKCB,chr16,F,23835978,24220611,8394200,384633,549555450,13225,16
5595,MAPK3,chr16,R,30114104,30123309,8403405,9205,549564655,13226,9
5619,PRM1,chr16,R,11280835,11281335,8403905,500,549565155,13227,1
5620,PRM2,chr16,R,11275635,11276480,8404750,845,549566000,13228,1
5652,PRSS8,chr16,R,31131432,31135830,8409148,4398,549570398,13229,5
5681,PSKH1,chr16,F,67893271,67929678,8445555,36407,549606805,13230,2
5699,PSMB10,chr16,R,67934503,67936877,8447929,2374,549609179,13231,7
5713,PSMD7,chr16,F,74296774,74306288,8457443,9514,549618693,13232,6
5930,RBBP6,chr16,F,24539586,24572863,8490720,33277,549651970,13233,18
5934,RBL2,chr16,F,53434438,53491648,8547930,57210,549709180,13234,23
6123,RPL3L,chr16,R,1944578,1954678,8558030,10100,549719280,13235,9
6137,RPL13,chr16,F,89560656,89566829,8564203,6173,549725453,13236,4
6187,RPS2,chr16,R,1962060,1964826,8566969,2766,549728219,13237,6
6210,RPS15A,chr16,R,18782954,18790334,8574349,7380,549735599,13238,4
6236,RRAD,chr16,R,66921678,66925536,8578207,3858,549739457,13239,4
6296,ACSM3,chr16,F,20763989,20797157,8611375,33168,549772625,13240,13
6299,SALL1,chr16,R,51135974,51152316,8627717,16342,549788967,13241,6
6338,SCNN1B,chr16,F,23302269,23381299,8706747,79030,549867997,13242,14
6340,SCNN1G,chr16,F,23182718,23216879,8740908,34161,549902158,13243,12
6345,SRL,chr16,R,4189373,4242080,8793615,52707,549954865,13244,5
6361,CCL17,chr16,F,57396189,57416063,8813489,19874,549974739,13245,5
6367,CCL22,chr16,F,57358782,57366190,8820897,7408,549982147,13246,2
6376,CX3CL1,chr16,F,57372460,57385048,8833485,12588,549994735,13247,2
6477,SIAH1,chr16,R,48360530,48448440,8921395,87910,550082645,13248,7
6483,ST3GAL2,chr16,R,70379434,70439088,8981049,59654,550142299,13249,6
6524,SLC5A2,chr16,F,31482534,31490770,8989285,8236,550150535,13250,12
6530,SLC6A2,chr16,F,55655603,55706192,9039874,50589,550201124,13251,16
6553,SLC9A5,chr16,F,67247550,67272191,9064515,24641,550225765,13252,16
6559,SLC12A3,chr16,F,56865206,56915850,9115159,50644,550276409,13253,25
6560,SLC12A4,chr16,R,67943473,67968694,9140380,25221,550301630,13254,25
6645,SNTB2,chr16,F,69187146,69309052,9262286,121906,550423536,13255,6
6650,CAPN15,chr16,F,527755,554636,9289167,26881,550450417,13256,15
6687,SPG7,chr16,F,89508380,89557768,9338555,49388,550499805,13257,20
6693,SPN,chr16,F,29662949,29670507,9346113,7558,550507363,13258,2
6755,SSTR5,chr16,F,1072755,1081454,9354812,8699,550516062,13259,1
6799,SULT1A2,chr16,R,28591942,28597083,9359953,5141,550521203,13260,6
6810,STX4,chr16,F,31033094,31040168,9367027,7074,550528277,13261,11
6817,SULT1A1,chr16,R,28605586,28623586,9385027,18000,550546277,13262,9
6818,SULT1A3,chr16,F,30199227,30204329,9390129,5102,550551379,13263,10
6898,TAT,chr16,R,71566850,71577095,9400374,10245,550561624,13264,11
6911,TBX6,chr16,R,30085792,30091937,9406519,6145,550567769,13265,7
6923,TCEB2,chr16,R,2771413,2777296,9412402,5883,550573652,13266,3
7014,TERF2,chr16,R,69355560,69386000,9442842,30440,550604092,13267,10
7023,TFAP4,chr16,R,4257185,4273000,9458657,15815,550619907,13268,9
7041,TGFB1I1,chr16,F,31472154,31477960,9464463,5806,550625713,13269,12
7084,TK2,chr16,R,66508002,66550412,9506873,42410,550668123,13270,9
7142,TNP2,chr16,R,11267856,11269303,9508320,1447,550669570,13271,1
7177,TPSAB1,chr16,F,1240676,1242554,9510198,1878,550671448,13272,5
7198,TRG-GCC3-1,chr16,R,70778210,70778281,9510269,71,550671519,13273,0
7249,TSC2,chr16,F,2047935,2088712,9551046,40777,550712296,13274,41
7284,TUFM,chr16,R,28842410,28846511,9555147,4101,550716397,13275,9
7329,UBE2I,chr16,F,1309152,1327018,9573013,17866,550734263,13276,9
7369,UMOD,chr16,R,20333050,20356301,9596264,23251,550757514,13277,14
7385,UQCRC2,chr16,F,21953287,21983347,9626324,30060,550787574,13278,13
7567,ZNF19,chr16,R,71474072,71489351,9641603,15279,550802853,13279,5
7571,ZNF23,chr16,R,71447596,71462252,9656259,14656,550817509,13280,6
7627,ZNF75A,chr16,F,3305405,3318851,9669705,13446,550830955,13281,7
7727,ZNF174,chr16,F,3401189,3430851,9699367,29662,550860617,13282,5
7752,ZNF200,chr16,R,3222324,3236221,9713264,13897,550874514,13283,6
7755,ZNF205,chr16,F,3112561,3120527,9721230,7966,550882480,13284,6
7760,ZNF213,chr16,F,3135055,3142804,9728979,7749,550890229,13285,5
7783,ZP2,chr16,R,21197451,21214510,9746038,17059,550907288,13286,19
7874,USP7,chr16,R,8892093,8963484,9817429,71391,550978679,13287,32
8131,NPRL3,chr16,R,84270,138698,9871857,54428,551033107,13288,15
8139,GAN,chr16,F,81314965,81380198,9937090,65233,551098340,13289,10
8140,SLC7A5,chr16,R,87830022,87869497,9976565,39475,551137815,13290,11
8303,SNN,chr16,F,11668432,11679159,9987292,10727,551148542,13291,1
8312,AXIN1,chr16,R,287439,361497,10061350,74058,551222600,13292,14
8399,PLA2G10,chr16,R,14672547,14694669,10083472,22122,551244722,13293,7
8448,DOC2A,chr16,R,30005513,30023280,10101239,17767,551262489,13294,17
8479,HIRIP3,chr16,R,29992320,29996096,10105015,3776,551266265,13295,6
8558,CDK10,chr16,F,89672246,89696364,10129133,24118,551290383,13296,17
8651,SOCS1,chr16,R,11254416,11256182,10130899,1766,551292149,13297,1
8663,EIF3C,chr16,F,28688557,28735730,10178072,47173,551339322,13298,20
8717,TRADD,chr16,R,67154184,67159909,10183797,5725,551345047,13299,4
8720,MBTPS1,chr16,R,84053760,84116943,10246980,63183,551408230,13300,22
8786,RGS11,chr16,R,268300,275943,10254623,7643,551415873,13301,19
8824,CES2,chr16,F,66934443,66945096,10265276,10653,551426526,13302,11
8883,NAE1,chr16,R,66802877,66830977,10293376,28100,551454626,13303,20
8912,CACNA1H,chr16,F,1153240,1221772,10361908,68532,551523158,13304,36
8938,BAIAP3,chr16,F,1333604,1349441,10377745,15837,551538995,13305,35
8996,NOL3,chr16,F,67170496,67175737,10382986,5241,551544236,13306,5
9013,TAF1C,chr16,R,84177846,84187070,10392210,9224,551553460,13307,14
9028,RHBDL1,chr16,F,675665,678271,10394816,2606,551556066,13308,7
9057,SLC7A6,chr16,F,68263829,68301823,10432810,37994,551594060,13309,14
9074,CLDN6,chr16,R,3014711,3018187,10436286,3476,551597536,13310,1
9080,CLDN9,chr16,F,3012455,3014505,10438336,2050,551599586,13311,0
9088,PKMYT1,chr16,R,2972790,2980539,10446085,7749,551607335,13312,9
9091,PIGQ,chr16,F,569967,584136,10460254,14169,551621504,13313,10
9093,DNAJA3,chr16,F,4425804,4456775,10491225,30971,551652475,13314,11
9100,USP10,chr16,F,84699948,84779922,10571199,79974,551732449,13315,17
9114,ATP6V0D1,chr16,R,67438013,67481186,10614372,43173,551775622,13316,9
9143,SYNGR3,chr16,F,1989944,1994275,10618703,4331,551779953,13317,3
9235,IL32,chr16,F,3065311,3069667,10623059,4356,551784309,13318,6
9274,BCL7C,chr16,R,30834040,30894376,10683395,60336,551844645,13319,7
9284,NPIPA1,chr16,F,14935309,14952074,10700160,16765,551861410,13320,11
9289,ADGRG1,chr16,F,57619534,57665039,10745665,45505,551906915,13321,22
9344,TAOK2,chr16,F,29973640,29992261,10764286,18621,551925536,13322,18
9351,SLC9A3R2,chr16,F,2026867,2039026,10776445,12159,551937695,13323,8
9516,LITAF,chr16,R,11547721,11636377,10865101,88656,552026351,13324,13
9564,BCAR1,chr16,R,75229029,75268053,10904125,39024,552065375,13325,16
9605,VPS9D1,chr16,R,89707132,89721272,10918265,14140,552079515,13326,17
9665,KIAA0430,chr16,R,15594368,15643166,10967063,48798,552128313,13327,28
9683,N4BP1,chr16,R,48538725,48610214,11038552,71489,552199802,13328,6
9688,NUP93,chr16,F,56730104,56844950,11153398,114846,552314648,13329,24
9709,HERPUD1,chr16,F,56931764,56943881,11165515,12117,552326765,13330,7
9717,SEC14L5,chr16,F,4958316,5019155,11226354,60839,552387604,13331,15
9726,ZNF646,chr16,F,31073755,31083512,11236111,9757,552397361,13332,2
9727,RAB11FIP3,chr16,F,425591,522485,11333005,96894,552494255,13333,17
9738,CCP110,chr16,F,19523856,19553408,11362557,29552,552523807,13334,16
9739,SETD1A,chr16,F,30948504,30984664,11398717,36160,552559967,13335,23
9742,IFT140,chr16,R,1510426,1612108,11500399,101682,552661649,13336,40
9764,KIAA0513,chr16,F,85027750,85094230,11566879,66480,552728129,13337,14
9780,PIEZO1,chr16,R,88715337,88784964,11636506,69627,552797756,13338,50
9785,DHX38,chr16,F,72093664,72112912,11655754,19248,552817004,13339,26
9798,IST1,chr16,F,71894407,71930639,11691986,36232,552853236,13340,11
9810,RNF40,chr16,F,30761611,30802340,11732715,40729,552893965,13341,23
9894,TELO2,chr16,F,1493343,1510459,11749831,17116,552911081,13342,22
9914,ATP2C2,chr16,F,84368522,84464187,11845496,95665,553006746,13343,30
9951,HS3ST4,chr16,F,25692025,26137688,12291159,445663,553452409,13344,1
9956,HS3ST2,chr16,F,22814202,22916338,12393295,102136,553554545,13345,3
9961,MVP,chr16,F,29820393,29848039,12420941,27646,553582191,13346,14
10101,NUBP2,chr16,F,1782922,1789191,12427210,6269,553588460,13347,9
10127,ZNF263,chr16,F,3283379,3301401,12445232,18022,553606482,13348,7
10131,TRAP1,chr16,R,3658036,3717597,12504793,59561,553666043,13349,18
10143,CLEC3A,chr16,F,78022545,78032106,12514354,9561,553675604,13350,3
10164,CHST4,chr16,F,71526119,71538590,12526825,12471,553688075,13351,1
10200,MPHOSPH6,chr16,R,82148160,82170224,12548889,22064,553710139,13352,5
10204,NUTF2,chr16,F,67846915,67872567,12574541,25652,553735791,13353,5
10229,COQ7,chr16,F,19067594,19080095,12587042,12501,553748292,13354,6
10232,MSLN,chr16,F,760731,768865,12595176,8134,553756426,13355,17
10261,IGSF6,chr16,R,21641283,21652666,12606559,11383,553767809,13356,5
10265,IRX5,chr16,F,54931198,54934485,12609846,3287,553771096,13357,3
10273,STUB1,chr16,F,680110,682768,12612504,2658,553773754,13358,6
10294,DNAJA2,chr16,R,46955361,46973714,12630857,18353,553792107,13359,8
10295,BCKDK,chr16,F,31108293,31112791,12635355,4498,553796605,13360,10
10300,KATNB1,chr16,F,57735719,57757250,12656886,21531,553818136,13361,20
10308,ZNF267,chr16,F,31873757,31917308,12700437,43551,553861687,13362,5
10328,EMC8,chr16,R,85778623,85799555,12721369,20932,553882619,13363,6
10368,CACNG3,chr16,F,24255552,24362416,12828233,106864,553989483,13364,3
10381,TUBB3,chr16,F,89922008,89936097,12842322,14089,554003572,13365,4
10421,CD2BP2,chr16,R,30350765,30355361,12846918,4596,554008168,13366,6
10423,CDIPT,chr16,R,29858355,29863288,12851851,4933,554013101,13367,5
10428,CFDP1,chr16,R,75293709,75433512,12991654,139803,554152904,13368,9
10573,MRPL28,chr16,R,367383,370569,12994840,3186,554156090,13369,5
10595,ERN2,chr16,R,23690303,23713500,13018037,23197,554179287,13370,23
10607,TBL3,chr16,F,1972062,1978750,13024725,6688,554185975,13371,21
10664,CTCF,chr16,F,67562406,67639185,13101504,76779,554262754,13372,11
10725,NFAT5,chr16,F,69565965,69704666,13240205,138701,554401455,13373,18
10847,SRCAP,chr16,F,30699140,30740129,13281194,40989,554442444,13374,33
10921,RNPS1,chr16,R,2253115,2268412,13296491,15297,554457741,13375,9
10942,PRSS21,chr16,F,2817162,2821722,13301051,4560,554462301,13376,5
11051,NUDT21,chr16,R,56429135,56451349,13323265,22214,554484515,13377,6
11060,WWP2,chr16,F,69762283,69941741,13502723,179458,554663973,13378,27
11105,PRDM7,chr16,R,90056565,90077339,13523497,20774,554684747,13379,10
11151,CORO1A,chr16,F,30183409,30189076,13529164,5667,554690414,13380,11
11269,DDX19B,chr16,F,70289766,70333832,13573230,44066,554734480,13381,13
11273,ATXN2L,chr16,F,28823047,28837237,13587420,14190,554748670,13382,22
11345,GABARAPL2,chr16,F,75566350,75577881,13598951,11531,554760201,13383,3
22879,MON1B,chr16,F,77190918,77199646,13607679,8728,554768929,13384,5
22928,SEPHS2,chr16,R,30443624,30445975,13610030,2351,554771280,13385,0
22980,TCF25,chr16,F,89873585,89911387,13647832,37802,554809082,13386,19
23019,CNOT1,chr16,R,58519945,58629886,13757773,109941,554919023,13387,49
23035,PHLPP2,chr16,R,71644923,71724701,13837551,79778,554998801,13388,19
23042,PDXDC1,chr16,F,14974590,15139349,14002310,164759,555163560,13389,24
23049,SMG1,chr16,R,18804852,18926409,14123867,121557,555285117,13390,62
23059,CLUAP1,chr16,F,3500944,3539048,14161971,38104,555323221,13391,12
23062,GGA2,chr16,R,23463541,23510494,14208924,46953,555370174,13392,17
23090,ZNF423,chr16,R,49487530,49857919,14579313,370389,555740563,13393,14
23117,NPIPB3,chr16,R,21402133,21425337,14602517,23204,555763767,13394,8
23162,MAPK8IP3,chr16,F,1706182,1770317,14666652,64135,555827902,13395,33
23174,ZCCHC14,chr16,R,87406245,87492269,14752676,86024,555913926,13396,13
23199,GSE1,chr16,F,85170002,85676206,15258880,506204,556420130,13397,22
23204,ARL6IP1,chr16,R,18791668,18801535,15268747,9867,556429997,13398,5
23214,XPO6,chr16,R,28097975,28211960,15382732,113985,556543982,13399,27
23247,KIAA0556,chr16,F,27550118,27780371,15612985,230253,556774235,13400,30
23274,CLEC16A,chr16,F,10944487,11193278,15861776,248791,557023026,13401,32
23295,MGRN1,chr16,F,4616492,4690974,15936258,74482,557097508,13402,18
23300,ATMIN,chr16,F,81035852,81047346,15947752,11494,557109002,13403,4
23322,RPGRIP1L,chr16,R,53599905,53703859,16051706,103954,557212956,13404,34
23361,ZNF629,chr16,R,30778448,30787277,16060535,8829,557221785,13405,2
23406,COTL1,chr16,R,84565595,84618096,16113036,52501,557274286,13406,3
23417,MLYCD,chr16,F,83899124,83916182,16130094,17058,557291344,13407,4
23420,NOMO1,chr16,F,14833785,14896157,16192466,62372,557353716,13408,30
23430,TPSD1,chr16,F,1256271,1258493,16194688,2222,557355938,13409,4
23450,SF3B3,chr16,F,70523787,70577668,16248569,53881,557409819,13410,25
23475,QPRT,chr16,F,29669839,29697994,16276724,28155,557437974,13411,4
23491,CES3,chr16,F,66961228,66975149,16290645,13921,557451895,13412,14
23524,SRRM2,chr16,F,2752328,2771412,16309729,19084,557470979,13413,16
23536,ADAT1,chr16,R,75598348,75623323,16334704,24975,557495954,13414,10
23563,CHST5,chr16,R,75528529,75535170,16341345,6641,557502595,13415,2
23568,ARL2BP,chr16,F,57245125,57253635,16349855,8510,557511105,13416,6
23589,CARHSP1,chr16,R,8852941,8869012,16365926,16071,557527176,13417,10
23594,ORC6,chr16,F,46689645,46698394,16374675,8749,557535925,13418,7
23644,EDC4,chr16,F,67873022,67884514,16386167,11492,557547417,13419,28
23659,PLA2G15,chr16,F,68245342,68261062,16401887,15720,557563137,13420,6
24150,TP53TG3,chr16,R,32673527,32676129,16404489,2602,557565739,13421,3
25823,TPSG1,chr16,R,1221487,1226384,16409386,4897,557570636,13422,6
25837,RAB26,chr16,F,2148143,2154140,16415383,5997,557576633,13423,10
25839,COG4,chr16,R,70480568,70523554,16458369,42986,557619619,13424,19
25880,TMEM186,chr16,R,8795179,8797648,16460838,2469,557622088,13425,1
25894,PLEKHG4,chr16,F,67277819,67289500,16472519,11681,557633769,13426,25
25970,SH2B1,chr16,F,28846599,28874213,16500133,27614,557661383,13427,12
26000,TBC1D10B,chr16,R,30357100,30370258,16513291,13158,557674541,13428,8
26048,ZNF500,chr16,R,4745986,4767218,16534523,21232,557695773,13429,7
26063,DECR2,chr16,F,401857,412487,16545153,10630,557706403,13430,8
26077,DKFZP434H168,chr16,R,56192616,56194525,16547062,1909,557708312,13431,0
26156,RSL1D1,chr16,R,11834195,11851585,16564452,17390,557725702,13432,8
26184,OR1F2P,chr16,F,3215561,3216546,16565437,985,557726687,13433,0
26231,LRRC29,chr16,R,67207138,67227059,16585358,19921,557746608,13434,8
26470,SEZ6L2,chr16,R,29871158,29899264,16613464,28106,557774714,13435,17
26471,NUPR1,chr16,R,28537340,28539174,16615298,1834,557776548,13436,2
26784,SNORA64,chr16,R,1962972,1963106,16615432,134,557776682,13437,0
26788,SNORD60,chr16,R,2155022,2155105,16615515,83,557776765,13438,0
27040,LAT,chr16,F,28984825,28990783,16621473,5958,557782723,13439,11
27132,CPNE7,chr16,F,89575767,89597246,16642952,21479,557804202,13440,18
27183,VPS4A,chr16,F,69311383,69325043,16656612,13660,557817862,13441,10
27189,IL17C,chr16,F,88638592,88640474,16658494,1882,557819744,13442,2
27324,TOX3,chr16,R,52436424,52547802,16769872,111378,557931122,13443,9
27327,TNRC6A,chr16,F,24729713,24826227,16866386,96514,558027636,13444,26
28304,IGHV3OR16-12,chr16,F,33802727,33803311,16866970,584,558028220,13445,1
28955,DEXI,chr16,R,10928890,10942400,16880480,13510,558041730,13446,2
28987,NOB1,chr16,R,69741853,69754968,16893595,13115,558054845,13447,8
29035,C16orf72,chr16,F,9091679,9119698,16921614,28019,558082864,13448,5
29066,ZC3H7A,chr16,R,11750585,11797258,16968287,46673,558129537,13449,25
29070,CCDC113,chr16,F,58196963,58283836,17055160,86873,558216410,13450,14
29100,TMEM208,chr16,F,67227107,67229279,17057332,2172,558218582,13451,5
29105,CFAP20,chr16,R,58113591,58129392,17073133,15801,558234383,13452,5
29108,PYCARD,chr16,R,31201485,31202776,17074424,1291,558235674,13453,2
29109,FHOD1,chr16,R,67229388,67247522,17092558,18134,558253808,13454,25
29117,BRD7,chr16,R,50319017,50368966,17142507,49949,558303757,13455,17
29123,ANKRD11,chr16,R,89267618,89490574,17365463,222956,558526713,13456,19
29800,ZDHHC1,chr16,R,67394418,67416436,17387481,22018,558548731,13457,10
29855,UBN1,chr16,F,4847445,4882401,17422437,34956,558583687,13458,21
29895,MYLPF,chr16,F,30374801,30377989,17425625,3188,558586875,13459,6
29904,EEF2K,chr16,F,22206270,22288745,17508100,82475,558669350,13460,18
29948,OSGIN1,chr16,F,83953221,83966332,17521211,13111,558682461,13461,5
29965,CDIP1,chr16,R,4510674,4538815,17549352,28141,558710602,13462,7
30812,SOX8,chr16,F,981807,986979,17554524,5172,558715774,13463,2
50615,IL21R,chr16,F,27402161,27452042,17604405,49881,558765655,13464,10
50855,PARD6A,chr16,F,67660947,67662778,17606236,1831,558767486,13465,2
51005,AMDHD2,chr16,F,2520361,2530954,17616829,10593,558778079,13466,10
51025,PAM16,chr16,R,4340250,4351372,17627951,11122,558789201,13467,4
51061,TXNDC11,chr16,R,11679079,11742878,17691750,63799,558853000,13468,13
51090,PLLP,chr16,R,57256096,57284672,17720326,28576,558881576,13469,3
51108,METTL9,chr16,F,21597220,21657473,17780579,60253,558941829,13470,7
51172,NAGPA,chr16,R,5024843,5033941,17789677,9098,558950927,13471,10
51192,CKLF,chr16,F,66552562,66566287,17803402,13725,558964652,13472,3
51283,BFAR,chr16,F,14632810,14669236,17839828,36426,559001078,13473,7
51327,AHSP,chr16,F,31527851,31528803,17840780,952,559002030,13474,3
51330,TNFRSF12A,chr16,F,3020311,3022383,17842852,2072,559004102,13475,3
51333,ZNF771,chr16,F,30407413,30418595,17854034,11182,559015284,13476,2
51388,NIP7,chr16,F,69339511,69343111,17857634,3600,559018884,13477,4
51451,LCMT1,chr16,F,25111725,25178231,17924140,66506,559085390,13478,12
51573,GDE1,chr16,R,19501692,19522128,17944576,20436,559105826,13479,5
51647,FAM96B,chr16,R,66932054,66934423,17946945,2369,559108195,13480,3
51659,GINS2,chr16,R,85677673,85688982,17958254,11309,559119504,13481,4
51673,TPPP3,chr16,R,67389806,67393535,17961983,3729,559123233,13482,4
51693,TRAPPC2L,chr16,F,88857097,88862678,17967564,5581,559128814,13483,4
51704,GPRC5B,chr16,R,19858970,19886045,17994639,27075,559155889,13484,6
51716,CES1P1,chr16,F,55760598,55774926,18008967,14328,559170217,13485,5
51728,POLR3K,chr16,R,46978,53632,18015621,6654,559176871,13486,2
51734,MSRB1,chr16,R,1938232,1943293,18020682,5061,559181932,13487,3
51741,WWOX,chr16,F,78099412,79212667,19133937,1113255,560295187,13488,16
51760,SYT17,chr16,F,19167975,19268334,19234296,100359,560395546,13489,9
51764,GNG13,chr16,R,798040,800733,19236989,2693,560398239,13490,2
53630,BCO1,chr16,F,81238641,81291142,19289490,52501,560450740,13491,10
54386,TERF2IP,chr16,F,75647703,75657442,19299229,9739,560460479,13492,2
54442,KCTD5,chr16,F,2682493,2709030,19325766,26537,560487016,13493,5
54496,PRMT7,chr16,F,68310973,68358829,19373622,47856,560534872,13494,22
54550,NECAB2,chr16,F,83965184,84002776,19411214,37592,560572464,13495,16
54620,FBXL19,chr16,F,30923054,30948783,19436943,25729,560598193,13496,11
54700,RRN3,chr16,R,15060021,15094335,19471257,34314,560632507,13497,18
54715,RBFOX1,chr16,F,5239781,7713340,21944816,2473559,563106066,13498,30
54758,KLHDC4,chr16,R,87696568,87765997,22014245,69429,563175495,13499,16
54768,HYDIN,chr16,R,70802083,71230722,22442884,428639,563604134,13500,89
54820,NDE1,chr16,F,15643266,15726353,22525971,83087,563687221,13501,13
54849,DEF8,chr16,F,89948696,89968060,22545335,19364,563706585,13502,14
54920,DUS2,chr16,F,68022943,68079323,22601715,56380,563762965,13503,16
54921,CHTF8,chr16,R,69118008,69132590,22616297,14582,563777547,13504,4
54925,ZSCAN32,chr16,R,3382080,3401065,22635282,18985,563796532,13505,7
54947,LPCAT2,chr16,F,55509000,55586670,22712952,77670,563874202,13506,16
54957,TXNL4B,chr16,R,72084856,72094316,22722412,9460,563883662,13507,5
54971,BANP,chr16,F,87949171,88077318,22850559,128147,564011809,13508,26
54985,HCFC1R1,chr16,R,3022619,3024296,22852236,1677,564013486,13509,2
54988,ACSM5,chr16,F,20409519,20440987,22883704,31468,564044954,13510,13
55027,HEATR3,chr16,F,50065969,50105481,22923216,39512,564084466,13511,15
55066,PDPR,chr16,F,70113625,70162534,22972125,48909,564133375,13512,20
55114,ARHGAP17,chr16,R,24919383,25015601,23068343,96218,564229593,13513,24
55159,RFWD3,chr16,R,74621393,74666892,23113842,45499,564275092,13514,14
55238,SLC38A7,chr16,R,58665108,58684777,23133511,19669,564294761,13515,12
55239,OGFOD1,chr16,F,56451416,56477495,23159590,26079,564320840,13516,12
55282,LRRC36,chr16,F,67326843,67385206,23217953,58363,564379203,13517,17
55308,DDX19A,chr16,F,70346860,70373383,23244476,26523,564405726,13518,12
55313,CPPED1,chr16,R,12659798,12803887,23388565,144089,564549815,13519,3
55336,FBXL8,chr16,F,67159987,67164174,23392752,4187,564554002,13520,2
55512,SMPD3,chr16,R,68358326,68448506,23482932,90180,564644182,13521,13
55565,ZNF821,chr16,R,71859679,71884867,23508120,25188,564669370,13522,12
55567,DNAH3,chr16,R,20933110,21159441,23734451,226331,564895701,13523,67
55623,THUMPD1,chr16,R,20733663,20741964,23742752,8301,564904002,13524,4
55625,ZDHHC7,chr16,R,84974459,85011732,23780025,37273,564941275,13525,9
55692,LUC7L,chr16,R,188970,229450,23820505,40480,564981755,13526,9
55697,VAC14,chr16,R,70687438,70801166,23934233,113728,565095483,13527,22
55715,DOK4,chr16,R,57471957,57486473,23948749,14516,565109999,13528,8
55718,POLR3E,chr16,F,22297365,22335103,23986487,37738,565147737,13529,22
55737,VPS35,chr16,R,46657994,46689232,24017725,31238,565178975,13530,17
55783,CMTR2,chr16,R,71282299,71289606,24025032,7307,565186282,13531,2
55794,DDX28,chr16,R,68021273,68023867,24027626,2594,565188876,13532,0
55815,TSNAXIP1,chr16,F,67806655,67828068,24049039,21413,565210289,13533,13
55839,CENPN,chr16,F,81006497,81033107,24075649,26610,565236899,13534,13
55911,APOBR,chr16,F,28494648,28498970,24079971,4322,565241221,13535,3
56052,ALG1,chr16,F,5071808,5087379,24095542,15571,565256792,13536,13
56061,UBFD1,chr16,F,23557540,23574394,24112396,16854,565273646,13537,9
56942,CMC2,chr16,R,80975801,81006897,24143492,31096,565304742,13538,4
57017,COQ9,chr16,F,57447424,57461275,24157343,13851,565318593,13539,8
57019,CIAPIN1,chr16,R,57428173,57447457,24176627,19284,565337877,13540,8
57020,C16orf62,chr16,F,19555072,19701163,24322718,146091,565483968,13541,32
57146,TMEM159,chr16,F,21158376,21180616,24344958,22240,565506208,13542,7
57149,LYRM1,chr16,F,20898804,20925006,24371160,26202,565532410,13543,10
57215,THAP11,chr16,F,67842309,67844195,24373046,1886,565534296,13544,0
57338,JPH3,chr16,F,87601834,87698156,24469368,96322,565630618,13545,7
57407,NMRAL1,chr16,R,4461688,4474895,24482575,13207,565643825,13546,8
57465,TBC1D24,chr16,F,2475145,2505733,24513163,30588,565674413,13547,7
57478,USP31,chr16,R,23061405,23149270,24601028,87865,565762278,13548,18
57496,MKL2,chr16,F,14071320,14266776,24796484,195456,565957734,13549,21
57524,CASKIN1,chr16,R,2177182,2196464,24815766,19282,565977016,13550,19
57546,PDP2,chr16,F,66880456,66891101,24826411,10645,565987661,13551,2
57567,ZNF319,chr16,R,57994667,58000684,24832428,6017,565993678,13552,2
57585,CRAMP1L,chr16,F,1614639,1677908,24895697,63269,566056947,13553,19
57610,RANBP10,chr16,R,67723069,67806652,24979280,83583,566140530,13554,16
57687,VAT1L,chr16,F,77788563,77980107,25170824,191544,566332074,13555,8
57707,TLDC1,chr16,R,84476359,84554045,25248510,77686,566409760,13556,11
57799,RAB40C,chr16,F,589356,629273,25288427,39917,566449677,13557,8
58189,WFDC1,chr16,F,84294705,84329851,25323573,35146,566484823,13558,6
58531,PRM3,chr16,R,11273198,11273595,25323970,397,566485220,13559,0
58986,TMEM8A,chr16,R,370775,381950,25335145,11175,566496395,13560,12
63922,CHTF18,chr16,F,788621,798074,25344598,9453,566505848,13561,17
63928,CHP2,chr16,F,23754626,23758951,25348923,4325,566510173,13562,6
64063,PRSS22,chr16,R,2852726,2858630,25354827,5904,566516077,13563,6
64127,NOD2,chr16,F,50693580,50733081,25394328,39501,566555578,13564,15
64131,XYLT1,chr16,R,17102323,17470881,25762886,368558,566924136,13565,12
64146,PDF,chr16,R,69328620,69330595,25764861,1975,566926111,13566,1
64174,DPEP2,chr16,R,67987389,68000611,25778083,13222,566939333,13567,11
64180,DPEP3,chr16,R,67975662,67980549,25782970,4887,566944220,13568,9
64223,MLST8,chr16,F,2205176,2209417,25787211,4241,566948461,13569,9
64282,PAPD5,chr16,F,50152917,50235310,25869604,82393,567030854,13570,12
64285,RHBDF1,chr16,R,58058,76355,25887901,18297,567049151,13571,17
64319,FBRS,chr16,F,30658430,30670810,25900281,12380,567061531,13572,17
64386,MMP25,chr16,F,3045962,3060729,25915048,14767,567076298,13573,14
64400,AKTIP,chr16,R,53491279,53504411,25928180,13132,567089430,13574,10
64428,NARFL,chr16,R,729752,741038,25939466,11286,567100716,13575,11
64493,LINC00235,chr16,R,526846,527407,25940027,561,567101277,13576,0
64499,TPSB2,chr16,R,1228335,1230184,25941876,1849,567103126,13577,5
64711,HS3ST6,chr16,R,1911462,1921422,25951836,9960,567113086,13578,3
64714,PDIA2,chr16,F,283117,287209,25955928,4092,567117178,13579,10
64717,TRG-CCC2-1,chr16,R,636735,636806,25955999,71,567117249,13580,0
64718,UNKL,chr16,R,1363204,1414749,26007544,51545,567168794,13581,17
64735,LINC00254,chr16,R,1878284,1884231,26013491,5947,567174741,13582,2
64755,C16orf58,chr16,R,31489468,31508419,26032442,18951,567193692,13583,12
64779,MTHFSD,chr16,R,86530175,86555235,26057502,25060,567218752,13584,11
64785,GINS3,chr16,F,58392393,58406144,26071253,13751,567232503,13585,3
64788,LMF1,chr16,R,853633,981318,26198938,127685,567360188,13586,23
65009,NDRG4,chr16,F,58463644,58513619,26248913,49975,567410163,13587,21
65057,ACD,chr16,R,67657511,67660815,26252217,3304,567413467,13588,11
65988,ZNF747,chr16,R,30530366,30534970,26256821,4604,567418071,13589,1
65990,FAM173A,chr16,F,720580,722590,26258831,2010,567420081,13590,4
65993,MRPS34,chr16,R,1771894,1773139,26260076,1245,567421326,13591,2
78994,PRR14,chr16,F,30650716,30656413,26265773,5697,567427023,13592,12
79001,VKORC1,chr16,R,31090853,31096337,26271257,5484,567432507,13593,4
79006,METRN,chr16,F,715172,717480,26273565,2308,567434815,13594,3
79007,DBNDD1,chr16,R,90004864,90020131,26288832,15267,567450082,13595,6
79008,SLX1B,chr16,F,29454500,29458224,26292556,3724,567453806,13596,5
79068,FTO,chr16,F,53703962,54114467,26703061,410505,567864311,13597,11
79077,DCTPP1,chr16,R,30423697,30430052,26709416,6355,567870666,13598,2
79091,METTL22,chr16,F,8621639,8661208,26748985,39569,567910235,13599,13
79152,FA2H,chr16,R,74712954,74774831,26810862,61877,567972112,13600,8
79153,GDPD3,chr16,R,30104809,30113943,26819996,9134,567981246,13601,9
79190,IRX6,chr16,F,55323961,55330760,26826795,6799,567988045,13602,5
79191,IRX3,chr16,R,54283299,54286856,26830352,3557,567991602,13603,3
79228,THOC6,chr16,F,3024030,3027755,26834077,3725,567995327,13604,12
79412,KREMEN2,chr16,F,2964215,2968383,26838245,4168,567999495,13605,8
79447,PAGR1,chr16,F,29816206,29822495,26844534,6289,568005784,13606,2
79567,FAM65A,chr16,F,67528813,67546788,26862509,17975,568023759,13607,24
79583,TMEM231,chr16,R,75538116,75556286,26880679,18170,568041929,13608,5
79585,CORO7,chr16,R,4354541,4416961,26943099,62420,568104349,13609,27
79613,TANGO6,chr16,F,68843552,69085182,27184729,241630,568345979,13610,18
79622,SNRNP25,chr16,F,53828,57669,27188570,3841,568349820,13611,4
79641,ROGDI,chr16,R,4796961,4802950,27194559,5989,568355809,13612,10
79650,USB1,chr16,F,57999599,58021623,27216583,22024,568377833,13613,9
79652,TMEM204,chr16,F,1528740,1555580,27243423,26840,568404673,13614,4
79724,ZNF768,chr16,R,30524000,30526589,27246012,2589,568407262,13615,1
79726,WDR59,chr16,R,74873567,74985123,27357568,111556,568518818,13616,26
79728,PALB2,chr16,R,23603161,23641357,27395764,38196,568557014,13617,14
79759,ZNF668,chr16,R,31060842,31074320,27409242,13478,568570492,13618,5
79767,ELMO3,chr16,F,67199110,67204029,27414161,4919,568575411,13619,19
79786,KLHL36,chr16,F,84648510,84667686,27433337,19176,568594587,13620,5
79791,FBXO31,chr16,R,87326986,87392107,27498458,65121,568659708,13621,10
79798,ARMC5,chr16,F,31458272,31467167,27507353,8895,568668603,13622,4
79801,SHCBP1,chr16,R,46580553,46622810,27549610,42257,568710860,13623,14
79831,KDM8,chr16,F,27203485,27222305,27568430,18820,568729680,13624,9
79838,TMC5,chr16,F,19410521,19499113,27657022,88592,568818272,13625,23
79874,RABEP2,chr16,R,28904420,28925211,27677813,20791,568839063,13626,12
79903,NAA60,chr16,F,3443653,3486963,27721123,43310,568882373,13627,8
79905,TMC7,chr16,F,18983933,19063942,27801132,80009,568962382,13628,16
79918,SETD6,chr16,F,58515478,58520527,27806181,5049,568967431,13629,7
80004,ESRP2,chr16,R,68228546,68236233,27813868,7687,568975118,13630,15
80011,FAM192A,chr16,R,57152465,57186230,27847633,33765,569008883,13631,12
80063,ATF7IP2,chr16,F,10386054,10483638,27945217,97584,569106467,13632,15
80152,CENPT,chr16,R,67828156,67847458,27964519,19302,569125769,13633,15
80178,C16orf59,chr16,F,2460110,2464963,27969372,4853,569130622,13634,9
80205,CHD9,chr16,F,53054997,53327502,28241877,272505,569403127,13635,47
80262,C16orf70,chr16,F,67109897,67148539,28280519,38642,569441769,13636,17
80270,HSD3B7,chr16,F,30985109,30989152,28284562,4043,569445812,13637,6
80777,CYB5B,chr16,F,69424594,69466264,28326232,41670,569487482,13638,4
80790,CMIP,chr16,F,81445169,81711762,28592825,266593,569754075,13639,25
81533,ITFG1,chr16,R,47154386,47461274,28899713,306888,570060963,13640,17
81577,GFOD2,chr16,R,67674532,67719370,28944551,44838,570105801,13641,3
81620,CDT1,chr16,F,88803777,88809258,28950032,5481,570111282,13642,9
81631,MAP1LC3B,chr16,F,87392194,87404774,28962612,12580,570123862,13643,3
81691,LOC81691,chr16,F,20806428,20849668,29005852,43240,570167102,13644,19
81831,NETO2,chr16,R,47081519,47144025,29068358,62506,570229608,13645,9
81854,ZNF205-AS1,chr16,R,3110459,3115598,29073497,5139,570234747,13646,2
81889,FAHD1,chr16,F,1827223,1840207,29086481,12984,570247731,13647,2
81893,SLC7A5P1,chr16,R,29613102,29613717,29087096,615,570248346,13648,0
83449,PMFBP1,chr16,R,72116697,72177002,29147401,60305,570308651,13649,28
83657,DYNLRB2,chr16,F,80540257,80550811,29157955,10554,570319205,13650,7
83693,HSDL1,chr16,R,84122138,84145195,29181012,23057,570342262,13651,6
83716,CRISPLD2,chr16,F,84819980,84909510,29270542,89530,570431792,13652,15
83719,YPEL3,chr16,R,30092313,30096216,29274445,3903,570435695,13653,5
83723,FAM57B,chr16,R,30024426,30053012,29303031,28586,570464281,13654,12
83752,LONP2,chr16,F,48244166,48353979,29412844,109813,570574094,13655,14
83886,PRSS27,chr16,R,2712417,2720578,29421005,8161,570582255,13656,6
83985,SPNS1,chr16,F,28974770,28984762,29430997,9992,570592247,13657,12
83986,ITFG3,chr16,F,234545,269943,29466395,35398,570627645,13658,17
84080,ENKD1,chr16,R,67662946,67666725,29470174,3779,570631424,13659,6
84138,SLC7A6OS,chr16,R,68300614,68310965,29480525,10351,570641775,13660,4
84148,KAT8,chr16,F,31117663,31131393,29494255,13730,570655505,13661,10
84166,NLRC5,chr16,F,56989546,57083526,29588235,93980,570749485,13662,54
84219,WDR24,chr16,R,684621,690649,29594263,6028,570755513,13663,9
84229,DRC7,chr16,F,57694800,57731455,29630918,36655,570792168,13664,18
84231,TRAF7,chr16,F,2155752,2178129,29653295,22377,570814545,13665,20
84256,FLYWCH1,chr16,F,2911920,2951208,29692583,39288,570853833,13666,13
84264,HAGHL,chr16,F,726935,729715,29695363,2780,570856613,13667,5
84290,CAPNS2,chr16,F,55566671,55567680,29696372,1009,570857622,13668,0
84309,NUDT16L1,chr16,F,4693557,4695859,29698674,2302,570859924,13669,2
84326,C16orf13,chr16,R,634426,636366,29700614,1940,570861864,13670,5
84331,FAM195A,chr16,F,641848,648474,29707240,6626,570868490,13671,4
84342,COG8,chr16,R,69328620,69339623,29718243,11003,570879493,13672,5
84464,SLX4,chr16,R,3581164,3611598,29748677,30434,570909927,13673,14
84501,SPIRE2,chr16,F,89817476,89871319,29802520,53843,570963770,13674,20
84516,DCTN5,chr16,F,23641365,23673747,29834902,32382,570996152,13675,7
84560,MT4,chr16,F,56565048,56568957,29838811,3909,571000061,13676,2
84572,GNPTG,chr16,F,1351898,1363351,29850264,11453,571011514,13677,10
84627,ZNF469,chr16,F,88233014,88440757,30058007,207743,571219257,13678,6
84656,GLYR1,chr16,R,4803202,4847333,30102138,44131,571263388,13679,18
84662,GLIS2,chr16,F,4316180,4339597,30125555,23417,571286805,13680,7
84706,GPT2,chr16,F,46884395,46931289,30172449,46894,571333699,13681,13
84752,B3GNT9,chr16,R,67148101,67150999,30175347,2898,571336597,13682,1
84891,ZSCAN10,chr16,R,3088889,3099317,30185775,10428,571347025,13683,5
84901,NFATC2IP,chr16,F,28950987,28966465,30201253,15478,571362503,13684,7
84916,CIRH1A,chr16,F,69132595,69169034,30237692,36439,571398942,13685,17
84937,ZNRF1,chr16,F,74999016,75110994,30349670,111978,571510920,13686,8
85320,ABCC11,chr16,R,48166909,48235177,30417938,68268,571579188,13687,32
85407,NKD1,chr16,F,50548329,50649249,30518858,100920,571680108,13688,13
85445,CNTNAP4,chr16,F,76277277,76560884,30802465,283607,571963715,13689,24
89927,C16orf45,chr16,F,15434467,15594689,30962687,160222,572123937,13690,8
89941,RHOT2,chr16,F,668082,674174,30968779,6092,572130029,13691,18
89970,RSPRY1,chr16,F,57186290,57240473,31022962,54183,572184212,13692,16
90835,C16orf93,chr16,R,30757422,30762277,31027817,4855,572189067,13693,8
90850,ZNF598,chr16,R,1997651,2009821,31039987,12170,572201237,13694,11
90861,HN1L,chr16,F,1678276,1702072,31063783,23796,572225033,13695,4
90864,SPSB3,chr16,R,1776711,1782605,31069677,5894,572230927,13696,7
91151,TIGD7,chr16,R,3298807,3305439,31076309,6632,572237559,13697,1
91807,MYLK3,chr16,R,46702281,46763289,31137317,61008,572298567,13698,15
91862,MARVELD3,chr16,F,71626137,71641965,31153145,15828,572314395,13699,4
91949,COG7,chr16,R,23388492,23453210,31217863,64718,572379113,13700,17
92017,SNX29,chr16,F,11976733,12574289,31815419,597556,572976669,13701,27
92154,MTSS1L,chr16,R,70661203,70686051,31840267,24848,573001517,13702,18
92595,ZNF764,chr16,R,30553763,30558321,31844825,4558,573006075,13703,2
92806,CENPBD1,chr16,R,89969774,89972832,31847883,3058,573009133,13704,0
92822,ZNF276,chr16,F,89720194,89740925,31868614,20731,573029864,13705,13
92922,CCDC102A,chr16,R,57512177,57537130,31893567,24953,573054817,13706,9
93107,KCNG4,chr16,R,84221134,84239750,31912183,18616,573073433,13707,2
93129,ORAI3,chr16,F,30949083,30954938,31918038,5855,573079288,13708,1
93517,SDR42E1,chr16,R,81997615,82011488,31931911,13873,573093161,13709,5
94160,ABCC12,chr16,R,48082972,48146770,31995709,63798,573156959,13710,28
112476,PRRT2,chr16,F,29811393,29815881,32000197,4488,573161447,13711,2
112479,ERI2,chr16,R,20780192,20806473,32026478,26281,573187728,13712,11
112755,STX1B,chr16,R,30989255,31010638,32047861,21383,573209111,13713,9
112869,CCDC101,chr16,F,28553927,28591790,32085724,37863,573246974,13714,9
113000,RPUSD1,chr16,R,784973,788387,32089138,3414,573250388,13715,5
113540,CMTM1,chr16,F,66566390,66579135,32101883,12745,573263133,13716,4
114780,PKD1L2,chr16,R,81100878,81220370,32221375,119492,573382625,13717,43
114984,FLYWCH2,chr16,F,2882803,2899382,32237954,16579,573399204,13718,3
114990,VASN,chr16,F,4371847,4383528,32249635,11681,573410885,13719,1
115509,ZNF689,chr16,R,30602557,30610775,32257853,8218,573419103,13720,4
115584,SLC5A11,chr16,F,24845862,24911628,32323619,65766,573484869,13721,17
115939,TSR3,chr16,R,1349239,1351872,32326252,2633,573487502,13722,5
115992,RNF166,chr16,R,88696494,88706421,32336179,9927,573497429,13723,9
116028,RMI2,chr16,F,11345437,11351763,32342505,6326,573503755,13724,1
116285,ACSM1,chr16,R,20623232,20697744,32417017,74512,573578267,13725,17
117166,WFIKKN1,chr16,F,631011,634116,32420122,3105,573581372,13726,1
118460,EXOSC6,chr16,R,70250230,70251930,32421822,1700,573583072,13727,0
123775,C16orf46,chr16,R,81053496,81077267,32445593,23771,573606843,13728,6
123803,NTAN1,chr16,R,15037852,15056079,32463820,18227,573625070,13729,10
123811,FOPNL,chr16,R,15865718,15888649,32486751,22931,573648001,13730,5
123872,DNAAF1,chr16,F,84145259,84177918,32519410,32659,573680660,13731,14
123876,ACSM2A,chr16,F,20451525,20487669,32555554,36144,573716804,13732,14
123879,DCUN1D3,chr16,R,20858073,20900239,32597720,42166,573758970,13733,2
123904,NRN1L,chr16,F,67884877,67886368,32599211,1491,573760461,13734,2
123920,CMTM3,chr16,F,66604031,66613892,32609072,9861,573770322,13735,5
123970,C16orf78,chr16,F,49373807,49399431,32634696,25624,573795946,13736,4
124044,SPATA2L,chr16,R,89696356,89701713,32640053,5357,573801303,13737,2
124045,SPATA33,chr16,F,89657743,89670458,32652768,12715,573814018,13738,2
124056,NOXO1,chr16,R,1978916,1981549,32655401,2633,573816651,13739,7
124093,CCDC78,chr16,R,722581,726881,32659701,4300,573820951,13740,6
124149,ANKRD26P1,chr16,R,46469336,46569097,32759462,99761,573920712,13741,16
124152,IQCK,chr16,F,19716455,19857585,32900592,141130,574061842,13742,10
124220,ZG16B,chr16,F,2830171,2832284,32902705,2113,574063955,13743,3
124221,PRSS30P,chr16,R,2839572,2842751,32905884,3179,574067134,13744,1
124222,PAQR4,chr16,F,2969244,2973489,32910129,4245,574071379,13745,2
124245,ZC3H18,chr16,F,88570378,88631964,32971715,61586,574132965,13746,18
124274,GPR139,chr16,R,20031454,20073778,33014039,42324,574175289,13747,2
124359,CDYL2,chr16,R,80597898,80805043,33221184,207145,574382434,13748,9
124401,ANKS3,chr16,R,4696509,4734377,33259052,37868,574420302,13749,18
124402,UBALD1,chr16,R,4608882,4614926,33265096,6044,574426346,13750,2
124404,SEPT12,chr16,R,4777608,4788521,33276009,10913,574437259,13751,9
124411,ZNF720,chr16,F,31713228,31794641,33357422,81413,574518672,13752,8
124446,TMEM219,chr16,F,29962029,29973052,33368445,11023,574529695,13753,6
124454,EARS2,chr16,R,23522012,23557375,33403808,35363,574565058,13754,9
124460,SNX20,chr16,R,50666299,50681353,33418862,15054,574580112,13755,4
124491,TMEM170A,chr16,R,75443243,75464737,33440356,21494,574601606,13756,4
146167,SLC38A8,chr16,R,84009666,84043097,33473787,33431,574635037,13757,11
146177,VWA3A,chr16,F,22091913,22156966,33538840,65053,574700090,13758,38
146183,OTOA,chr16,F,21664154,21760729,33635415,96575,574796665,13759,29
146198,ZFP90,chr16,F,68539288,68576072,33672199,36784,574833449,13760,5
146206,RLTPR,chr16,F,67645003,67657569,33684765,12566,574846015,13761,37
146212,KCTD19,chr16,R,67289431,67326761,33722095,37330,574883345,13762,18
146223,CMTM4,chr16,R,66598213,66696707,33820589,98494,574981839,13763,5
146225,CMTM2,chr16,F,66579447,66588275,33829417,8828,574990667,13764,3
146227,BEAN1,chr16,F,66427296,66493529,33895650,66233,575056900,13765,15
146279,TEKT5,chr16,R,10581368,10742416,34056698,161048,575217948,13766,14
146310,RNF151,chr16,F,1966822,1968975,34058851,2153,575220101,13767,3
146325,PRR35,chr16,F,560421,565529,34063959,5108,575225209,13768,2
146330,FBXL16,chr16,R,692499,705825,34077285,13326,575238535,13769,5
146336,SSTR5-AS1,chr16,R,1064080,1078731,34091936,14651,575253186,13770,3
146378,C16orf92,chr16,F,30023333,30024702,34093305,1369,575254555,13771,3
146395,GSG1L,chr16,R,27787528,28063509,34369286,275981,575530536,13772,9
146429,SLC22A31,chr16,R,89195755,89201671,34375202,5916,575536452,13773,7
146433,IL34,chr16,F,70579894,70660684,34455992,80790,575617242,13774,10
146434,ZNF597,chr16,R,3432421,3443537,34467108,11116,575628358,13775,3
146439,CCDC64B,chr16,R,3027709,3036963,34476362,9254,575637612,13776,10
146456,TMED6,chr16,R,69343245,69351809,34484926,8564,575646176,13777,3
146481,FRG2DP,chr16,R,35477413,35480596,34488109,3183,575649359,13778,2
146512,FLJ30679,chr16,F,86555319,86557299,34490089,1980,575651339,13779,0
146513,LOC146513,chr16,F,86286430,86293389,34497048,6959,575658298,13780,2
146540,ZNF785,chr16,R,30573218,30586421,34510251,13203,575671501,13781,4
146542,ZNF688,chr16,R,30569676,30572495,34513070,2819,575674320,13782,2
146547,PRSS36,chr16,R,31138922,31150094,34524242,11172,575685492,13783,13
146556,C16orf89,chr16,R,5042771,5066145,34547616,23374,575708866,13784,8
146562,C16orf71,chr16,F,4734287,4749396,34562725,15109,575723975,13785,9
161882,ZFPM1,chr16,F,88451430,88535166,34646461,83736,575807711,13786,14
161931,ADAD2,chr16,F,84191116,84197166,34652511,6050,575813761,13787,11
162073,ITPRIPL2,chr16,F,19113931,19121630,34660210,7699,575821460,13788,0
162083,C16orf82,chr16,F,27066897,27069166,34662479,2269,575823729,13789,0
162239,ZFP1,chr16,F,75132508,75172234,34702205,39726,575863455,13790,5
170692,ADAMTS18,chr16,R,77282127,77435114,34855192,152987,576016442,13791,22
196483,EEF2KMT,chr16,R,5084299,5097820,34868713,13521,576029963,13792,8
197187,SNAI3-AS1,chr16,F,88663372,88687186,34892527,23814,576053777,13793,4
197196,LINC00311,chr16,F,85282957,85288082,34897652,5125,576058902,13794,2
197257,LDHD,chr16,R,75111859,75116772,34902565,4913,576063815,13795,10
197258,FUK,chr16,F,70454583,70480274,34928256,25691,576089506,13796,26
197259,MLKL,chr16,R,74671854,74701148,34957550,29294,576118800,13797,10
197320,ZNF778,chr16,F,89202037,89232637,34988150,30600,576149400,13798,10
197322,ACSF3,chr16,F,89093808,89155846,35050188,62038,576211438,13799,16
197335,WDR90,chr16,F,649362,667833,35068659,18471,576229909,13800,40
197342,EME2,chr16,F,1773227,1776238,35071670,3011,576232920,13801,7
197358,NLRC3,chr16,R,3539032,3578373,35111011,39341,576272261,13802,24
197370,NSMCE1,chr16,R,27224993,27268809,35154827,43816,576316077,13803,9
197407,ZNF48,chr16,F,30378311,30400108,35176624,21797,576337874,13804,2
204474,PDILT,chr16,R,20359169,20404742,35222197,45573,576383447,13805,11
221184,CPNE2,chr16,F,57092542,57148369,35278024,55827,576439274,13806,15
221188,ADGRG5,chr16,F,57529332,57577210,35325902,47878,576487152,13807,12
221191,PRSS54,chr16,R,58279996,58295047,35340953,15051,576502203,13808,6
221223,CES5A,chr16,R,55846153,55956031,35450831,109878,576612081,13809,14
222487,ADGRG3,chr16,F,57668191,57689378,35472018,21187,576633268,13810,12
246778,IL27,chr16,R,28499068,28526399,35499349,27331,576660599,13811,5
253980,KCTD13,chr16,R,29906334,29926232,35519247,19898,576680497,13812,6
253982,ASPHD1,chr16,F,29900825,29920112,35538534,19287,576699784,13813,4
254528,MEIOB,chr16,R,1833982,1872178,35576730,38196,576737980,13814,13
255027,MPV17L,chr16,F,15395697,15409686,35590719,13989,576751969,13815,4
255762,PDZD9,chr16,R,21957539,22001127,35634307,43588,576795557,13816,6
255919,CNEP1R1,chr16,F,50025205,50037088,35646190,11883,576807440,13817,6
257629,ANKS4B,chr16,F,21233694,21252429,35664925,18735,576826175,13818,1
260429,PRSS33,chr16,R,2783952,2787607,35668580,3655,576829830,13819,6
260434,PYDC1,chr16,R,31215961,31217093,35669712,1132,576830962,13820,1
283820,NOMO2,chr16,R,18499923,18562112,35731901,62189,576893151,13821,30
283847,CCDC79,chr16,R,66754410,66801620,35779111,47210,576940361,13822,23
283848,CES4A,chr16,F,66988588,67009758,35800281,21170,576961531,13823,15
283849,EXOC3L1,chr16,R,67184378,67190204,35806107,5826,576967357,13824,13
283854,CASC22,chr16,F,52271422,52280299,35814984,8877,576976234,13825,6
283856,LOC283856,chr16,R,56092986,56191094,35913092,98108,577074342,13826,4
283860,LINC00304,chr16,F,89159219,89163675,35917548,4456,577078798,13827,3
283867,LINC00922,chr16,R,65284498,65576300,36209350,291802,577370600,13828,8
283869,NPW,chr16,F,2019519,2020755,36210586,1236,577371836,13829,1
283870,BRICD5,chr16,R,2209252,2213540,36214874,4288,577376124,13830,4
283871,PGP,chr16,R,2211601,2214821,36218094,3220,577379344,13831,1
283875,LINC00514,chr16,F,2989053,2994509,36223550,5456,577384800,13832,4
283876,LINC00921,chr16,F,3263767,3267567,36227350,3800,577388600,13833,1
283887,LOC283887,chr16,F,25067037,25068955,36229268,1918,577390518,13834,1
283888,IL21R-AS1,chr16,R,27447668,27453393,36234993,5725,577396243,13835,2
283897,C16orf54,chr16,R,29742462,29746329,36238860,3867,577400110,13836,2
283899,INO80E,chr16,F,29995689,30005790,36248961,10101,577410211,13837,6
283902,HCCAT5,chr16,F,73092348,73093774,36250387,1426,577411637,13838,2
283914,LINC01566,chr16,F,35363415,35391713,36278685,28298,577439935,13839,10
283922,LOC283922,chr16,R,74332405,74368255,36314535,35850,577475785,13840,14
283927,NUDT7,chr16,F,77722491,77742260,36334304,19769,577495554,13841,6
283932,FBXL19-AS1,chr16,R,30919318,30923269,36338255,3951,577499505,13842,0
283933,ZNF843,chr16,R,31435563,31443027,36345719,7464,577506969,13843,1
283948,NHLRC4,chr16,F,566994,569495,36348220,2501,577509470,13844,1
283951,C16orf91,chr16,R,1419743,1420800,36349277,1057,577510527,13845,1
283953,TMEM114,chr16,R,8526548,8590193,36412922,63645,577574172,13846,7
283970,PDXDC2P,chr16,R,69976296,70065948,36502574,89652,577663824,13847,25
283971,CLEC18C,chr16,F,70173321,70187147,36516400,13826,577677650,13848,13
326343,MT1DP,chr16,F,56643686,56644941,36517655,1255,577678905,13849,3
333929,SNAI3,chr16,R,88677681,88686474,36526448,8793,577687698,13850,2
339044,PKD1P1,chr16,F,16317608,16350608,36559448,33000,577720698,13851,30
339059,LOC339059,chr16,F,88742766,88745748,36562430,2982,577723680,13852,2
339105,PRSS53,chr16,R,31083423,31090035,36569042,6612,577730292,13853,8
339123,JMJD8,chr16,R,681666,684441,36571817,2775,577733067,13854,8
339145,FAM92B,chr16,R,85098351,85112508,36585974,14157,577747224,13855,8
342346,C16orf96,chr16,F,4538708,4600455,36647721,61747,577808971,13856,17
342357,ZKSCAN2,chr16,R,25236000,25257889,36669610,21889,577830860,13857,6
342371,ATXN1L,chr16,F,71845990,71857333,36680953,11343,577842203,13858,2
342372,PKD1L3,chr16,R,71929537,71999978,36751394,70441,577912644,13859,29
348158,ACSM2B,chr16,R,20536260,20576373,36791507,40113,577952757,13860,15
348174,CLEC18A,chr16,F,69950393,69964347,36805461,13954,577966711,13861,14
348180,CTU2,chr16,F,88706482,88715386,36814365,8904,577975615,13862,14
353511,PKD1P6,chr16,R,15104722,15131601,36841244,26879,578002494,13863,17
360226,PRSS41,chr16,F,2798475,2805284,36848053,6809,578009303,13864,4
374739,TEPP,chr16,F,57976434,57988354,36859973,11920,578021223,13865,7
386757,SLC6A10P,chr16,R,32877475,32885142,36867640,7667,578028890,13866,8
387254,SLC7A5P2,chr16,R,21517892,21520444,36870192,2552,578031442,13867,0
388199,PRR25,chr16,F,805442,813861,36878611,8419,578039861,13868,2
388228,SBK1,chr16,F,28258702,28323849,36943758,65147,578105008,13869,4
388242,LOC388242,chr16,R,29464966,29467578,36946370,2612,578107620,13870,4
388272,C16orf87,chr16,R,46802046,46831162,36975486,29116,578136736,13871,3
388276,C16orf97,chr16,R,52026351,52078517,37027652,52166,578188902,13872,7
388282,LOC388282,chr16,F,57810065,57816927,37034514,6862,578195764,13873,3
388284,C16orf86,chr16,F,67666805,67668758,37036467,1953,578197717,13874,3
388289,C16orf47,chr16,R,73126637,73144447,37054277,17810,578215527,13875,3
390664,C1QTNF8,chr16,R,1088225,1096306,37062358,8081,578223608,13876,4
390667,PTX4,chr16,R,1485938,1488467,37064887,2529,578226137,13877,2
390705,LOC390705,chr16,R,32289546,32289981,37065322,435,578226572,13878,0
390732,CES1P2,chr16,F,55724924,55750211,37090609,25287,578251859,13879,13
390748,PABPN1L,chr16,R,88862622,88870156,37098143,7534,578259393,13880,7
400499,LOC400499,chr16,R,11372600,11523533,37249076,150933,578410326,13881,65
400500,BCAR4,chr16,R,11819829,11828832,37258079,9003,578419329,13882,3
400506,KNOP1,chr16,R,19706346,19718361,37270094,12015,578431344,13883,6
400508,CRYM-AS1,chr16,F,21300848,21318591,37287837,17743,578449087,13884,2
400511,LINC01567,chr16,R,24661421,24671062,37297478,9641,578458728,13885,2
400512,FLJ21408,chr16,F,27268204,27290468,37319742,22264,578480992,13886,4
400533,FLJ26245,chr16,F,35746551,35756624,37329815,10073,578491065,13887,2
400541,LOC400541,chr16,R,70156339,70173448,37346924,17109,578508174,13888,2
400548,LOC400548,chr16,F,85137149,85149443,37359218,12294,578520468,13889,2
400550,FENDRR,chr16,R,86474524,86508860,37393554,34336,578554804,13890,6
400553,LOC400553,chr16,R,88099408,88100985,37395131,1577,578556381,13891,1
400555,ZC3H18-AS1,chr16,R,88554001,88567106,37408236,13105,578569486,13892,4
400558,LOC400558,chr16,F,89166382,89169147,37411001,2765,578572251,13893,2
404550,C16orf74,chr16,R,85707509,85751083,37454575,43574,578615825,13894,4
406930,MIR138-2,chr16,F,56858517,56858601,37454659,84,578615909,13895,0
406932,MIR140,chr16,F,69933080,69933180,37454759,100,578616009,13896,0
408050,NOMO3,chr16,F,16232531,16294811,37517039,62280,578678289,13897,30
440335,SMIM22,chr16,F,4788390,4796491,37525140,8101,578686390,13898,6
440345,NPIPB4,chr16,R,21834567,21880845,37571418,46278,578732668,13899,13
440346,LOC440346,chr16,F,22374322,22376273,37573369,1951,578734619,13900,0
440348,NPIPB15,chr16,F,74375000,74392115,37590484,17115,578751734,13901,13
440352,SNX29P2,chr16,F,29302286,29365059,37653257,62773,578814507,13902,8
440354,SMG1P2,chr16,R,29527607,29566219,37691869,38612,578853119,13903,26
440356,CDIPT-AS1,chr16,F,29863682,29868053,37696240,4371,578857490,13904,6
440359,YBX3P1,chr16,R,31567766,31569524,37697998,1758,578859248,13905,0
440386,LOC440386,chr16,F,74366842,74369826,37700982,2984,578862232,13906,2
440387,CTRB2,chr16,R,75204095,75207174,37704061,3079,578865311,13907,6
440390,LOC440390,chr16,F,87057783,87063991,37710269,6208,578871519,13908,2
442901,MIR328,chr16,R,67202320,67202395,37710344,75,578871594,13909,0
445329,SULT1A4,chr16,F,29459885,29464980,37715439,5095,578876689,13910,10
493829,TRIM72,chr16,F,31214020,31225189,37726608,11169,578887858,13911,6
497190,CLEC18B,chr16,R,74408630,74422248,37740226,13618,578901476,13912,14
548593,SLX1A,chr16,F,30193842,30197566,37743950,3724,578905200,13913,5
552900,BOLA2,chr16,R,29443248,29455128,37755830,11880,578917080,13914,6
554206,LOC554206,chr16,F,25031740,25032777,37756867,1037,578918117,13915,0
574042,SNORA10,chr16,R,1962333,1962466,37757000,133,578918250,13916,0
574455,MIR193B,chr16,F,14303966,14304049,37757083,83,578918333,13917,0
595101,SMG1P5,chr16,R,30267592,30335374,37824865,67782,578986115,13918,27
606500,SNORD68,chr16,F,89561429,89561501,37824937,72,578986187,13919,0
606551,UBE2MP1,chr16,R,35169430,35170391,37825898,961,578987148,13920,0
606724,LOC606724,chr16,F,29449344,29449915,37826469,571,578987719,13921,0
613037,LOC613037,chr16,R,30223028,30245611,37849052,22583,579010302,13922,6
613038,LOC613038,chr16,R,30204315,30206927,37851664,2612,579012914,13923,4
619553,MIR484,chr16,F,15643293,15643372,37851743,79,579012993,13924,0
641298,SMG1P1,chr16,F,22437007,22492220,37906956,55213,579068206,13925,28
642696,LOC642696,chr16,R,12087562,12089946,37909340,2384,579070590,13926,1
642778,NPIPA3,chr16,F,14706472,14726338,37929206,19866,579090456,13927,13
642799,NPIPA2,chr16,F,14745594,14765448,37949060,19854,579110310,13928,13
643714,CASC16,chr16,R,52552086,52606975,38003949,54889,579165199,13929,3
643802,LOC643802,chr16,R,53369361,53371129,38005717,1768,579166967,13930,1
643911,CRNDE,chr16,R,54918862,54929189,38016044,10327,579177294,13931,5
644314,MT1IP,chr16,F,56676115,56677877,38017806,1762,579179056,13932,3
644649,APOOP5,chr16,R,59754131,59755191,38018866,1060,579180116,13933,0
645644,FLJ42627,chr16,F,2638981,2646129,38026014,7148,579187264,13934,0
645811,CCDC154,chr16,R,1433424,1444844,38037434,11420,579198684,13935,16
646174,C16orf90,chr16,R,3493483,3495721,38039672,2238,579200922,13936,2
647187,IGHV3OR16-6,chr16,F,32916795,32978333,38101210,61538,579262460,13937,16
649159,LINC00273,chr16,R,34158584,34160036,38102662,1452,579263912,13938,0
650655,ABCA17P,chr16,F,2340921,2426699,38188440,85778,579349690,13939,16
652276,LOC652276,chr16,F,2603383,2630494,38215551,27111,579376801,13940,3
653190,ABCC6P1,chr16,F,18571247,18598289,38242593,27042,579403843,13941,9
653319,KIAA0895L,chr16,R,67175601,67183980,38250972,8379,579412222,13942,6
653390,RRN3P2,chr16,F,29074841,29116718,38292849,41877,579454099,13943,16
653550,TP53TG3C,chr16,F,33194263,33196858,38295444,2595,579456694,13944,3
653786,LOC653786,chr16,F,22545697,22576865,38326612,31168,579487862,13945,8
653808,ZG16,chr16,F,29760826,29781648,38347434,20822,579508684,13946,4
654483,BOLA2B,chr16,R,30192934,30194306,38348806,1372,579510056,13947,2
677813,SNORA30,chr16,F,30710536,30710665,38348935,129,579510185,13948,0
677827,SNORA46,chr16,R,58548498,58548633,38349070,135,579510320,13949,0
677830,SNORA76A,chr16,R,58559795,58559931,38349206,136,579510456,13950,0
677844,SNORA78,chr16,F,1965183,1965310,38349333,127,579510583,13951,0
692111,SNORD71,chr16,R,71758401,71758487,38349419,86,579510669,13952,0
692214,SNORD111,chr16,F,70538004,70538098,38349513,94,579510763,13953,0
724032,MIR662,chr16,F,770182,770277,38349608,95,579510858,13954,0
728276,CLEC19A,chr16,F,19285754,19324537,38388391,38783,579549641,13955,5
728689,EIF3CL,chr16,R,28379578,28403841,38412654,24263,579573904,13956,20
728734,NPIPB8,chr16,F,28624516,28658725,38446863,34209,579608113,13957,14
728741,NPIPB6,chr16,R,28342511,28364929,38469281,22418,579630531,13958,14
728888,NPIPB11,chr16,R,29381182,29405678,38493777,24496,579655027,13959,10
729159,LOC729159,chr16,R,60358454,60359763,38495086,1309,579656336,13960,0
729264,TP53TG3D,chr16,F,32253323,32255928,38497691,2605,579658941,13961,2
729355,TP53TG3B,chr16,F,33360876,33363478,38500293,2602,579661543,13962,3
729652,LOC729652,chr16,R,2464935,2468207,38503565,3272,579664815,13963,0
729887,LOC729887,chr16,F,84116180,84117571,38504956,1391,579666206,13964,1
729993,SHISA9,chr16,F,12901619,13562919,39166256,661300,580327506,13965,9
730013,ABCC6P2,chr16,R,14822431,14824702,39168527,2271,580329777,13966,1
730092,RRN3P1,chr16,R,21796629,21819174,39191072,22545,580352322,13967,11
730094,C16orf52,chr16,F,22008134,22084654,39267592,76520,580428842,13968,2
730183,LOC730183,chr16,R,30697703,30698489,39268378,786,580429628,13969,1
732275,LINC00917,chr16,R,86331849,86345679,39282208,13830,580443458,13970,6
735301,SNHG9,chr16,F,1964995,1965504,39282717,509,580443967,13971,1
752014,CEMP1,chr16,R,2530034,2531408,39284091,1374,580445341,13972,0
780776,TVP23A,chr16,R,10761363,10818859,39341587,57496,580502837,13973,10
100033411,DUXB,chr16,R,75693728,75701418,39349277,7690,580510527,13974,4
100113402,SNORD111B,chr16,F,70529498,70529599,39349378,101,580510628,13975,0
100126328,MIR940,chr16,F,2271746,2271840,39349472,94,580510722,13976,0
100126355,MIR365A,chr16,F,14309284,14309371,39349559,87,580510809,13977,0
100128079,LOC100128079,chr16,R,27650133,27719029,39418455,68896,580579705,13978,2
100128770,LOC100128770,chr16,F,3032480,3039133,39425108,6653,580586358,13979,7
100128788,SRRM2-AS1,chr16,R,2737075,2752600,39440633,15525,580601883,13980,7
100128881,VPS9D1-AS1,chr16,F,89711855,89718165,39446943,6310,580608193,13981,3
100128882,LOC100128882,chr16,R,88512835,88531995,39466103,19160,580627353,13982,3
100129215,LOC100129215,chr16,R,87693536,87696147,39468714,2611,580629964,13983,0
100129617,LOC100129617,chr16,F,81665353,81667276,39470637,1923,580631887,13984,0
100129697,LOC100129697,chr16,F,88940038,88951524,39482123,11486,580643373,13985,1
100129781,LOC100129781,chr16,F,14321462,14326519,39487180,5057,580648430,13986,3
100130015,URAHP,chr16,R,90039760,90047783,39495203,8023,580656453,13987,5
100130285,LOC100130285,chr16,R,640068,641735,39496870,1667,580658120,13988,0
100130700,LOC100130700,chr16,R,35505086,35506469,39498253,1383,580659503,13989,2
100130894,VAC14-AS1,chr16,F,70755059,70773251,39516445,18192,580677695,13990,5
100130958,SYCE1L,chr16,F,77199451,77213079,39530073,13628,580691323,13991,10
100131303,LOC100131303,chr16,R,68013435,68015911,39532549,2476,580693799,13992,1
100131998,RRN3P3,chr16,R,22419545,22437715,39550719,18170,580711969,13993,6
100132169,WASIR2,chr16,F,22915,25114,39552918,2199,580714168,13994,1
100132247,NPIPB5,chr16,F,22513522,22536535,39575931,23013,580737181,13995,13
100132341,CLUHP3,chr16,F,31700612,31707437,39582756,6825,580744006,13996,8
100132529,TAT-AS1,chr16,F,71565015,71572438,39590179,7423,580751429,13997,3
100134368,LOC100134368,chr16,F,382240,392960,39600899,10720,580762149,13998,2
100188847,MIR1225,chr16,R,2090194,2090284,39600989,90,580762239,13999,0
100188985,TRG-GCC2-2,chr16,R,70779038,70779109,39601060,71,580762310,14000,0
100189020,TRP-AGG1-1,chr16,F,3191988,3192060,39601132,72,580762382,14001,0
100189032,TRL-TAG3-1,chr16,R,22195710,22195792,39601214,82,580762464,14002,0
100189062,TRK-CTT4-1,chr16,F,3191500,3191573,39601287,73,580762537,14003,0
100189086,TRT-CGT2-1,chr16,F,14285892,14285964,39601359,72,580762609,14004,0
100189089,TRL-CAG2-2,chr16,R,57300479,57300562,39601442,83,580762692,14005,0
100189119,TRK-CTT3-1,chr16,R,3157404,3157477,39601515,73,580762765,14006,0
100189125,TRK-TTT1-1,chr16,R,73478316,73478389,39601588,73,580762838,14007,0
100189130,TRL-CAG2-1,chr16,F,57299950,57300033,39601671,83,580762921,14008,0
100189135,TRM-CAT2-1,chr16,F,71426492,71426565,39601744,73,580762994,14009,0
100189136,TRP-AGG2-5,chr16,R,3182634,3182706,39601816,72,580763066,14010,0
100189163,TRG-GCC2-3,chr16,F,70789506,70789577,39601887,71,580763137,14011,0
100189168,TRR-CCT3-1,chr16,F,3152899,3152972,39601960,73,580763210,14012,0
100189173,TRR-CCG1-1,chr16,F,3150673,3150746,39602033,73,580763283,14013,0
100189209,TRK-CTT5-1,chr16,R,3180553,3180626,39602106,73,580763356,14014,0
100189220,TRG-GCC5-1,chr16,F,70788693,70788764,39602177,71,580763427,14015,0
100189221,TRP-CGG1-2,chr16,F,3172047,3172119,39602249,72,580763499,14016,0
100189226,TRM-CAT6-1,chr16,R,87384021,87384094,39602322,73,580763572,14017,0
100189270,TRR-CCT5-1,chr16,F,3193917,3193990,39602395,73,580763645,14018,0
100189281,TRP-TGG3-4,chr16,F,3188093,3188165,39602467,72,580763717,14019,0
100189282,TRK-CTT2-2,chr16,F,3175690,3175763,39602540,73,580763790,14020,0
100189291,TRL-AAG2-2,chr16,F,22297139,22297221,39602622,82,580763872,14021,0
100189296,TRP-AGG2-6,chr16,F,3189633,3189705,39602694,72,580763944,14022,0
100189335,TRP-TGG3-2,chr16,F,3158921,3158993,39602766,72,580764016,14023,0
100189388,TRP-TGG3-3,chr16,R,3184132,3184204,39602838,72,580764088,14024,0
100190986,LOC100190986,chr16,R,21432002,21434455,39605291,2453,580766541,14025,0
100271836,SMG1P3,chr16,R,21446682,21502281,39660890,55599,580822140,14026,28
100287029,DDX11L10,chr16,F,11554,14090,39663426,2536,580824676,14027,2
100287036,LOC100287036,chr16,F,89321132,89325110,39667404,3978,580828654,14028,2
100287175,LOC100287175,chr16,F,636442,638620,39669582,2178,580830832,14029,2
100288072,SDR42E2,chr16,F,22162437,22191856,39699001,29419,580860251,14030,14
100288162,LOC100288162,chr16,R,14925749,14927283,39700535,1534,580861785,14031,2
100288332,NPIPA5,chr16,R,15363623,15381972,39718884,18349,580880134,14032,12
100289092,ATP2A1-AS1,chr16,R,28878956,28879921,39719849,965,580881099,14033,1
100289574,HERC2P4,chr16,R,32170042,32188113,39737920,18071,580899170,14034,13
100289580,LOC100289580,chr16,F,88731179,88741425,39748166,10246,580909416,14035,2
100302119,MIR1538,chr16,R,69565807,69565868,39748227,61,580909477,14036,0
100302243,MIR1972-1,chr16,R,15010320,15010397,39748304,77,580909554,14037,0
100302261,MIR1910,chr16,R,85741620,85741700,39748384,80,580909634,14038,0
100302738,RNU6-21P,chr16,R,62187539,62187646,39748491,107,580909741,14039,0
100313773,MIR548H2,chr16,R,11306439,11306527,39748579,88,580909829,14040,0
100313837,MIR762,chr16,F,30893902,30893985,39748662,83,580909912,14041,0
100379141,SNORA70D,chr16,R,71698566,71698701,39748797,135,580910047,14042,0
100422836,MIR3180-3,chr16,R,18402177,18402271,39748891,94,580910141,14043,0
100422853,MIR3182,chr16,F,83508345,83508408,39748954,63,580910204,14044,0
100422870,MIR3180-1,chr16,F,14911219,14911313,39749048,94,580910298,14045,0
100422886,MIR3179-2,chr16,F,16300158,16300242,39749132,84,580910382,14046,0
100422922,MIR1972-2,chr16,F,70030345,70030422,39749209,77,580910459,14047,0
100422923,MIR548W,chr16,F,26025236,26025310,39749283,74,580910533,14048,0
100422956,MIR3180-2,chr16,F,16309878,16309966,39749371,88,580910621,14049,0
100422960,MIR3179-1,chr16,F,14901507,14901591,39749455,84,580910705,14050,0
100422972,MIR3181,chr16,F,50742304,50742377,39749528,73,580910778,14051,0
100422974,MIR3178,chr16,R,2531921,2532005,39749612,84,580910862,14052,0
100423006,MIR3179-3,chr16,R,18411893,18411977,39749696,84,580910946,14053,0
100423012,MIR3177,chr16,F,1734984,1735066,39749778,82,580911028,14054,0
100423037,MIR3176,chr16,F,543276,543366,39749868,90,580911118,14055,0
100463285,MTRNR2L4,chr16,R,3371052,3372283,39751099,1231,580912349,14056,0
100500812,MIR3677,chr16,F,2270712,2270772,39751159,60,580912409,14057,0
100500852,MIR3180-4,chr16,R,15154849,15155002,39751312,153,580912562,14058,0
100500891,MIR3935,chr16,F,56245519,56245623,39751416,104,580912666,14059,0
100500910,MIR3670-1,chr16,F,14907716,14907781,39751481,65,580912731,14060,0
100500916,MIR3180-5,chr16,R,2135976,2136129,39751634,153,580912884,14061,0
100500917,MIR3680-1,chr16,R,21506048,21506135,39751721,87,580912971,14062,0
100505619,LINC00919,chr16,R,52083064,52085109,39753766,2045,580915016,14063,2
100505692,FTO-IT1,chr16,F,54039392,54040373,39754747,981,580915997,14064,1
100505865,LINC00920,chr16,F,66408523,66410901,39757125,2378,580918375,14065,1
100505915,LOC100505915,chr16,F,15094410,15109197,39771912,14787,580933162,14066,3
100505942,LOC100505942,chr16,R,67517705,67528745,39782952,11040,580944202,14067,1
100505948,LOC100505948,chr16,R,34978721,34979937,39784168,1216,580945418,14068,1
100506060,SMG1P7,chr16,R,70219580,70226033,39790621,6453,580951871,14069,5
100506083,LOC100506083,chr16,R,70315639,70346747,39821729,31108,580982979,14070,4
100506172,LINC01568,chr16,F,73386804,73421396,39856321,34592,581017571,14071,2
100506281,LOC100506281,chr16,F,75226382,75228203,39858142,1821,581019392,14072,4
100506542,LINC01082,chr16,F,86196180,86199720,39861682,3540,581022932,14073,1
100506581,C16orf95,chr16,R,87302797,87317420,39876305,14623,581037555,14074,6
100506655,LCMT1-AS2,chr16,R,25140570,25149032,39884767,8462,581046017,14075,2
100507221,LOC100507221,chr16,R,32262897,32281946,39903816,19049,581065066,14076,5
100507303,SNHG19,chr16,R,2154801,2155375,39904390,574,581065640,14077,1
100507321,ERVK13-1,chr16,R,2658388,2673439,39919441,15051,581080691,14078,2
100507419,MMP25-AS1,chr16,R,3052124,3059370,39926687,7246,581087937,14079,4
100507458,ZNF213-AS1,chr16,R,3125528,3134882,39936041,9354,581097291,14080,5
100507501,LINC01569,chr16,R,4245824,4253789,39944006,7965,581105256,14081,2
100507534,LOC100507534,chr16,R,47849313,47887130,39981823,37817,581143073,14082,1
100507577,LOC100507577,chr16,F,48355684,48362999,39989138,7315,581150388,14083,1
100507589,NAGPA-AS1,chr16,F,5033701,5042971,39998408,9270,581159658,14084,1
100507607,NPIPB9,chr16,F,28742727,28772850,40028531,30123,581189781,14085,15
100526830,SLX1A-SULT1A3,chr16,F,30194432,30204329,40038428,9897,581199678,14086,10
100526831,SLX1B-SULT1A4,chr16,F,29455090,29464980,40048318,9890,581209568,14087,10
100529144,CORO7-PAM16,chr16,R,4340250,4416961,40125029,76711,581286279,14088,27
100529251,CKLF-CMTM1,chr16,F,66552562,66579135,40151602,26573,581312852,14089,4
100616150,MIR4720,chr16,F,81385017,81385093,40151678,76,581312928,14090,0
100616167,MIR4722,chr16,R,88716277,88716337,40151738,60,581312988,14091,0
100616172,MIR4719,chr16,F,76868935,76869019,40151822,84,581313072,14092,0
100616195,MIR4718,chr16,F,12720320,12720371,40151873,51,581313123,14093,0
100616231,MIR4519,chr16,R,30875265,30875323,40151931,58,581313181,14094,0
100616241,MIR4717,chr16,F,2274619,2274691,40152003,72,581313253,14095,0
100616256,MIR4721,chr16,R,28843918,28844007,40152092,89,581313342,14096,0
100616258,MIR4516,chr16,F,2133118,2133204,40152178,86,581313428,14097,0
100616405,MIR4518,chr16,F,30503918,30504001,40152261,83,581313511,14098,0
100616487,MIR4517,chr16,F,28958582,28958661,40152340,79,581313590,14099,0
100652740,PYCARD-AS1,chr16,F,31201884,31203452,40153908,1568,581315158,14100,1
100652777,LOC100652777,chr16,R,14709069,14733781,40178620,24712,581339870,14101,4
100652781,SNX29P1,chr16,F,21349362,21385933,40215191,36571,581376441,14102,5
100846994,MIR3670-2,chr16,F,16306369,16306434,40215256,65,581376506,14103,0
100847022,MIR5093,chr16,R,85306225,85306325,40215356,100,581376606,14104,0
100847028,MIR5587,chr16,F,535315,535368,40215409,53,581376659,14105,0
100847041,MIR3680-2,chr16,R,29599178,29599265,40215496,87,581376746,14106,0
100847057,MIR5189,chr16,F,88468917,88469031,40215610,114,581376860,14107,0
100862671,TMEM265,chr16,F,30740190,30745196,40220616,5006,581381866,14108,2
100873755,RNU6-23P,chr16,R,70445295,70445399,40220720,104,581381970,14109,0
100996338,LOC100996338,chr16,R,54245543,54270879,40246056,25336,581407306,14110,2
100996345,LOC100996345,chr16,R,54366003,54370660,40250713,4657,581411963,14111,2
100996425,LOC100996425,chr16,R,80828734,80840222,40262201,11488,581423451,14112,2
100996541,FAM157C,chr16,F,90102263,90177606,40337544,75343,581498794,14113,3
101059938,NPIPA7,chr16,F,16378793,16393972,40352723,15179,581513973,14114,9
101059953,NPIPA8,chr16,R,18317918,18333112,40367917,15194,581529167,14115,9
101060097,LOC101060097,chr16,F,32082479,32085096,40370534,2617,581531784,14116,3
101154687,LINC01081,chr16,R,86225579,86286247,40431202,60668,581592452,14117,5
101926896,GLIS2-AS1,chr16,R,4324647,4328340,40434895,3693,581596145,14118,3
101926950,LINC01570,chr16,R,5601168,5616250,40449977,15082,581611227,14119,2
101927009,LOC101927009,chr16,F,9401726,9408093,40456344,6367,581617594,14120,1
101927026,LOC101927026,chr16,F,9184663,9657268,40928949,472605,582090199,14121,12
101927080,LOC101927080,chr16,F,47297158,47362922,40994713,65764,582155963,14122,5
101927102,ITFG1-AS1,chr16,F,47144067,47162747,41013393,18680,582174643,14123,4
101927131,LOC101927131,chr16,F,11465259,11473175,41021309,7916,582182559,14124,2
101927132,LOC101927132,chr16,F,47858580,47908431,41071160,49851,582232410,14125,5
101927227,LOC101927227,chr16,R,12366407,12372582,41077335,6175,582238585,14126,1
101927228,LOC101927228,chr16,F,49466105,49469875,41081105,3770,582242355,14127,1
101927250,LOC101927250,chr16,R,50100477,50153014,41133642,52537,582294892,14128,4
101927272,LOC101927272,chr16,F,50668854,50671639,41136427,2785,582297677,14129,2
101927311,LOC101927311,chr16,R,14009275,14016018,41143170,6743,582304420,14130,2
101927313,LOC101927313,chr16,R,50856612,50879720,41166278,23108,582327528,14131,1
101927334,LOC101927334,chr16,F,51017757,51035777,41184298,18020,582345548,14132,2
101927348,LOC101927348,chr16,R,14018879,14021077,41186496,2198,582347746,14133,2
101927364,LINC01571,chr16,F,51762518,51772646,41196624,10128,582357874,14134,2
101927469,LOC101927469,chr16,R,14895761,14913685,41214548,17924,582375798,14135,5
101927480,LOC101927480,chr16,R,54847246,54848291,41215593,1045,582376843,14136,1
101927536,LOC101927536,chr16,F,56662256,56666864,41220201,4608,582381451,14137,4
101927556,LOC101927556,chr16,F,58129479,58163295,41254017,33816,582415267,14138,4
101927580,LOC101927580,chr16,F,59855352,60053973,41452638,198621,582613888,14139,3
101927605,LOC101927605,chr16,F,60359781,60499355,41592212,139574,582753462,14140,8
101927629,LOC101927629,chr16,F,63730219,63755868,41617861,25649,582779111,14141,3
101927650,LOC101927650,chr16,R,65141755,65176573,41652679,34818,582813929,14142,3
101927676,LOC101927676,chr16,R,66127805,66134038,41658912,6233,582820162,14143,3
101927726,BEAN1-AS1,chr16,R,66469795,66476402,41665519,6607,582826769,14144,2
101927793,LOC101927793,chr16,F,88883395,88888453,41670577,5058,582831827,14145,2
101927814,LOC101927814,chr16,R,21589697,21599385,41680265,9688,582841515,14146,2
101927817,LOC101927817,chr16,F,89430917,89454494,41703842,23577,582865092,14147,3
101927837,LOC101927837,chr16,F,67481319,67505134,41727657,23815,582888907,14148,3
101927863,LOC101927863,chr16,R,89491516,89506568,41742709,15052,582903959,14149,3
101927910,LOC101927910,chr16,F,89912039,89916412,41747082,4373,582908332,14150,2
101927957,LINC01572,chr16,R,72283300,72665009,42128791,381709,583290041,14151,13
101927978,LOC101927978,chr16,F,72747100,72787246,42168937,40146,583330187,14152,5
101927998,LOC101927998,chr16,R,73609524,73811427,42370840,201903,583532090,14153,3
101927999,LOC101927999,chr16,F,90165269,90168604,42374175,3335,583535425,14154,2
101928035,LOC101928035,chr16,R,74192391,74215521,42397305,23130,583558555,14155,3
101928188,LOC101928188,chr16,R,29212567,29221006,42405744,8439,583566994,14156,3
101928203,LOC101928203,chr16,F,76634997,76658478,42429225,23481,583590475,14157,3
101928215,LOC101928215,chr16,R,29104509,29109208,42433924,4699,583595174,14158,2
101928230,LOC101928230,chr16,F,79600902,79612426,42445448,11524,583606698,14159,3
101928248,LINC01229,chr16,F,79770470,79801343,42476321,30873,583637571,14160,5
101928276,LINC01227,chr16,R,80567102,80572808,42482027,5706,583643277,14161,5
101928364,LOC101928364,chr16,F,82545423,82553242,42489846,7819,583651096,14162,2
101928392,LOC101928392,chr16,R,82545095,82575461,42520212,30366,583681462,14163,4
101928417,LOC101928417,chr16,R,82953229,82990298,42557281,37069,583718531,14164,2
101928446,LOC101928446,chr16,F,82773318,82829638,42613601,56320,583774851,14165,2
101928474,LOC101928474,chr16,R,84916185,84924966,42622382,8781,583783632,14166,2
101928502,LOC101928502,chr16,R,85307447,85312163,42627098,4716,583788348,14167,1
101928556,LOC101928556,chr16,F,29469794,29505466,42662770,35672,583824020,14168,2
101928557,LOC101928557,chr16,F,85792414,85792933,42663289,519,583824539,14169,1
101928582,LOC101928582,chr16,R,86196418,86201314,42668185,4896,583829435,14170,3
101928595,LOC101928595,chr16,F,30096429,30104116,42675872,7687,583837122,14171,1
101928614,LOC101928614,chr16,R,86720563,86722010,42677319,1447,583838569,14172,2
101928659,LOC101928659,chr16,F,87317508,87318038,42677849,530,583839099,14173,1
101928682,LOC101928682,chr16,R,87271905,87292452,42698396,20547,583859646,14174,4
101928707,LOC101928707,chr16,F,30355394,30357108,42700110,1714,583861360,14175,1
101928708,LOC101928708,chr16,F,87212114,87226430,42714426,14316,583875676,14176,2
101928736,MIR762HG,chr16,F,30875459,30895220,42734187,19761,583895437,14177,2
101928737,LOC101928737,chr16,F,87494186,87515630,42755631,21444,583916881,14178,3
101928762,LOC101928762,chr16,F,31041931,31049816,42763516,7885,583924766,14179,2
101928829,LOC101928829,chr16,F,31508435,31509569,42764650,1134,583925900,14180,1
101928880,LOC101928880,chr16,F,88194280,88195217,42765587,937,583926837,14181,2
101929031,LOC101929031,chr16,R,33562874,33571660,42774373,8786,583935623,14182,5
101929280,LOC101929280,chr16,F,594996,597964,42777341,2968,583938591,14183,1
101929304,LOC101929304,chr16,F,12570191,12574287,42781437,4096,583942687,14184,3
101929387,LMF1-AS1,chr16,F,921032,934524,42794929,13492,583956179,14185,2
101929440,LOC101929440,chr16,F,1408403,1412251,42798777,3848,583960027,14186,1
101929480,LOC101929480,chr16,R,1713528,1715612,42800861,2084,583962111,14187,1
101929566,LOC101929566,chr16,R,2865836,2868236,42803261,2400,583964511,14188,1
101929605,LOC101929605,chr16,R,33495800,33527959,42835420,32159,583996670,14189,10
101929613,LOC101929613,chr16,F,2998954,3000813,42837279,1859,583998529,14190,5
101929732,LOC101929732,chr16,F,3542233,3559589,42854635,17356,584015885,14191,4
101929989,LOC101929989,chr16,F,8882333,8892650,42864952,10317,584026202,14192,7
101930112,LOC101930112,chr16,F,89490954,89498516,42872514,7562,584033764,14193,1
101930131,LOC101930131,chr16,F,90138062,90156007,42890459,17945,584051709,14194,4
102465134,MIR6126,chr16,R,3485380,3485469,42890548,89,584051798,14195,0
102465251,MIR6504,chr16,F,81611347,81611408,42890609,61,584051859,14196,0
102465252,MIR6506,chr16,R,15611029,15611095,42890675,66,584051925,14197,0
102465429,MIR6511B1,chr16,R,2106668,2106753,42890760,85,584052010,14198,0
102465459,MIR6767,chr16,F,2445391,2445457,42890826,66,584052076,14199,0
102465460,MIR6768,chr16,F,2463966,2464038,42890898,72,584052148,14200,0
102465461,MIR6770-1,chr16,F,14930819,14930879,42890958,60,584052208,14201,0
102465462,MIR6771,chr16,F,50292615,50292675,42891018,60,584052268,14202,0
102465463,MIR6772,chr16,R,57772288,57772352,42891082,64,584052332,14203,0
102465464,MIR6775,chr16,R,87834591,87834660,42891151,69,584052401,14204,0
102465520,MIR6862-1,chr16,R,28390981,28391051,42891221,70,584052471,14205,0
102465683,MIR6511A3,chr16,F,16368875,16368942,42891288,67,584052538,14206,0
102465684,MIR6511A4,chr16,R,18344012,18344079,42891355,67,584052605,14207,0
102465840,MIR7854,chr16,F,81533901,81533966,42891420,65,584052670,14208,0
102465863,MIR8058,chr16,F,82688930,82689019,42891509,89,584052759,14209,0
102465867,MIR8065,chr16,F,5632466,5632566,42891609,100,584052859,14210,0
102465907,MIR6862-2,chr16,F,28724251,28724321,42891679,70,584052929,14211,0
102465908,MIR6770-2,chr16,F,16329304,16329364,42891739,60,584052989,14212,0
102465985,MIR6511B2,chr16,R,15134074,15134145,42891810,71,584053060,14213,0
102466194,MIR6773,chr16,R,68233425,68233499,42891884,74,584053134,14214,0
102466247,MIR1273H,chr16,F,24203115,24203231,42892000,116,584053250,14215,0
102466259,MIR6770-3,chr16,R,18379350,18379410,42892060,60,584053310,14216,0
102466268,MIR6511A1,chr16,F,14925936,14926003,42892127,67,584053377,14217,0
102466731,MIR6769A,chr16,F,4671317,4671390,42892200,73,584053450,14218,0
102466732,MIR6774,chr16,F,85918346,85918416,42892270,70,584053520,14219,0
102466752,MIR6863,chr16,F,56904263,56904353,42892360,90,584053610,14220,0
102466812,MIR6511A2,chr16,F,16324587,16324654,42892427,67,584053677,14221,0
102467079,LOC102467079,chr16,F,52085280,52099067,42906214,13787,584067464,14222,2
102467146,MAFTRR,chr16,R,79721311,79770532,42955435,49221,584116685,14223,5
102723323,LOC102723323,chr16,R,51387700,51525613,43093348,137913,584254598,14224,6
102723373,LOC102723373,chr16,F,53373492,53384259,43104115,10767,584265365,14225,2
102723385,LOC102723385,chr16,R,19062753,19067691,43109053,4938,584270303,14226,4
102723396,LOC102723396,chr16,R,20220736,20232533,43120850,11797,584282100,14227,2
102723466,LOC102723466,chr16,F,56280230,56302899,43143519,22669,584304769,14228,2
102723510,LCMT1-AS1,chr16,R,25100563,25111555,43154511,10992,584315761,14229,2
102723536,LOC102723536,chr16,F,26318130,26364057,43200438,45927,584361688,14230,5
102723550,LOC102723550,chr16,F,62239209,62248068,43209297,8859,584370547,14231,2
102723560,LOC102723560,chr16,F,62725617,62835682,43319362,110065,584480612,14232,4
102723692,LOC102723692,chr16,F,17134468,17138732,43323626,4264,584484876,14233,3
102723708,LOC102723708,chr16,R,29225593,29231787,43329820,6194,584491070,14234,3
102723728,LOC102723728,chr16,R,18417324,18434787,43347283,17463,584508533,14235,8
102723786,LOC102723786,chr16,F,71288807,71309963,43368439,21156,584529689,14236,4
102723796,LOC102723796,chr16,R,71429995,71442046,43380490,12051,584541740,14237,9
102723876,LOC102723876,chr16,F,73764153,73775520,43391857,11367,584553107,14238,5
102724018,LOC102724018,chr16,R,31562664,31596887,43426080,34223,584587330,14239,3
102724047,LOC102724047,chr16,R,78230186,78241459,43437353,11273,584598603,14240,4
102724062,LOC102724062,chr16,F,32600340,32637511,43474524,37171,584635774,14241,15
102724084,LOC102724084,chr16,R,80155957,80563135,43881702,407178,585042952,14242,5
102724101,LOC102724101,chr16,F,33304367,33306938,43884273,2571,585045523,14243,3
102724127,LOC102724127,chr16,F,33459673,33462249,43886849,2576,585048099,14244,3
102724163,LOC102724163,chr16,R,83797235,83803976,43893590,6741,585054840,14245,2
102724207,LOC102724207,chr16,R,33721293,33763756,43936053,42463,585097303,14246,19
102724344,LOC102724344,chr16,F,86716912,86742083,43961224,25171,585122474,14247,8
102724467,LOC102724467,chr16,R,87766330,87779148,43974042,12818,585135292,14248,3
102724485,LOC102724485,chr16,R,34351482,34381482,44004042,30000,585165292,14249,11
102724506,LOC102724506,chr16,F,88087375,88089730,44006397,2355,585167647,14250,2
102724523,LOC102724523,chr16,F,34431898,34433114,44007613,1216,585168863,14251,1
102724632,LOC102724632,chr16,F,88903696,88908108,44012025,4412,585173275,14252,3
102724669,LOC102724669,chr16,R,89157889,89158152,44012288,263,585173538,14253,2
102724730,LOC102724730,chr16,R,89833422,89835956,44014822,2534,585176072,14254,1
102724847,LOC102724847,chr16,F,49162682,49170015,44022155,7333,585183405,14255,4
102724859,LOC102724859,chr16,F,49282050,49290362,44030467,8312,585191717,14256,4
102724907,LOC102724907,chr16,R,50734701,50742815,44038581,8114,585199831,14257,3
102724927,LOC102724927,chr16,R,3947608,3950444,44041417,2836,585202667,14258,1
102724928,LOC102724928,chr16,F,35030346,35060345,44071416,29999,585232666,14259,12
102724940,LOC102724940,chr16,F,50880172,50901061,44092305,20889,585253555,14260,5
102725116,LOC102725116,chr16,F,56108955,56136743,44120093,27788,585281343,14261,5
102725168,LOC102725168,chr16,F,71326162,71328977,44122908,2815,585284158,14262,2
103504726,MIR3670-3,chr16,R,18405697,18405762,44122973,65,585284223,14263,0
103504729,MIR3179-4,chr16,R,18494492,18494576,44123057,84,585284307,14264,0
103504738,MIR6859-4,chr16,R,17051,17119,44123125,68,585284375,14265,0
103504740,MIR3670-4,chr16,R,18488300,18488365,44123190,65,585284440,14266,0
103752587,FOXC2-AS1,chr16,R,86565144,86567761,44125807,2617,585287057,14267,1
104266959,LINC01195,chr16,R,9446012,9455505,44135300,9493,585296550,14268,4
104355218,LINC01177,chr16,R,9441293,9444985,44138992,3692,585300242,14269,3
104644205,ENPP7P13,chr16,F,33769376,33784275,44153891,14899,585315141,14270,2
105369154,LOC105369154,chr16,R,15136204,15154766,44172453,18562,585333703,14271,5
105369155,LOC105369155,chr16,R,67210433,67226998,44189018,16565,585350268,14272,3
105369182,LOC105369182,chr16,R,28341323,28366318,44214013,24995,585375263,14273,2
105369183,LOC105369183,chr16,R,33966103,33975873,44223783,9770,585385033,14274,6
105369184,LOC105369184,chr16,R,32290340,32310965,44244408,20625,585405658,14275,4
105369213,LOC105369213,chr16,F,81739030,81777318,44282696,38288,585443946,14276,6
105369246,LOC105369246,chr16,R,88089866,88090794,44283624,928,585444874,14277,0
105369266,LOC105369266,chr16,R,33329443,33331189,44285370,1746,585446620,14278,2
105369297,LOC105369297,chr16,R,25649435,25671222,44307157,21787,585468407,14279,4
105371036,LOC105371036,chr16,R,383435,386986,44310708,3551,585471958,14280,2
105371037,LOC105371037,chr16,R,417947,425520,44318281,7573,585479531,14281,2
105371038,LOC105371038,chr16,R,648481,649313,44319113,832,585480363,14282,1
105371039,LOC105371039,chr16,R,664985,665575,44319703,590,585480953,14283,1
105371041,LOC105371041,chr16,F,849812,853977,44323868,4165,585485118,14284,1
105371042,LOC105371042,chr16,R,1126623,1134385,44331630,7762,585492880,14285,4
105371043,LOC105371043,chr16,R,1200822,1201711,44332519,889,585493769,14286,2
105371044,LOC105371044,chr16,R,1425550,1428843,44335812,3293,585497062,14287,1
105371045,LOC105371045,chr16,F,1430308,1433421,44338925,3113,585500175,14288,1
105371046,LOC105371046,chr16,F,1604315,1610328,44344938,6013,585506188,14289,1
105371047,LOC105371047,chr16,R,1530387,1533569,44348120,3182,585509370,14290,2
105371048,LOC105371048,chr16,F,1888946,1890434,44349608,1488,585510858,14291,1
105371049,LOC105371049,chr16,F,2091435,2094884,44353057,3449,585514307,14292,2
105371050,LOC105371050,chr16,R,2451611,2460022,44361468,8411,585522718,14293,3
105371051,LOC105371051,chr16,F,2308629,2311570,44364409,2941,585525659,14294,2
105371052,LOC105371052,chr16,R,2464149,2471062,44371322,6913,585532572,14295,2
105371054,LOC105371054,chr16,F,2857853,2861778,44375247,3925,585536497,14296,2
105371055,LOC105371055,chr16,R,2939884,2956156,44391519,16272,585552769,14297,4
105371056,LOC105371056,chr16,R,3006566,3007459,44392412,893,585553662,14298,1
105371057,LOC105371057,chr16,R,3038005,3045919,44400326,7914,585561576,14299,3
105371058,LOC105371058,chr16,R,3077271,3087169,44410224,9898,585571474,14300,3
105371059,LOC105371059,chr16,F,3364675,3399669,44445218,34994,585606468,14301,2
105371060,LOC105371060,chr16,F,3565039,3579753,44459932,14714,585621182,14302,3
105371061,LOC105371061,chr16,R,3651927,3657767,44465772,5840,585627022,14303,2
105371062,LOC105371062,chr16,R,4180116,4181987,44467643,1871,585628893,14304,1
105371063,LOC105371063,chr16,F,4254513,4255336,44468466,823,585629716,14305,2
105371064,LOC105371064,chr16,F,4895351,4926651,44499766,31300,585661016,14306,6
105371065,LOC105371065,chr16,F,5133264,5143508,44510010,10244,585671260,14307,1
105371066,LOC105371066,chr16,R,5213786,5220692,44516916,6906,585678166,14308,3
105371067,LOC105371067,chr16,F,5198456,5235849,44554309,37393,585715559,14309,3
105371068,LOC105371068,chr16,R,7042800,7055584,44567093,12784,585728343,14310,6
105371069,LOC105371069,chr16,R,7855124,7894384,44606353,39260,585767603,14311,2
105371070,LOC105371070,chr16,R,7982100,8112633,44736886,130533,585898136,14312,2
105371071,LOC105371071,chr16,F,8296493,8299377,44739770,2884,585901020,14313,3
105371072,LOC105371072,chr16,F,8379166,8404151,44764755,24985,585926005,14314,2
105371073,LOC105371073,chr16,F,8664175,8674373,44774953,10198,585936203,14315,2
105371074,LOC105371074,chr16,F,8961504,8966990,44780439,5486,585941689,14316,1
105371075,LOC105371075,chr16,F,9294817,9297974,44783596,3157,585944846,14317,1
105371076,LOC105371076,chr16,F,10031636,10037297,44789257,5661,585950507,14318,2
105371077,LOC105371077,chr16,F,9791750,9809101,44806608,17351,585967858,14319,3
105371078,LOC105371078,chr16,R,10215429,10252643,44843822,37214,586005072,14320,5
105371079,LOC105371079,chr16,F,10691169,10692971,44845624,1802,586006874,14321,1
105371080,LOC105371080,chr16,R,10842198,10889476,44892902,47278,586054152,14322,3
105371081,LOC105371081,chr16,R,11129370,11131519,44895051,2149,586056301,14323,1
105371082,LOC105371082,chr16,F,11249045,11396486,45042492,147441,586203742,14324,6
105371083,LOC105371083,chr16,R,11341808,11345299,45045983,3491,586207233,14325,1
105371084,LOC105371084,chr16,F,11851567,11896551,45090967,44984,586252217,14326,2
105371085,LOC105371085,chr16,R,12550537,12568499,45108929,17962,586270179,14327,3
105371086,LOC105371086,chr16,R,12546523,12549278,45111684,2755,586272934,14328,2
105371087,LOC105371087,chr16,F,12372670,12373904,45112918,1234,586274168,14329,2
105371088,LOC105371088,chr16,R,12651917,12653370,45114371,1453,586275621,14330,1
105371089,LOC105371089,chr16,F,12759161,12760745,45115955,1584,586277205,14331,1
105371090,LOC105371090,chr16,F,12745839,12759157,45129273,13318,586290523,14332,4
105371091,LOC105371091,chr16,R,13185655,13203387,45147005,17732,586308255,14333,3
105371092,LOC105371092,chr16,R,12937514,12957598,45167089,20084,586328339,14334,4
105371093,LOC105371093,chr16,R,13882847,13926606,45210848,43759,586372098,14335,6
105371094,LOC105371094,chr16,F,14486795,14489038,45213091,2243,586374341,14336,1
105371095,LOC105371095,chr16,R,14695768,14703638,45220961,7870,586382211,14337,3
105371096,LOC105371096,chr16,F,15181165,15195343,45235139,14178,586396389,14338,4
105371097,LOC105371097,chr16,R,15282375,15300457,45253221,18082,586414471,14339,2
105371098,LOC105371098,chr16,R,16380295,16398504,45271430,18209,586432680,14340,2
105371099,LOC105371099,chr16,R,16294415,16312316,45289331,17901,586450581,14341,3
105371100,LOC105371100,chr16,F,16208604,16218808,45299535,10204,586460785,14342,4
105371101,LOC105371101,chr16,F,16143752,16164106,45319889,20354,586481139,14343,3
105371102,LOC105371102,chr16,R,15504719,15521028,45336198,16309,586497448,14344,3
105371103,LOC105371103,chr16,F,15359068,15380921,45358051,21853,586519301,14345,4
105371105,LOC105371105,chr16,F,16455616,16473684,45376119,18068,586537369,14346,2
105371106,LOC105371106,chr16,R,17471010,17483616,45388725,12606,586549975,14347,2
105371107,LOC105371107,chr16,R,17826025,17831835,45394535,5810,586555785,14348,2
105371108,LOC105371108,chr16,F,18092972,18106954,45408517,13982,586569767,14349,4
105371111,LOC105371111,chr16,R,18820568,18827194,45415143,6626,586576393,14350,1
105371113,LOC105371113,chr16,F,19334176,19337799,45418766,3623,586580016,14351,2
105371114,LOC105371114,chr16,R,19344392,19393463,45467837,49071,586629087,14352,6
105371115,LOC105371115,chr16,R,19761160,19766822,45473499,5662,586634749,14353,2
105371116,LOC105371116,chr16,F,19923591,19929225,45479133,5634,586640383,14354,2
105371117,LOC105371117,chr16,F,19976375,19985078,45487836,8703,586649086,14355,3
105371118,LOC105371118,chr16,F,20208603,20209281,45488514,678,586649764,14356,2
105371119,LOC105371119,chr16,R,20440696,20447517,45495335,6821,586656585,14357,3
105371120,LOC105371120,chr16,F,20580370,20583653,45498618,3283,586659868,14358,2
105371121,LOC105371121,chr16,R,20830578,20839811,45507851,9233,586669101,14359,1
105371123,LOC105371123,chr16,R,21227418,21244079,45524512,16661,586685762,14360,3
105371124,LOC105371124,chr16,F,21252995,21277422,45548939,24427,586710189,14361,2
105371125,LOC105371125,chr16,F,21290469,21294346,45552816,3877,586714066,14362,2
105371126,LOC105371126,chr16,R,21761323,21793090,45584583,31767,586745833,14363,4
105371129,LOC105371129,chr16,R,22086200,22092293,45590676,6093,586751926,14364,4
105371130,LOC105371130,chr16,F,22382083,22407457,45616050,25374,586777300,14365,4
105371131,LOC105371131,chr16,R,22532771,22538879,45622158,6108,586783408,14366,2
105371132,LOC105371132,chr16,R,22577465,22608063,45652756,30598,586814006,14367,5
105371133,LOC105371133,chr16,F,21399786,21424972,45677942,25186,586839192,14368,2
105371140,LOC105371140,chr16,F,23560805,23562004,45679141,1199,586840391,14369,1
105371141,LOC105371141,chr16,R,24100770,24116727,45695098,15957,586856348,14370,2
105371142,LOC105371142,chr16,F,24236052,24252860,45711906,16808,586873156,14371,6
105371143,LOC105371143,chr16,R,24465526,24479097,45725477,13571,586886727,14372,2
105371144,LOC105371144,chr16,F,25075794,25078786,45728469,2992,586889719,14373,1
105371145,LOC105371145,chr16,R,25069453,25083036,45742052,13583,586903302,14374,2
105371146,LOC105371146,chr16,R,25418282,25433666,45757436,15384,586918686,14375,4
105371147,LOC105371147,chr16,F,25490961,25503824,45770299,12863,586931549,14376,3
105371148,LOC105371148,chr16,R,25736009,25743842,45778132,7833,586939382,14377,3
105371149,LOC105371149,chr16,R,26269113,26270862,45779881,1749,586941131,14378,2
105371150,LOC105371150,chr16,R,26280442,26310707,45810146,30265,586971396,14379,2
105371151,LOC105371151,chr16,R,26299974,26302012,45812184,2038,586973434,14380,2
105371152,LOC105371152,chr16,R,26584771,26595452,45822865,10681,586984115,14381,2
105371153,LOC105371153,chr16,R,27041192,27048445,45830118,7253,586991368,14382,5
105371154,LOC105371154,chr16,R,27061983,27083988,45852123,22005,587013373,14383,3
105371155,LOC105371155,chr16,R,27151309,27153864,45854678,2555,587015928,14384,2
105371157,LOC105371157,chr16,R,27746107,27747890,45856461,1783,587017711,14385,2
105371158,LOC105371158,chr16,F,28097473,28111036,45870024,13563,587031274,14386,1
105371159,LOC105371159,chr16,R,29291885,29294351,45872490,2466,587033740,14387,2
105371160,LOC105371160,chr16,R,29174986,29183990,45881494,9004,587042744,14388,3
105371161,LOC105371161,chr16,R,29133343,29141824,45889975,8481,587051225,14389,2
105371162,LOC105371162,chr16,R,29130313,29132441,45892103,2128,587053353,14390,2
105371163,LOC105371163,chr16,F,28837638,28842699,45897164,5061,587058414,14391,1
105371164,LOC105371164,chr16,F,28597304,28603054,45902914,5750,587064164,14392,4
105371165,LOC105371165,chr16,F,28492367,28493602,45904149,1235,587065399,14393,2
105371166,LOC105371166,chr16,R,29808648,29809533,45905034,885,587066284,14394,1
105371167,LOC105371167,chr16,F,29787512,29788123,45905645,611,587066895,14395,1
105371168,LOC105371168,chr16,F,29597790,29603655,45911510,5865,587072760,14396,1
105371169,LOC105371169,chr16,F,30370113,30373010,45914407,2897,587075657,14397,4
105371171,LOC105371171,chr16,R,31487195,31488492,45915704,1297,587076954,14398,1
105371173,LOC105371173,chr16,R,31542750,31553607,45926561,10857,587087811,14399,2
105371174,LOC105371174,chr16,F,32044692,32050933,45932802,6241,587094052,14400,2
105371177,LOC105371177,chr16,R,32693598,32694298,45933502,700,587094752,14401,2
105371178,LOC105371178,chr16,F,32638674,32666543,45961371,27869,587122621,14402,6
105371179,LOC105371179,chr16,R,32636693,32650869,45975547,14176,587136797,14403,2
105371180,LOC105371180,chr16,R,32356876,32359017,45977688,2141,587138938,14404,2
105371182,LOC105371182,chr16,F,32126413,32131304,45982579,4891,587143829,14405,1
105371183,LOC105371183,chr16,R,33666639,33676044,45991984,9405,587153234,14406,2
105371184,LOC105371184,chr16,R,678506,680527,45994005,2021,587155255,14407,4
105371191,LOC105371191,chr16,R,32329726,32349365,46013644,19639,587174894,14408,5
105371192,LOC105371192,chr16,F,33027233,33062726,46049137,35493,587210387,14409,4
105371195,LOC105371195,chr16,R,35025591,35030242,46053788,4651,587215038,14410,2
105371197,LOC105371197,chr16,F,35139992,35145951,46059747,5959,587220997,14411,3
105371198,LOC105371198,chr16,F,35327466,35333893,46066174,6427,587227424,14412,2
105371199,LOC105371199,chr16,R,35319030,35327711,46074855,8681,587236105,14413,3
105371200,LOC105371200,chr16,F,35207859,35244710,46111706,36851,587272956,14414,5
105371201,LOC105371201,chr16,F,35398492,35401780,46114994,3288,587276244,14415,2
105371202,LOC105371202,chr16,F,35466229,35476658,46125423,10429,587286673,14416,2
105371203,LOC105371203,chr16,F,35450770,35457947,46132600,7177,587293850,14417,2
105371204,LOC105371204,chr16,F,35506330,35524631,46150901,18301,587312151,14418,6
105371205,LOC105371205,chr16,R,35555700,35565022,46160223,9322,587321473,14419,2
105371236,LOC105371236,chr16,R,47744169,47753802,46169856,9633,587331106,14420,5
105371237,LOC105371237,chr16,R,47953038,47965551,46182369,12513,587343619,14421,3
105371238,LOC105371238,chr16,F,47965569,47971685,46188485,6116,587349735,14422,2
105371240,LOC105371240,chr16,F,48623437,48748924,46313972,125487,587475222,14423,3
105371241,LOC105371241,chr16,R,49075572,49122735,46361135,47163,587522385,14424,5
105371243,LOC105371243,chr16,R,49312510,49316515,46365140,4005,587526390,14425,1
105371244,LOC105371244,chr16,R,49374121,49454091,46445110,79970,587606360,14426,8
105371245,LOC105371245,chr16,F,49454228,49460767,46451649,6539,587612899,14427,2
105371248,LOC105371248,chr16,R,50390915,50395692,46456426,4777,587617676,14428,1
105371250,LOC105371250,chr16,F,50505996,50522561,46472991,16565,587634241,14429,2
105371251,LOC105371251,chr16,R,50783858,50805332,46494465,21474,587655715,14430,2
105371252,LOC105371252,chr16,F,50805439,50807629,46496655,2190,587657905,14431,1
105371253,LOC105371253,chr16,R,51126626,51135774,46505803,9148,587667053,14432,3
105371255,LOC105371255,chr16,F,51151941,51189290,46543152,37349,587704402,14433,2
105371256,LOC105371256,chr16,F,51362001,51377976,46559127,15975,587720377,14434,4
105371257,LOC105371257,chr16,R,51719079,51767172,46607220,48093,587768470,14435,3
105371258,LOC105371258,chr16,R,51918215,51921151,46610156,2936,587771406,14436,2
105371259,LOC105371259,chr16,R,51985398,51994589,46619347,9191,587780597,14437,2
105371261,LOC105371261,chr16,F,52239679,52269440,46649108,29761,587810358,14438,3
105371262,LOC105371262,chr16,F,52416789,52419866,46652185,3077,587813435,14439,2
105371263,LOC105371263,chr16,F,52622463,52630327,46660049,7864,587821299,14440,1
105371264,LOC105371264,chr16,F,52607053,52613908,46666904,6855,587828154,14441,4
105371265,LOC105371265,chr16,F,52581251,52588579,46674232,7328,587835482,14442,3
105371266,LOC105371266,chr16,R,52763334,52764102,46675000,768,587836250,14443,1
105371267,LOC105371267,chr16,R,52975952,53052917,46751965,76965,587913215,14444,4
105371268,LOC105371268,chr16,R,53510283,53519535,46761217,9252,587922467,14445,1
105371269,LOC105371269,chr16,R,53544358,53560428,46777287,16070,587938537,14446,7
105371270,LOC105371270,chr16,F,53560727,53580951,46797511,20224,587958761,14447,2
105371271,LOC105371271,chr16,F,54056197,54057437,46798751,1240,587960001,14448,1
105371272,LOC105371272,chr16,F,54370407,54374716,46803060,4309,587964310,14449,2
105371273,LOC105371273,chr16,R,54545727,54559078,46816411,13351,587977661,14450,2
105371274,LOC105371274,chr16,F,54634441,54652152,46834122,17711,587995372,14451,2
105371275,LOC105371275,chr16,R,54853552,54893566,46874136,40014,588035386,14452,2
105371276,LOC105371276,chr16,F,54847215,54854994,46881915,7779,588043165,14453,2
105371278,LOC105371278,chr16,R,55042997,55049302,46888220,6305,588049470,14454,2
105371279,LOC105371279,chr16,R,55366722,55369570,46891068,2848,588052318,14455,2
105371280,LOC105371280,chr16,R,55714265,55721836,46898639,7571,588059889,14456,3
105371282,LOC105371282,chr16,R,56264874,56269568,46903333,4694,588064583,14457,1
105371284,LOC105371284,chr16,R,56609414,56611920,46905839,2506,588067089,14458,1
105371285,LOC105371285,chr16,R,56684103,56687406,46909142,3303,588070392,14459,2
105371286,LOC105371286,chr16,R,56708898,56730015,46930259,21117,588091509,14460,2
105371287,LOC105371287,chr16,F,56708828,56724575,46946006,15747,588107256,14461,2
105371289,LOC105371289,chr16,R,57133494,57135445,46947957,1951,588109207,14462,1
105371290,LOC105371290,chr16,F,57255510,57256164,46948611,654,588109861,14463,1
105371291,LOC105371291,chr16,R,57567662,57607352,46988301,39690,588149551,14464,3
105371292,LOC105371292,chr16,R,57661857,57663443,46989887,1586,588151137,14465,1
105371293,LOC105371293,chr16,R,58238572,58249851,47001166,11279,588162416,14466,4
105371294,LOC105371294,chr16,F,58295068,58300850,47006948,5782,588168198,14467,2
105371295,LOC105371295,chr16,F,58461537,58462856,47008267,1319,588169517,14468,1
105371296,LOC105371296,chr16,R,58847742,58880381,47040906,32639,588202156,14469,2
105371297,LOC105371297,chr16,F,58684668,58707611,47063849,22943,588225099,14470,1
105371298,LOC105371298,chr16,R,59404809,59463769,47122809,58960,588284059,14471,8
105371299,LOC105371299,chr16,R,59944169,59971667,47150307,27498,588311557,14472,7
105371300,LOC105371300,chr16,R,59916261,59942774,47176820,26513,588338070,14473,8
105371301,LOC105371301,chr16,R,61229803,61230416,47177433,613,588338683,14474,1
105371302,LOC105371302,chr16,F,61365503,61447716,47259646,82213,588420896,14475,2
105371304,LOC105371304,chr16,F,61457939,61470116,47271823,12177,588433073,14476,2
105371305,LOC105371305,chr16,F,61918320,61940988,47294491,22668,588455741,14477,3
105371306,LOC105371306,chr16,F,62679267,62682241,47297465,2974,588458715,14478,2
105371307,LOC105371307,chr16,R,63058087,63090302,47329680,32215,588490930,14479,2
105371308,LOC105371308,chr16,R,63286913,63618092,47660859,331179,588822109,14480,4
105371309,LOC105371309,chr16,F,63847044,63848553,47662368,1509,588823618,14481,2
105371310,LOC105371310,chr16,F,64344304,64535040,47853104,190736,589014354,14482,7
105371311,LOC105371311,chr16,F,64345029,64346589,47854664,1560,589015914,14483,1
105371313,LOC105371313,chr16,F,64904798,64916386,47866252,11588,589027502,14484,2
105371314,LOC105371314,chr16,F,65123754,65138818,47881316,15064,589042566,14485,3
105371315,LOC105371315,chr16,F,66092838,66110408,47898886,17570,589060136,14486,2
105371316,LOC105371316,chr16,F,66134970,66146599,47910515,11629,589071765,14487,2
105371317,LOC105371317,chr16,R,66238827,66267047,47938735,28220,589099985,14488,5
105371318,LOC105371318,chr16,R,66363895,66375804,47950644,11909,589111894,14489,2
105371319,LOC105371319,chr16,R,67142020,67143329,47951953,1309,589113203,14490,1
105371320,LOC105371320,chr16,R,67265113,67279235,47966075,14122,589127325,14491,2
105371321,LOC105371321,chr16,R,68512108,68514920,47968887,2812,589130137,14492,2
105371322,LOC105371322,chr16,R,69176075,69185253,47978065,9178,589139315,14493,2
105371323,LOC105371323,chr16,R,69324573,69325534,47979026,961,589140276,14494,1
105371325,LOC105371325,chr16,F,69522996,69524557,47980587,1561,589141837,14495,2
105371326,LOC105371326,chr16,F,69965013,69973864,47989438,8851,589150688,14496,3
105371328,LOC105371328,chr16,F,70188315,70189006,47990129,691,589151379,14497,2
105371329,LOC105371329,chr16,F,70417365,70426903,47999667,9538,589160917,14498,3
105371331,LOC105371331,chr16,F,71230088,71264909,48034488,34821,589195738,14499,2
105371332,LOC105371332,chr16,R,71366588,71392136,48060036,25548,589221286,14500,5
105371333,LOC105371333,chr16,R,71410314,71425946,48075668,15632,589236918,14501,3
105371334,LOC105371334,chr16,R,71583768,71621373,48113273,37605,589274523,14502,2
105371335,LOC105371335,chr16,F,71513810,71517852,48117315,4042,589278565,14503,1
105371336,LOC105371336,chr16,R,71629620,71631470,48119165,1850,589280415,14504,1
105371338,LOC105371338,chr16,F,72806103,72812010,48125072,5907,589286322,14505,2
105371339,LOC105371339,chr16,F,72787277,72822786,48160581,35509,589321831,14506,2
105371340,LOC105371340,chr16,F,72266837,72287212,48180956,20375,589342206,14507,2
105371341,LOC105371341,chr16,F,72203688,72207719,48184987,4031,589346237,14508,2
105371342,LOC105371342,chr16,F,73815649,73816011,48185349,362,589346599,14509,1
105371343,LOC105371343,chr16,F,74843104,74845444,48187689,2340,589348939,14510,2
105371344,LOC105371344,chr16,F,75255952,75263167,48194904,7215,589356154,14511,2
105371345,LOC105371345,chr16,F,75280280,75293602,48208226,13322,589369476,14512,3
105371346,LOC105371346,chr16,R,75714023,75732740,48226943,18717,589388193,14513,4
105371347,LOC105371347,chr16,R,75835346,75860845,48252442,25499,589413692,14514,5
105371348,LOC105371348,chr16,F,75905098,75915651,48262995,10553,589424245,14515,3
105371349,LOC105371349,chr16,R,76064639,76121808,48320164,57169,589481414,14516,3
105371350,LOC105371350,chr16,F,77590781,77626235,48355618,35454,589516868,14517,3
105371351,LOC105371351,chr16,R,77934504,77949736,48370850,15232,589532100,14518,5
105371352,LOC105371352,chr16,R,79202623,79211600,48379827,8977,589541077,14519,1
105371353,LOC105371353,chr16,R,78793580,78796778,48383025,3198,589544275,14520,1
105371355,LOC105371355,chr16,R,78495770,78506613,48393868,10843,589555118,14521,3
105371356,LOC105371356,chr16,F,79675953,79747103,48465018,71150,589626268,14522,7
105371357,LOC105371357,chr16,F,80051343,80168480,48582155,117137,589743405,14523,6
105371358,LOC105371358,chr16,R,80080691,80109575,48611039,28884,589772289,14524,4
105371359,LOC105371359,chr16,R,80257845,80265764,48618958,7919,589780208,14525,2
105371360,LOC105371360,chr16,F,80551854,80555068,48622172,3214,589783422,14526,1
105371361,LOC105371361,chr16,F,81071689,81076598,48627081,4909,589788331,14527,1
105371362,LOC105371362,chr16,R,81629893,81648564,48645752,18671,589807002,14528,2
105371363,LOC105371363,chr16,R,82044332,82064420,48665840,20088,589827090,14529,2
105371365,LOC105371365,chr16,F,82170308,82179276,48674808,8968,589836058,14530,2
105371366,LOC105371366,chr16,R,83720400,83729740,48684148,9340,589845398,14531,2
105371367,LOC105371367,chr16,R,83701655,83717920,48700413,16265,589861663,14532,2
105371368,LOC105371368,chr16,R,83382864,83399617,48717166,16753,589878416,14533,3
105371369,LOC105371369,chr16,R,82707317,82716463,48726312,9146,589887562,14534,4
105371370,LOC105371370,chr16,F,83816440,83831774,48741646,15334,589902896,14535,2
105371371,LOC105371371,chr16,F,83931235,83951460,48761871,20225,589923121,14536,8
105371372,LOC105371372,chr16,R,83929794,83931113,48763190,1319,589924440,14537,2
105371373,LOC105371373,chr16,R,83915608,83920952,48768534,5344,589929784,14538,1
105371374,LOC105371374,chr16,R,84460653,84468407,48776288,7754,589937538,14539,2
105371375,LOC105371375,chr16,F,84504844,84507679,48779123,2835,589940373,14540,1
105371376,LOC105371376,chr16,R,84642648,84650843,48787318,8195,589948568,14541,6
105371377,LOC105371377,chr16,R,84729014,84730815,48789119,1801,589950369,14542,2
105371378,LOC105371378,chr16,F,84780929,84795698,48803888,14769,589965138,14543,7
105371379,LOC105371379,chr16,F,84928219,84943056,48818725,14837,589979975,14544,5
105371380,LOC105371380,chr16,R,85079344,85084100,48823481,4756,589984731,14545,3
105371381,LOC105371381,chr16,R,85119961,85124164,48827684,4203,589988934,14546,2
105371382,LOC105371382,chr16,R,85146383,85168989,48850290,22606,590011540,14547,1
105371383,LOC105371383,chr16,R,85634227,85639847,48855910,5620,590017160,14548,3
105371384,LOC105371384,chr16,R,85575900,85583486,48863496,7586,590024746,14549,1
105371385,LOC105371385,chr16,R,85520672,85522866,48865690,2194,590026940,14550,2
105371386,LOC105371386,chr16,R,85449115,85465819,48882394,16704,590043644,14551,2
105371387,LOC105371387,chr16,F,85182203,85185673,48885864,3470,590047114,14552,2
105371388,LOC105371388,chr16,F,85926019,85949182,48909027,23163,590070277,14553,2
105371389,LOC105371389,chr16,R,86047818,86049340,48910549,1522,590071799,14554,1
105371390,LOC105371390,chr16,F,86645220,86647356,48912685,2136,590073935,14555,2
105371391,LOC105371391,chr16,F,86682343,86696445,48926787,14102,590088037,14556,2
105371392,LOC105371392,chr16,R,86761597,86763965,48929155,2368,590090405,14557,2
105371393,LOC105371393,chr16,R,86846426,87057690,49140419,211264,590301669,14558,5
105371394,LOC105371394,chr16,F,87117559,87120017,49142877,2458,590304127,14559,4
105371397,LOC105371397,chr16,R,87700831,87703017,49145063,2186,590306313,14560,1
105371398,LOC105371398,chr16,R,87678450,87679463,49146076,1013,590307326,14561,2
105371399,LOC105371399,chr16,F,87766255,87775382,49155203,9127,590316453,14562,2
105371400,LOC105371400,chr16,R,87881548,87886124,49159779,4576,590321029,14563,1
105371401,LOC105371401,chr16,R,88177297,88186920,49169402,9623,590330652,14564,2
105371407,LOC105371407,chr16,F,88727206,88728975,49171171,1769,590332421,14565,1
105371408,LOC105371408,chr16,R,88855127,88856579,49172623,1452,590333873,14566,1
105371409,LOC105371409,chr16,F,88925446,88930657,49177834,5211,590339084,14567,1
105371410,LOC105371410,chr16,F,88870753,88872216,49179297,1463,590340547,14568,2
105371411,LOC105371411,chr16,R,89060337,89062351,49181311,2014,590342561,14569,2
105371412,LOC105371412,chr16,F,89071038,89073455,49183728,2417,590344978,14570,2
105371413,LOC105371413,chr16,R,89254590,89257193,49186331,2603,590347581,14571,2
105371414,LOC105371414,chr16,F,89296084,89300962,49191209,4878,590352459,14572,1
105371416,LOC105371416,chr16,R,89682506,89685298,49194001,2792,590355251,14573,1
105371417,LOC105371417,chr16,F,89701490,89703524,49196035,2034,590357285,14574,1
105371418,LOC105371418,chr16,R,89871064,89873296,49198267,2232,590359517,14575,1
105371419,LOC105371419,chr16,R,89846859,89854276,49205684,7417,590366934,14576,1
105371421,LOC105371421,chr16,R,89986148,89987852,49207388,1704,590368638,14577,1
105376746,LOC105376746,chr16,F,80886,83044,49209546,2158,590370796,14578,1
105376747,LOC105376747,chr16,R,14734886,14742760,49217420,7874,590378670,14579,3
105376749,LOC105376749,chr16,R,14748191,14769985,49239214,21794,590400464,14580,4
105376750,LOC105376750,chr16,F,18073873,18076287,49241628,2414,590402878,14581,2
105376751,LOC105376751,chr16,R,18238289,18256304,49259643,18015,590420893,14582,2
105376752,LOC105376752,chr16,R,18358071,18372027,49273599,13956,590434849,14583,7
105376753,LOC105376753,chr16,F,18313387,18331611,49291823,18224,590453073,14584,2
105376770,LOC105376770,chr16,R,55653123,55655652,49294352,2529,590455602,14585,1
105376771,LOC105376771,chr16,F,57917457,57921242,49298137,3785,590459387,14586,1
105376772,LOC105376772,chr16,R,74406534,74407239,49298842,705,590460092,14587,2
105376773,LOC105376773,chr16,R,74388536,74389055,49299361,519,590460611,14588,1
105376774,LOC105376774,chr16,F,76771019,76772931,49301273,1912,590462523,14589,1
105376775,LOC105376775,chr16,R,77462909,77516073,49354437,53164,590515687,14590,3
105376776,LOC105376776,chr16,R,78418619,78437737,49373555,19118,590534805,14591,2
105376777,LOC105376777,chr16,F,84291443,84294838,49376950,3395,590538200,14592,3
105376778,LOC105376778,chr16,F,86049454,86060206,49387702,10752,590548952,14593,1
105376779,LOC105376779,chr16,R,88386926,88391933,49392709,5007,590553959,14594,2
105376780,LOC105376780,chr16,F,89232740,89234453,49394422,1713,590555672,14595,0
105376781,LOC105376781,chr16,F,90158127,90159806,49396101,1679,590557351,14596,2
105376782,LOC105376782,chr16,F,90156048,90157203,49397256,1155,590558506,14597,1
105376783,LOC105376783,chr16,F,90133833,90137822,49401245,3989,590562495,14598,3
105376784,LOC105376784,chr16,F,90122392,90125950,49404803,3558,590566053,14599,1
105376785,LOC105376785,chr16,F,90102672,90106120,49408251,3448,590569501,14600,1
105376786,LOC105376786,chr16,R,90101178,90101838,49408911,660,590570161,14601,1
105376788,LOC105376788,chr16,F,90167496,90168771,49410186,1275,590571436,14602,0
105377820,LOC105377820,chr16,R,35255044,35255540,49410682,496,590571932,14603,1
105379460,LOC105379460,chr16,F,18490567,18500319,49420434,9752,590581684,14604,2
105379461,LOC105379461,chr16,F,20674417,20718430,49464447,44013,590625697,14605,2
105379462,LOC105379462,chr16,F,27926079,27929559,49467927,3480,590629177,14606,2
105379464,LOC105379464,chr16,F,28748970,28774040,49492997,25070,590654247,14607,2
105379465,LOC105379465,chr16,R,32734590,32741112,49499519,6522,590660769,14608,1
105379466,LOC105379466,chr16,F,32235134,32235834,49500219,700,590661469,14609,2
105379467,LOC105379467,chr16,F,32188320,32194848,49506747,6528,590667997,14610,1
105379468,LOC105379468,chr16,R,33203843,33207348,49510252,3505,590671502,14611,1
105379469,LOC105379469,chr16,R,33370462,33373967,49513757,3505,590675007,14612,1
105379470,LOC105379470,chr16,R,33469233,33472738,49517262,3505,590678512,14613,1
105379472,LOC105379472,chr16,F,30394112,30395749,49518899,1637,590680149,14614,2
105379473,LOC105379473,chr16,R,33385982,33387728,49520645,1746,590681895,14615,2
105379474,LOC105379474,chr16,R,33484764,33486510,49522391,1746,590683641,14616,2
105379475,LOC105379475,chr16,F,34381586,34386237,49527042,4651,590688292,14617,2
15,AANAT,chr17,F,76452852,76470790,17938,17938,590706230,14618,9
29,ABR,chr17,R,1003517,1187322,201743,183805,590890035,14619,32
31,ACACA,chr17,R,37084991,37406822,523574,321831,591211866,14620,64
37,ACADVL,chr17,F,7217124,7225267,531717,8143,591220009,14621,20
40,ASIC2,chr17,R,33013086,34156806,1675437,1143720,592363729,14622,10
47,ACLY,chr17,R,41866915,41930542,1739064,63627,592427356,14623,29
51,ACOX1,chr17,R,75941506,75979434,1776992,37928,592465284,14624,14
71,ACTG1,chr17,R,81509970,81512866,1779888,2896,592468180,14625,5
136,ADORA2B,chr17,F,15927782,15975896,1828002,48114,592516294,14626,5
163,AP2B1,chr17,F,35586898,35726417,1967521,139519,592655813,14627,25
218,ALDH3A1,chr17,R,19737983,19748433,1977971,10450,592666263,14628,10
224,ALDH3A2,chr17,F,19648135,19677596,2007432,29461,592695724,14629,11
230,ALDOC,chr17,R,28573114,28576948,2011266,3834,592699558,14630,9
239,ALOX12,chr17,F,6994195,7010754,2027825,16559,592716117,14631,13
242,ALOX12B,chr17,R,8072635,8087703,2042893,15068,592731185,14632,14
245,ALOX12P2,chr17,F,6853575,6900349,2089667,46774,592777959,14633,15
246,ALOX15,chr17,R,4630918,4641665,2100414,10747,592788706,14634,13
247,ALOX15B,chr17,F,8039039,8049134,2110509,10095,592798801,14635,13
314,AOC2,chr17,F,42844591,42850707,2116625,6116,592804917,14636,3
332,BIRC5,chr17,F,78214195,78225635,2128065,11440,592816357,14637,5
350,APOH,chr17,R,66212028,66229438,2145475,17410,592833767,14638,7
379,ARL4D,chr17,F,43398984,43401136,2147627,2152,592835919,14639,2
396,ARHGDIA,chr17,R,81867718,81871406,2151315,3688,592839607,14640,5
409,ARRB2,chr17,F,4710493,4721500,2162322,11007,592850614,14641,16
432,ASGR1,chr17,R,7173430,7179564,2168456,6134,592856748,14642,9
433,ASGR2,chr17,R,7101321,7115522,2182657,14201,592870949,14643,10
443,ASPA,chr17,F,3474109,3499406,2207954,25297,592896246,14644,8
482,ATP1B2,chr17,F,7646626,7657771,2219099,11145,592907391,14645,7
489,ATP2A3,chr17,R,3923868,3964464,2259695,40596,592947987,14646,23
516,ATP5G1,chr17,F,48892785,48895871,2262781,3086,592951073,14647,4
535,ATP6V0A1,chr17,F,42458843,42522579,2326517,63736,593014809,14648,22
642,BLMH,chr17,R,30248194,30292166,2370489,43972,593058781,14649,11
672,BRCA1,chr17,R,43044294,43125483,2451678,81189,593139970,14650,23
708,C1QBP,chr17,R,5432778,5439151,2458051,6373,593146343,14651,5
752,FMNL1,chr17,F,45221905,45247320,2483466,25415,593171758,14652,27
762,CA4,chr17,F,60149940,60159546,2493072,9606,593181364,14653,8
782,CACNB1,chr17,R,39173455,39197703,2517320,24248,593205612,14654,17
786,CACNG1,chr17,F,67044535,67056797,2529582,12262,593217874,14655,3
924,CD7,chr17,R,82314864,82317604,2532322,2740,593220614,14656,3
968,CD68,chr17,F,7579486,7582111,2534947,2625,593223239,14657,5
974,CD79B,chr17,R,63928737,63932353,2538563,3616,593226855,14658,5
990,CDC6,chr17,F,40287688,40303161,2554036,15473,593242328,14659,12
996,CDC27,chr17,R,47117696,47189312,2625652,71616,593313944,14660,19
1018,CDK3,chr17,F,76000905,76005999,2630746,5094,593319038,14661,9
1101,CHAD,chr17,R,50464491,50469881,2636136,5390,593324428,14662,3
1107,CHD3,chr17,F,7884775,7912757,2664118,27982,593352410,14663,44
1140,CHRNB1,chr17,F,7445086,7457613,2676645,12527,593364937,14664,10
1145,CHRNE,chr17,R,4897768,4903128,2682005,5360,593370297,14665,11
1213,CLTC,chr17,F,59619688,59696956,2759273,77268,593447565,14666,35
1236,CCR7,chr17,R,40553768,40565484,2770989,11716,593459281,14667,4
1267,CNP,chr17,F,41966740,41977736,2781985,10996,593470277,14668,4
1277,COL1A1,chr17,R,50184095,50201648,2799538,17553,593487830,14669,50
1352,COX10,chr17,F,14069401,14217922,2948059,148521,593636351,14670,11
1353,COX11,chr17,R,54951897,54968780,2964942,16883,593653234,14671,6
1362,CPD,chr17,F,30378909,30469657,3055690,90748,593743982,14672,21
1366,CLDN7,chr17,R,7259902,7263193,3058981,3291,593747273,14673,4
1394,CRHR1,chr17,F,45784279,45835828,3110530,51549,593798822,14674,13
1398,CRK,chr17,R,1421352,1456267,3145445,34915,593833737,14675,2
1411,CRYBA1,chr17,F,29246856,29254494,3153083,7638,593841375,14676,5
1440,CSF3,chr17,F,40015360,40017813,3155536,2453,593843828,14677,3
1442,CSH1,chr17,R,63894907,63896661,3157290,1754,593845582,14678,4
1443,CSH2,chr17,R,63872011,63873729,3159008,1718,593847300,14679,3
1444,CSHL1,chr17,R,63909601,63911323,3160730,1722,593849022,14680,3
1453,CSNK1D,chr17,R,82239724,82273742,3194748,34018,593883040,14681,12
1468,SLC25A10,chr17,F,81712235,81721016,3203529,8781,593891821,14682,11
1497,CTNS,chr17,F,3636467,3663103,3230165,26636,593918457,14683,11
1534,CYB561,chr17,R,63432303,63446361,3244223,14058,593932515,14684,7
1636,ACE,chr17,F,63477060,63498380,3265543,21320,593953835,14685,25
1655,DDX5,chr17,R,64498255,64506924,3274212,8669,593962504,14686,15
1659,DHX8,chr17,F,43483916,43526796,3317092,42880,594005384,14687,22
1742,DLG4,chr17,R,7189889,7220050,3347253,30161,594035545,14688,24
1747,DLX3,chr17,R,49977078,49995224,3365399,18146,594053691,14689,3
1748,DLX4,chr17,F,49969197,49974959,3371161,5762,594059453,14690,2
1770,DNAH9,chr17,F,11598430,11970168,3742899,371738,594431191,14691,70
1801,DPH1,chr17,F,2030136,2043431,3756194,13295,594444486,14692,12
1819,DRG2,chr17,F,18087866,18107985,3776313,20119,594464605,14693,12
1845,DUSP3,chr17,R,43766120,43779000,3789193,12880,594477485,14694,2
1856,DVL2,chr17,R,7225341,7234548,3798400,9207,594486692,14695,15
1949,EFNB3,chr17,F,7705201,7711375,3804574,6174,594492866,14696,4
1973,EIF4A1,chr17,F,7572705,7579006,3810875,6301,594499167,14697,10
1984,EIF5A,chr17,F,7306998,7312463,3816340,5465,594504632,14698,10
2027,ENO3,chr17,F,4949181,4957131,3824290,7950,594512582,14699,13
2064,ERBB2,chr17,F,39688083,39728662,3864869,40579,594553161,14700,31
2081,ERN1,chr17,R,64043029,64130142,3951982,87113,594640274,14701,21
2118,ETV4,chr17,R,43527842,43546432,3970572,18590,594658864,14702,13
2123,EVI2A,chr17,R,31316409,31321749,3975912,5340,594664204,14703,2
2124,EVI2B,chr17,R,31302869,31314389,3987432,11520,594675724,14704,3
2125,EVPL,chr17,R,76006844,76027452,4008040,20608,594696332,14705,21
2145,EZH1,chr17,R,42700274,42745078,4052844,44804,594741136,14706,20
2186,BPTF,chr17,F,67825527,67984378,4211695,158851,594899987,14707,33
2194,FASN,chr17,R,82078337,82098289,4231647,19952,594919939,14708,42
2232,FDXR,chr17,R,74862496,74873031,4242182,10535,594930474,14709,14
2256,FGF11,chr17,F,7438272,7444932,4248842,6660,594937134,14710,6
2302,FOXJ1,chr17,R,76136332,76141299,4253809,4967,594942101,14711,2
2310,FOXO3B,chr17,R,18665922,18673181,4261068,7259,594949360,14712,0
2314,FLII,chr17,R,18244814,18258916,4275170,14102,594963462,14713,29
2319,FLOT2,chr17,R,28879338,28897697,4293529,18359,594981821,14714,11
2520,GAST,chr17,F,41712325,41715969,4297173,3644,594985465,14715,2
2535,FZD2,chr17,F,44557443,44561262,4300992,3819,594989284,14716,0
2538,G6PC,chr17,F,42900796,42914433,4314629,13637,595002921,14717,4
2548,GAA,chr17,F,80101530,80119881,4332980,18351,595021272,14718,19
2584,GALK1,chr17,R,75757936,75765199,4340243,7263,595028535,14719,7
2642,GCGR,chr17,F,81804131,81814013,4350125,9882,595038417,14720,14
2648,KAT2A,chr17,R,42113110,42121393,4358408,8283,595046700,14721,17
2670,GFAP,chr17,R,44905625,44915552,4368335,9927,595056627,14722,8
2688,GH1,chr17,R,63917192,63918852,4369995,1660,595058287,14723,4
2689,GH2,chr17,R,63880211,63881942,4371726,1731,595060018,14724,3
2695,GIP,chr17,R,48958555,48968593,4381764,10038,595070056,14725,5
2793,GNGT2,chr17,R,49204441,49210574,4387897,6133,595076189,14726,4
2811,GP1BA,chr17,F,4932274,4935030,4390653,2756,595078945,14727,1
2826,CCR10,chr17,R,42679401,42681827,4393079,2426,595081371,14728,1
2837,UTS2R,chr17,F,82374276,82375586,4394389,1310,595082681,14729,0
2873,GPS1,chr17,F,82051350,82057470,4400509,6120,595088801,14730,12
2874,GPS2,chr17,R,7312658,7315339,4403190,2681,595091482,14731,10
2885,GRB2,chr17,R,75318075,75405709,4490824,87634,595179116,14732,5
2886,GRB7,chr17,F,39737908,39747285,4500201,9377,595188493,14733,17
2896,GRN,chr17,F,44345085,44353106,4508222,8021,595196514,14734,12
2905,GRIN2C,chr17,R,74842020,74861514,4527716,19494,595216008,14735,15
3000,GUCY2D,chr17,F,8002669,8020340,4545387,17671,595233679,14736,19
3021,H3F3B,chr17,R,75776433,75779935,4548889,3502,595237181,14737,3
3060,HCRT,chr17,R,42184059,42185452,4550282,1393,595238574,14738,1
3090,HIC1,chr17,F,2055098,2059687,4554871,4589,595243163,14739,2
3131,HLF,chr17,F,55264959,55325065,4614977,60106,595303269,14740,4
3211,HOXB1,chr17,R,48529444,48530910,4616443,1466,595304735,14741,1
3212,HOXB2,chr17,R,48542654,48545031,4618820,2377,595307112,14742,3
3213,HOXB3,chr17,R,48548869,48590282,4660233,41413,595348525,14743,13
3214,HOXB4,chr17,R,48575506,48578381,4663108,2875,595351400,14744,1
3215,HOXB5,chr17,R,48591256,48593741,4665593,2485,595353885,14745,1
3216,HOXB6,chr17,R,48594094,48604992,4676491,10898,595364783,14746,4
3217,HOXB7,chr17,R,48607231,48611021,4680281,3790,595368573,14747,1
3218,HOXB8,chr17,R,48612345,48615112,4683048,2767,595371340,14748,1
3219,HOXB9,chr17,R,48615127,48626473,4694394,11346,595382686,14749,2
3292,HSD17B1,chr17,F,42551942,42555214,4697666,3272,595385958,14750,3
3384,ICAM2,chr17,R,64002594,64020634,4715706,18040,595403998,14751,5
3396,ICT1,chr17,F,75012663,75021261,4724304,8598,595412596,14752,5
3430,IFI35,chr17,F,43006724,43014459,4732039,7735,595420331,14753,6
3487,IGFBP4,chr17,F,40443423,40457730,4746346,14307,595434638,14754,3
3607,FOXK2,chr17,F,82519717,82604607,4831236,84890,595519528,14755,10
3674,ITGA2B,chr17,R,44372180,44389505,4848561,17325,595536853,14756,29
3675,ITGA3,chr17,F,50055975,50090485,4883071,34510,595571363,14757,25
3682,ITGAE,chr17,R,3714624,3801243,4969690,86619,595657982,14758,30
3690,ITGB3,chr17,F,47253841,47312711,5028560,58870,595716852,14759,14
3691,ITGB4,chr17,F,75721341,75757819,5065038,36478,595753330,14760,42
3728,JUP,chr17,R,41754606,41786712,5097144,32106,595785436,14761,16
3759,KCNJ2,chr17,F,70168615,70180044,5108573,11429,595796865,14762,2
3768,KCNJ12,chr17,F,21376386,21419872,5152059,43486,595840351,14763,4
3773,KCNJ16,chr17,F,70075224,70135608,5212443,60384,595900735,14764,9
3837,KPNB1,chr17,F,47649837,47683638,5246244,33801,595934536,14765,22
3838,KPNA2,chr17,F,68035731,68046854,5257367,11123,595945659,14766,11
3857,KRT9,chr17,R,41565840,41572058,5263585,6218,595951877,14767,7
3858,KRT10,chr17,R,40818116,40822618,5268087,4502,595956379,14768,7
3859,KRT12,chr17,R,40861177,40867210,5274120,6033,595962412,14769,7
3860,KRT13,chr17,R,41500980,41505613,5278753,4633,595967045,14770,7
3861,KRT14,chr17,R,41582278,41586895,5283370,4617,595971662,14771,7
3866,KRT15,chr17,R,41513744,41522413,5292039,8669,595980331,14772,8
3868,KRT16,chr17,R,41609777,41612827,5295089,3050,595983381,14773,7
3872,KRT17,chr17,R,41619439,41624630,5300280,5191,595988572,14774,7
3880,KRT19,chr17,R,41523616,41528389,5305053,4773,595993345,14775,5
3881,KRT31,chr17,R,41393723,41397592,5308922,3869,595997214,14776,6
3882,KRT32,chr17,R,41459512,41469252,5318662,9740,596006954,14777,6
3883,KRT33A,chr17,R,41345704,41350812,5323770,5108,596012062,14778,7
3884,KRT33B,chr17,R,41363493,41369800,5330077,6307,596018369,14779,6
3885,KRT34,chr17,R,41377649,41383816,5336244,6167,596024536,14780,7
3886,KRT35,chr17,R,41476688,41482743,5342299,6055,596030591,14781,6
3927,LASP1,chr17,F,38869858,38921770,5394211,51912,596082503,14782,7
3959,LGALS3BP,chr17,R,78971252,78979979,5402938,8727,596091230,14783,5
3965,LGALS9,chr17,F,27631147,27649560,5421351,18413,596109643,14784,11
3975,LHX1,chr17,F,36937474,36944615,5428492,7141,596116784,14785,4
3980,LIG3,chr17,F,34980497,35008448,5456443,27951,596144735,14786,22
3993,LLGL2,chr17,F,75525079,75575209,5506573,50130,596194865,14787,28
3996,LLGL1,chr17,F,18225592,18244875,5525856,19283,596214148,14788,22
4025,LPO,chr17,F,58237736,58268536,5556656,30800,596244948,14789,12
4077,NBR1,chr17,F,43170470,43211689,5597875,41219,596286167,14790,22
4097,MAFG,chr17,R,81918268,81931560,5611167,13292,596299459,14791,5
4137,MAPT,chr17,F,45894381,46028334,5745120,133953,596433412,14792,14
4185,ADAM11,chr17,F,44759036,44781846,5767930,22810,596456222,14793,26
4213,MEIS3P1,chr17,F,15786849,15789705,5770786,2856,596459078,14794,0
4215,MAP3K3,chr17,F,63622208,63696310,5844888,74102,596533180,14795,16
4222,MEOX1,chr17,R,43640388,43661954,5866454,21566,596554746,14796,2
4239,MFAP4,chr17,R,19383441,19387219,5870232,3778,596558524,14797,5
4302,MLLT6,chr17,F,38705619,38729803,5894416,24184,596582708,14798,21
4335,MNT,chr17,R,2384059,2400964,5911321,16905,596599613,14799,8
4353,MPO,chr17,R,58269854,58284313,5925780,14459,596614072,14800,12
4355,MPP2,chr17,R,43875356,43909711,5960135,34355,596648427,14801,18
4356,MPP3,chr17,R,43800798,43833179,5992516,32381,596680808,14802,20
4591,TRIM37,chr17,R,58982637,59106905,6116784,124268,596805076,14803,25
4619,MYH1,chr17,R,10492306,10518542,6143020,26236,596831312,14804,39
4620,MYH2,chr17,R,10521147,10549700,6171573,28553,596859865,14805,40
4621,MYH3,chr17,R,10628525,10679030,6222078,50505,596910370,14806,43
4622,MYH4,chr17,R,10443289,10469559,6248348,26270,596936640,14807,39
4626,MYH8,chr17,R,10390324,10421950,6279974,31626,596968266,14808,38
4628,MYH10,chr17,R,8474204,8631012,6436782,156808,597125074,14809,44
4635,MYL4,chr17,F,47209012,47227697,6455467,18685,597143759,14810,9
4641,MYO1C,chr17,R,1464185,1492707,6483989,28522,597172281,14811,33
4642,MYO1D,chr17,R,32492521,32877173,6868641,384652,597556933,14812,24
4669,NAGLU,chr17,F,42535932,42544449,6877158,8517,597565450,14813,5
4761,NEUROD2,chr17,R,39603767,39607922,6881313,4155,597569605,14814,3
4763,NF1,chr17,F,31007872,31377677,7251118,369805,597939410,14815,72
4779,NFE2L1,chr17,F,48048323,48061545,7264340,13222,597952632,14816,6
4804,NGFR,chr17,F,49495292,49515020,7284068,19728,597972360,14817,5
4830,NME1,chr17,F,51153558,51162089,7292599,8531,597980891,14818,5
4831,NME2,chr17,F,51165434,51171744,7298909,6310,597987201,14819,8
4836,NMT1,chr17,F,45061282,45109016,7346643,47734,598034935,14820,11
4843,NOS2,chr17,R,27756765,27804341,7394219,47576,598082511,14821,28
4884,NPTX1,chr17,R,80466832,80476604,7403991,9772,598092283,14822,4
4905,NSF,chr17,F,46590668,46757464,7570787,166796,598259079,14823,21
4927,NUP88,chr17,R,5386025,5419739,7604501,33714,598292793,14824,17
4974,OMG,chr17,R,31294649,31297362,7607214,2713,598295506,14825,1
4991,OR1D2,chr17,R,3092057,3092996,7608153,939,598296445,14826,0
4994,OR3A1,chr17,R,3288317,3386209,7706045,97892,598394337,14827,2
4995,OR3A2,chr17,R,3277889,3278974,7707130,1085,598395422,14828,0
5023,P2RX1,chr17,R,3896590,3916666,7727206,20076,598415498,14829,11
5026,P2RX5,chr17,R,3673226,3696404,7750384,23178,598438676,14830,14
5034,P4HB,chr17,R,81843157,81860668,7767895,17511,598456187,14831,10
5048,PAFAH1B1,chr17,F,2593628,2685617,7859884,91989,598548176,14832,13
5148,PDE6G,chr17,R,81650458,81657054,7866480,6596,598554772,14833,3
5164,PDK2,chr17,F,50094736,50111369,7883113,16633,598571405,14834,13
5175,PECAM1,chr17,R,64319414,64413801,7977500,94387,598665792,14835,17
5176,SERPINF1,chr17,F,1761964,1777565,7993101,15601,598681393,14836,7
5187,PER1,chr17,R,8140469,8156405,8009037,15936,598697329,14837,23
5193,PEX12,chr17,R,35574794,35578637,8012880,3843,598701172,14838,2
5198,PFAS,chr17,F,8249254,8270491,8034117,21237,598722409,14839,27
5216,PFN1,chr17,R,4945649,4949086,8037554,3437,598725846,14840,2
5245,PHB,chr17,R,49404047,49414905,8048412,10858,598736704,14841,7
5306,PITPNA,chr17,R,1517988,1562816,8093240,44828,598781532,14842,12
5338,PLD2,chr17,F,4807100,4823432,8109572,16332,598797864,14843,24
5345,SERPINF2,chr17,F,1742806,1755265,8122031,12459,598810323,14844,12
5376,PMP22,chr17,R,15229776,15265357,8157612,35581,598845904,14845,6
5409,PNMT,chr17,F,39667980,39670475,8160107,2495,598848399,14846,4
5414,SEPT4,chr17,R,58520249,58540818,8180676,20569,598868968,14847,14
5430,POLR2A,chr17,F,7484378,7514618,8210916,30240,598899208,14848,28
5469,MED1,chr17,R,39404284,39451280,8257912,46996,598946204,14849,16
5539,PPY,chr17,R,43940803,43944248,8261357,3445,598949649,14850,4
5573,PRKAR1A,chr17,F,68413622,68551316,8399051,137694,599087343,14851,15
5578,PRKCA,chr17,F,66302781,66810744,8907014,507963,599595306,14852,20
5598,MAPK7,chr17,F,19377720,19383544,8912838,5824,599601130,14853,8
5606,MAP2K3,chr17,F,21284655,21315240,8943423,30585,599631715,14854,14
5608,MAP2K6,chr17,F,69414696,69542329,9071056,127633,599759348,14855,15
5635,PRPSAP1,chr17,R,76310786,76354149,9114419,43363,599802711,14856,10
5636,PRPSAP2,chr17,F,18856298,18931287,9189408,74989,599877700,14857,13
5691,PSMB3,chr17,F,38752712,38764231,9200927,11519,599889219,14858,5
5694,PSMB6,chr17,F,4796143,4798503,9203287,2360,599891579,14859,5
5697,PYY,chr17,R,43952732,44024260,9274815,71528,599963107,14860,6
5705,PSMC5,chr17,F,63827409,63832027,9279433,4618,599967725,14861,11
5709,PSMD3,chr17,F,39980767,39997960,9296626,17193,599984918,14862,11
5717,PSMD11,chr17,F,32444462,32483319,9335483,38857,600023775,14863,12
5718,PSMD12,chr17,R,67340485,67366605,9361603,26120,600049895,14864,12
5831,PYCR1,chr17,R,81932383,81937328,9366548,4945,600054840,14865,6
5833,PCYT2,chr17,R,81902900,81911477,9375125,8577,600063417,14866,15
5878,RAB5C,chr17,R,42124975,42155044,9405194,30069,600093486,14867,8
5881,RAC3,chr17,F,82031655,82034204,9407743,2549,600096035,14868,5
5889,RAD51C,chr17,F,58692535,58734342,9449550,41807,600137842,14869,11
5892,RAD51D,chr17,R,35099791,35119869,9469628,20078,600157920,14870,10
5914,RARA,chr17,F,40309170,40357643,9518101,48473,600206393,14871,15
5957,RCVRN,chr17,R,9897707,9905367,9525761,7660,600214053,14872,3
5986,RFNG,chr17,R,82047901,82051774,9529634,3873,600217926,14873,8
6066,RNU2-1,chr17,R,43233789,43233977,9529822,188,600218114,14874,0
6117,RPA1,chr17,F,1829978,1899554,9599398,69576,600287690,14875,16
6143,RPL19,chr17,F,39200282,39204727,9603843,4445,600292135,14876,5
6147,RPL23A,chr17,F,28719981,28724356,9608218,4375,600296510,14877,4
6154,RPL26,chr17,R,8377515,8383247,9613950,5732,600302242,14878,3
6155,RPL27,chr17,F,42998428,43002959,9618481,4531,600306773,14879,4
6169,RPL38,chr17,F,74203655,74209880,9624706,6225,600312998,14880,4
6182,MRPL12,chr17,F,81703369,81707526,9628863,4157,600317155,14881,4
6198,RPS6KB1,chr17,F,59893045,59950426,9686244,57381,600374536,14882,18
6329,SCN4A,chr17,R,63938553,63990150,9737841,51597,600426133,14883,24
6341,SCO1,chr17,R,10680331,10697568,9755078,17237,600443370,14884,5
6346,CCL1,chr17,R,34360327,34363233,9757984,2906,600446276,14885,2
6347,CCL2,chr17,F,34255276,34257203,9759911,1927,600448203,14886,2
6348,CCL3,chr17,R,36088255,36090160,9761816,1905,600450108,14887,2
6351,CCL4,chr17,F,36103826,36105621,9763611,1795,600451903,14888,2
6352,CCL5,chr17,R,35871490,35880373,9772494,8883,600460786,14889,3
6354,CCL7,chr17,F,34270215,34272242,9774521,2027,600462813,14890,2
6355,CCL8,chr17,F,34319046,34321402,9776877,2356,600465169,14891,2
6356,CCL11,chr17,F,34285667,34288180,9779390,2513,600467682,14892,2
6357,CCL13,chr17,F,34356451,34358610,9781549,2159,600469841,14893,2
6358,CCL14,chr17,R,35983655,35986728,9784622,3073,600472914,14894,3
6359,CCL15,chr17,R,35997581,36002038,9789079,4457,600477371,14895,7
6360,CCL16,chr17,R,35976492,35982889,9795476,6397,600483768,14896,3
6362,CCL18,chr17,F,36064271,36071481,9802686,7210,600490978,14897,2
6368,CCL23,chr17,R,36013055,36017975,9807606,4920,600495898,14898,3
6388,SDF2,chr17,R,28648355,28662189,9821440,13834,600509732,14899,3
6397,SEC14L1,chr17,F,77088642,77217101,9949899,128459,600638191,14900,20
6398,SECTM1,chr17,R,82321023,82334045,9962921,13022,600651213,14901,5
6416,MAP2K4,chr17,F,12020817,12143831,10085935,123014,600774227,14902,14
6426,SRSF1,chr17,R,58000918,58007346,10092363,6428,600780655,14903,2
6427,SRSF2,chr17,R,76734114,76737629,10095878,3515,600784170,14904,1
6442,SGCA,chr17,F,50165974,50175932,10105836,9958,600794128,14905,9
6448,SGSH,chr17,R,80206965,80220400,10119271,13435,600807563,14906,9
6458,SH3GL1P1,chr17,F,32040335,32042832,10121768,2497,600810060,14907,0
6459,SH3GL1P2,chr17,F,30624317,30626823,10124274,2506,600812566,14908,0
6462,SHBG,chr17,F,7614063,7633383,10143594,19320,600831886,14909,9
6470,SHMT1,chr17,R,18327859,18363563,10179298,35704,600867590,14910,12
6517,SLC2A4,chr17,F,7281734,7288048,10185612,6314,600873904,14911,10
6521,SLC4A1,chr17,R,44248389,44268161,10205384,19772,600893676,14912,21
6532,SLC6A4,chr17,R,30194318,30235968,10247034,41650,600935326,14913,14
6603,SMARCD2,chr17,R,63832080,63842991,10257945,10911,600946237,14914,12
6605,SMARCE1,chr17,R,40627719,40647851,10278077,20132,600966369,14915,10
6613,SUMO2,chr17,R,75167729,75183003,10293351,15274,600981643,14916,3
6662,SOX9,chr17,F,72121019,72126420,10298752,5401,600987044,14917,2
6665,SOX15,chr17,R,7588179,7590170,10300743,1991,600989035,14918,1
6668,SP2,chr17,F,47896053,47932271,10336961,36218,601025253,14919,12
6720,SREBF1,chr17,R,17811348,17837017,10362630,25669,601050922,14920,19
6730,SRP68,chr17,R,76038774,76072526,10396382,33752,601084674,14921,16
6752,SSTR2,chr17,F,73165020,73171955,10403317,6935,601091609,14922,1
6774,STAT3,chr17,R,42313323,42388503,10478497,75180,601166789,14923,23
6776,STAT5A,chr17,F,42287546,42311943,10502894,24397,601191186,14924,19
6777,STAT5B,chr17,R,42199176,42276460,10580178,77284,601268470,14925,19
6827,SUPT4H1,chr17,R,58345174,58352238,10587242,7064,601275534,14926,4
6830,SUPT6H,chr17,F,28662202,28702237,10627277,40035,601315569,14927,40
6844,VAMP2,chr17,R,8159146,8162975,10631106,3829,601319398,14928,5
6871,TADA2A,chr17,F,37406876,37477481,10701711,70605,601390003,14929,17
6904,TBCD,chr17,F,82752059,82943186,10892838,191127,601581130,14930,56
6909,TBX2,chr17,F,61394697,61409466,10907607,14769,601595899,14931,8
6928,HNF1B,chr17,R,37686430,37745078,10966255,58648,601654547,14932,10
6945,MLX,chr17,F,42567059,42573203,10972399,6144,601660691,14933,7
7067,THRA,chr17,F,40062192,40093867,11004074,31675,601692366,14934,10
7077,TIMP2,chr17,R,78852976,78925390,11076488,72414,601764780,14935,4
7083,TK1,chr17,R,78174078,78187204,11089614,13126,601777906,14936,6
7126,TNFAIP1,chr17,F,28335521,28347009,11101102,11488,601789394,14937,6
7153,TOP2A,chr17,R,40388520,40417950,11130532,29430,601818824,14938,35
7156,TOP3A,chr17,R,18273920,18315007,11171619,41087,601859911,14939,18
7157,TP53,chr17,R,7668401,7687550,11190768,19149,601879060,14940,10
7196,TRG-GCC2-4,chr17,F,8125745,8125816,11190839,71,601879131,14941,0
7206,TRK-TTT3-4,chr17,F,8119154,8119227,11190912,73,601879204,14942,0
7208,TRL-TAG1-1,chr17,R,8120313,8120395,11190994,82,601879286,14943,0
7228,TRQ-CTG1-2,chr17,F,8119751,8119823,11191066,72,601879358,14944,0
7229,TRQ-TTG1-1,chr17,F,49192527,49192599,11191138,72,601879430,14945,0
7230,TRR-TCT2-1,chr17,F,8120924,8121012,11191226,88,601879518,14946,1
7233,TRR-CCG2-1,chr17,R,68019896,68019969,11191299,73,601879591,14947,0
7266,DNAJC7,chr17,R,41974004,42021371,11238666,47367,601926958,14948,19
7283,TUBG1,chr17,F,42609339,42615238,11244565,5899,601932857,14949,10
7314,UBB,chr17,F,16380792,16382745,11246518,1953,601934810,14950,2
7326,UBE2G1,chr17,R,4269216,4366674,11343976,97458,602032268,14951,5
7343,UBTF,chr17,R,44205032,44221626,11360570,16594,602048862,14952,24
7442,TRPV1,chr17,R,3565445,3609411,11404536,43966,602092828,14953,18
7448,VTN,chr17,R,28367276,28370352,11407612,3076,602095904,14954,7
7473,WNT3,chr17,R,46762505,46818760,11463867,56255,602152159,14955,4
7484,WNT9B,chr17,F,46833200,46886775,11517442,53575,602205734,14956,5
7531,YWHAE,chr17,R,1344539,1400375,11573278,55836,602261570,14957,7
7566,ZNF18,chr17,R,11977438,11997510,11593350,20072,602281642,14958,10
7703,PCGF2,chr17,R,38733896,38749817,11609271,15921,602297563,14959,12
7706,TRIM25,chr17,R,56887908,56914048,11635411,26140,602323703,14960,8
7716,VEZF1,chr17,R,57971546,57988254,11652119,16708,602340411,14961,6
7732,RNF112,chr17,F,19410789,19417276,11658606,6487,602346898,14962,14
7756,ZNF207,chr17,F,32350137,32408085,11716554,57948,602404846,14963,16
7775,ZNF232,chr17,R,5105733,5123102,11733923,17369,602422215,14964,5
8148,TAF15,chr17,F,35809454,35847242,11771711,37788,602460003,14965,16
8153,RND2,chr17,F,43025240,43032041,11778512,6801,602466804,14966,5
8161,COIL,chr17,R,56938198,56961050,11801364,22852,602489656,14967,6
8165,AKAP1,chr17,F,57085191,57121349,11837522,36158,602525814,14968,14
8288,EPX,chr17,F,58192727,58205174,11849969,12447,602538261,14969,12
8313,AXIN2,chr17,R,65528562,65561622,11883029,33060,602571321,14970,13
8383,OR1A1,chr17,F,3215620,3216550,11883959,930,602572251,14971,0
8386,OR1D5,chr17,R,3062668,3063607,11884898,939,602573190,14972,0
8387,OR1E1,chr17,R,3397465,3398410,11885843,945,602574135,14973,0
8388,OR1E2,chr17,R,3432869,3433841,11886815,972,602575107,14974,0
8390,OR1G1,chr17,R,3126504,3128253,11888564,1749,602576856,14975,1
8392,OR3A3,chr17,F,3420423,3421666,11889807,1243,602578099,14976,1
8396,PIP4K2B,chr17,R,38765688,38799965,11924084,34277,602612376,14977,14
8402,SLC25A11,chr17,R,4937129,4940167,11927122,3038,602615414,14978,7
8405,SPOP,chr17,R,49598883,49678163,12006402,79280,602694694,14979,13
8447,DOC2B,chr17,R,143687,181630,12044345,37943,602732637,14980,11
8456,FOXN1,chr17,F,28506228,28538900,12077017,32672,602765309,14981,12
8493,PPM1D,chr17,F,60600182,60666280,12143115,66098,602831407,14982,6
8506,CNTNAP1,chr17,F,42682613,42699993,12160495,17380,602848787,14983,24
8522,GAS7,chr17,R,9910608,10198551,12448438,287943,603136730,14984,18
8526,DGKE,chr17,F,56834098,56869567,12483907,35469,603172199,14985,14
8533,COPS3,chr17,R,17246623,17281303,12518587,34680,603206879,14986,12
8535,CBX4,chr17,R,79833155,79839414,12524846,6259,603213138,14987,5
8557,TCAP,chr17,F,39665345,39666554,12526055,1209,603214347,14988,1
8578,SCARF1,chr17,R,1633857,1645789,12537987,11932,603226279,14989,10
8631,SKAP1,chr17,R,48133437,48430235,12834785,296798,603523077,14990,18
8632,DNAH17,chr17,R,78423696,78577432,12988521,153736,603676813,14991,81
8639,AOC3,chr17,F,42851122,42858130,12995529,7008,603683821,14992,5
8678,BECN1,chr17,R,42810131,42824292,13009690,14161,603697982,14993,12
8687,KRT38,chr17,R,41436368,41441344,13014666,4976,603702958,14994,6
8688,KRT37,chr17,R,41420556,41424570,13018680,4014,603706972,14995,6
8689,KRT36,chr17,R,41486135,41494015,13026560,7880,603714852,14996,6
8711,TNK1,chr17,F,7380558,7389774,13035776,9216,603724068,14997,13
8714,ABCC3,chr17,F,50634842,50691704,13092638,56862,603780930,14998,30
8735,MYH13,chr17,R,10300865,10373005,13164778,72140,603853070,14999,40
8741,TNFSF13,chr17,F,7558291,7561608,13168095,3317,603856387,15000,5
8742,TNFSF12,chr17,F,7549057,7557890,13176928,8833,603865220,15001,7
8787,RGS9,chr17,F,65137337,65227703,13267294,90366,603955586,15002,19
8811,GALR2,chr17,F,76072087,76077541,13272748,5454,603961040,15003,3
8834,TMEM11,chr17,R,21197949,21214595,13289394,16646,603977686,15004,2
8844,KSR1,chr17,F,27456463,27626441,13459372,169978,604147664,15005,28
8851,CDK5R1,chr17,F,32487086,32491254,13463540,4168,604151832,15006,1
8877,SPHK1,chr17,F,76381566,76387860,13469834,6294,604158126,15007,7
8913,CACNA1G,chr17,F,50561067,50629625,13538392,68558,604226684,15008,37
9001,HAP1,chr17,R,41722638,41734646,13550400,12008,604238692,15009,10
9020,MAP3K14,chr17,R,45263118,45317064,13604346,53946,604292638,15010,16
9021,SOCS3,chr17,R,78356776,78360079,13607649,3303,604295941,15011,1
9032,TM4SF5,chr17,F,4771891,4783211,13618969,11320,604307261,15012,4
9043,SPAG9,chr17,R,50962173,51120865,13777661,158692,604465953,15013,33
9058,SLC13A2,chr17,F,28473356,28497781,13802086,24425,604490378,15014,13
9094,UNC119,chr17,R,28546706,28552628,13808008,5922,604496300,15015,3
9098,USP6,chr17,F,5116437,5175032,13866603,58595,604554895,15016,38
9110,MTMR4,chr17,R,58489531,58518110,13895182,28579,604583474,15017,22
9120,SLC16A6,chr17,R,68267025,68291264,13919421,24239,604607713,15018,8
9121,SLC16A5,chr17,F,75087726,75106162,13937857,18436,604626149,15019,7
9123,SLC16A3,chr17,F,82228405,82239499,13948951,11094,604637243,15020,8
9135,RABEP1,chr17,F,5282262,5386340,14053029,104078,604741321,15021,19
9144,SYNGR2,chr17,F,78168550,78172928,14057407,4378,604745699,15022,2
9146,HGS,chr17,F,81683931,81702121,14075597,18190,604763889,15023,23
9196,KCNAB3,chr17,R,7921858,7929435,14083174,7577,604771466,15024,13
9212,AURKB,chr17,R,8204730,8210776,14089220,6046,604777512,15025,9
9220,TIAF1,chr17,R,29073520,29075609,14091309,2089,604779601,15026,0
9241,NOG,chr17,F,56593698,56595590,14093201,1892,604781493,15027,0
9256,BZRAP1,chr17,R,58301226,58328795,14120770,27569,604809062,15028,33
9267,CYTH1,chr17,R,78674046,78782342,14229066,108296,604917358,15029,16
9326,ZNHIT3,chr17,F,36486626,36499310,14241750,12684,604930042,15030,5
9340,GLP2R,chr17,F,9825542,9892104,14308312,66562,604996604,15031,13
9343,EFTUD2,chr17,R,44850286,44899625,14357651,49339,605045943,15032,28
9349,RPL23,chr17,R,38850067,38853800,14361384,3733,605049676,15033,4
9368,SLC9A3R1,chr17,F,74748611,74769360,14382133,20749,605070425,15034,5
9382,COG1,chr17,F,73193033,73208507,14397607,15474,605085899,15035,13
9400,RECQL5,chr17,R,75626844,75667191,14437954,40347,605126246,15036,23
9423,NTN1,chr17,F,9021541,9244000,14660413,222459,605348705,15037,7
9482,STX8,chr17,R,9250470,9575958,14985901,325488,605674193,15038,9
9487,PIGL,chr17,F,16217194,16349164,15117871,131970,605806163,15039,9
9489,PGS1,chr17,F,78378617,78424659,15163913,46042,605852205,15040,11
9496,TBX4,chr17,F,61444625,61485110,15204398,40485,605892690,15041,14
9501,RPH3AL,chr17,R,212388,386254,15378264,173866,606066556,15042,12
9513,FXR2,chr17,R,7591229,7614897,15401932,23668,606090224,15043,17
9520,NPEPPS,chr17,F,47522949,47623276,15502259,100327,606190551,15044,23
9526,MPDU1,chr17,F,7583646,7588212,15506825,4566,606195117,15045,5
9527,GOSR1,chr17,F,30477407,30526814,15556232,49407,606244524,15046,9
9552,SPAG7,chr17,R,4959225,4967837,15564844,8612,606253136,15047,7
9560,CCL4L2,chr17,F,36211062,36212878,15566660,1816,606254952,15048,1
9570,GOSR2,chr17,F,46923113,46967000,15610547,43887,606298839,15049,15
9572,NR1D1,chr17,R,40092783,40100725,15618489,7942,606306781,15050,7
9611,NCOR1,chr17,R,16030093,16216746,15805142,186653,606493434,15051,50
9618,TRAF4,chr17,F,28744004,28750958,15812096,6954,606500388,15052,7
9625,AATK,chr17,R,81117294,81166072,15860874,48778,606549166,15053,19
9703,KIAA0100,chr17,R,28614439,28645159,15891594,30720,606579886,15054,38
9706,ULK2,chr17,R,19770827,19867926,15988693,97099,606676985,15055,27
9720,CCDC144A,chr17,F,16690234,16774999,16073458,84765,606761750,15056,20
9744,ACAP1,chr17,F,7336510,7351478,16088426,14968,606776718,15057,21
9755,TBKBP1,chr17,F,47694064,47712063,16106425,17999,606794717,15058,11
9772,KIAA0195,chr17,F,75441158,75500452,16165719,59294,606854011,15059,35
9775,EIF4A3,chr17,R,80135213,80147183,16177689,11970,606865981,15060,11
9842,PLEKHM1,chr17,R,45434246,45490780,16234223,56534,606922515,15061,16
9851,KIAA0753,chr17,R,6578150,6641744,16297817,63594,606986109,15062,25
9862,MED24,chr17,R,40019096,40054636,16333357,35540,607021649,15063,26
9884,LRRC37A,chr17,F,46239318,46337794,16431833,98476,607120125,15064,18
9902,MRC2,chr17,F,62626514,62693601,16498920,67087,607187212,15065,30
9905,SGSM2,chr17,F,2337511,2381074,16542483,43563,607230775,15066,26
9912,ARHGAP44,chr17,F,12789511,12991643,16744615,202132,607432907,15067,21
9931,HELZ,chr17,R,67070437,67245963,16920141,175526,607608433,15068,36
9953,HS3ST3B1,chr17,F,14301049,14349406,16968498,48357,607656790,15069,2
9955,HS3ST3A1,chr17,R,13494031,13601974,17076441,107943,607764733,15070,6
9969,MED13,chr17,R,61942604,62065311,17199148,122707,607887440,15071,31
10014,HDAC5,chr17,R,44076752,44123646,17246042,46894,607934334,15072,28
10040,TOM1L1,chr17,F,54900690,54961967,17307319,61277,607995611,15073,16
10052,GJC1,chr17,R,44793953,44830811,17344177,36858,608032469,15074,7
10140,TOB1,chr17,R,50862222,50867978,17349933,5756,608038225,15075,3
10189,ALYREF,chr17,R,81887834,81891622,17353721,3788,608042013,15076,6
10197,PSME3,chr17,F,42833141,42843760,17364340,10619,608052632,15077,11
10209,EIF1,chr17,F,41688874,41691646,17367112,2772,608055404,15078,3
10230,NBR2,chr17,F,43125582,43145113,17386643,19531,608074935,15079,4
10237,SLC35B1,chr17,R,49700933,49708135,17393845,7202,608082137,15080,10
10238,DCAF7,chr17,F,63550434,63594279,17437690,43845,608125982,15081,6
10241,CALCOCO2,chr17,F,48830987,48865245,17471948,34258,608160240,15082,15
10266,RAMP2,chr17,F,42761193,42763041,17473796,1848,608162088,15083,3
10349,ABCA10,chr17,R,69148006,69244815,17570605,96809,608258897,15084,39
10350,ABCA9,chr17,R,68974631,69067443,17663417,92812,608351709,15085,41
10351,ABCA8,chr17,R,68867286,68955408,17751539,88122,608439831,15086,42
10400,PEMT,chr17,R,17505562,17591703,17837680,86141,608525972,15087,10
10458,BAIAP2,chr17,F,81035143,81117432,17919969,82289,608608261,15088,18
10462,CLEC10A,chr17,R,7074536,7080601,17926034,6065,608614326,15089,9
10476,ATP5H,chr17,R,75038859,75046979,17934154,8120,608622446,15090,5
10481,HOXB13,chr17,R,48724762,48728749,17938141,3987,608626433,15091,1
10493,VAT1,chr17,R,43014604,43022442,17945979,7838,608634271,15092,5
10513,APPBP2,chr17,R,60443148,60526240,18029071,83092,608717363,15093,14
10514,MYBBP1A,chr17,R,4538895,4555386,18045562,16491,608733854,15094,25
10517,FBXW10,chr17,F,18740222,18779349,18084689,39127,608772981,15095,16
10594,PRPF8,chr17,R,1650628,1684882,18118943,34254,608807235,15096,42
10609,P3H4,chr17,R,41801951,41812616,18129608,10665,608817900,15097,7
10610,ST6GALNAC2,chr17,R,76565378,76586066,18150296,20688,608838588,15098,10
10614,HEXIM1,chr17,F,45147316,45152101,18155081,4785,608843373,15099,0
10615,SPAG5,chr17,R,28577564,28599038,18176555,21474,608864847,15100,23
10626,TRIM16,chr17,R,15627965,15682879,18231469,54914,608919761,15101,8
10642,IGF2BP1,chr17,F,48997411,49056145,18290203,58734,608978495,15102,15
10672,GNA13,chr17,R,65009288,65056802,18337717,47514,609026009,15103,6
10693,CCT6B,chr17,R,34927858,34980919,18390778,53061,609079070,15104,14
10743,RAI1,chr17,F,17681472,17811453,18520759,129981,609209051,15105,5
10749,KIF1C,chr17,F,4997947,5028399,18551211,30452,609239503,15106,23
10750,GRAP,chr17,R,19020676,19047023,18577558,26347,609265850,15107,5
10801,SEPT9,chr17,F,77281409,77500596,18796745,219187,609485037,15108,28
10871,CD300C,chr17,R,74541064,74546171,18801852,5107,609490144,15109,3
10882,C1QL1,chr17,R,44959692,44968276,18810436,8584,609498728,15110,1
10900,RUNDC3A,chr17,F,44307917,44318670,18821189,10753,609509481,15111,11
10948,STARD3,chr17,F,39637079,39664201,18848311,27122,609536603,15112,13
10951,CBX1,chr17,R,48070051,48101521,18879781,31470,609568073,15113,5
10966,RAB40B,chr17,R,82654958,82698722,18923545,43764,609611837,15114,9
11011,TLK2,chr17,F,62477080,62615481,19061946,138401,609750238,15115,29
11056,DDX52,chr17,R,37609738,37643464,19095672,33726,609783964,15116,16
11072,DUSP14,chr17,F,37488560,37513501,19120613,24941,609808905,15117,4
11143,KAT7,chr17,F,49788618,49829096,19161091,40478,609849383,15118,15
11216,AKAP10,chr17,R,19904451,19977856,19234496,73405,609922788,15119,14
11232,POLG2,chr17,R,64476993,64497066,19254569,20073,609942861,15120,10
11248,NXPH3,chr17,F,49575935,49583810,19262444,7875,609950736,15121,1
11267,SNF8,chr17,R,48930095,48945414,19277763,15319,609966055,15122,7
11276,SYNRG,chr17,R,37514796,37609496,19372463,94700,610060755,15123,26
11314,CD300A,chr17,F,74466365,74484798,19390896,18433,610079188,15124,7
11322,TMC6,chr17,R,78112917,78132407,19410386,19490,610098678,15125,20
11325,DDX42,chr17,F,63773883,63819317,19455820,45434,610144112,15126,19
11337,GABARAP,chr17,R,7240418,7242434,19457836,2016,610146128,15127,3
22794,CASC3,chr17,F,40140253,40172178,19489761,31925,610178053,15128,13
22806,IKZF3,chr17,R,39757714,39864188,19596235,106474,610284527,15129,8
22834,ZNF652,chr17,R,49289205,49362473,19669503,73268,610357795,15130,7
22843,PPM1E,chr17,F,58755868,58985179,19898814,229311,610587106,15131,8
22861,NLRP1,chr17,R,5501398,5584512,19981928,83114,610670220,15132,17
22899,ARHGEF15,chr17,F,8310237,8322516,19994207,12279,610682499,15133,17
22901,ARSG,chr17,F,68257158,68450773,20187822,193615,610876114,15134,22
22905,EPN2,chr17,F,19237376,19336715,20287161,99339,610975453,15135,10
22994,CEP131,chr17,R,81189592,81222994,20320563,33402,611008855,15136,25
23098,SARM1,chr17,F,28371661,28401045,20349947,29384,611038239,15137,8
23108,RAP1GAP2,chr17,F,2755697,3037741,20631991,282044,611320283,15138,34
23125,CAMTA2,chr17,R,4967991,4987673,20651673,19682,611339965,15139,23
23131,GPATCH8,chr17,R,44395276,44503602,20759999,108326,611448291,15140,12
23135,KDM6B,chr17,F,7834199,7854800,20780600,20601,611468892,15141,29
23140,ZZEF1,chr17,R,4004444,4143020,20919176,138576,611607468,15142,55
23163,GGA3,chr17,R,75225479,75262393,20956090,36914,611644382,15143,20
23164,MPRIP,chr17,F,17042467,17192648,21106271,150181,611794563,15144,24
23210,JMJD6,chr17,R,76712831,76726799,21120239,13968,611808531,15145,7
23265,EXOC7,chr17,R,76080992,76103787,21143034,22795,611831326,15146,21
23277,CLUH,chr17,R,2689385,2711633,21165282,22248,611853574,15147,25
23293,SMG6,chr17,R,2059838,2303813,21409257,243975,612097549,15148,30
23302,WSCD1,chr17,F,6069105,6124427,21464579,55322,612152871,15149,12
23326,USP22,chr17,R,20999592,21043409,21508396,43817,612196688,15150,13
23399,CTDNEP1,chr17,R,7243586,7251940,21516750,8354,612205042,15151,8
23415,KCNH4,chr17,R,42156891,42181278,21541137,24387,612229429,15152,16
23460,ABCA6,chr17,R,69078088,69141992,21605041,63904,612293333,15153,39
23461,ABCA5,chr17,R,69244434,69327182,21687789,82748,612376081,15154,38
23495,TNFRSF13B,chr17,R,16939083,16972088,21720794,33005,612409086,15155,4
23510,KCTD2,chr17,F,75032566,75065889,21754117,33323,612442409,15156,9
23512,SUZ12,chr17,F,31937024,32001045,21818138,64021,612506430,15157,17
23531,MMD,chr17,R,55392612,55421993,21847519,29381,612535811,15158,8
23533,PIK3R5,chr17,R,8878915,8965712,21934316,86797,612622608,15159,20
23558,WBP2,chr17,R,75845698,75855420,21944038,9722,612632330,15160,8
23580,CDC42EP4,chr17,R,73283623,73312004,21972419,28381,612660711,15161,2
23587,ELP5,chr17,F,7252052,7259940,21980307,7888,612668599,15162,6
23591,FAM215A,chr17,F,43917207,43917987,21981087,780,612669379,15163,0
23614,PPY2P,chr17,F,28247443,28248289,21981933,846,612670225,15164,1
23615,PYY2,chr17,F,28226562,28228060,21983431,1498,612671723,15165,1
23729,SHPK,chr17,R,3608261,3636322,22011492,28061,612699784,15166,6
23746,AIPL1,chr17,R,6423736,6435199,22022955,11463,612711247,15167,5
25794,FSCN2,chr17,F,81513050,81539790,22049695,26740,612737987,15168,11
25926,NOL11,chr17,F,67717832,67744208,22076071,26376,612764363,15169,17
25979,DHRS7B,chr17,F,21126274,21191972,22141769,65698,612830061,15170,8
25984,KRT23,chr17,R,40922695,40937643,22156717,14948,612845009,15171,8
26001,RNF167,chr17,F,4940032,4945222,22161907,5190,612850199,15172,9
26022,TMEM98,chr17,F,32927909,32941649,22175647,13740,612863939,15173,8
26073,POLDIP2,chr17,R,28346627,28357589,22186609,10962,612874901,15174,10
26083,TBC1D29,chr17,F,30559565,30565667,22192711,6102,612881003,15175,5
26115,TANC2,chr17,F,62966663,63427706,22653754,461043,613342046,15176,30
26118,WSB1,chr17,F,27294079,27313844,22673519,19765,613361811,15177,9
26151,NAT9,chr17,R,74770546,74776395,22679368,5849,613367660,15178,7
26168,SENP3,chr17,F,7561991,7571969,22689346,9978,613377638,15179,10
26189,OR1A2,chr17,F,3197516,3198448,22690278,932,613378570,15180,0
26207,PITPNC1,chr17,F,67377280,67697263,23010261,319983,613698553,15181,10
26284,ERAL1,chr17,F,28855024,28861054,23016291,6030,613704583,15182,9
26502,NARF,chr17,F,82458183,82488267,23046375,30084,613734667,15183,15
26574,AATF,chr17,F,36948874,37056871,23154372,107997,613842664,15184,11
26689,OR4D1,chr17,F,58155153,58156086,23155305,933,613843597,15185,0
26772,SNORD4B,chr17,F,28723680,28723754,23155379,74,613843671,15186,0
26773,SNORD4A,chr17,F,28722581,28722653,23155451,72,613843743,15187,0
26781,SNORA67,chr17,F,7577954,7578091,23155588,137,613843880,15188,0
26800,SNORD49A,chr17,F,16440035,16440106,23155659,71,613843951,15189,0
26808,SNORD42B,chr17,F,28720549,28720616,23155726,67,613844018,15190,0
26809,SNORD42A,chr17,F,28723429,28723491,23155788,62,613844080,15191,0
26851,SNORD3B-1,chr17,F,19061911,19062128,23156005,217,613844297,15192,0
27043,PELP1,chr17,R,4671383,4704337,23188959,32954,613877251,15193,17
27077,B9D1,chr17,R,19335262,19378182,23231879,42920,613920171,15194,9
27091,CACNG5,chr17,F,66835116,66887296,23284059,52180,613972351,15195,5
27092,CACNG4,chr17,F,66964863,67033402,23352598,68539,614040890,15196,3
27175,TUBG2,chr17,F,42659247,42667006,23360357,7759,614048649,15197,11
27346,TMEM97,chr17,F,28319094,28328685,23369948,9591,614058240,15198,2
28511,NKIRAS2,chr17,F,42017560,42025641,23378029,8081,614066321,15199,4
28958,COA3,chr17,R,42797617,42798725,23379137,1108,614067429,15200,1
28964,GIT1,chr17,R,29573468,29589592,23395261,16124,614083553,15201,20
29098,RANGRF,chr17,F,8288386,8290092,23396967,1706,614085259,15202,2
29115,SAP30BP,chr17,F,75667115,75708062,23437914,40947,614126206,15203,14
29893,PSMC3IP,chr17,R,42572309,42577831,23443436,5522,614131728,15204,7
29916,SNX11,chr17,F,48107553,48122745,23458628,15192,614146920,15205,7
29928,TIMM22,chr17,F,997116,1002167,23463679,5051,614151971,15206,3
30009,TBX21,chr17,F,47733243,47746122,23476558,12879,614164850,15207,7
30833,NT5C,chr17,R,75130224,75131795,23478129,1571,614166421,15208,4
30837,SOCS7,chr17,F,38352123,38405593,23531599,53470,614219891,15209,9
30850,CDR2L,chr17,F,74987631,75005800,23549768,18169,614238060,15210,4
30851,TAX1BP3,chr17,R,3662892,3668679,23555555,5787,614243847,15211,3
50488,MINK1,chr17,F,4833339,4898061,23620277,64722,614308569,15212,34
50628,GEMIN4,chr17,R,744415,752872,23628734,8457,614317026,15213,5
50964,SOST,chr17,R,43753730,43758788,23633792,5058,614322084,15214,1
51003,MED31,chr17,R,6643312,6651634,23642114,8322,614330406,15215,3
51009,DERL2,chr17,R,5471250,5486512,23657376,15262,614345668,15216,9
51030,TVP23B,chr17,F,18781144,18806714,23682946,25570,614371238,15217,7
51031,GLOD4,chr17,R,759308,782331,23705969,23023,614394261,15218,8
51081,MRPS7,chr17,F,75261667,75266376,23710678,4709,614398970,15219,4
51087,YBX2,chr17,R,7288251,7294557,23716984,6306,614405276,15220,8
51096,UTP18,chr17,F,51260535,51297933,23754382,37398,614442674,15221,15
51136,RNFT1,chr17,R,59952361,59964756,23766777,12395,614455069,15222,8
51155,HN1,chr17,R,75135242,75154683,23786218,19441,614474510,15223,6
51168,MYO15A,chr17,F,18108705,18180225,23857738,71520,614546030,15224,65
51174,TUBD1,chr17,R,59859478,59892945,23891205,33467,614579497,15225,9
51181,DCXR,chr17,R,82035880,82037697,23893022,1817,614581314,15226,7
51195,RAPGEFL1,chr17,F,40177009,40195656,23911669,18647,614599961,15227,16
51204,TACO1,chr17,F,63600871,63608365,23919163,7494,614607455,15228,4
51225,ABI3,chr17,F,49210226,49223225,23932162,12999,614620454,15229,7
51226,COPZ2,chr17,R,48026166,48048091,23954087,21925,614642379,15230,10
51264,MRPL27,chr17,R,50367866,50373201,23959422,5335,614647714,15231,3
51268,PIPOX,chr17,F,29042899,29057218,23973741,14319,614662033,15232,7
51321,AMZ2,chr17,F,68205996,68257164,24024909,51168,614713201,15233,9
51326,ARL17A,chr17,R,46499817,46579792,24104884,79975,614793176,15234,11
51379,CRLF3,chr17,R,30782683,30824760,24146961,42077,614835253,15235,9
51393,TRPV2,chr17,F,16415541,16437003,24168423,21462,614856715,15236,15
51479,ANKFY1,chr17,R,4163370,4264008,24269061,100638,614957353,15237,29
51529,ANAPC11,chr17,F,81890789,81900533,24278805,9744,614967097,15238,7
51547,SIRT7,chr17,R,81911938,81918182,24285049,6244,614973341,15239,11
51629,SLC25A39,chr17,R,44319624,44324857,24290282,5233,614978574,15240,11
51649,MRPS23,chr17,R,57838925,57850072,24301429,11147,614989721,15241,4
51651,PTRH2,chr17,R,59697305,59707495,24311619,10190,614999911,15242,2
51655,RASD1,chr17,R,17494436,17496395,24313578,1959,615001870,15243,1
51701,NLK,chr17,F,28042646,28205140,24476072,162494,615164364,15244,12
51747,LUC7L3,chr17,F,50719564,50752711,24509219,33147,615197511,15245,12
51751,HIGD1B,chr17,F,44844814,44850480,24514885,5666,615203177,15246,4
51755,CDK12,chr17,F,39461485,39567559,24620959,106074,615309251,15247,24
51763,INPP5K,chr17,R,1494574,1516888,24643273,22314,615331565,15248,13
54474,KRT20,chr17,R,40875888,40885243,24652628,9355,615340920,15249,7
54475,NLE1,chr17,R,35131321,35142315,24663622,10994,615351914,15250,13
54478,FAM64A,chr17,F,6444204,6451065,24670483,6861,615358775,15251,6
54549,SDK2,chr17,R,73334383,73644484,24980584,310101,615668876,15252,45
54739,XAF1,chr17,F,6755571,6775647,25000660,20076,615688952,15253,9
54752,FNDC8,chr17,F,35121611,35130732,25009781,9121,615698073,15254,3
54757,FAM20A,chr17,R,68534560,68600954,25076175,66394,615764467,15255,13
54785,C17orf59,chr17,R,8188332,8190246,25078089,1914,615766381,15256,0
54799,MBTD1,chr17,R,51177418,51260493,25161164,83075,615849456,15257,20
54828,BCAS3,chr17,F,60677810,61392838,25876192,715028,616564484,15258,37
54868,TMEM104,chr17,F,74776482,74839783,25939493,63301,616627785,15259,10
54883,CWC25,chr17,R,38800433,38825350,25964410,24917,616652702,15260,11
54890,ALKBH5,chr17,F,18183552,18209954,25990812,26402,616679104,15261,3
54894,RNF43,chr17,R,58353675,58417620,26054757,63945,616743049,15262,8
54902,TTC19,chr17,F,15999379,16029409,26084787,30030,616773079,15263,10
54903,MKS1,chr17,R,58205435,58219605,26098957,14170,616787249,15264,19
55018,LINC00483,chr17,R,50761033,50767515,26105439,6482,616793731,15265,3
55028,C17orf80,chr17,F,73232232,73248959,26122166,16727,616810458,15266,8
55036,CCDC40,chr17,F,80036631,80100613,26186148,63982,616874440,15267,24
55040,EPN3,chr17,F,50532686,50543750,26197212,11064,616885504,15268,9
55062,WIPI1,chr17,R,68421280,68457512,26233444,36232,616921736,15269,12
55065,SLC52A1,chr17,R,5032601,5035458,26236301,2857,616924593,15270,4
55073,LRRC37A4P,chr17,R,45505882,45520523,26250942,14641,616939234,15271,5
55090,MED9,chr17,F,17476985,17493220,26267177,16235,616955469,15272,1
55106,SLFN12,chr17,R,35409649,35433229,26290757,23580,616979049,15273,6
55135,WRAP53,chr17,F,7686070,7703502,26308189,17432,616996481,15274,11
55163,PNPO,chr17,F,47941522,47949308,26315975,7786,617004267,15275,6
55175,KLHL11,chr17,R,41848517,41865431,26332889,16914,617021181,15276,1
55178,RNMTL1,chr17,F,782272,792509,26343126,10237,617031418,15277,3
55181,SMG8,chr17,F,59210009,59215250,26348367,5241,617036659,15278,3
55244,SLC47A1,chr17,F,19533853,19579033,26393547,45180,617081839,15279,16
55273,TMEM100,chr17,R,55719626,55732121,26406042,12495,617094334,15280,3
55275,VPS53,chr17,R,508667,714856,26612231,206189,617300523,15281,23
55288,RHOT1,chr17,F,32142453,32253374,26723152,110921,617411444,15282,27
55316,RSAD1,chr17,F,50478799,50502164,26746517,23365,617434809,15283,11
55352,COPRS,chr17,R,31851864,31859307,26753960,7443,617442252,15284,4
55379,LRRC59,chr17,R,50381232,50397553,26770281,16321,617458573,15285,6
55421,C17orf85,chr17,R,3802159,3846251,26814373,44092,617502665,15286,14
55545,MSX2P1,chr17,F,58156958,58159120,26816535,2162,617504827,15287,0
55666,NPLOC4,chr17,R,81556884,81637153,26896804,80269,617585096,15288,20
55720,TSR1,chr17,R,2322677,2337384,26911511,14707,617599803,15289,14
55731,FAM222B,chr17,R,28755977,28854985,27010519,99008,617698811,15290,9
55771,PRR11,chr17,F,59155498,59206709,27061730,51211,617750022,15291,9
55803,ADAP2,chr17,F,30921684,30959398,27099444,37714,617787736,15292,10
55808,ST6GALNAC1,chr17,R,76617773,76643838,27125509,26065,617813801,15293,11
55813,UTP6,chr17,R,31863170,31901710,27164049,38540,617852341,15294,18
55852,TEX2,chr17,R,64147432,64263323,27279940,115891,617968232,15295,13
55876,GSDMB,chr17,R,39904594,39919377,27294723,14783,617983015,15296,10
55890,GPRC5C,chr17,F,74424502,74451658,27321879,27156,618010171,15297,7
56155,TEX14,chr17,R,58556676,58692079,27457282,135403,618145574,15298,33
56270,WDR45B,chr17,R,82614561,82648535,27491256,33974,618179548,15299,11
56919,DHX33,chr17,R,5440911,5469060,27519405,28149,618207697,15300,11
56934,CA10,chr17,R,51630312,52160017,28049110,529705,618737402,15301,12
56953,NT5M,chr17,F,17303365,17347663,28093408,44298,618781700,15302,9
56970,ATXN7L3,chr17,R,44191804,44199701,28101305,7897,618789597,15303,13
56985,ADPRM,chr17,F,10697609,10711558,28115254,13949,618803546,15304,3
57003,CCDC47,chr17,R,63745249,63773728,28143733,28479,618832025,15305,13
57048,PLSCR3,chr17,R,7389726,7394843,28148850,5117,618837142,15306,7
57125,PLXDC1,chr17,R,39063302,39151649,28237197,88347,618925489,15307,13
57151,LYZL6,chr17,R,35934517,35943710,28246390,9193,618934682,15308,4
57332,CBX8,chr17,R,79794376,79797116,28249130,2740,618937422,15309,4
57335,ZNF286A,chr17,F,15699576,15720787,28270341,21211,618958633,15310,5
57336,ZNF287,chr17,R,16549912,16569206,28289635,19294,618977927,15311,6
57409,MIF4GD,chr17,R,75266227,75271292,28294700,5065,618982992,15312,8
57508,INTS2,chr17,R,61865366,61928030,28357364,62664,619045656,15313,26
57513,CASKIN2,chr17,R,75500259,75515583,28372688,15324,619060980,15314,20
57521,RPTOR,chr17,F,80544824,80966373,28794237,421549,619482529,15315,33
57532,NUFIP2,chr17,R,29255835,29294148,28832550,38313,619520842,15316,5
57547,ZNF624,chr17,R,16599869,16655626,28888307,55757,619576599,15317,8
57551,TAOK1,chr17,F,29390924,29551904,29049287,160980,619737579,15318,20
57555,NLGN2,chr17,F,7408182,7419864,29060969,11682,619749261,15319,6
57597,BAHCC1,chr17,F,81395463,81466332,29131838,70869,619820130,15320,29
57602,USP36,chr17,R,78787384,78840898,29185352,53514,619873644,15321,21
57636,ARHGAP23,chr17,F,38419285,38512392,29278459,93107,619966751,15322,29
57649,PHF12,chr17,R,28905246,28951605,29324818,46359,620013110,15323,19
57659,ZBTB4,chr17,R,7459365,7484249,29349702,24884,620037994,15324,7
57674,RNF213,chr17,F,80260839,80398786,29487649,137947,620175941,15325,71
57690,TNRC6C,chr17,F,78004169,78108835,29592315,104666,620280607,15326,22
58191,CXCL16,chr17,R,4733528,4739928,29598715,6400,620287007,15327,5
58485,TRAPPC1,chr17,R,7930344,7931999,29600370,1655,620288662,15328,3
58488,PCTP,chr17,F,55750978,55843209,29692601,92231,620380893,15329,8
59342,SCPEP1,chr17,F,56978106,57006768,29721263,28662,620409555,15330,13
59344,ALOXE3,chr17,R,8095899,8118916,29744280,23017,620432572,15331,16
60386,SLC25A19,chr17,R,75272979,75289957,29761258,16978,620449550,15332,7
60528,ELAC2,chr17,R,12991611,13018064,29787711,26453,620476003,15333,23
60681,FKBP10,chr17,F,41812261,41823217,29798667,10956,620486959,15334,10
63826,SRR,chr17,F,2303370,2325264,29820561,21894,620508853,15335,10
63893,UBE2O,chr17,R,76389531,76453206,29884236,63675,620572528,15336,18
63897,HEATR6,chr17,R,60043190,60078931,29919977,35741,620608269,15337,21
64118,DUS1L,chr17,R,82057871,82065821,29927927,7950,620616219,15338,12
64122,FN3K,chr17,F,82735575,82751197,29943549,15622,620631841,15339,5
64132,XYLT2,chr17,F,50346031,50361185,29958703,15154,620646995,15340,12
64149,C17orf75,chr17,R,32328440,32350047,29980310,21607,620668602,15341,10
64359,NXN,chr17,R,799312,979767,30160765,180455,620849057,15342,10
64446,DNAI2,chr17,F,74274231,74314884,30201418,40653,620889710,15343,15
64518,TEKT3,chr17,R,15303810,15341889,30239497,38079,620927789,15344,9
64750,SMURF2,chr17,R,64542281,64662268,30359484,119987,621047776,15345,19
64772,ENGASE,chr17,F,79071522,79088603,30376565,17081,621064857,15346,16
64847,SPATA20,chr17,F,50547088,50555852,30385329,8764,621073621,15347,16
64978,MRPL38,chr17,R,75898642,75905100,30391787,6458,621080079,15348,8
65264,UBE2Z,chr17,F,48908368,48929060,30412479,20692,621100771,15349,6
65266,WNK4,chr17,F,42779672,42797066,30429873,17394,621118165,15350,18
78995,C17orf53,chr17,F,44141905,44162477,30450445,20572,621138737,15351,11
79003,MIS12,chr17,F,5486373,5490814,30454886,4441,621143178,15352,3
79018,GID4,chr17,F,18039296,18068405,30483995,29109,621172287,15353,7
79058,ASPSCR1,chr17,F,81977549,82017563,30524009,40014,621212301,15354,18
79066,METTL16,chr17,R,2416048,2511906,30619867,95858,621308159,15355,10
79089,TMUB2,chr17,F,44186968,44191731,30624630,4763,621312922,15356,4
79092,CARD14,chr17,F,80169991,80209331,30663970,39340,621352262,15357,25
79132,DHX58,chr17,R,42101403,42112733,30675300,11330,621363592,15358,13
79142,PHF23,chr17,R,7235027,7239717,30679990,4690,621368282,15359,7
79148,MMP28,chr17,R,35756248,35795707,30719449,39459,621407741,15360,12
79154,DHRS11,chr17,F,36591785,36600804,30728468,9019,621416760,15361,8
79157,MFSD11,chr17,F,76736564,76804356,30796260,67792,621484552,15362,19
79170,PRR15L,chr17,R,47951966,47957894,30802188,5928,621490480,15363,3
79415,C17orf62,chr17,R,82442585,82450831,30810434,8246,621498726,15364,6
79637,ARMC7,chr17,F,75109951,75130265,30830748,20314,621519040,15365,3
79643,CHMP6,chr17,F,80991840,81000133,30839041,8293,621527333,15366,7
79651,RHBDF2,chr17,R,76470892,76501437,30869586,30545,621557878,15367,20
79665,DHX40,chr17,F,59565524,59608352,30912414,42828,621600706,15368,17
79672,FN3KRP,chr17,F,82716705,82728017,30923726,11312,621612018,15369,6
79701,OGFOD3,chr17,R,82389209,82418637,30953154,29428,621641446,15370,10
79736,TEFM,chr17,R,30898982,30906775,30960947,7793,621649239,15371,3
79755,ZNF750,chr17,R,82829433,82840055,30971569,10622,621659861,15372,2
79777,ACBD4,chr17,F,45132599,45144181,30983151,11582,621671443,15373,13
79850,FAM57A,chr17,F,732606,742835,30993380,10229,621681672,15374,4
79877,DCAKD,chr17,R,45023337,45061141,31031184,37804,621719476,15375,9
79893,GGNBP2,chr17,F,36544887,36589848,31076145,44961,621764437,15376,13
79902,NUP85,chr17,F,75205449,75235759,31106455,30310,621794747,15377,21
79915,ATAD5,chr17,F,30831475,30895869,31170849,64394,621859141,15378,22
79922,MRM1,chr17,F,36601580,36634698,31203967,33118,621892259,15379,8
79990,PLEKHH3,chr17,R,42667913,42677030,31213084,9117,621901376,15380,13
79999,LOC79999,chr17,R,19154523,19158872,31217433,4349,621905725,15381,2
80022,MYO15B,chr17,F,75588057,75626849,31256225,38792,621944517,15382,60
80039,FAM106A,chr17,R,18524565,18526846,31258506,2281,621946798,15383,0
80169,CTC1,chr17,R,8224820,8248095,31281781,23275,621970073,15384,22
80174,DBF4B,chr17,F,44708607,44758852,31332026,50245,622020318,15385,17
80179,MYO19,chr17,R,36495754,36535457,31371729,39703,622060021,15386,28
80221,ACSF2,chr17,F,50426157,50474845,31420417,48688,622108709,15387,18
80233,C17orf70,chr17,R,81539884,81552403,31432936,12519,622121228,15388,9
80279,CDK5RAP3,chr17,F,47967903,47981786,31446819,13883,622135111,15389,12
80320,SP6,chr17,R,47844907,47876190,31478102,31283,622166394,15390,3
80347,COASY,chr17,F,42562073,42566281,31482310,4208,622170602,15391,8
80725,SRCIN1,chr17,R,38530023,38605930,31558217,75907,622246509,15392,18
80755,AARSD1,chr17,R,42950525,42964498,31572190,13973,622260482,15393,11
80774,LIMD2,chr17,R,63695888,63701769,31578071,5881,622266363,15394,8
81033,KCNH6,chr17,F,63523333,63548977,31603715,25644,622292007,15395,15
81558,FAM117A,chr17,R,49710324,49764156,31657547,53832,622345839,15396,7
81565,NDEL1,chr17,F,8435851,8471708,31693404,35857,622381696,15397,11
81671,VMP1,chr17,F,59707501,59840593,31826496,133092,622514788,15398,11
81850,KRTAP1-3,chr17,R,41033883,41034855,31827468,972,622515760,15399,0
81851,KRTAP1-1,chr17,R,41040558,41041461,31828371,903,622516663,15400,0
81870,KRTAP9-9,chr17,F,41255383,41256364,31829352,981,622517644,15401,0
81871,KRTAP4-6,chr17,R,41139432,41140487,31830407,1055,622518699,15402,0
81872,KRTAP2-1,chr17,R,41046540,41047316,31831183,776,622519475,15403,0
83394,PITPNM3,chr17,R,6450343,6556557,31937397,106214,622625689,15404,22
83450,LRRC48,chr17,F,17972779,18016889,31981507,44110,622669799,15405,19
83460,EMC6,chr17,F,3668722,3669669,31982454,947,622670746,15406,1
83538,TTC25,chr17,F,41930616,41965651,32017489,35035,622705781,15407,12
83547,RILP,chr17,R,1646149,1650098,32021438,3949,622709730,15408,7
83659,TEKT1,chr17,R,6797992,6831741,32055187,33749,622743479,15409,7
83755,KRTAP4-12,chr17,R,41123090,41124167,32056264,1077,622744556,15410,0
83871,RAB34,chr17,R,28714280,28718268,32060252,3988,622748544,15411,10
83882,TSPAN10,chr17,F,81637170,81648755,32071837,11585,622760129,15412,5
83895,KRTAP1-5,chr17,R,41026025,41027202,32073014,1177,622761306,15413,0
83896,KRTAP3-1,chr17,R,41008520,41009114,32073608,594,622761900,15414,0
83897,KRTAP3-2,chr17,R,40999192,40999886,32074302,694,622762594,15415,0
83899,KRTAP9-2,chr17,F,41226647,41227652,32075307,1005,622763599,15416,0
83900,KRTAP9-3,chr17,F,41232462,41233454,32076299,992,622764591,15417,0
83901,KRTAP9-8,chr17,F,41238017,41239004,32077286,987,622765578,15418,0
83902,KRTAP17-1,chr17,R,41314916,41315695,32078065,779,622766357,15419,0
83903,GSG2,chr17,F,3723902,3726699,32080862,2797,622769154,15420,0
83990,BRIP1,chr17,R,61679185,61863937,32265614,184752,622953906,15421,23
84073,MYCBPAP,chr17,F,50508383,50531502,32288733,23119,622977025,15422,19
84074,QRICH2,chr17,R,76274048,76308690,32323375,34642,623011667,15423,20
84081,NSRP1,chr17,F,30116806,30186475,32393044,69669,623081336,15424,7
84152,PPP1R1B,chr17,F,39626207,39636625,32403462,10418,623091754,15425,7
84218,TBC1D3F,chr17,R,36428611,36439523,32414374,10912,623102666,15426,13
84225,ZMYND15,chr17,F,4740014,4746119,32420479,6105,623108771,15427,13
84254,CAMKK1,chr17,R,3860314,3894891,32455056,34577,623143348,15428,19
84268,RPAIN,chr17,F,5419640,5433020,32468436,13380,623156728,15429,7
84282,RNF135,chr17,F,30958920,30999911,32509427,40991,623197719,15430,7
84299,MIEN1,chr17,R,39729155,39730541,32510813,1386,623199105,15431,2
84311,MRPL45,chr17,F,38297022,38323218,32537009,26196,623225301,15432,7
84313,VPS25,chr17,F,42773435,42779600,32543174,6165,623231466,15433,5
84314,TMEM107,chr17,R,8172977,8176396,32546593,3419,623234885,15434,4
84316,NAA38,chr17,R,7856684,7885283,32575192,28599,623263484,15435,4
84336,TMEM101,chr17,R,44011187,44024260,32588265,13073,623276557,15436,6
84366,PRAC1,chr17,R,48721718,48722520,32589067,802,623277359,15437,1
84440,RAB11FIP4,chr17,F,31391623,31538217,32735661,146594,623423953,15438,15
84461,NEURL4,chr17,R,7315631,7329319,32749349,13688,623437641,15439,28
84514,GHDC,chr17,R,42189086,42194532,32754795,5446,623443087,15440,9
84616,KRTAP4-4,chr17,R,41159652,41160731,32755874,1079,623444166,15441,0
84622,ZNF594,chr17,R,5179534,5191883,32768223,12349,623456515,15442,1
84643,KIF2B,chr17,F,53822877,53825212,32770558,2335,623458850,15443,0
84667,HES7,chr17,R,8120589,8125739,32775708,5150,623464000,15444,4
84669,USP32,chr17,R,60177230,60422470,33020948,245240,623709240,15445,37
84687,PPP1R9B,chr17,R,50133734,50151022,33038236,17288,623726528,15446,10
84690,SPATA22,chr17,R,3440010,3513852,33112078,73842,623800370,15447,10
84733,CBX2,chr17,F,79777187,79787650,33122541,10463,623810833,15448,5
84815,MGC12916,chr17,F,14303739,14305745,33124547,2006,623812839,15449,0
84817,TXNDC17,chr17,F,6640901,6644541,33128187,3640,623816479,15450,3
84923,FAM104A,chr17,R,73207352,73232394,33153229,25042,623841521,15451,5
84940,CORO6,chr17,R,29614755,29622908,33161382,8153,623849674,15452,10
84951,TNS4,chr17,R,40475827,40501681,33187236,25854,623875528,15453,12
84961,FBXL20,chr17,R,39252643,39402661,33337254,150018,624025546,15454,17
84981,MIR22HG,chr17,R,1711503,1716272,33342023,4769,624030315,15455,2
85001,MGC16275,chr17,R,74209979,74213321,33345365,3342,624033657,15456,1
85280,KRTAP9-4,chr17,F,41249686,41250653,33346332,967,624034624,15457,0
85285,KRTAP4-1,chr17,R,41184099,41184895,33347128,796,624035420,15458,1
85289,KRTAP4-5,chr17,R,41148923,41149802,33348007,879,624036299,15459,0
85290,KRTAP4-3,chr17,R,41167230,41168172,33348949,942,624037241,15460,0
85291,KRTAP4-2,chr17,R,41177445,41178208,33349712,763,624038004,15461,0
85293,KRTAP3-3,chr17,R,40993429,40994133,33350416,704,624038708,15462,0
85294,KRTAP2-4,chr17,R,41065115,41065879,33351180,764,624039472,15463,0
85302,FBF1,chr17,R,75910536,75941038,33381682,30502,624069974,15464,28
85451,UNK,chr17,F,75784838,75825805,33422649,40967,624110941,15465,21
85464,SSH2,chr17,R,29625937,29930239,33726951,304302,624415243,15466,23
90313,TP53I13,chr17,F,29567179,29580820,33740592,13641,624428884,15467,11
90410,IFT20,chr17,R,28328324,28335489,33747757,7165,624436049,15468,6
90506,LRRC46,chr17,F,47831626,47837713,33753844,6087,624442136,15469,8
90507,SCRN2,chr17,R,47837680,47841333,33757497,3653,624445789,15470,6
90586,AOC4P,chr17,F,42867144,42869217,33759570,2073,624447862,15471,0
90799,CEP95,chr17,F,64506761,64537951,33790760,31190,624479052,15472,20
91107,TRIM47,chr17,R,75874163,75878600,33795197,4437,624483489,15473,6
91369,ANKRD40,chr17,R,50693189,50707909,33809917,14720,624498209,15474,4
91603,ZNF830,chr17,F,34961529,34963186,33811574,1657,624499866,15475,0
91607,SLFN11,chr17,R,35350304,35373853,33835123,23549,624523415,15476,6
91608,RASL10B,chr17,F,35731659,35743525,33846989,11866,624535281,15477,3
91647,ATPAF2,chr17,R,17977780,18039169,33908378,61389,624596670,15478,14
92162,TMEM88,chr17,F,7854895,7856099,33909582,1204,624597874,15479,1
92335,STRADA,chr17,R,63702831,63741970,33948721,39139,624637013,15480,12
92340,PRR29,chr17,F,63998343,64004305,33954683,5962,624642975,15481,4
92521,SPECC1,chr17,F,20009335,20314759,34260107,305424,624948399,15482,18
92579,G6PC3,chr17,F,44070729,44076344,34265722,5615,624954014,15483,6
92591,ASB16,chr17,F,44170705,44179083,34274100,8378,624962392,15484,4
92659,MAFG-AS1,chr17,F,81927828,81930753,34277025,2925,624965317,15485,1
92736,OTOP2,chr17,F,74922962,74933913,34287976,10951,624976268,15486,7
93210,PGAP3,chr17,R,39671121,39688070,34304925,16949,624993217,15487,8
93649,MYOCD,chr17,F,12665889,12768949,34407985,103060,625096277,15488,14
94005,PIGS,chr17,R,28553387,28571869,34426467,18482,625114759,15489,11
94015,TTYH2,chr17,F,74213556,74262020,34474931,48464,625163223,15490,14
94086,HSPB9,chr17,F,42122737,42123353,34475547,616,625163839,15491,0
94103,ORMDL3,chr17,R,39921041,39927631,34482137,6590,625170429,15492,4
94150,CDRT7,chr17,F,15030974,15031957,34483120,983,625171412,15493,2
94151,CDRT8,chr17,R,15104984,15106187,34484323,1203,625172615,15494,1
94158,CDRT15P1,chr17,F,14024497,14025598,34485424,1101,625173716,15495,0
96597,TBC1D27,chr17,R,16922922,16929592,34492094,6670,625180386,15496,4
112483,SAT2,chr17,R,7626233,7627876,34493737,1643,625182029,15497,5
113026,PLCD3,chr17,R,45111639,45132533,34514631,20894,625202923,15498,15
113235,SLC46A1,chr17,R,28394641,28406212,34526202,11571,625214494,15499,4
113277,TMEM106A,chr17,F,43211826,43220041,34534417,8215,625222709,15500,8
114659,LRRC37B,chr17,F,32007371,32053500,34580546,46129,625268838,15501,15
114757,CYGB,chr17,R,76527347,76557597,34610796,30250,625299088,15502,6
114804,RNF157,chr17,R,76142452,76240368,34708712,97916,625397004,15503,22
114826,SMYD4,chr17,R,1779534,1829881,34759059,50347,625447351,15504,12
114881,OSBPL7,chr17,R,47807366,47821826,34773519,14460,625461811,15505,23
114897,C1QTNF1,chr17,F,79022933,79049788,34800374,26855,625488666,15506,7
115024,NT5C3B,chr17,R,41825081,41836271,34811564,11190,625499856,15507,8
116236,ABHD15,chr17,R,29560660,29567024,34817928,6364,625506220,15508,1
116238,TLCD1,chr17,R,28724347,28727935,34821516,3588,625509808,15509,5
116729,PPP1R27,chr17,R,81833491,81835050,34823075,1559,625511367,15510,2
116840,CNTROB,chr17,F,7932123,7949919,34840871,17796,625529163,15511,18
117246,FTSJ3,chr17,R,63819432,63827671,34849110,8239,625537402,15512,20
117584,RFFL,chr17,R,35009111,35089329,34929328,80218,625617620,15513,7
118432,RPL29P2,chr17,F,7754319,7754976,34929985,657,625618277,15514,0
124512,METTL23,chr17,F,76725872,76733881,34937994,8009,625626286,15515,6
124535,HSF5,chr17,R,58420166,58488401,35006229,68235,625694521,15516,5
124538,OR4D2,chr17,F,58169655,58170579,35007153,924,625695445,15517,0
124540,MSI2,chr17,F,57256569,57700477,35451061,443908,626139353,15518,18
124565,SLC38A10,chr17,R,81244810,81295433,35501684,50623,626189976,15519,17
124583,CANT1,chr17,R,78991715,79009817,35519786,18102,626208078,15520,6
124590,USH1G,chr17,R,74916082,74923263,35526967,7181,626215259,15521,3
124599,CD300LB,chr17,R,74521173,74531474,35537268,10301,626225560,15522,3
124602,KIF19,chr17,F,74326211,74355820,35566877,29609,626255169,15523,19
124626,ZPBP2,chr17,F,39868163,39877896,35576610,9733,626264902,15524,7
124637,CYB5D1,chr17,F,7857745,7863486,35582351,5741,626270643,15525,4
124641,OVCA2,chr17,F,2041982,2043431,35583800,1449,626272092,15526,12
124739,USP43,chr17,F,9643492,9729687,35669995,86195,626358287,15527,16
124751,KRBA2,chr17,R,8368636,8376711,35678070,8075,626366362,15528,4
124773,C17orf64,chr17,F,60421084,60431426,35688412,10342,626376704,15529,9
124783,SPATA32,chr17,R,45247273,45262112,35703251,14839,626391543,15530,9
124790,HEXIM2,chr17,F,45160025,45170040,35713266,10015,626401558,15531,4
124801,LSM12,chr17,R,44034634,44067619,35746251,32985,626434543,15532,6
124808,CCDC43,chr17,R,44677436,44689797,35758612,12361,626446904,15533,4
124817,CNTD1,chr17,F,42798666,42811587,35771533,12921,626459825,15534,7
124842,TMEM132E,chr17,F,34580748,34639319,35830104,58571,626518396,15535,10
124857,WFIKKN2,chr17,F,50835243,50842348,35837209,7105,626525501,15536,1
124871,FLJ40194,chr17,F,49248242,49258665,35847632,10423,626535924,15537,2
124872,B4GALNT2,chr17,F,49132459,49169989,35885162,37530,626573454,15538,12
124912,SPACA3,chr17,F,32991863,32997874,35891173,6011,626579465,15539,4
124923,SGK494,chr17,R,28607963,28614193,35897403,6230,626585695,15540,11
124925,SEZ6,chr17,R,28954904,29006440,35948939,51536,626637231,15541,17
124930,ANKRD13B,chr17,F,29593508,29614761,35970192,21253,626658484,15542,15
124935,SLC43A2,chr17,R,1569253,1630018,36030957,60765,626719249,15543,17
124936,CYB5D2,chr17,F,4143167,4157701,36045491,14534,626733783,15544,5
124944,C17orf49,chr17,F,7014736,7017524,36048279,2788,626736571,15545,7
124961,ZFP3,chr17,F,5078458,5096374,36066195,17916,626754487,15546,1
124975,GGT6,chr17,R,4556926,4560596,36069865,3670,626758157,15547,3
124976,SPNS2,chr17,F,4498833,4539933,36110965,41100,626799257,15548,12
124989,EFCAB13,chr17,F,47323960,47441312,36228317,117352,626916609,15549,24
124995,MRPL10,chr17,R,47823271,47831541,36236587,8270,626924879,15550,5
124997,WDR81,chr17,F,1716522,1738599,36258664,22077,626946956,15551,11
125058,TBC1D16,chr17,R,79932342,80035867,36362189,103525,627050481,15552,14
125061,AFMID,chr17,F,78185101,78207701,36384789,22600,627073081,15553,13
125111,GJD3,chr17,R,40360651,40364693,36388831,4042,627077123,15554,0
125113,KRT222,chr17,R,40655619,40665164,36398376,9545,627086668,15555,5
125115,KRT40,chr17,R,40977715,40987139,36407800,9424,627096092,15556,7
125144,LRRC75A-AS1,chr17,F,16438986,16470648,36439462,31662,627127754,15557,8
125150,ZSWIM7,chr17,R,15976559,15999692,36462595,23133,627150887,15558,4
125170,MIEF2,chr17,F,18260533,18265781,36467843,5248,627156135,15559,4
125206,SLC5A10,chr17,F,18950675,19020691,36537859,70016,627226151,15560,18
140735,DYNLL2,chr17,F,58083418,58090257,36544698,6839,627232990,15561,2
140771,SMCR5,chr17,R,17776685,17779529,36547542,2844,627235834,15562,0
140775,SMCR8,chr17,F,18315279,18328056,36560319,12777,627248611,15563,1
146664,MGAT5B,chr17,F,76850502,76950393,36660210,99891,627348502,15564,26
146691,TOM1L2,chr17,R,17843507,17972470,36789173,128963,627477465,15565,16
146705,ENTHD2,chr17,R,81228276,81239091,36799988,10815,627488280,15566,13
146712,B3GNTL1,chr17,R,82942148,83051845,36909685,109697,627597977,15567,20
146713,RBFOX3,chr17,R,79089344,79611101,37431442,521757,628119734,15568,17
146722,CD300LF,chr17,R,74694307,74713059,37450194,18752,628138486,15569,8
146723,C17orf77,chr17,F,74584678,74594209,37459725,9531,628148017,15570,3
146754,DNAH2,chr17,F,7717353,7833744,37576116,116391,628264408,15571,89
146760,RTN4RL1,chr17,R,1934676,2025345,37666785,90669,628355077,15572,13
146771,TCAM1P,chr17,F,63857015,63864379,37674149,7364,628362441,15573,5
146779,EFCAB3,chr17,F,62370217,62416479,37720411,46262,628408703,15574,13
146795,LOC146795,chr17,F,72342810,72355309,37732910,12499,628421202,15575,3
146802,SLC47A2,chr17,R,19678314,19718842,37773438,40528,628461730,15576,23
146822,CDRT15,chr17,R,14235855,14236833,37774416,978,628462708,15577,2
146845,CFAP52,chr17,F,9576626,9643459,37841249,66833,628529541,15578,13
146849,CCDC42,chr17,R,8729927,8744836,37856158,14909,628544450,15579,6
146850,PIK3R6,chr17,R,8802721,8867697,37921134,64976,628609426,15580,22
146852,ODF4,chr17,F,8339836,8346048,37927346,6212,628615638,15581,3
146853,C17orf50,chr17,F,35760592,35765079,37931833,4487,628620125,15582,2
146857,SLFN13,chr17,R,35435095,35449008,37945746,13913,628634038,15583,8
146861,SLC35G3,chr17,R,35192519,35194393,37947620,1874,628635912,15584,0
146862,UNC45B,chr17,F,35147797,35189345,37989168,41548,628677460,15585,19
146880,LOC146880,chr17,R,64749661,64781999,38021506,32338,628709798,15586,13
146894,CD300LG,chr17,F,43846776,43863639,38038369,16863,628726661,15587,9
146909,KIF18B,chr17,R,44924710,44947745,38061404,23035,628749696,15588,15
146923,RUNDC1,chr17,F,42980509,42993696,38074591,13187,628762883,15589,5
146956,EME1,chr17,F,50373219,50381752,38083124,8533,628771416,15590,7
147004,LOC147004,chr17,F,33533832,33627260,38176552,93428,628864844,15591,12
147007,TMEM199,chr17,F,28357580,28363683,38182655,6103,628870947,15592,5
147011,PROCA1,chr17,R,28703196,28712071,38191530,8875,628879822,15593,6
147015,DHRS13,chr17,R,28897780,28903071,38196821,5291,628885113,15594,4
147040,KCTD11,chr17,F,7351888,7354944,38199877,3056,628888169,15595,0
147081,CRHR1-IT1,chr17,F,45638974,45646229,38207132,7255,628895424,15596,2
147093,LINC00974,chr17,R,41549605,41554495,38212022,4890,628900314,15597,2
147111,NOTUM,chr17,R,81952506,81961823,38221339,9317,628909631,15598,11
147138,TMC8,chr17,F,78128850,78142968,38235457,14118,628923749,15599,18
147166,TRIM16L,chr17,F,18697997,18736118,38273578,38121,628961870,15600,13
147172,LRRC37BP1,chr17,F,30576464,30637466,38334580,61002,629022872,15601,8
147179,WIPF2,chr17,F,40219303,40284136,38399413,64833,629087705,15602,8
147183,KRT25,chr17,R,40748020,40755542,38406935,7522,629095227,15603,8
147184,TMEM99,chr17,F,40819091,40836274,38424118,17183,629112410,15604,3
162282,ANKFN1,chr17,F,55965603,56511407,38969922,545804,629658214,15605,30
162333,MARCH10,chr17,R,62701313,62808381,39076990,107068,629765282,15606,16
162387,MFSD6L,chr17,R,8797109,8799349,39079230,2240,629767522,15607,0
162394,SLFN5,chr17,F,35243066,35267749,39103913,24683,629792205,15608,4
162417,NAGS,chr17,F,44004545,44009068,39108436,4523,629796728,15609,7
162427,FAM134C,chr17,R,42579507,42609427,39138356,29920,629826648,15610,9
162461,TMEM92,chr17,F,50271405,50281485,39148436,10080,629836728,15611,5
162466,PHOSPHO1,chr17,R,49223365,49231692,39156763,8327,629845055,15612,3
162494,RHBDL3,chr17,F,32266130,32324661,39215294,58531,629903586,15613,11
162514,TRPV3,chr17,R,3510501,3557995,39262788,47494,629951080,15614,18
162515,SLC16A11,chr17,R,7041616,7044400,39265572,2784,629953864,15615,2
162517,FBXO39,chr17,F,6776174,6796474,39285872,20300,629974164,15616,5
162540,SPPL2C,chr17,F,45844889,45847072,39288055,2183,629976347,15617,0
162605,KRT28,chr17,R,40792195,40799959,39295819,7764,629984111,15618,7
162632,USP32P1,chr17,F,16786891,16804505,39313433,17614,630001725,15619,7
192666,KRT24,chr17,R,40697990,40703750,39319193,5760,630007485,15620,7
201134,CEP112,chr17,R,65635539,66192131,39875785,556592,630564077,15621,37
201140,DHRS7C,chr17,R,9771433,9791577,39895929,20144,630584221,15622,6
201158,TVP23C,chr17,R,15502263,15563631,39957297,61368,630645589,15623,6
201161,CENPV,chr17,R,16342533,16353498,39968262,10965,630656554,15624,4
201163,FLCN,chr17,R,17206923,17237188,39998527,30265,630686819,15625,16
201164,PLD6,chr17,R,17200994,17206332,40003865,5338,630692157,15626,1
201176,ARHGAP27,chr17,R,45393901,45432916,40042880,39015,630731172,15627,22
201181,ZNF385C,chr17,R,42024875,42072630,40090635,47755,630778927,15628,16
201191,SAMD14,chr17,R,50111308,50129882,40109209,18574,630797501,15629,13
201229,LYRM9,chr17,R,27878313,27893383,40124279,15070,630812571,15630,6
201232,SLC16A13,chr17,F,7036074,7040121,40128326,4047,630816618,15631,3
201243,C17orf74,chr17,F,7424880,7427568,40131014,2688,630819306,15632,2
201254,STRA13,chr17,R,82018702,82022930,40135242,4228,630823534,15633,4
201255,LRRC45,chr17,F,82023249,82031151,40143144,7902,630831436,15634,16
201266,SLC39A11,chr17,R,72645945,73092714,40589913,446769,631278205,15635,18
201283,AMZ2P1,chr17,R,64966549,64975585,40598949,9036,631287241,15636,4
201292,TRIM65,chr17,R,75880378,75897003,40615574,16625,631303866,15637,7
201294,UNC13D,chr17,R,75827224,75844717,40633067,17493,631321359,15638,32
201299,RDM1,chr17,R,35918079,35930811,40645799,12732,631334091,15639,7
201305,SPNS3,chr17,F,4433923,4488204,40700080,54281,631388372,15640,13
220594,USP32P2,chr17,R,18511261,18521252,40710071,9991,631398363,15641,4
246176,GAS2L2,chr17,R,35744510,35753745,40719306,9235,631407598,15642,5
246744,STH,chr17,F,45999249,45999694,40719751,445,631408043,15643,0
246754,MTVR2,chr17,R,56884101,56884913,40720563,812,631408855,15644,0
252983,STXBP4,chr17,F,54968734,55164285,40916114,195551,631604406,15645,18
253962,CACNA1G-AS1,chr17,R,50556206,50562108,40922016,5902,631610308,15646,1
254272,TBC1D28,chr17,R,18634433,18644433,40932016,10000,631620308,15647,12
254863,TMEM256,chr17,R,7402973,7404131,40933174,1158,631621466,15648,3
255061,TAC4,chr17,R,49838308,49848017,40942883,9709,631631175,15649,4
255275,MYADML2,chr17,R,81939644,81947233,40950472,7589,631638764,15650,2
255877,BCL6B,chr17,F,7023049,7029642,40957065,6593,631645357,15651,8
256223,CDRT15L2,chr17,F,20579723,20580911,40958253,1188,631646545,15652,1
256302,NATD1,chr17,R,21238869,21253266,40972650,14397,631660942,15653,2
256933,NPB,chr17,F,81902195,81902905,40973360,710,631661652,15654,1
256957,HEATR9,chr17,R,35854945,35868891,40987306,13946,631675598,15655,14
283982,LINC00469,chr17,R,73749269,73828537,41066574,79268,631754866,15656,3
283985,FADS6,chr17,R,74876775,74893811,41083610,17036,631771902,15657,5
283987,HID1,chr17,R,74950741,74972805,41105674,22064,631793966,15658,19
283989,TSEN54,chr17,F,75515706,75524739,41114707,9033,631802999,15659,11
283991,UBALD2,chr17,F,76265204,76271298,41120801,6094,631809093,15660,2
283999,TMEM235,chr17,F,78231309,78240987,41130479,9678,631818771,15661,10
284001,CCDC57,chr17,R,82101469,82213520,41242530,112051,631930822,15662,26
284004,HEXDC,chr17,F,82418375,82442640,41266795,24265,631955087,15663,13
284009,LOC284009,chr17,R,2406980,2415436,41275251,8456,631963543,15664,2
284013,VMO1,chr17,R,4785284,4786434,41276401,1150,631964693,15665,2
284018,C17orf58,chr17,R,67991098,67996784,41282087,5686,631970379,15666,2
284021,MILR1,chr17,F,64447248,64479383,41314222,32135,632002514,15667,14
284023,LOC284023,chr17,R,7913321,7915947,41316848,2626,632005140,15668,1
284029,LINC00324,chr17,R,8220629,8224043,41320262,3414,632008554,15669,2
284034,LINC00670,chr17,F,12549967,12637187,41407482,87220,632095774,15670,3
284040,CDRT4,chr17,R,15436014,15467611,41439079,31597,632127371,15671,3
284047,CCDC144B,chr17,R,18537799,18625617,41526897,87818,632215189,15672,16
284058,KANSL1,chr17,R,46029915,46225374,41722356,195459,632410648,15673,19
284067,C17orf105,chr17,F,43778390,43784842,41728808,6452,632417100,15674,6
284069,FAM171A2,chr17,R,44353732,44363867,41738943,10135,632427235,15675,7
284071,C17orf104,chr17,F,44656393,44678306,41760856,21913,632449148,15676,8
284076,TTLL6,chr17,R,48762230,48817107,41815733,54877,632504025,15677,16
284080,LOC284080,chr17,R,50050348,50055739,41821124,5391,632509416,15678,2
284083,C17orf47,chr17,R,58540680,58544372,41824816,3692,632513108,15679,1
284085,KRT18P55,chr17,R,28275985,28307382,41856213,31397,632544505,15680,2
284086,NEK8,chr17,F,28725896,28742766,41873083,16870,632561375,15681,17
284098,PIGW,chr17,F,36535001,36539368,41877450,4367,632565742,15682,1
284099,C17orf78,chr17,F,37375934,37392708,41894224,16774,632582516,15683,6
284100,YWHAEP7,chr17,R,37842948,37884743,41936019,41795,632624311,15684,6
284106,CISD3,chr17,F,38730256,38735605,41941368,5349,632629660,15685,3
284110,GSDMA,chr17,F,39962972,39977880,41956276,14908,632644568,15686,13
284111,SLC13A5,chr17,R,6684712,6713421,41984985,28709,632673277,15687,12
284114,TMEM102,chr17,F,7428824,7437679,41993840,8855,632682132,15688,4
284116,KRT42P,chr17,R,41626326,41640199,42007713,13873,632696005,15689,10
284119,PTRF,chr17,R,42402448,42423320,42028585,20872,632716877,15690,2
284123,FAM27L,chr17,F,22298763,22299893,42029715,1130,632718007,15691,1
284124,FLJ36000,chr17,F,22406018,22413741,42037438,7723,632725730,15692,1
284129,SLC26A11,chr17,F,80220400,80253509,42070547,33109,632758839,15693,17
284131,ENDOV,chr17,F,80415116,80438086,42093517,22970,632781809,15694,14
284161,GDPD1,chr17,F,59220466,59275970,42149021,55504,632837313,15695,9
284184,C17orf89,chr17,F,81239310,81241298,42151009,1988,632839301,15696,2
284185,LINC00482,chr17,R,81302823,81309248,42157434,6425,632845726,15697,3
284186,TMEM105,chr17,R,81305813,81330674,42182295,24861,632870587,15698,3
284191,LOC284191,chr17,R,16975234,16981353,42188414,6119,632876706,15699,2
284194,LGALS9B,chr17,R,20449394,20467535,42206555,18141,632894847,15700,12
284207,METRNL,chr17,F,83079690,83095129,42221994,15439,632910286,15701,4
286753,TUSC5,chr17,F,1279662,1300987,42243319,21325,632931611,15702,2
317719,KLHL10,chr17,F,41837489,41848347,42254177,10858,632942469,15703,5
326624,RAB37,chr17,F,74671116,74747335,42330396,76219,633018688,15704,12
339166,LOC339166,chr17,F,5772233,5930696,42488859,158463,633177151,15705,3
339168,TMEM95,chr17,F,7355133,7357219,42490945,2086,633179237,15706,6
339175,METTL2A,chr17,F,62423884,62450093,42517154,26209,633205446,15707,8
339184,CCDC144NL,chr17,R,20847347,20896647,42566454,49300,633254746,15708,5
339192,LOC339192,chr17,R,45219312,45219974,42567116,662,633255408,15709,1
339201,ASB16-AS1,chr17,R,44175972,44186717,42577861,10745,633266153,15710,3
339210,C17orf67,chr17,R,56791912,56834062,42620011,42150,633308303,15711,8
339221,ENPP7,chr17,F,79730918,79742926,42632019,12008,633320311,15712,5
339229,OXLD1,chr17,R,81665035,81666637,42633621,1602,633321913,15713,0
339230,CCDC137,chr17,F,81666730,81673907,42640798,7177,633329090,15714,6
339231,ARL16,chr17,R,81681154,81683924,42643568,2770,633331860,15715,4
339240,KRT17P5,chr17,F,18422180,18425333,42646721,3153,633335013,15716,0
339260,LOC339260,chr17,F,20938519,20982357,42690559,43838,633378851,15717,5
339263,C17orf51,chr17,R,21439839,21551678,42802398,111839,633490690,15718,5
339287,MSL1,chr17,F,40121987,40136794,42817205,14807,633505497,15719,9
342510,CD300E,chr17,R,74609882,74623758,42831081,13876,633519373,15720,3
342527,SMTNL2,chr17,F,4583980,4608319,42855420,24339,633543712,15721,9
342538,NACA2,chr17,R,61590432,61591202,42856190,770,633544482,15722,0
342574,KRT27,chr17,R,40776807,40782534,42861917,5727,633550209,15723,7
342618,SLFN14,chr17,R,35545733,35560836,42877020,15103,633565312,15724,6
342666,LRRC37A11P,chr17,F,39029905,39053205,42900320,23300,633588612,15725,4
342667,STAC2,chr17,R,39210535,39225787,42915572,15252,633603864,15726,10
347741,OTOP3,chr17,F,74935801,74949992,42929763,14191,633618055,15727,6
348235,SKA2,chr17,R,59109946,59155439,42975256,45493,633663548,15728,3
348249,CCL15-CCL14,chr17,R,35983655,36002038,42993639,18383,633681931,15729,7
348254,CCDC144CP,chr17,F,20321173,20402191,43074657,81018,633762949,15730,15
348262,FAM195B,chr17,R,81822360,81833294,43085591,10934,633773883,15731,5
350383,GPR142,chr17,F,74367406,74373008,43091193,5602,633779485,15732,3
353149,TBC1D26,chr17,F,15732276,15744784,43103701,12508,633791993,15733,14
353174,ZACN,chr17,F,76079181,76082804,43107324,3623,633795616,15734,8
353288,KRT26,chr17,R,40766237,40772159,43113246,5922,633801538,15735,7
359845,FAM101B,chr17,R,439977,445940,43119209,5963,633807501,15736,1
360205,PRAC2,chr17,F,48720808,48724758,43123159,3950,633811451,15737,4
373861,HILS1,chr17,R,50171427,50172476,43124208,1049,633812500,15738,0
374286,CDRT1,chr17,R,15565481,15619704,43178431,54223,633866723,15739,13
374768,SPEM1,chr17,F,7420359,7421632,43179704,1273,633867996,15740,2
374786,EFCAB5,chr17,F,29929855,30108452,43358301,178597,634046593,15741,30
374819,LRRC37A3,chr17,R,64854146,64919480,43423635,65334,634111927,15742,13
376412,RNF126P1,chr17,F,57045477,57046795,43424953,1318,634113245,15743,0
388323,GLTPD2,chr17,F,4788421,4790592,43427124,2171,634115416,15744,2
388324,INCA1,chr17,R,4988129,4997922,43436917,9793,634125209,15745,8
388325,SCIMP,chr17,R,5208919,5234860,43462858,25941,634151150,15746,5
388327,C17orf100,chr17,F,6651738,6653298,43464418,1560,634152710,15747,0
388333,SPDYE4,chr17,R,8746867,8759412,43476963,12545,634165255,15748,7
388335,TMEM220,chr17,R,10713321,10730329,43493971,17008,634182263,15749,5
388336,SHISA6,chr17,F,11241416,11564063,43816618,322647,634504910,15750,10
388341,LRRC75A,chr17,R,16442004,16492191,43866805,50187,634555097,15751,4
388364,TMIGD1,chr17,R,30316328,30334076,43884553,17748,634572845,15752,6
388381,C17orf98,chr17,R,38825391,38841500,43900662,16109,634588954,15753,3
388387,LINC00671,chr17,R,42874673,42898734,43924723,24061,634613015,15754,5
388389,CCDC103,chr17,F,44899711,44903679,43928691,3968,634616983,15755,3
388394,RPRML,chr17,R,46978155,46979248,43929784,1093,634618076,15756,0
388403,YPEL2,chr17,F,59331691,59401734,43999827,70043,634688119,15757,4
388406,LOC388406,chr17,F,60564545,60586620,44021902,22075,634710194,15758,3
388407,C17orf82,chr17,F,61411750,61413280,44023432,1530,634711724,15759,0
388419,BTBD17,chr17,R,74356415,74363652,44030669,7237,634718961,15760,5
388428,AATK-AS1,chr17,F,81165506,81183164,44048327,17658,634736619,15761,5
388436,LOC388436,chr17,F,19219381,19223730,44052676,4349,634740968,15762,2
388574,FLJ43681,chr17,F,83226896,83240804,44066584,13908,634754876,15763,3
390756,OR3A4P,chr17,F,3310244,3311446,44067786,1202,634756078,15764,0
390790,ARL5C,chr17,R,39156893,39166161,44077054,9268,634765346,15765,5
390792,KRT39,chr17,R,40958416,40966892,44085530,8476,634773822,15766,6
399512,SLC25A35,chr17,R,8287763,8295400,44093167,7637,634781459,15767,6
399687,MYO18A,chr17,R,29073509,29180389,44200047,106880,634888339,15768,41
400566,C17orf97,chr17,F,410326,414666,44204387,4340,634892679,15769,1
400569,MED11,chr17,F,4731407,4733610,44206590,2203,634894882,15770,2
400578,KRT16P2,chr17,R,16830482,16832833,44208941,2351,634897233,15771,4
400579,FLJ35934,chr17,F,18411158,18414388,44212171,3230,634900463,15772,1
400581,GRAPL,chr17,F,19127468,19158835,44243538,31367,634931830,15773,4
400591,C17orf102,chr17,R,34574122,34579369,44248785,5247,634937077,15774,1
400604,TOB1-AS1,chr17,F,50866678,50868371,44250478,1693,634938770,15775,1
400612,LOC400612,chr17,R,63996070,63999899,44254307,3829,634942599,15776,2
400617,KCNJ2-AS1,chr17,R,70166960,70169402,44256749,2442,634945041,15777,0
400618,SOX9-AS1,chr17,R,72071041,72120793,44306501,49752,634994793,15778,8
400619,LINC00511,chr17,R,72598040,72640472,44348933,42432,635037225,15779,4
400620,LOC400620,chr17,F,73786821,73800795,44362907,13974,635051199,15780,6
400622,LOC400622,chr17,F,77526794,77536598,44372711,9804,635061003,15781,4
400624,FLJ45079,chr17,R,77879000,77884087,44377798,5087,635066090,15782,1
400627,LOC400627,chr17,R,80968620,80971354,44380532,2734,635068824,15783,1
400629,TEX19,chr17,F,82359246,82363776,44385062,4530,635073354,15784,1
401884,MGC57346,chr17,F,45620328,45637963,44402697,17635,635090989,15785,4
404093,CUEDC1,chr17,R,57861242,57955323,44496778,94081,635185070,15786,14
404266,HOXB-AS3,chr17,F,48590419,48606414,44512773,15995,635201065,15787,7
406902,MIR10A,chr17,R,48579837,48579947,44512883,110,635201175,15788,0
406921,MIR132,chr17,R,2049907,2050008,44512984,101,635201276,15789,0
406934,MIR142,chr17,R,58331231,58331318,44513071,87,635201363,15790,0
406936,MIR144,chr17,R,28861532,28861618,44513157,86,635201449,15791,0
406943,MIR152,chr17,R,48037160,48037247,44513244,87,635201536,15792,0
406968,MIR193A,chr17,F,31559995,31560083,44513332,88,635201624,15793,0
406971,MIR195,chr17,R,7017614,7017701,44513419,87,635201711,15794,0
406972,MIR196A1,chr17,R,48632489,48632559,44513489,70,635201781,15795,0
406991,MIR21,chr17,F,59841265,59841337,44513561,72,635201853,15796,0
406994,MIR212,chr17,R,2050270,2050380,44513671,110,635201963,15797,0
407004,MIR22,chr17,R,1713902,1713987,44513756,85,635202048,15798,0
407027,MIR301A,chr17,R,59151135,59151221,44513842,86,635202134,15799,0
407977,TNFSF12-TNFSF13,chr17,F,7549057,7561608,44526393,12551,635214685,15800,5
414059,TBC1D3B,chr17,R,36165680,36176624,44537337,10944,635225629,15801,13
414060,TBC1D3C,chr17,R,38057692,38068634,44548279,10942,635236571,15802,14
414062,CCL3L3,chr17,R,36194868,36196748,44550159,1880,635238451,15803,2
439921,MXRA7,chr17,R,76673649,76711005,44587515,37356,635275807,15804,7
440400,RNASEK,chr17,F,7012416,7014533,44589632,2117,635277924,15805,3
440416,CCDC144NL-AS1,chr17,F,20868432,20905230,44626430,36798,635314722,15806,2
440419,TBC1D3P5,chr17,F,27418004,27431623,44640049,13619,635328341,15807,12
440423,SUZ12P1,chr17,F,30709607,30770050,44700492,60443,635388784,15808,7
440434,LOC440434,chr17,R,38195739,38257249,44762002,61510,635450294,15809,11
440435,GPR179,chr17,R,38325609,38343810,44780203,18201,635468495,15810,10
440446,LOC440446,chr17,F,51336714,51342571,44786060,5857,635474352,15811,2
440452,TBC1D3P2,chr17,R,62264704,62275655,44797011,10951,635485303,15812,13
440456,PLEKHM1P,chr17,R,64784840,64837184,44849355,52344,635537647,15813,10
440461,LOC440461,chr17,F,68198659,68200302,44850998,1643,635539290,15814,0
440465,BAIAP2-AS1,chr17,R,81029132,81034719,44856585,5587,635544877,15815,1
442898,MIR324,chr17,R,7223296,7223379,44856668,83,635544960,15816,0
442906,MIR338,chr17,R,81125882,81125949,44856735,67,635545027,15817,0
474170,LRRC37A2,chr17,F,46511689,46555650,44900696,43961,635588988,15818,14
494188,FBXO47,chr17,R,38936277,38967486,44931905,31209,635620197,15819,10
494335,MIR423,chr17,F,30117078,30117172,44931999,94,635620291,15820,0
503640,ARGFXP2,chr17,R,32150356,32151571,44933214,1215,635621506,15821,0
503645,DPRXP4,chr17,F,30975334,30976004,44933884,670,635622176,15822,0
574411,MIR451A,chr17,R,28861368,28861440,44933956,72,635622248,15823,0
574456,MIR497,chr17,R,7017910,7018022,44934068,112,635622360,15824,0
619505,SNORA21,chr17,R,38852862,38852995,44934201,133,635622493,15825,0
642843,CPSF4L,chr17,R,73242342,73262532,44954391,20190,635642683,15826,6
643008,SMIM5,chr17,F,75633433,75641406,44962364,7973,635650656,15827,3
643664,SLC35G6,chr17,F,7481401,7483064,44964027,1663,635652319,15828,1
643904,RNF222,chr17,R,8390703,8397833,44971157,7130,635659449,15829,3
644070,LOC644070,chr17,R,9801472,9809311,44978996,7839,635667288,15830,3
644139,PIRT,chr17,R,10822474,10838101,44994623,15627,635682915,15831,1
644172,LOC644172,chr17,R,45600100,45601862,44996385,1762,635684677,15832,0
644246,KANSL1-AS1,chr17,F,46193572,46196723,44999536,3151,635687828,15833,1
644694,CDRT15P2,chr17,F,15764702,15765689,45000523,987,635688815,15834,2
644767,LOC644767,chr17,R,79598623,79601286,45003186,2663,635691478,15835,0
644815,FAM83G,chr17,R,18971067,19004747,45036866,33680,635725158,15836,5
644945,KRT16P3,chr17,R,20501512,20504498,45039852,2986,635728144,15837,6
645027,EVPLL,chr17,F,18377691,18389652,45051813,11961,635740105,15838,11
645638,WFDC21P,chr17,R,60083565,60088467,45056715,4902,635745007,15839,2
645832,SEBOX,chr17,R,28364267,28365151,45057599,884,635745891,15840,2
652965,SNORA48,chr17,F,7574712,7574847,45057734,135,635746026,15841,0
652966,SNORD10,chr17,F,7576810,7576958,45057882,148,635746174,15842,0
653166,OR1D4,chr17,F,3240675,3241265,45058472,590,635746764,15843,0
653240,KRTAP4-11,chr17,R,41117180,41118354,45059646,1174,635747938,15844,0
653479,MRPL45P2,chr17,R,47450226,47492620,45102040,42394,635790332,15845,5
653486,SCGB1C2,chr17,F,132363,139067,45108744,6704,635797036,15846,3
653645,TBC1D3P1-DHX40P1,chr17,R,59976023,60018975,45151696,42952,635839988,15847,11
653653,LOC653653,chr17,R,60101759,60102919,45152856,1160,635841148,15848,0
654346,LGALS9C,chr17,F,18476784,18494945,45171017,18161,635859309,15849,11
654364,NME1-NME2,chr17,F,51153535,51171744,45189226,18209,635877518,15850,8
654434,SNHG20,chr17,F,77088642,77094986,45195570,6344,635883862,15851,2
677681,SCARNA20,chr17,R,60231515,60231645,45195700,130,635883992,15852,0
677763,SCARNA21,chr17,F,7906122,7906260,45195838,138,635884130,15853,0
677781,SCARNA16,chr17,F,77089306,77089493,45196025,187,635884317,15854,0
677842,SNORA76C,chr17,F,64146338,64146471,45196158,133,635884450,15855,0
677848,SNORD1A,chr17,F,76561632,76561706,45196232,74,635884524,15856,0
677849,SNORD1B,chr17,F,76561107,76561193,45196318,86,635884610,15857,0
677850,SNORD1C,chr17,F,76558791,76558869,45196396,78,635884688,15858,0
677882,SNORA59B,chr17,F,19557559,19557711,45196548,152,635884840,15859,0
692076,SNORD7,chr17,F,35573656,35573753,45196645,97,635884937,15860,0
692087,SNORD49B,chr17,F,16439508,16439556,45196693,48,635884985,15861,0
692106,SNORD65,chr17,F,16441225,16441298,45196766,73,635885058,15862,0
692207,SNORD91A,chr17,R,2330278,2330370,45196858,92,635885150,15863,0
692208,SNORD91B,chr17,R,2329124,2329210,45196944,86,635885236,15864,0
692227,SNORD104,chr17,F,64146077,64146157,45197024,80,635885316,15865,0
693120,MIR33B,chr17,R,17813835,17813931,45197120,96,635885412,15866,0
693131,MIR548D2,chr17,R,67471488,67471585,45197217,97,635885509,15867,0
693217,MIR632,chr17,F,32350108,32350202,45197311,94,635885603,15868,0
693218,MIR633,chr17,F,62944214,62944312,45197409,98,635885701,15869,0
693219,MIR634,chr17,F,66787071,66787168,45197506,97,635885798,15870,0
693220,MIR635,chr17,R,68424450,68424548,45197604,98,635885896,15871,0
693221,MIR636,chr17,R,76736449,76736548,45197703,99,635885995,15872,0
724027,MIR657,chr17,R,81125275,81125373,45197801,98,635886093,15873,0
727676,SNORD118,chr17,R,8173452,8173588,45197937,136,635886229,15874,0
727857,BHLHA9,chr17,F,1270563,1271271,45198645,708,635886937,15875,0
727910,TLCD2,chr17,R,1702789,1710368,45206224,7579,635894516,15876,3
728224,KRTAP4-8,chr17,R,41096980,41098123,45207367,1143,635895659,15877,0
728255,KRTAP1-4,chr17,R,41029676,41030125,45207816,449,635896108,15878,0
728279,KRTAP2-2,chr17,R,41054497,41055211,45208530,714,635896822,15879,0
728318,KRTAP9-1,chr17,F,41189886,41190639,45209283,753,635897575,15880,0
728392,LOC728392,chr17,R,5499426,5500999,45210856,1573,635899148,15881,1
728806,NSFP1,chr17,F,46372812,46423097,45261141,50285,635949433,15882,6
729220,FLJ45513,chr17,F,49844714,49848837,45265264,4123,635953556,15883,3
729252,KRT16P1,chr17,F,18439907,18442895,45268252,2988,635956544,15884,6
729288,ZNF286B,chr17,R,18658428,18682259,45292083,23831,635980375,15885,4
729683,LOC729683,chr17,F,63700337,63702685,45294431,2348,635982723,15886,0
729873,TBC1D3,chr17,R,38181475,38192555,45305511,11080,635993803,15887,13
729877,TBC1D3H,chr17,R,36377474,36388441,45316478,10967,636004770,15888,14
730755,KRTAP2-3,chr17,R,41059239,41060092,45317331,853,636005623,15889,0
768206,PRCD,chr17,F,76527585,76553580,45343326,25995,636031618,15890,7
768216,MIR454,chr17,R,59137757,59137872,45343441,115,636031733,15891,0
780851,SNORD3A,chr17,F,19188015,19188232,45343658,217,636031950,15892,0
780852,SNORD3B-2,chr17,R,19063919,19064136,45343875,217,636032167,15893,0
780853,SNORD3C,chr17,R,19190028,19190245,45344092,217,636032384,15894,0
780854,SNORD3D,chr17,R,19112419,19112636,45344309,217,636032601,15895,0
100124536,SNORA38B,chr17,F,67740669,67740801,45344441,132,636032733,15896,0
100126313,MIR744,chr17,F,12081898,12081996,45344539,98,636032831,15897,0
100126356,MIR365B,chr17,F,31575410,31575521,45344650,111,636032942,15898,0
100128006,LOC100128006,chr17,R,12760133,12790284,45374801,30151,636063093,15899,1
100128288,LOC100128288,chr17,R,8358412,8360541,45376930,2129,636065222,15900,0
100128560,MYHAS,chr17,F,10383131,10625540,45619339,242409,636307631,15901,10
100128977,MAPT-AS1,chr17,R,45843355,45895513,45671497,52158,636359789,15902,1
100129396,FAM106CP,chr17,F,16788742,16790501,45673256,1759,636361548,15903,0
100129503,PP13,chr17,F,81003340,81005126,45675042,1786,636363334,15904,0
100130148,MAPT-IT1,chr17,F,45895782,45898798,45678058,3016,636366350,15905,0
100130311,C17orf107,chr17,F,4899461,4905329,45683926,5868,636372218,15906,3
100130370,LOC100130370,chr17,R,81375497,81386797,45695226,11300,636383518,15907,4
100130520,LOC100130520,chr17,R,74557245,74567534,45705515,10289,636393807,15908,4
100130581,LINC00910,chr17,R,43369844,43388898,45724569,19054,636412861,15909,5
100130876,LOC100130876,chr17,R,940348,943585,45727806,3237,636416098,15910,3
100130933,SMIM6,chr17,F,75644821,75647977,45730962,3156,636419254,15911,2
100130950,LOC100130950,chr17,F,5192083,5235636,45774515,43553,636462807,15912,7
100131096,TNRC6C-AS1,chr17,R,78107400,78111799,45778914,4399,636467206,15913,1
100131347,LOC100131347,chr17,F,39057018,39081451,45803347,24433,636491639,15914,4
100131439,CD300LD,chr17,R,74579971,74592231,45815607,12260,636503899,15915,3
100131454,DBIL5P,chr17,F,752332,755336,45818611,3004,636506903,15916,0
100132174,LOC100132174,chr17,R,77722871,77728559,45824299,5688,636512591,15917,1
100132386,KRTAP4-9,chr17,F,41105388,41106488,45825399,1100,636513691,15918,0
100132476,KRTAP4-7,chr17,F,41084206,41085144,45826337,938,636514629,15919,0
100133319,PRO1804,chr17,R,69232974,69235012,45828375,2038,636516667,15920,0
100133991,MAP3K14-AS1,chr17,F,45247924,45268630,45849081,20706,636537373,15921,6
100134391,LOC100134391,chr17,F,73737853,73756831,45868059,18978,636556351,15922,7
100134444,KCNJ18,chr17,F,21692522,21705700,45881237,13178,636569529,15923,3
100134934,TEN1,chr17,F,75979216,76000586,45902607,21370,636590899,15924,3
100141515,C17orf99,chr17,F,78146039,78166904,45923472,20865,636611764,15925,6
100170841,C17orf96,chr17,R,38671702,38674934,45926704,3232,636614996,15926,0
100189037,TRS-CGA1-1,chr17,R,8138880,8138962,45926786,82,636615078,15927,0
100189052,TRC-GCA2-1,chr17,F,38867644,38867716,45926858,72,636615150,15928,0
100189078,TRR-CCT1-1,chr17,F,75033905,75033978,45926931,73,636615223,15929,0
100189080,TRSUP-TTA1-1,chr17,F,60786231,60786302,45927002,71,636615294,15930,0
100189090,TRC-GCA4-1,chr17,R,38869291,38869363,45927074,72,636615366,15931,0
100189105,TRC-GCA2-2,chr17,R,39153733,39153805,45927146,72,636615438,15932,0
100189112,TRW-CCA3-1,chr17,F,8186357,8186429,45927218,72,636615510,15933,0
100189123,TRW-CCA1-1,chr17,R,8220868,8220940,45927290,72,636615582,15934,0
100189124,TRP-CGG1-3,chr17,R,8222832,8222904,45927362,72,636615654,15935,0
100189176,TRN-GTT2-5,chr17,R,38751780,38751854,45927436,74,636615728,15936,0
100189181,TRR-CCT2-1,chr17,R,75034430,75034503,45927509,73,636615801,15937,0
100189184,TRS-AGA2-1,chr17,R,8226609,8226691,45927591,82,636615883,15938,0
100189187,TRT-AGT1-1,chr17,F,8187159,8187233,45927665,74,636615957,15939,0
100189203,TRW-CCA2-1,chr17,F,19508180,19508252,45927737,72,636616029,15940,0
100189206,TRG-TCC3-1,chr17,F,8221547,8221619,45927809,72,636616101,15941,0
100189222,TRT-AGT1-2,chr17,R,8226234,8226308,45927883,74,636616175,15942,0
100189245,TRT-CGT4-1,chr17,F,31550073,31550145,45927955,72,636616247,15943,0
100189255,TRX-CAT1-2,chr17,R,82494720,82494792,45928027,72,636616319,15944,0
100189277,TRG-CCC3-1,chr17,F,19860861,19860932,45928098,71,636616390,15945,0
100189331,TRS-GCT4-2,chr17,F,8186865,8186947,45928180,82,636616472,15946,0
100189371,TRR-TCG3-1,chr17,F,75035112,75035185,45928253,73,636616545,15947,0
100189383,TRD-GTC2-9,chr17,R,8222237,8222309,45928325,72,636616617,15948,0
100189387,TRI-AAT5-2,chr17,F,8187592,8187666,45928399,74,636616691,15949,0
100189393,TRI-AAT4-1,chr17,R,8226990,8227064,45928473,74,636616765,15950,0
100189414,TRC-GCA2-3,chr17,R,39154490,39154562,45928545,72,636616837,15951,0
100189435,TRC-GCA14-1,chr17,R,38861683,38861755,45928617,72,636616909,15952,0
100189438,TRT-AGT4-1,chr17,R,8139451,8139525,45928691,74,636616983,15953,0
100190938,RAMP2-AS1,chr17,R,42753913,42761257,45936035,7344,636624327,15954,3
100287042,LOC100287042,chr17,F,75271298,75273895,45938632,2597,636626924,15955,0
100287072,LOC100287072,chr17,F,20712445,20737865,45964052,25420,636652344,15956,11
100287808,LOC100287808,chr17,F,38748914,38751457,45966595,2543,636654887,15957,0
100288866,LOC100288866,chr17,R,49505656,49574064,46035003,68408,636723295,15958,2
100289255,LINC00675,chr17,R,10794912,10804099,46044190,9187,636732482,15959,1
100294362,LOC100294362,chr17,R,80351829,80415168,46107529,63339,636795821,15960,1
100302124,MIR1288,chr17,F,16282013,16282088,46107604,75,636795896,15961,0
100302208,MIR1253,chr17,R,2748077,2748182,46107709,105,636796001,15962,0
100302211,MIR1203,chr17,R,48156426,48156511,46107794,85,636796086,15963,0
100302229,MIR1250,chr17,R,81133195,81133308,46107907,113,636796199,15964,0
100302256,MIR1180,chr17,R,19344505,19344574,46107976,69,636796268,15965,0
100302287,MIR548H3,chr17,R,13543528,13543646,46108094,118,636796386,15966,0
100306951,PITPNA-AS1,chr17,F,1516918,1518096,46109272,1178,636797564,15967,1
100313779,MIR2117,chr17,F,43444805,43444885,46109352,80,636797644,15968,0
100422835,MIR3183,chr17,R,1022475,1022559,46109436,84,636797728,15969,0
100422851,MIR4316,chr17,R,77396983,77397054,46109507,71,636797799,15970,0
100422915,MIR3065,chr17,F,81125876,81125955,46109586,79,636797878,15971,0
100422944,MIR3186,chr17,R,81451103,81451188,46109671,85,636797963,15972,0
100422961,MIR4315-2,chr17,R,64822029,64822102,46109744,73,636798036,15973,0
100422969,MIR2909,chr17,F,37033744,37033813,46109813,69,636798105,15974,0
100422978,MIR3185,chr17,R,48724407,48724475,46109881,68,636798173,15975,0
100422983,MIR4314,chr17,F,8088055,8088147,46109973,92,636798265,15976,0
100423003,MIR3184,chr17,R,30117085,30117160,46110048,75,636798340,15977,0
100423004,MIR4315-1,chr17,R,45475362,45475435,46110121,73,636798413,15978,0
100462977,MTRNR2L1,chr17,F,22523110,22524665,46111676,1555,636799968,15979,0
100499466,LINC00674,chr17,F,68101554,68135929,46146051,34375,636834343,15980,5
100499467,LINC00673,chr17,R,72403321,72592804,46335534,189483,637023826,15981,3
100500827,MIR3614,chr17,R,56891269,56891355,46335620,86,637023912,15982,0
100500841,MIR3678,chr17,F,75406068,75406162,46335714,94,637024006,15983,0
100500847,MIR3615,chr17,F,74748612,74748699,46335801,87,637024093,15984,0
100500895,MIR548AA2,chr17,F,67471488,67471585,46335898,97,637024190,15985,0
100505576,LINC00672,chr17,F,38925167,38929384,46340115,4217,637028407,15986,1
100505591,LRRC3C,chr17,F,39927721,39945034,46357428,17313,637045720,15987,6
100505724,KRTAP9-7,chr17,F,41275697,41276207,46357938,510,637046230,15988,0
100505753,KRTAP16-1,chr17,R,41307699,41309253,46359492,1554,637047784,15989,0
100505782,LOC100505782,chr17,F,41402415,41412588,46369665,10173,637057957,15990,2
100505909,LOC100505909,chr17,R,83220526,83227932,46377071,7406,637065363,15991,2
100506084,ARL17B,chr17,R,46274183,46362064,46464952,87881,637153244,15992,10
100506325,SP2-AS1,chr17,R,47898385,47941404,46507971,43019,637196263,15993,2
100506371,LOC100506371,chr17,R,183823,187251,46511399,3428,637199691,15994,1
100506388,LOC100506388,chr17,F,331204,333488,46513683,2284,637201975,15995,2
100506436,SPAG5-AS1,chr17,F,28599132,28617377,46531928,18245,637220220,15996,2
100506596,LOC100506596,chr17,R,32178955,32180069,46533042,1114,637221334,15997,0
100506650,C17orf112,chr17,F,52983990,52987658,46536710,3668,637225002,15998,4
100506677,AA06,chr17,R,33529786,33533760,46540684,3974,637228976,15999,2
100506713,ALOX12-AS1,chr17,R,6985122,7012334,46567896,27212,637256188,16000,2
100506736,SLFN12L,chr17,R,35474922,35491208,46584182,16286,637272474,16001,5
100506755,MIR497HG,chr17,R,7015817,7019654,46588019,3837,637276311,16002,2
100506779,BZRAP1-AS1,chr17,F,58325449,58353727,46616297,28278,637304589,16003,7
100506898,MAGOH2P,chr17,R,10715942,10716582,46616937,640,637305229,16004,0
100506974,LOC100506974,chr17,R,13776627,13892841,46733151,116214,637421443,16005,6
100507002,LOC100507002,chr17,F,65100811,65111095,46743435,10284,637431727,16006,2
100507131,LOC100507131,chr17,R,17858226,17860803,46746012,2577,637434304,16007,0
100507191,LOC100507191,chr17,R,75821142,75821990,46746860,848,637435152,16008,0
100507218,RNF157-AS1,chr17,F,76140555,76154648,46760953,14093,637449245,16009,7
100507246,SNHG16,chr17,F,76557763,76565348,46768538,7585,637456830,16010,3
100507351,LOC100507351,chr17,F,77546940,77565024,46786622,18084,637474914,16011,1
100507410,C1QTNF1-AS1,chr17,R,79019208,79027655,46795069,8447,637483361,16012,2
100507608,KRTAP9-6,chr17,F,41265377,41265860,46795552,483,637483844,16013,0
100510707,TBC1D3J,chr17,R,36449776,36456035,46801811,6259,637490103,16014,7
100526648,MIR1273E,chr17,R,64425068,64425170,46801913,102,637490205,16015,0
100529145,TEN1-CDK3,chr17,F,75979216,76005999,46828696,26783,637516988,16016,9
100529207,RAD51L3-RFFL,chr17,R,35009111,35121522,46941107,112411,637629399,16017,6
100529209,RNASEK-C17orf49,chr17,F,7012416,7017524,46946215,5108,637634507,16018,7
100529211,TMEM256-PLSCR3,chr17,R,7389726,7404131,46960620,14405,637648912,16019,3
100533177,KRTAP29-1,chr17,R,41301825,41302851,46961646,1026,637649938,16020,0
100533496,TVP23C-CDRT4,chr17,R,15436014,15563631,47089263,127617,637777555,16021,6
100533789,LRRC37A8P,chr17,R,35904219,35911023,47096067,6804,637784359,16022,0
100533955,SENP3-EIF4A1,chr17,F,7561991,7579006,47113082,17015,637801374,16023,10
100533970,P2RX5-TAX1BP3,chr17,R,3662892,3696404,47146594,33512,637834886,16024,14
100616121,MIR1268B,chr17,F,80098827,80098877,47146644,50,637834936,16025,0
100616122,MIR4523,chr17,F,29390661,29390730,47146713,69,637835005,16026,0
100616125,MIR4731,chr17,R,15251626,15251696,47146783,70,637835075,16027,0
100616132,MIR4728,chr17,F,39726494,39726561,47146850,67,637835142,16028,0
100616153,MIR4726,chr17,F,38719690,38719748,47146908,58,637835200,16029,0
100616170,MIR4739,chr17,R,79707175,79707249,47146982,74,637835274,16030,0
100616196,MIR4525,chr17,R,82668232,82668307,47147057,75,637835349,16031,0
100616203,MIR4734,chr17,R,38702261,38702331,47147127,70,637835419,16032,0
100616204,MIR4729,chr17,F,59366082,59366154,47147199,72,637835491,16033,0
100616210,MIR4737,chr17,R,60043024,60043105,47147280,81,637835572,16034,0
100616220,MIR4736,chr17,R,58335975,58336022,47147327,47,637835619,16035,0
100616248,MIR4724,chr17,F,31534882,31534971,47147416,89,637835708,16036,0
100616266,MIR4733,chr17,R,31094349,31094425,47147492,76,637835784,16037,0
100616273,MIR451B,chr17,F,28861370,28861438,47147560,68,637835852,16038,0
100616277,MIR4522,chr17,R,27293909,27293996,47147647,87,637835939,16039,0
100616282,MIR4738,chr17,R,75784520,75784607,47147734,87,637836026,16040,0
100616294,MIR4740,chr17,R,81400715,81400778,47147797,63,637836089,16041,0
100616316,MIR4524A,chr17,R,69099563,69099632,47147866,69,637836158,16042,0
100616359,MIR4730,chr17,F,80419417,80419493,47147942,76,637836234,16043,0
100616385,MIR4732,chr17,R,28861654,28861730,47148018,76,637836310,16044,0
100616387,MIR3064,chr17,R,64500773,64500839,47148084,66,637836376,16045,0
100616388,MIR4723,chr17,F,28360653,28360734,47148165,81,637836457,16046,0
100616401,MIR4520-1,chr17,R,6655439,6655509,47148235,70,637836527,16047,0
100616406,MIR4521,chr17,F,8186944,8187004,47148295,60,637836587,16048,0
100616408,MIR5047,chr17,R,64501213,64501313,47148395,100,637836687,16049,0
100616416,MIR4727,chr17,F,38825837,38825892,47148450,55,637836742,16050,0
100616449,MIR4725,chr17,F,31575268,31575358,47148540,90,637836832,16051,0
100616466,MIR4520-2,chr17,F,6655448,6655502,47148594,54,637836886,16052,0
100616494,MIR1269B,chr17,R,12917267,12917342,47148669,75,637836961,16053,0
100652883,ALOX15P1,chr17,F,6657718,6661382,47152333,3664,637840625,16054,4
100652929,HP09025,chr17,F,79707265,79712317,47157385,5052,637845677,16055,1
100653515,KIAA1731NL,chr17,R,78890578,78903217,47170024,12639,637858316,16056,3
100847008,MIR4524B,chr17,F,69099541,69099656,47170139,115,637858431,16057,0
100847030,MIR548AT,chr17,F,42494772,42494830,47170197,58,637858489,16058,0
100847046,MIR5010,chr17,F,42514187,42514307,47170317,120,637858609,16059,0
100847067,MIR5089,chr17,F,46973016,46973100,47170401,84,637858693,16060,0
100861437,NARR,chr17,R,28715992,28717890,47172299,1898,637860591,16061,2
100861516,RAI1-AS1,chr17,R,17759153,17766302,47179448,7149,637867740,16062,1
100874018,EPN2-AS1,chr17,R,19296595,19306261,47189114,9666,637877406,16063,2
100874058,COX10-AS1,chr17,R,14029291,14069458,47229281,40167,637917573,16064,2
100874261,LINC00854,chr17,R,43221416,43231269,47239134,9853,637927426,16065,5
100874309,EPN2-IT1,chr17,F,19271392,19274388,47242130,2996,637930422,16066,2
100874362,HOXB-AS1,chr17,F,48544350,48551241,47249021,6891,637937313,16067,6
100885848,PTGES3L,chr17,R,42968087,42980528,47261462,12441,637949754,16068,17
100885850,PTGES3L-AARSD1,chr17,R,42950525,42980528,47291465,30003,637979757,16069,17
100996259,FAM106B,chr17,F,20417291,20419050,47293224,1759,637981516,16070,0
100996273,LOC100996273,chr17,F,77439911,77446373,47299686,6462,637987978,16071,0
100996291,LOC100996291,chr17,R,78261348,78278492,47316830,17144,638005122,16072,6
100996294,LOC100996294,chr17,R,20530041,20533271,47320060,3230,638008352,16073,1
100996295,DNAH17-AS1,chr17,F,78484909,78503056,47338207,18147,638026499,16074,5
100996660,LOC100996660,chr17,R,60126534,60135748,47347421,9214,638035713,16075,4
100996792,LOC100996792,chr17,R,21773014,21783473,47357880,10459,638046172,16076,4
100996813,LOC100996813,chr17,F,19577659,19633825,47414046,56166,638102338,16077,12
100996842,LOC100996842,chr17,R,7582032,7584784,47416798,2752,638105090,16078,1
101059954,LOC101059954,chr17,F,40523195,40527002,47420605,3807,638108897,16079,1
101060321,LOC101060321,chr17,F,36322241,36334759,47433123,12518,638121415,16080,13
101060351,TBC1D3K,chr17,F,37923804,37935371,47444690,11567,638132982,16081,13
101060376,TBC1D3L,chr17,R,37978154,37989062,47455598,10908,638143890,16082,14
101060389,LOC101060389,chr17,F,38004032,38014908,47466474,10876,638154766,16083,14
101060400,LOC101060400,chr17,R,48634803,48647072,47478743,12269,638167035,16084,3
101060544,LINC01563,chr17,F,21075555,21090613,47493801,15058,638182093,16085,2
101101775,TMEM220-AS1,chr17,F,10729776,10815164,47579189,85388,638267481,16086,8
101340251,SNORD124,chr17,R,40027541,40027645,47579293,104,638267585,16087,0
101559451,LOC101559451,chr17,F,4704229,4705529,47580593,1300,638268885,16088,1
101926967,LOC101926967,chr17,F,44198842,44223707,47605458,24865,638293750,16089,1
101926984,LOC101926984,chr17,R,28263633,28275902,47617727,12269,638306019,16090,1
101926996,RUNDC3A-AS1,chr17,R,44299573,44308431,47626585,8858,638314877,16091,3
101927017,LINC01180,chr17,R,44646363,44650349,47630571,3986,638318863,16092,2
101927018,LOC101927018,chr17,F,28926274,28944749,47649046,18475,638337338,16093,1
101927057,LOC101927057,chr17,R,31272010,31275502,47652538,3492,638340830,16094,1
101927060,LOC101927060,chr17,R,47056711,47100282,47696109,43571,638384401,16095,4
101927093,LOC101927093,chr17,R,30573470,30576658,47699297,3188,638387589,16096,2
101927166,LOC101927166,chr17,F,48444832,48466040,47720505,21208,638408797,16097,5
101927198,LOC101927198,chr17,F,32827882,32860890,47753513,33008,638441805,16098,7
101927207,LOC101927207,chr17,R,49457860,49461749,47757402,3889,638445694,16099,2
101927230,LOC101927230,chr17,F,50214693,50215420,47758129,727,638446421,16100,2
101927239,LOC101927239,chr17,R,34169375,34183632,47772386,14257,638460678,16101,5
101927253,LOC101927253,chr17,R,50627029,50631940,47777297,4911,638465589,16102,1
101927274,LOC101927274,chr17,R,51312608,51335162,47799851,22554,638488143,16103,5
101927337,LOC101927337,chr17,R,53088570,53106388,47817669,17818,638505961,16104,2
101927339,LOC101927339,chr17,F,35984458,35990270,47823481,5812,638511773,16105,1
101927367,LOC101927367,chr17,R,55449862,55458532,47832151,8670,638520443,16106,2
101927369,LOC101927369,chr17,R,36116161,36149062,47865052,32901,638553344,16107,4
101927389,LOC101927389,chr17,F,55612977,55650247,47902322,37270,638590614,16108,6
101927510,LOC101927510,chr17,R,57252768,57257037,47906591,4269,638594883,16109,3
101927539,LOC101927539,chr17,R,57600863,57608412,47914140,7549,638602432,16110,2
101927557,LOC101927557,chr17,R,57522247,57523597,47915490,1350,638603782,16111,2
101927581,CCDC182,chr17,R,57744480,57745329,47916339,849,638604631,16112,0
101927666,LOC101927666,chr17,R,58076890,58083204,47922653,6314,638610945,16113,2
101927688,SEPT4-AS1,chr17,F,58519836,58556925,47959742,37089,638648034,16114,4
101927727,LOC101927727,chr17,F,909631,911230,47961341,1599,638649633,16115,1
101927728,LINC01476,chr17,R,59430868,59526857,48057330,95989,638745622,16116,2
101927755,LOC101927755,chr17,F,59965095,59996972,48089207,31877,638777499,16117,4
101927839,LOC101927839,chr17,F,2232677,2233610,48090140,933,638778432,16118,1
101927855,LOC101927855,chr17,R,61361593,61383553,48112100,21960,638800392,16119,4
101927864,LOC101927864,chr17,R,2366588,2371204,48116716,4616,638805008,16120,2
101927877,LOC101927877,chr17,F,62808466,62836371,48144621,27905,638832913,16121,1
101927898,LOC101927898,chr17,R,63682335,63690982,48153268,8647,638841560,16122,2
101927911,LOC101927911,chr17,R,2962246,2965895,48156917,3649,638845209,16123,2
101927979,LOC101927979,chr17,F,4987681,4988778,48158014,1097,638846306,16124,2
101928000,LOC101928000,chr17,F,5111935,5114397,48160476,2462,638848768,16125,2
101928001,PRKCA-AS1,chr17,R,66398068,66416854,48179262,18786,638867554,16126,3
101928021,LOC101928021,chr17,F,67243958,67272108,48207412,28150,638895704,16127,3
101928045,LOC101928045,chr17,R,67675541,67717775,48249646,42234,638937938,16128,3
101928104,LINC01482,chr17,F,68628153,68679606,48301099,51453,638989391,16129,4
101928122,LINC01483,chr17,F,69593986,69903000,48610113,309014,639298405,16130,5
101928141,LINC01028,chr17,F,70051270,70068095,48626938,16825,639315230,16131,2
101928165,CASC17,chr17,R,71097773,71202179,48731344,104406,639419636,16132,3
101928205,LOC101928205,chr17,F,72072332,72093481,48752493,21149,639440785,16133,5
101928235,LOC101928235,chr17,F,8965779,8968423,48755137,2644,639443429,16134,1
101928251,LOC101928251,chr17,F,73513635,73518770,48760272,5135,639448564,16135,1
101928266,LOC101928266,chr17,R,9171067,9179118,48768323,8051,639456615,16136,3
101928343,LOC101928343,chr17,F,74599839,74625910,48794394,26071,639482686,16137,4
101928350,LOC101928350,chr17,R,11857182,11881269,48818481,24087,639506773,16138,3
101928418,LOC101928418,chr17,R,12671861,12706135,48852755,34274,639541047,16139,2
101928447,LOC101928447,chr17,R,76105973,76132499,48879281,26526,639567573,16140,5
101928475,LOC101928475,chr17,F,15014789,15052276,48916768,37487,639605060,16141,1
101928514,LOC101928514,chr17,F,76799043,76807102,48924827,8059,639613119,16142,2
101928567,LOC101928567,chr17,R,15806241,15817742,48936328,11501,639624620,16143,2
101928674,LOC101928674,chr17,F,78360447,78373909,48949790,13462,639638082,16144,7
101928710,LOC101928710,chr17,R,78617383,78632057,48964464,14674,639652756,16145,4
101928738,LOC101928738,chr17,F,79919356,79924010,48969118,4654,639657410,16146,1
101928766,LOC101928766,chr17,R,79915251,79926725,48980592,11474,639668884,16147,5
101928855,LOC101928855,chr17,R,80801639,80805632,48984585,3993,639672877,16148,3
101928991,LOC101928991,chr17,R,2724410,2749562,49009737,25152,639698029,16149,3
101929141,LOC101929141,chr17,F,18834661,18865564,49040640,30903,639728932,16150,5
101929185,LOC101929185,chr17,F,57988109,57989295,49041826,1186,639730118,16151,0
101929240,LOC101929240,chr17,F,64750401,64751508,49042933,1107,639731225,16152,0
101929482,LOC101929482,chr17,R,242139,244984,49045778,2845,639734070,16153,1
101929494,LOC101929494,chr17,R,38450678,38452425,49047525,1747,639735817,16154,3
101929511,LOC101929511,chr17,R,82290045,82293210,49050690,3165,639738982,16155,1
101929552,LOC101929552,chr17,R,82713904,82716473,49053259,2569,639741551,16156,1
101929578,LOC101929578,chr17,F,39237785,39251019,49066493,13234,639754785,16157,10
101929650,LOC101929650,chr17,F,83143914,83145259,49067838,1345,639756130,16158,1
101929693,RARA-AS1,chr17,R,40340866,40343136,49070108,2270,639758400,16159,2
101929767,LOC101929767,chr17,R,43148365,43170403,49092146,22038,639780438,16160,1
101929777,LOC101929777,chr17,R,46830594,46833154,49094706,2560,639782998,16161,2
101929823,LOC101929823,chr17,R,68097,108364,49134973,40267,639823265,16162,18
101929828,LOC101929828,chr17,R,109545,111566,49136994,2021,639825286,16163,1
101929831,LOC101929831,chr17,R,79632705,79659866,49164155,27161,639852447,16164,4
101929950,LOC101929950,chr17,F,38078235,38118280,49204200,40045,639892492,16165,4
101929997,LOC101929997,chr17,F,22331201,22333141,49206140,1940,639894432,16166,3
101930496,LOC101930496,chr17,F,83110232,83119423,49215331,9191,639903623,16167,2
101930665,LOC101930665,chr17,F,21612848,21642127,49244610,29279,639932902,16168,4
102464831,MIR6080,chr17,F,64780758,64780824,49244676,66,639932968,16169,0
102465136,MIR378J,chr17,R,37614930,37615039,49244785,109,639933077,16170,0
102465137,MIR6129,chr17,R,49288345,49288454,49244894,109,639933186,16171,0
102465141,MIR6165,chr17,F,49510816,49510900,49244978,84,639933270,16172,0
102465465,MIR6776,chr17,R,2692860,2692919,49245037,59,639933329,16173,0
102465466,MIR6777,chr17,R,17813479,17813545,49245103,66,639933395,16174,0
102465467,MIR6779,chr17,F,38914978,38915042,49245167,64,639933459,16175,0
102465468,MIR6781,chr17,R,42823879,42823943,49245231,64,639933523,16176,0
102465469,MIR6782,chr17,R,44207770,44207839,49245300,69,639933592,16177,0
102465470,MIR6784,chr17,R,45114366,45114433,49245367,67,639933659,16178,0
102465471,MIR6786,chr17,F,81693756,81693869,49245480,113,639933772,16179,0
102465472,MIR6787,chr17,F,82236667,82236728,49245541,61,639933833,16180,0
102465521,MIR6864,chr17,R,4969701,4969771,49245611,70,639933903,16181,0
102465522,MIR6865,chr17,R,4970085,4970150,49245676,65,639933968,16182,0
102465523,MIR6867,chr17,F,40193596,40193663,49245743,67,639934035,16183,0
102465532,MIR6883,chr17,R,8144993,8145071,49245821,78,639934113,16184,0
102466195,MIR6780A,chr17,R,42708083,42708151,49245889,68,639934181,16185,0
102466658,MIR6510,chr17,R,41517163,41517217,49245943,54,639934235,16186,0
102466733,MIR6778,chr17,R,18340813,18340886,49246016,73,639934308,16187,0
102466734,MIR6783,chr17,R,44934617,44934681,49246080,64,639934372,16188,0
102466753,MIR6868,chr17,R,76098018,76098076,49246138,58,639934430,16189,0
102466757,MIR6884,chr17,R,40026331,40026409,49246216,78,639934508,16190,0
102466864,MIR6516,chr17,F,77089416,77089497,49246297,81,639934589,16191,0
102466911,MIR6785,chr17,F,75498547,75498628,49246378,81,639934670,16192,0
102466918,MIR8059,chr17,F,50768649,50768730,49246459,81,639934751,16193,0
102466986,MIR6866,chr17,F,40161932,40162001,49246528,69,639934820,16194,0
102606463,LINC01152,chr17,F,72030653,72041297,49257172,10644,639945464,16195,2
102723414,LOC102723414,chr17,R,36349123,36361576,49269625,12453,639957917,16196,3
102723456,LOC102723456,chr17,R,36861673,36863150,49271102,1477,639959394,16197,1
102723471,LOC102723471,chr17,R,36932104,36936708,49275706,4604,639963998,16198,1
102723487,LINC01497,chr17,F,69961706,69983544,49297544,21838,639985836,16199,4
102723505,LOC102723505,chr17,R,72021850,72025979,49301673,4129,639989965,16200,2
102723517,LOC102723517,chr17,R,72034106,72057734,49325301,23628,640013593,16201,2
102723567,LOC102723567,chr17,R,74056962,74112891,49381230,55929,640069522,16202,5
102723595,LOC102723595,chr17,R,37923537,37924366,49382059,829,640070351,16203,1
102723608,LOC102723608,chr17,R,37949738,37962200,49394521,12462,640082813,16204,3
102723641,HID1-AS1,chr17,F,74970688,74975728,49399561,5040,640087853,16205,2
102723754,LOC102723754,chr17,R,22509552,22523186,49413195,13634,640101487,16206,2
102723777,LOC102723777,chr17,R,65379,68072,49415888,2693,640104180,16207,3
102723806,LOC102723806,chr17,F,82395799,82398189,49418278,2390,640106570,16208,2
102723819,LOC102723819,chr17,R,38029293,38041724,49430709,12431,640119001,16209,3
102723851,LOC102723851,chr17,R,38127032,38128066,49431743,1034,640120035,16210,1
102723859,LOC102723859,chr17,F,38119292,38138868,49451319,19576,640139611,16211,17
102723913,LOC102723913,chr17,F,83119827,83123431,49454923,3604,640143215,16212,2
102723933,LOC102723933,chr17,R,38153234,38165697,49467386,12463,640155678,16213,3
102723943,LOC102723943,chr17,F,38192648,38193477,49468215,829,640156507,16214,1
102723961,LOC102723961,chr17,F,79815943,79823284,49475556,7341,640163848,16215,3
102724009,LOC102724009,chr17,R,5019213,5020093,49476436,880,640164728,16216,1
102724103,LOC102724103,chr17,R,39993914,39997323,49479845,3409,640168137,16217,1
102724164,LOC102724164,chr17,R,7582169,7583814,49481490,1645,640169782,16218,1
102724175,LOC102724175,chr17,F,42871311,42874494,49484673,3183,640172965,16219,3
102724183,LOC102724183,chr17,F,43929878,43943989,49498784,14111,640187076,16220,8
102724262,LOC102724262,chr17,F,8506496,8513798,49506086,7302,640194378,16221,3
102724391,LOC102724391,chr17,F,46034950,46035770,49506906,820,640195198,16222,1
102724432,LOC102724432,chr17,R,46983684,46997099,49520321,13415,640208613,16223,2
102724508,LOC102724508,chr17,R,47303442,47323901,49540780,20459,640229072,16224,3
102724517,LOC102724517,chr17,F,28043339,28048926,49546367,5587,640234659,16225,1
102724532,LOC102724532,chr17,R,47891228,47895811,49550950,4583,640239242,16226,2
102724596,LOC102724596,chr17,F,49361164,49380094,49569880,18930,640258172,16227,7
102724624,LOC102724624,chr17,F,19089447,19097563,49577996,8116,640266288,16228,3
102724625,LOC102724625,chr17,R,32079344,32095129,49593781,15785,640282073,16229,5
102724715,LOC102724715,chr17,F,32877332,32906609,49623058,29277,640311350,16230,2
102724731,LOC102724731,chr17,F,32944647,32950361,49628772,5714,640317064,16231,2
102724732,LOC102724732,chr17,R,55580596,55589913,49638089,9317,640326381,16232,2
102724862,LOC102724862,chr17,R,36253638,36264603,49649054,10965,640337346,16233,14
102724956,LOC102724956,chr17,F,36264618,36265447,49649883,829,640338175,16234,2
102725238,LOC102725238,chr17,F,42423186,42440922,49667619,17736,640355911,16235,5
103689912,TBX2-AS1,chr17,R,61393455,61399606,49673770,6151,640362062,16236,2
103752589,TMEM92-AS1,chr17,R,50281578,50287855,49680047,6277,640368339,16237,3
104355297,ABCA9-AS1,chr17,F,69004713,69018323,49693657,13610,640381949,16238,3
104909134,MGC57346-CRHR1,chr17,F,45620328,45835828,49909157,215500,640597449,16239,13
105274304,LOC105274304,chr17,F,76671927,76673658,49910888,1731,640599180,16240,0
105369205,LOC105369205,chr17,F,20921023,20999752,49989617,78729,640677909,16241,5
105369210,LOC105369210,chr17,R,16929739,16936518,49996396,6779,640684688,16242,3
105369225,LOC105369225,chr17,F,45554188,45558649,50000857,4461,640689149,16243,1
105371425,LOC105371425,chr17,F,338868,341409,50003398,2541,640691690,16244,2
105371426,LOC105371426,chr17,F,321422,322457,50004433,1035,640692725,16245,1
105371428,LOC105371428,chr17,F,252817,268394,50020010,15577,640708302,16246,2
105371430,LOC105371430,chr17,R,401241,417165,50035934,15924,640724226,16247,2
105371432,LOC105371432,chr17,F,354715,357581,50038800,2866,640727092,16248,2
105371476,LOC105371476,chr17,F,573263,588903,50054440,15640,640742732,16249,2
105371477,LOC105371477,chr17,F,523139,541832,50073133,18693,640761425,16250,1
105371478,LOC105371478,chr17,R,1225890,1229724,50076967,3834,640765259,16251,1
105371479,LOC105371479,chr17,F,1180410,1190368,50086925,9958,640775217,16252,3
105371480,LOC105371480,chr17,R,1148234,1153884,50092575,5650,640780867,16253,2
105371481,LOC105371481,chr17,F,1013171,1014081,50093485,910,640781777,16254,1
105371482,LOC105371482,chr17,F,1007318,1009390,50095557,2072,640783849,16255,1
105371483,LOC105371483,chr17,F,1492818,1495093,50097832,2275,640786124,16256,1
105371484,LOC105371484,chr17,F,1620359,1626014,50103487,5655,640791779,16257,2
105371485,LOC105371485,chr17,F,2017733,2020706,50106460,2973,640794752,16258,1
105371487,LOC105371487,chr17,F,2174366,2215826,50147920,41460,640836212,16259,4
105371488,LOC105371488,chr17,F,2381799,2384325,50150446,2526,640838738,16260,1
105371489,LOC105371489,chr17,F,2563250,2569136,50156332,5886,640844624,16261,2
105371490,LOC105371490,chr17,F,2688239,2689308,50157401,1069,640845693,16262,1
105371491,LOC105371491,chr17,R,2720800,2723258,50159859,2458,640848151,16263,1
105371492,LOC105371492,chr17,R,3652549,3657998,50165308,5449,640853600,16264,2
105371493,LOC105371493,chr17,R,3643108,3651755,50173955,8647,640862247,16265,4
105371494,LOC105371494,chr17,F,3697157,3719024,50195822,21867,640884114,16266,3
105371495,LOC105371495,chr17,F,3846663,3853318,50202477,6655,640890769,16267,2
105371496,LOC105371496,chr17,F,3977059,3983089,50208507,6030,640896799,16268,2
105371498,LOC105371498,chr17,R,4616763,4629907,50221651,13144,640909943,16269,2
105371499,LOC105371499,chr17,F,4645321,4665775,50242105,20454,640930397,16270,3
105371500,LOC105371500,chr17,R,4713949,4714980,50243136,1031,640931428,16271,1
105371501,LOC105371501,chr17,F,5030805,5053374,50265705,22569,640953997,16272,4
105371502,LOC105371502,chr17,R,5025613,5031613,50271705,6000,640959997,16273,2
105371505,LOC105371505,chr17,R,5360960,5362905,50273650,1945,640961942,16274,1
105371506,LOC105371506,chr17,F,5469056,5470392,50274986,1336,640963278,16275,2
105371507,LOC105371507,chr17,F,5539696,5554775,50290065,15079,640978357,16276,4
105371508,LOC105371508,chr17,R,6149979,6190547,50330633,40568,641018925,16277,5
105371509,LOC105371509,chr17,R,6342518,6375012,50363127,32494,641051419,16278,4
105371511,LOC105371511,chr17,F,7116484,7118010,50364653,1526,641052945,16279,1
105371512,LOC105371512,chr17,F,7131263,7140890,50374280,9627,641062572,16280,2
105371513,LOC105371513,chr17,R,7307185,7307867,50374962,682,641063254,16281,1
105371516,LOC105371516,chr17,R,7832890,7834111,50376183,1221,641064475,16282,2
105371517,LOC105371517,chr17,F,7951368,7961886,50386701,10518,641074993,16283,3
105371518,LOC105371518,chr17,F,8056899,8063456,50393258,6557,641081550,16284,1
105371519,LOC105371519,chr17,R,8191287,8199496,50401467,8209,641089759,16285,1
105371520,LOC105371520,chr17,F,8174622,8183616,50410461,8994,641098753,16286,2
105371522,LOC105371522,chr17,F,8119745,8144268,50434984,24523,641123276,16287,3
105371523,LOC105371523,chr17,F,8365568,8382136,50451552,16568,641139844,16288,2
105371524,LOC105371524,chr17,F,8495247,8497182,50453487,1935,641141779,16289,1
105371525,LOC105371525,chr17,F,8670611,8702516,50485392,31905,641173684,16290,4
105371526,LOC105371526,chr17,F,8714567,8717443,50488268,2876,641176560,16291,2
105371528,LOC105371528,chr17,F,8718593,8721377,50491052,2784,641179344,16292,2
105371529,LOC105371529,chr17,F,8744955,8749113,50495210,4158,641183502,16293,3
105371530,LOC105371530,chr17,R,8765868,8768280,50497622,2412,641185914,16294,2
105371531,LOC105371531,chr17,R,9243886,9250114,50503850,6228,641192142,16295,1
105371532,LOC105371532,chr17,R,9238714,9239707,50504843,993,641193135,16296,1
105371533,LOC105371533,chr17,F,9235990,9238984,50507837,2994,641196129,16297,1
105371534,LOC105371534,chr17,R,10711135,10713168,50509870,2033,641198162,16298,1
105371536,LOC105371536,chr17,R,10905380,10922819,50527309,17439,641215601,16299,5
105371537,LOC105371537,chr17,R,11836962,11837976,50528323,1014,641216615,16300,2
105371538,LOC105371538,chr17,R,11560804,11598460,50565979,37656,641254271,16301,2
105371539,LOC105371539,chr17,R,12002356,12020722,50584345,18366,641272637,16302,3
105371540,LOC105371540,chr17,R,12590760,12605957,50599542,15197,641287834,16303,2
105371541,LOC105371541,chr17,R,13298868,13306791,50607465,7923,641295757,16304,3
105371543,LOC105371543,chr17,R,13353147,13387067,50641385,33920,641329677,16305,5
105371544,LOC105371544,chr17,F,13619734,13627647,50649298,7913,641337590,16306,2
105371545,LOC105371545,chr17,R,14800205,14802273,50651366,2068,641339658,16307,2
105371547,LOC105371547,chr17,F,15175096,15182015,50658285,6919,641346577,16308,4
105371548,LOC105371548,chr17,R,15413732,15419298,50663851,5566,641352143,16309,2
105371549,LOC105371549,chr17,F,15289350,15311621,50686122,22271,641374414,16310,3
105371550,LOC105371550,chr17,R,15277288,15290204,50699038,12916,641387330,16311,2
105371551,LOC105371551,chr17,F,16832686,16835115,50701467,2429,641389759,16312,2
105371552,LOC105371552,chr17,F,16822426,16829837,50708878,7411,641397170,16313,3
105371553,LOC105371553,chr17,F,16816358,16819007,50711527,2649,641399819,16314,3
105371554,LOC105371554,chr17,F,16535897,16548583,50724213,12686,641412505,16315,4
105371555,LOC105371555,chr17,F,16486551,16503709,50741371,17158,641429663,16316,3
105371556,LOC105371556,chr17,R,16003462,16008953,50746862,5491,641435154,16317,2
105371557,LOC105371557,chr17,R,15831276,15847957,50763543,16681,641451835,16318,3
105371558,LOC105371558,chr17,F,15817862,15930886,50876567,113024,641564859,16319,6
105371559,LOC105371559,chr17,R,15744632,15764581,50896516,19949,641584808,16320,6
105371562,LOC105371562,chr17,F,16982762,17006087,50919841,23325,641608133,16321,4
105371563,LOC105371563,chr17,R,17034454,17042140,50927527,7686,641615819,16322,2
105371564,LOC105371564,chr17,R,17674118,17681202,50934611,7084,641622903,16323,5
105371566,LOC105371566,chr17,R,18102004,18117789,50950396,15785,641638688,16324,6
105371568,LOC105371568,chr17,R,18146971,18153195,50956620,6224,641644912,16325,3
105371569,LOC105371569,chr17,R,18442883,18448741,50962478,5858,641650770,16326,2
105371570,LOC105371570,chr17,R,18437977,18440057,50964558,2080,641652850,16327,2
105371572,LOC105371572,chr17,R,19048698,19055936,50971796,7238,641660088,16328,2
105371573,LOC105371573,chr17,F,19362719,19369872,50978949,7153,641667241,16329,2
105371574,LOC105371574,chr17,R,19417365,19460967,51022551,43602,641710843,16330,2
105371576,LOC105371576,chr17,R,19470543,19493214,51045222,22671,641733514,16331,3
105371577,LOC105371577,chr17,F,19589659,19590690,51046253,1031,641734545,16332,2
105371578,LOC105371578,chr17,R,19560444,19571471,51057280,11027,641745572,16333,2
105371579,LOC105371579,chr17,R,20084461,20086872,51059691,2411,641747983,16334,1
105371580,LOC105371580,chr17,R,20574078,20579627,51065240,5549,641753532,16335,4
105371582,LOC105371582,chr17,R,20614276,20633230,51084194,18954,641772486,16336,2
105371583,LOC105371583,chr17,R,20649344,20665589,51100439,16245,641788731,16337,2
105371584,LOC105371584,chr17,F,20668059,20684476,51116856,16417,641805148,16338,6
105371587,LOC105371587,chr17,R,21078583,21085271,51123544,6688,641811836,16339,2
105371588,LOC105371588,chr17,R,21566594,21574365,51131315,7771,641819607,16340,2
105371589,LOC105371589,chr17,F,21496982,21521455,51155788,24473,641844080,16341,5
105371591,LOC105371591,chr17,R,2706476,2708492,51157804,2016,641846096,16342,1
105371592,LOC105371592,chr17,F,2708662,2713146,51162288,4484,641850580,16343,5
105371595,LOC105371595,chr17,R,22234555,22266387,51194120,31832,641882412,16344,7
105371597,LOC105371597,chr17,F,22266464,22297344,51225000,30880,641913292,16345,3
105371703,LOC105371703,chr17,R,27072387,27089240,51241853,16853,641930145,16346,3
105371704,LOC105371704,chr17,R,27230188,27231798,51243463,1610,641931755,16347,2
105371705,LOC105371705,chr17,R,27398137,27405406,51250732,7269,641939024,16348,2
105371706,LOC105371706,chr17,R,27412706,27413945,51251971,1239,641940263,16349,1
105371707,LOC105371707,chr17,R,27649393,27650394,51252972,1001,641941264,16350,1
105371708,LOC105371708,chr17,R,27930392,27991694,51314274,61302,642002566,16351,4
105371709,LOC105371709,chr17,R,28034150,28041882,51322006,7732,642010298,16352,2
105371710,LOC105371710,chr17,R,28204998,28210272,51327280,5274,642015572,16353,2
105371711,LOC105371711,chr17,F,28132681,28144415,51339014,11734,642027306,16354,1
105371712,LOC105371712,chr17,R,28246453,28250834,51343395,4381,642031687,16355,1
105371713,LOC105371713,chr17,F,28405362,28406785,51344818,1423,642033110,16356,1
105371714,LOC105371714,chr17,F,28770820,28783525,51357523,12705,642045815,16357,2
105371715,LOC105371715,chr17,R,29009801,29010582,51358304,781,642046596,16358,1
105371716,LOC105371716,chr17,F,29012786,29016512,51362030,3726,642050322,16359,1
105371717,LOC105371717,chr17,F,29140477,29163947,51385500,23470,642073792,16360,3
105371718,LOC105371718,chr17,R,29204856,29212706,51393350,7850,642081642,16361,2
105371719,LOC105371719,chr17,R,30090365,30118073,51421058,27708,642109350,16362,1
105371720,LOC105371720,chr17,F,30236905,30252233,51436386,15328,642124678,16363,5
105371721,LOC105371721,chr17,R,30310832,30314370,51439924,3538,642128216,16364,2
105371722,LOC105371722,chr17,R,31090895,31093414,51442443,2519,642130735,16365,2
105371723,LOC105371723,chr17,F,30646542,30663479,51459380,16937,642147672,16366,2
105371724,LOC105371724,chr17,F,31379324,31382116,51462172,2792,642150464,16367,1
105371725,LOC105371725,chr17,R,31425314,31428318,51465176,3004,642153468,16368,2
105371726,LOC105371726,chr17,R,31599954,31606408,51471630,6454,642159922,16369,2
105371728,LOC105371728,chr17,F,32083147,32097125,51485608,13978,642173900,16370,2
105371730,LOC105371730,chr17,R,32141225,32143117,51487500,1892,642175792,16371,1
105371731,LOC105371731,chr17,R,32258044,32265451,51494907,7407,642183199,16372,2
105371732,LOC105371732,chr17,R,32280386,32281034,51495555,648,642183847,16373,1
105371733,LOC105371733,chr17,F,32519630,32531468,51507393,11838,642195685,16374,2
105371734,LOC105371734,chr17,R,32509953,32523674,51521114,13721,642209406,16375,1
105371735,LOC105371735,chr17,F,34156633,34164238,51528719,7605,642217011,16376,3
105371737,LOC105371737,chr17,F,33111916,33155533,51572336,43617,642260628,16377,4
105371738,LOC105371738,chr17,F,34473796,34477274,51575814,3478,642264106,16378,3
105371739,LOC105371739,chr17,F,34479268,34483012,51579558,3744,642267850,16379,2
105371740,LOC105371740,chr17,R,34725508,34727062,51581112,1554,642269404,16380,1
105371741,LOC105371741,chr17,F,34852217,34854004,51582899,1787,642271191,16381,2
105371742,LOC105371742,chr17,R,34760587,34923396,51745708,162809,642434000,16382,6
105371743,LOC105371743,chr17,F,35568088,35574313,51751933,6225,642440225,16383,1
105371744,LOC105371744,chr17,F,35868919,35884725,51767739,15806,642456031,16384,2
105371745,LOC105371745,chr17,F,35884736,35885860,51768863,1124,642457155,16385,2
105371746,LOC105371746,chr17,R,36037594,36062770,51794039,25176,642482331,16386,3
105371747,LOC105371747,chr17,R,36225282,36237902,51806659,12620,642494951,16387,2
105371748,LOC105371748,chr17,F,36483241,36486382,51809800,3141,642498092,16388,2
105371749,LOC105371749,chr17,R,36475946,36486662,51820516,10716,642508808,16389,4
105371750,LOC105371750,chr17,F,36722941,36750975,51848550,28034,642536842,16390,4
105371751,LOC105371751,chr17,R,36672229,36676488,51852809,4259,642541101,16391,3
105371753,LOC105371753,chr17,R,37043575,37052775,51862009,9200,642550301,16392,2
105371754,LOC105371754,chr17,F,37710670,37724862,51876201,14192,642564493,16393,2
105371756,LOC105371756,chr17,F,37649098,37651481,51878584,2383,642566876,16394,1
105371757,LOC105371757,chr17,R,37797914,37815697,51896367,17783,642584659,16395,3
105371758,LOC105371758,chr17,F,37963947,37966515,51898935,2568,642587227,16396,3
105371759,LOC105371759,chr17,F,38167447,38170014,51901502,2567,642589794,16397,3
105371760,LOC105371760,chr17,R,38266770,38295603,51930335,28833,642618627,16398,2
105371761,LOC105371761,chr17,F,38564329,38565391,51931397,1062,642619689,16399,1
105371762,LOC105371762,chr17,R,38719036,38720365,51932726,1329,642621018,16400,1
105371763,LOC105371763,chr17,F,38700975,38703537,51935288,2562,642623580,16401,2
105371764,LOC105371764,chr17,R,38682086,38705524,51958726,23438,642647018,16402,2
105371765,LOC105371765,chr17,F,38841519,38848290,51965497,6771,642653789,16403,2
105371766,LOC105371766,chr17,R,39026707,39027126,51965916,419,642654208,16404,1
105371767,LOC105371767,chr17,R,39008088,39027637,51985465,19549,642673757,16405,3
105371768,LOC105371768,chr17,F,39175766,39184330,51994029,8564,642682321,16406,2
105371770,LOC105371770,chr17,R,39567265,39573134,51999898,5869,642688190,16407,1
105371771,LOC105371771,chr17,R,39594723,39598250,52003425,3527,642691717,16408,2
105371772,LOC105371772,chr17,R,40315192,40318151,52006384,2959,642694676,16409,1
105371773,LOC105371773,chr17,F,40516941,40522565,52012008,5624,642700300,16410,2
105371774,LOC105371774,chr17,F,40548315,40554664,52018357,6349,642706649,16411,1
105371775,LOC105371775,chr17,F,40687264,40697840,52028933,10576,642717225,16412,2
105371776,LOC105371776,chr17,F,40801461,40814128,52041600,12667,642729892,16413,5
105371777,LOC105371777,chr17,F,40849360,40921604,52113844,72244,642802136,16414,3
105371779,LOC105371779,chr17,F,41893180,41897742,52118406,4562,642806698,16415,2
105371780,LOC105371780,chr17,F,42072768,42090097,52135735,17329,642824027,16416,2
105371781,LOC105371781,chr17,F,42153413,42157639,52139961,4226,642828253,16417,2
105371783,LOC105371783,chr17,F,43316253,43317113,52140821,860,642829113,16418,1
105371784,LOC105371784,chr17,F,43377834,43381168,52144155,3334,642832447,16419,2
105371785,LOC105371785,chr17,F,43368643,43373809,52149321,5166,642837613,16420,1
105371786,LOC105371786,chr17,F,43669588,43706240,52185973,36652,642874265,16421,4
105371787,LOC105371787,chr17,R,43914431,43917378,52188920,2947,642877212,16422,1
105371789,LOC105371789,chr17,F,44110809,44120524,52198635,9715,642886927,16423,2
105371790,LOC105371790,chr17,R,44274087,44275681,52200229,1594,642888521,16424,3
105371791,LOC105371791,chr17,F,44536275,44537857,52201811,1582,642890103,16425,2
105371792,LOC105371792,chr17,F,44678961,44688218,52211068,9257,642899360,16426,3
105371793,LOC105371793,chr17,F,44919426,44924797,52216439,5371,642904731,16427,1
105371795,LOC105371795,chr17,R,45168799,45172643,52220283,3844,642908575,16428,3
105371796,LOC105371796,chr17,R,45363254,45366588,52223617,3334,642911909,16429,2
105371798,LOC105371798,chr17,R,46909741,46912793,52226669,3052,642914961,16430,2
105371799,LOC105371799,chr17,R,46228570,46241441,52239540,12871,642927832,16431,2
105371800,LOC105371800,chr17,R,45922505,45935950,52252985,13445,642941277,16432,2
105371801,LOC105371801,chr17,R,45826971,45829271,52255285,2300,642943577,16433,2
105371802,LOC105371802,chr17,R,45657495,45670915,52268705,13420,642956997,16434,2
105371805,LOC105371805,chr17,F,45452409,45457112,52273408,4703,642961700,16435,2
105371806,LOC105371806,chr17,F,48011316,48012240,52274332,924,642962624,16436,1
105371807,LOC105371807,chr17,F,48294374,48309040,52288998,14666,642977290,16437,2
105371808,LOC105371808,chr17,R,48520540,48527507,52295965,6967,642984257,16438,3
105371809,LOC105371809,chr17,F,48642452,48707346,52360859,64894,643049151,16439,10
105371810,LOC105371810,chr17,F,48623141,48625737,52363455,2596,643051747,16440,0
105371811,LOC105371811,chr17,F,48732983,48743465,52373937,10482,643062229,16441,2
105371812,LOC105371812,chr17,F,48752904,48753609,52374642,705,643062934,16442,1
105371813,LOC105371813,chr17,F,48812719,48816958,52378881,4239,643067173,16443,3
105371814,LOC105371814,chr17,R,48874859,48892677,52396699,17818,643084991,16444,2
105371815,LOC105371815,chr17,R,48995040,48997093,52398752,2053,643087044,16445,2
105371816,LOC105371816,chr17,F,49224872,49226640,52400520,1768,643088812,16446,2
105371817,LOC105371817,chr17,F,49895686,49933565,52438399,37879,643126691,16447,4
105371818,LOC105371818,chr17,R,50157872,50166103,52446630,8231,643134922,16448,4
105371819,LOC105371819,chr17,F,50238848,50256593,52464375,17745,643152667,16449,2
105371820,LOC105371820,chr17,R,50213812,50216750,52467313,2938,643155605,16450,3
105371821,LOC105371821,chr17,F,50209364,50214138,52472087,4774,643160379,16451,2
105371822,LOC105371822,chr17,F,50256612,50263339,52478814,6727,643167106,16452,3
105371823,LOC105371823,chr17,R,50503411,50508197,52483600,4786,643171892,16453,1
105371824,LOC105371824,chr17,R,50537293,50538197,52484504,904,643172796,16454,1
105371825,LOC105371825,chr17,R,50886746,50894057,52491815,7311,643180107,16455,2
105371826,LOC105371826,chr17,F,50908914,50923919,52506820,15005,643195112,16456,8
105371827,LOC105371827,chr17,F,51041800,51085953,52550973,44153,643239265,16457,2
105371828,LOC105371828,chr17,F,51435567,51445802,52561208,10235,643249500,16458,2
105371829,LOC105371829,chr17,F,52231569,52236498,52566137,4929,643254429,16459,2
105371830,LOC105371830,chr17,F,52532530,52535722,52569329,3192,643257621,16460,2
105371831,LOC105371831,chr17,F,52862363,52899583,52606549,37220,643294841,16461,3
105371832,LOC105371832,chr17,R,54388521,54670484,52888512,281963,643576804,16462,4
105371833,LOC105371833,chr17,R,55510884,55561032,52938660,50148,643626952,16463,7
105371834,LOC105371834,chr17,R,56530759,56538939,52946840,8180,643635132,16464,3
105371835,LOC105371835,chr17,R,56835337,56843682,52955185,8345,643643477,16465,2
105371836,LOC105371836,chr17,F,56961145,56975951,52969991,14806,643658283,16466,4
105371838,LOC105371838,chr17,R,57442447,57447131,52974675,4684,643662967,16467,1
105371839,LOC105371839,chr17,R,57771780,57835995,53038890,64215,643727182,16468,2
105371840,LOC105371840,chr17,R,58045799,58059944,53053035,14145,643741327,16469,5
105371841,LOC105371841,chr17,F,58219979,58233553,53066609,13574,643754901,16470,1
105371842,LOC105371842,chr17,F,58632919,58651649,53085339,18730,643773631,16471,2
105371843,LOC105371843,chr17,R,58724110,58756105,53117334,31995,643805626,16472,2
105371844,LOC105371844,chr17,R,59181319,59183020,53119035,1701,643807327,16473,1
105371845,LOC105371845,chr17,F,59500391,59506857,53125501,6466,643813793,16474,2
105371846,LOC105371846,chr17,F,59425036,59499435,53199900,74399,643888192,16475,2
105371847,LOC105371847,chr17,F,59529866,59550534,53220568,20668,643908860,16476,2
105371849,LOC105371849,chr17,F,60079308,60088695,53229955,9387,643918247,16477,1
105371850,LOC105371850,chr17,R,60402536,60417404,53244823,14868,643933115,16478,2
105371851,LOC105371851,chr17,F,61740194,61744291,53248920,4097,643937212,16479,2
105371852,LOC105371852,chr17,R,62075463,62077280,53250737,1817,643939029,16480,2
105371853,LOC105371853,chr17,F,62275694,62276590,53251633,896,643939925,16481,1
105371854,LOC105371854,chr17,R,62375074,62380502,53257061,5428,643945353,16482,3
105371855,LOC105371855,chr17,F,62705947,62758153,53309267,52206,643997559,16483,3
105371856,LOC105371856,chr17,R,63380157,63415011,53344121,34854,644032413,16484,5
105371857,LOC105371857,chr17,R,63320174,63354776,53378723,34602,644067015,16485,3
105371858,LOC105371858,chr17,F,63960598,63966573,53384698,5975,644072990,16486,3
105371860,LOC105371860,chr17,R,64844395,64847381,53387684,2986,644075976,16487,1
105371861,LOC105371861,chr17,F,64775658,64777828,53389854,2170,644078146,16488,1
105371862,LOC105371862,chr17,R,64926997,64930092,53392949,3095,644081241,16489,1
105371863,LOC105371863,chr17,R,64951466,64953225,53394708,1759,644083000,16490,1
105371864,LOC105371864,chr17,R,65078157,65100712,53417263,22555,644105555,16491,3
105371866,LOC105371866,chr17,F,65471994,65479900,53425169,7906,644113461,16492,3
105371867,LOC105371867,chr17,F,65879309,65926424,53472284,47115,644160576,16493,4
105371868,LOC105371868,chr17,R,67560393,67575444,53487335,15051,644175627,16494,3
105371869,LOC105371869,chr17,R,67431309,67444617,53500643,13308,644188935,16495,3
105371870,LOC105371870,chr17,F,68166436,68186866,53521073,20430,644209365,16496,5
105371871,LOC105371871,chr17,F,68147504,68161137,53534706,13633,644222998,16497,2
105371872,LOC105371872,chr17,F,68460559,68468505,53542652,7946,644230944,16498,2
105371873,LOC105371873,chr17,F,68558392,68581418,53565678,23026,644253970,16499,2
105371874,LOC105371874,chr17,F,68822688,68875259,53618249,52571,644306541,16500,4
105371875,LOC105371875,chr17,R,68800226,68824420,53642443,24194,644330735,16501,2
105371876,LOC105371876,chr17,R,68798728,68800150,53643865,1422,644332157,16502,2
105371877,LOC105371877,chr17,R,68715486,68733524,53661903,18038,644350195,16503,1
105371878,LOC105371878,chr17,F,69331843,69343487,53673547,11644,644361839,16504,2
105371879,LOC105371879,chr17,R,69358748,69362942,53677741,4194,644366033,16505,2
105371880,LOC105371880,chr17,R,69476146,69485461,53687056,9315,644375348,16506,1
105371881,LOC105371881,chr17,R,69996079,70075137,53766114,79058,644454406,16507,2
105371882,LOC105371882,chr17,R,70150904,70158192,53773402,7288,644461694,16508,2
105371883,LOC105371883,chr17,R,70885134,70900858,53789126,15724,644477418,16509,2
105371884,LOC105371884,chr17,R,70811470,70835275,53812931,23805,644501223,16510,1
105371885,LOC105371885,chr17,R,71045050,71047895,53815776,2845,644504068,16511,2
105371886,LOC105371886,chr17,R,72340083,72342572,53818265,2489,644506557,16512,2
105371887,LOC105371887,chr17,F,72640674,72644729,53822320,4055,644510612,16513,2
105371888,LOC105371888,chr17,R,73941851,73950860,53831329,9009,644519621,16514,4
105371889,LOC105371889,chr17,R,73958732,73979508,53852105,20776,644540397,16515,1
105371890,LOC105371890,chr17,R,74032299,74043145,53862951,10846,644551243,16516,3
105371891,LOC105371891,chr17,R,74312099,74317239,53868091,5140,644556383,16517,3
105371892,LOC105371892,chr17,R,74534634,74537886,53871343,3252,644559635,16518,1
105371893,LOC105371893,chr17,R,74747016,74748912,53873239,1896,644561531,16519,2
105371894,LOC105371894,chr17,R,74672314,74678040,53878965,5726,644567257,16520,2
105371895,LOC105371895,chr17,R,75114727,75119443,53883681,4716,644571973,16521,1
105371896,LOC105371896,chr17,R,76243187,76263848,53904342,20661,644592634,16522,6
105371897,LOC105371897,chr17,F,76376660,76380066,53907748,3406,644596040,16523,1
105371899,LOC105371899,chr17,R,76953180,76969199,53923767,16019,644612059,16524,6
105371900,LOC105371900,chr17,R,77107079,77120082,53936770,13003,644625062,16525,2
105371901,LOC105371901,chr17,R,77123965,77141439,53954244,17474,644642536,16526,4
105371902,LOC105371902,chr17,R,77468562,77470869,53956551,2307,644644843,16527,1
105371903,LOC105371903,chr17,R,77460091,77461042,53957502,951,644645794,16528,2
105371904,LOC105371904,chr17,R,77385574,77388672,53960600,3098,644648892,16529,2
105371905,LOC105371905,chr17,R,77373729,77377341,53964212,3612,644652504,16530,2
105371906,LOC105371906,chr17,F,77253763,77270801,53981250,17038,644669542,16531,9
105371907,LOC105371907,chr17,R,77257736,77282699,54006213,24963,644694505,16532,2
105371908,LOC105371908,chr17,R,77797655,77840697,54049255,43042,644737547,16533,5
105371909,LOC105371909,chr17,F,77926229,77935348,54058374,9119,644746666,16534,2
105371910,LOC105371910,chr17,F,78248226,78252491,54062639,4265,644750931,16535,1
105371911,LOC105371911,chr17,F,78279630,78306116,54089125,26486,644777417,16536,2
105371912,LOC105371912,chr17,F,78342112,78346377,54093390,4265,644781682,16537,2
105371913,LOC105371913,chr17,F,78670608,78675631,54098413,5023,644786705,16538,1
105371914,LOC105371914,chr17,F,78903338,78913431,54108506,10093,644796798,16539,2
105371915,LOC105371915,chr17,F,78985912,78993240,54115834,7328,644804126,16540,1
105371916,LOC105371916,chr17,F,79183266,79186476,54119044,3210,644807336,16541,3
105371917,LOC105371917,chr17,R,79779673,79781685,54121056,2012,644809348,16542,1
105371918,LOC105371918,chr17,F,79799298,79802529,54124287,3231,644812579,16543,1
105371919,LOC105371919,chr17,F,79823497,79827704,54128494,4207,644816786,16544,2
105371920,LOC105371920,chr17,R,80200672,80204262,54132084,3590,644820376,16545,2
105371921,LOC105371921,chr17,R,80885803,80891713,54137994,5910,644826286,16546,2
105371922,LOC105371922,chr17,R,80559048,80587121,54166067,28073,644854359,16547,4
105371923,LOC105371923,chr17,R,81017968,81028678,54176777,10710,644865069,16548,3
105371924,LOC105371924,chr17,F,81134509,81137035,54179303,2526,644867595,16549,1
105371925,LOC105371925,chr17,F,81229482,81234029,54183850,4547,644872142,16550,2
105371926,LOC105371926,chr17,R,81452857,81455260,54186253,2403,644874545,16551,2
105371927,LOC105371927,chr17,R,81480522,81481284,54187015,762,644875307,16552,1
105371928,LOC105371928,chr17,F,81491838,81510246,54205423,18408,644893715,16553,1
105371929,LOC105371929,chr17,F,81733568,81739548,54211403,5980,644899695,16554,2
105371930,LOC105371930,chr17,R,28222782,28228461,54217082,5679,644905374,16555,2
105371931,LOC105371931,chr17,R,29368856,29392458,54240684,23602,644928976,16556,2
105371932,LOC105371932,chr17,R,35241323,35244151,54243512,2828,644931804,16557,3
105371933,LOC105371933,chr17,F,35372832,35374437,54245117,1605,644933409,16558,2
105371934,LOC105371934,chr17,R,40318288,40323603,54250432,5315,644938724,16559,3
105371935,LOC105371935,chr17,F,60025993,60040475,54264914,14482,644953206,16560,3
105371936,LOC105371936,chr17,F,62344039,62353998,54274873,9959,644963165,16561,3
105371937,LOC105371937,chr17,R,62463847,62479796,54290822,15949,644979114,16562,2
105371938,LOC105371938,chr17,F,81942017,81955417,54304222,13400,644992514,16563,2
105371939,LOC105371939,chr17,R,81975967,81977429,54305684,1462,644993976,16564,1
105371940,LOC105371940,chr17,R,82425893,82430428,54310219,4535,644998511,16565,2
105371941,LOC105371941,chr17,R,82454373,82458035,54313881,3662,645002173,16566,2
105371942,LOC105371942,chr17,R,82582753,82588712,54319840,5959,645008132,16567,2
105371943,LOC105371943,chr17,F,82728915,82732815,54323740,3900,645012032,16568,2
105371944,LOC105371944,chr17,F,82941489,82942075,54324326,586,645012618,16569,0
105371945,LOC105371945,chr17,R,82848861,82849945,54325410,1084,645013702,16570,1
105371948,LOC105371948,chr17,F,83193577,83199883,54331716,6306,645020008,16571,2
105376789,LOC105376789,chr17,R,81800412,81807271,54338575,6859,645026867,16572,3
105376790,LOC105376790,chr17,R,82380822,82383611,54341364,2789,645029656,16573,4
105376791,LOC105376791,chr17,R,82701904,82705329,54344789,3425,645033081,16574,1
105376795,LOC105376795,chr17,F,503026,511347,54353110,8321,645041402,16575,2
105376797,LOC105376797,chr17,F,4565751,4572178,54359537,6427,645047829,16576,1
105376798,LOC105376798,chr17,F,5094893,5111791,54376435,16898,645064727,16577,1
105376799,LOC105376799,chr17,F,8128568,8139209,54387076,10641,645075368,16578,1
105376800,LOC105376800,chr17,F,8304000,8305065,54388141,1065,645076433,16579,1
105376801,LOC105376801,chr17,F,8295473,8303446,54396114,7973,645084406,16580,2
105376802,LOC105376802,chr17,F,19118606,19125845,54403353,7239,645091645,16581,2
105376836,LOC105376836,chr17,F,36657892,36715155,54460616,57263,645148908,16582,4
105376837,LOC105376837,chr17,R,41965518,41966617,54461715,1099,645150007,16583,1
105376838,LOC105376838,chr17,R,46169094,46169962,54462583,868,645150875,16584,1
105376839,LOC105376839,chr17,R,45585785,45597843,54474641,12058,645162933,16585,2
105376840,LOC105376840,chr17,R,45448018,45450611,54477234,2593,645165526,16586,1
105376842,LOC105376842,chr17,F,58019030,58026739,54484943,7709,645173235,16587,2
105376843,LOC105376843,chr17,F,64144949,64146810,54486804,1861,645175096,16588,1
105376844,LOC105376844,chr17,F,64835656,64910624,54561772,74968,645250064,16589,7
105376846,LOC105376846,chr17,R,71891823,71907746,54577695,15923,645265987,16590,2
105376847,LOC105376847,chr17,R,76700189,76707304,54584810,7115,645273102,16591,1
105376849,LOC105376849,chr17,R,60119030,60120552,54586332,1522,645274624,16592,3
105377821,LOC105377821,chr17,F,22392721,22399180,54592791,6459,645281083,16593,3
105377822,LOC105377822,chr17,F,22388743,22389971,54594019,1228,645282311,16594,1
105377823,LOC105377823,chr17,F,22379255,22380521,54595285,1266,645283577,16595,1
105377824,LOC105377824,chr17,F,22375279,22378151,54598157,2872,645286449,16596,2
105377825,LOC105377825,chr17,R,114735,133559,54616981,18824,645305273,16597,5
105377826,LOC105377826,chr17,R,81904,86392,54621469,4488,645309761,16598,2
116,ADCYAP1,chr18,F,904344,912172,7828,7828,645317589,16599,5
361,AQP4,chr18,R,26852042,26865752,21538,13710,645331299,16600,5
498,ATP5A1,chr18,R,46084143,46104233,41628,20090,645351389,16601,12
596,BCL2,chr18,R,63123345,63319778,238061,196433,645547822,16602,4
753,LDLRAD4,chr18,F,13218729,13652754,672086,434025,645981847,16603,13
1000,CDH2,chr18,R,27932878,28177481,916689,244603,646226450,16604,19
1005,CDH7,chr18,F,65750251,65880939,1047377,130688,646357138,16605,13
1068,CETN1,chr18,F,580342,582020,1049055,1678,646358816,16606,0
1149,CIDEA,chr18,F,12254318,12277595,1072332,23277,646382093,16607,5
1528,CYB5A,chr18,R,74253291,74292016,1111057,38725,646420818,16608,5
1630,DCC,chr18,F,52340171,53535903,2306789,1195732,647616550,16609,32
1823,DSC1,chr18,R,31129235,31162856,2340410,33621,647650171,16610,16
1824,DSC2,chr18,R,31065973,31102432,2376869,36459,647686630,16611,17
1825,DSC3,chr18,R,30989364,31042815,2430320,53451,647740081,16612,16
1828,DSG1,chr18,F,31318088,31359246,2471478,41158,647781239,16613,14
1829,DSG2,chr18,F,31498063,31548851,2522266,50788,647832027,16614,14
1830,DSG3,chr18,F,31447768,31478702,2553200,30934,647862961,16615,15
1837,DTNA,chr18,F,34493289,34891844,2951755,398555,648261516,16616,30
2235,FECH,chr18,R,57544840,57586737,2993652,41897,648303413,16617,11
2531,KDSR,chr18,R,63327737,63367273,3033188,39536,648342949,16618,10
2587,GALR1,chr18,F,77250051,77270142,3053279,20091,648363040,16619,2
2589,GALNT1,chr18,F,35627435,35711834,3137678,84399,648447439,16620,11
2627,GATA6,chr18,F,22169436,22202528,3170770,33092,648480531,16621,6
2774,GNAL,chr18,F,11689014,11885685,3367441,196671,648677202,16622,15
2922,GRP,chr18,F,59219117,59230771,3379095,11654,648688856,16623,6
3613,IMPA2,chr18,F,11981427,12030886,3428554,49459,648738315,16624,9
3909,LAMA3,chr18,F,23689442,23955066,3694178,265624,649003939,16625,76
3998,LMAN1,chr18,R,59327822,59359276,3725632,31454,649035393,16626,12
4087,SMAD2,chr18,R,47833094,47931193,3823731,98099,649133492,16627,15
4089,SMAD4,chr18,F,51030212,51085042,3878561,54830,649188322,16628,11
4092,SMAD7,chr18,R,48919852,48950711,3909420,30859,649219181,16629,4
4152,MBD1,chr18,R,50266622,50281774,3924572,15152,649234333,16630,18
4155,MBP,chr18,R,76978832,77133708,4079448,154876,649389209,16631,12
4158,MC2R,chr18,R,13882043,13915707,4113112,33664,649422873,16632,2
4160,MC4R,chr18,R,60371330,60372768,4114550,1438,649424311,16633,0
4161,MC5R,chr18,F,13825543,13826862,4115869,1319,649425630,16634,0
4200,ME2,chr18,F,50878603,50949795,4187061,71192,649496822,16635,15
4225,MEP1B,chr18,F,32190023,32220404,4217442,30381,649527203,16636,14
4645,MYO5B,chr18,R,49822785,50195081,4589738,372296,649899499,16637,39
4677,NARS,chr18,R,57600655,57621945,4611028,21290,649920789,16638,13
4729,NDUFV2,chr18,F,9102629,9134345,4642744,31716,649952505,16639,7
4772,NFATC1,chr18,F,79395771,79529323,4776296,133552,650086057,16640,10
4864,NPC1,chr18,R,23506183,23586617,4856730,80434,650166491,16641,27
5055,SERPINB2,chr18,F,63887704,63903890,4872916,16186,650182677,16642,8
5205,ATP8B1,chr18,R,57646425,57803822,5030313,157397,650340074,16643,30
5268,SERPINB5,chr18,F,63476910,63505085,5058488,28175,650368249,16644,7
5271,SERPINB8,chr18,F,63970027,64006821,5095282,36794,650405043,16645,9
5273,SERPINB10,chr18,F,63907968,63936111,5123425,28143,650433186,16646,9
5275,SERPINB13,chr18,F,63587201,63599199,5135423,11998,650445184,16647,8
5289,PIK3C3,chr18,F,41955198,42084606,5264831,129408,650574592,16648,25
5366,PMAIP1,chr18,F,59899959,59904306,5269178,4347,650578939,16649,1
5596,MAPK4,chr18,F,50560113,50731826,5440891,171713,650750652,16650,11
5771,PTPN2,chr18,R,12785477,12884335,5539749,98858,650849510,16651,13
5797,PTPRM,chr18,F,7567315,8406861,6379295,839546,651689056,16652,42
5874,RAB27B,chr18,F,54717865,54895516,6556946,177651,651866707,16653,9
5932,RBBP8,chr18,F,22914120,23026488,6669314,112368,651979075,16654,23
6014,RIT2,chr18,R,42743217,43115692,7041789,372475,652351550,16655,5
6093,ROCK1,chr18,R,20949739,21111851,7203901,162112,652513662,16656,34
6139,RPL17,chr18,R,49488480,49492565,7207986,4085,652517747,16657,6
6317,SERPINB3,chr18,R,63655196,63661963,7214753,6767,652524514,16658,7
6318,SERPINB4,chr18,R,63637258,63644319,7221814,7061,652531575,16659,7
6563,SLC14A1,chr18,F,45723755,45752520,7250579,28765,652560340,16660,12
6632,SNRPD1,chr18,F,21612268,21630247,7268558,17979,652578319,16661,3
6760,SS18,chr18,R,26016252,26091212,7343518,74960,652653279,16662,17
6860,SYT4,chr18,R,43267891,43277650,7353277,9759,652663038,16663,3
6875,TAF4B,chr18,F,26226444,26391685,7518518,165241,652828279,16664,17
6925,TCF4,chr18,R,55222330,55635993,7932181,413663,653241942,16665,32
7050,TGIF1,chr18,F,3411926,3458411,7978666,46485,653288427,16666,9
7276,TTR,chr18,F,31591766,31599024,7985924,7258,653295685,16667,3
7298,TYMS,chr18,F,657603,673499,8001820,15896,653311581,16668,6
7525,YES1,chr18,R,721587,812326,8092559,90739,653402320,16669,12
7541,ZBTB14,chr18,R,5289018,5297053,8100594,8035,653410355,16670,5
7572,ZNF24,chr18,R,35332213,35344462,8112843,12249,653422604,16671,4
7776,ZNF236,chr18,F,76822560,76970732,8261015,148172,653570776,16672,37
8170,SLC14A2,chr18,F,45212956,45683107,8731166,470151,654040927,16673,22
8710,SERPINB7,chr18,F,63753046,63805376,8783496,52330,654093257,16674,11
8715,NOL4,chr18,R,33851099,34224834,9157231,373735,654466992,16675,18
8731,RNMT,chr18,F,13726646,13764556,9195141,37910,654504902,16676,14
8736,MYOM1,chr18,R,3066806,3220108,9348443,153302,654658204,16677,37
8774,NAPG,chr18,F,10525875,10552769,9375337,26894,654685098,16678,13
8780,RIOK3,chr18,F,23452822,23483140,9405655,30318,654715416,16679,12
8792,TNFRSF11A,chr18,F,62325286,62387710,9468079,62424,654777840,16680,11
8932,MBD2,chr18,R,54151600,54224788,9541267,73188,654851028,16681,7
9050,PSTPIP2,chr18,R,45983535,46072297,9630029,88762,654939790,16682,15
9063,PIAS2,chr18,R,46808245,46920167,9741951,111922,655051712,16683,19
9097,USP14,chr18,F,158482,213739,9797208,55257,655106969,16684,15
9150,CTDP1,chr18,F,79679800,79754510,9871918,74710,655181679,16685,13
9218,VAPA,chr18,F,9913957,9960021,9917982,46064,655227743,16686,7
9229,DLGAP1,chr18,R,3496031,4455310,10877261,959279,656187022,16687,20
9306,SOCS6,chr18,F,70288900,70330199,10918560,41299,656228321,16688,2
9331,B4GALT6,chr18,R,31622245,31725286,11021601,103041,656331362,16689,11
9352,TXNL1,chr18,R,56602386,56638689,11057904,36303,656367665,16690,10
9388,LIPG,chr18,F,49560698,49592908,11090114,32210,656399875,16691,10
9480,ONECUT2,chr18,F,57435684,57491298,11145728,55614,656455489,16692,1
9525,VPS4B,chr18,R,63389189,63422519,11179058,33330,656488819,16693,11
9658,ZNF516,chr18,R,76357681,76495234,11316611,137553,656626372,16694,10
9663,LPIN2,chr18,R,2916993,3013315,11412933,96322,656722694,16695,21
9811,CTIF,chr18,F,48539055,48863217,11737095,324162,657046856,16696,17
9984,THOC1,chr18,R,214519,268059,11790635,53540,657100396,16697,22
9989,PPP4R1,chr18,R,9546790,9615276,11859121,68486,657168882,16698,22
10194,TSHZ1,chr18,F,75210754,75289950,11938317,79196,657248078,16699,3
10403,NDC80,chr18,F,2571510,2616635,11983442,45125,657293203,16700,16
10449,ACAA2,chr18,R,49783503,49813881,12013820,30378,657323581,16701,9
10627,MYL12A,chr18,F,3247481,3256237,12022576,8756,657332337,16702,5
10650,SLMO1,chr18,F,12407895,12432238,12046919,24343,657356680,16703,10
10666,CD226,chr18,R,69859458,69961787,12149248,102329,657459009,16704,10
10778,ZNF271P,chr18,F,35290271,35310766,12169743,20495,657479504,16705,2
10892,MALT1,chr18,F,58671385,58750139,12248497,78754,657558258,16706,18
10907,TXNL4A,chr18,R,79972220,79988592,12264869,16372,657574630,16707,3
10928,RALBP1,chr18,F,9475531,9538108,12327446,62577,657637207,16708,9
10939,AFG3L2,chr18,R,12328943,12377309,12375812,48366,657685573,16709,16
10982,MAPRE2,chr18,F,34976927,35143470,12542355,166543,657852116,16710,10
11031,RAB31,chr18,F,9708230,9862556,12696681,154326,658006442,16711,6
11201,POLI,chr18,F,54269478,54321266,12748469,51788,658058230,16712,11
22850,ADNP2,chr18,F,80109030,80140348,12779787,31318,658089548,16713,4
22878,TRAPPC8,chr18,R,31829172,31943212,12893827,114040,658203588,16714,30
23136,EPB41L3,chr18,R,5392380,5630666,13132113,238286,658441874,16715,32
23239,PHLPP1,chr18,F,62715438,62980443,13397118,265005,658706879,16716,17
23253,ANKRD12,chr18,F,9136752,9285985,13546351,149233,658856112,16717,15
23255,MTCL1,chr18,F,8705577,8832778,13673552,127201,658983313,16718,19
23327,NEDD4L,chr18,F,58044232,58401541,14030861,357309,659340622,16719,37
23335,WDR7,chr18,F,56651342,57029805,14409324,378463,659719085,16720,30
23347,SMCHD1,chr18,F,2655886,2805017,14558455,149131,659868216,16721,51
23556,PIGN,chr18,R,62044223,62187118,14701350,142895,660011111,16722,32
25800,SLC39A6,chr18,R,36108530,36129814,14722634,21284,660032395,16723,10
25914,RTTN,chr18,R,70003803,70205726,14924557,201923,660234318,16724,52
25925,ZNF521,chr18,R,25061923,25352250,15214884,290327,660524645,16725,10
25941,TPGS2,chr18,R,36780023,36829393,15264254,49370,660574015,16726,11
26040,SETBP1,chr18,F,44680172,45068510,15652592,388338,660962353,16727,7
26251,KCNG2,chr18,F,79797962,79903195,15757825,105233,661067586,16728,4
26256,CABYR,chr18,F,24138955,24161600,15780470,22645,661090231,16729,8
26790,SNORD58B,chr18,R,49491663,49491729,15780536,66,661090297,16730,0
26791,SNORD58A,chr18,R,49491282,49491347,15780601,65,661090362,16731,0
27098,CLUL1,chr18,F,596997,650298,15833902,53301,661143663,16732,15
27164,SALL3,chr18,F,78980274,78998969,15852597,18695,661162358,16733,2
28316,CDH20,chr18,F,61333581,61555773,16074789,222192,661384550,16734,11
28513,CDH19,chr18,R,66501186,66604138,16177741,102952,661487502,16735,12
29090,TIMM21,chr18,F,74148510,74158969,16188200,10459,661497961,16736,5
29906,ST8SIA5,chr18,R,46679117,46757169,16266252,78052,661576013,16737,8
29919,C18orf8,chr18,F,23503469,23531807,16294590,28338,661604351,16738,19
30062,RAX,chr18,R,59267034,59273393,16300949,6359,661610710,16739,2
30827,CXXC1,chr18,R,50282342,50288322,16306929,5980,661616690,16740,15
51046,ST8SIA3,chr18,F,57352489,57371800,16326240,19311,661636001,16741,4
51124,IER3IP1,chr18,R,47155018,47176374,16347596,21356,661657357,16742,2
51224,TCEB3B,chr18,R,47032571,47035617,16350642,3046,661660403,16743,0
51320,MEX3C,chr18,R,51174549,51197681,16373774,23132,661683535,16744,1
51444,RNF138,chr18,F,32091854,32131561,16413481,39707,661723242,16745,7
54495,TMX3,chr18,R,68673687,68715298,16455092,41611,661764853,16746,18
54808,DYM,chr18,R,49041473,49460709,16874328,419236,662184089,16747,22
54877,ZCCHC2,chr18,F,62523409,62587709,16938628,64300,662248389,16748,16
54941,RNF125,chr18,F,32018222,32088528,17008934,70306,662318695,16749,6
55034,MOCOS,chr18,F,36187516,36268722,17090140,81206,662399901,16750,14
55125,CEP192,chr18,F,12991320,13125053,17223873,133733,662533634,16751,46
55197,RPRD1A,chr18,R,35989823,36067594,17301644,77771,662611405,16752,10
55205,ZNF532,chr18,F,58862599,58986477,17425522,123878,662735283,16753,21
55250,ELP2,chr18,F,36129873,36174725,17470374,44852,662780135,16754,22
55364,IMPACT,chr18,F,24426644,24453531,17497261,26887,662807022,16755,10
55520,ELAC1,chr18,F,50968016,50988120,17517365,20104,662827126,16756,3
55556,ENOSF1,chr18,R,670323,712662,17559704,42339,662869465,16757,16
55628,ZNF407,chr18,F,74597869,75065672,18027507,467803,663337268,16758,12
55748,CNDP2,chr18,F,74496264,74523454,18054697,27190,663364458,16759,14
56651,LINC00470,chr18,R,1268310,1359629,18146016,91319,663455777,16760,6
56853,CELF4,chr18,R,37190089,37566037,18521964,375948,663831725,16761,16
56907,SPIRE1,chr18,R,12446511,12658102,18733555,211591,664043316,16762,20
56984,PSMG2,chr18,F,12658738,12725740,18800557,67002,664110318,16763,7
57045,TWSG1,chr18,F,9334766,9402420,18868211,67654,664177972,16764,5
57132,CHMP1B,chr18,F,11851389,11854449,18871271,3060,664181032,16765,0
57534,MIB1,chr18,F,21740792,21870957,19001436,130165,664311197,16766,24
57536,KIAA1328,chr18,F,36829108,37247316,19419644,418208,664729405,16767,25
57565,KLHL14,chr18,R,32672667,32773011,19519988,100344,664829749,16768,10
57614,KIAA1468,chr18,F,62187243,62307122,19639867,119879,664949628,16769,36
57724,EPG5,chr18,R,45800579,45967339,19806627,166760,665116388,16770,46
59340,HRH4,chr18,F,24460567,24487427,19833487,26860,665143248,16771,4
63895,PIEZO2,chr18,R,10670133,11148762,20312116,478629,665621877,16772,55
64693,CTAGE1,chr18,R,22413600,22417915,20316431,4315,665626192,16773,0
64762,GAREM,chr18,R,32263520,32470496,20523407,206976,665833168,16774,6
64863,METTL4,chr18,R,2537524,2571490,20557373,33966,665867134,16775,9
65258,MPPE1,chr18,R,11883470,11908797,20582700,25327,665892461,16776,14
79822,ARHGAP28,chr18,F,6729717,6915716,20768699,185999,666078460,16777,19
79839,CCDC102B,chr18,F,68715253,69171081,21224527,455828,666534288,16778,19
79863,RBFA,chr18,F,80034345,80050652,21240834,16307,666550595,16779,6
79959,CEP76,chr18,R,12661749,12702777,21281862,41028,666591623,16780,12
80000,GREB1L,chr18,F,21242241,21525423,21565044,283182,666874805,16781,34
80148,PQLC1,chr18,R,79902419,79951664,21614289,49245,666924050,16782,10
80206,FHOD3,chr18,F,36297695,36780059,22096653,482364,667406414,16783,30
80323,CCDC68,chr18,R,54901508,54959508,22154653,58000,667464414,16784,14
80816,ASXL3,chr18,F,33578576,33751195,22327272,172619,667637033,16785,19
81035,COLEC12,chr18,R,319354,500729,22508647,181375,667818408,16786,9
81832,NETO1,chr18,R,72742313,72867575,22633909,125262,667943670,16787,16
81929,SEH1L,chr18,F,12947983,12987537,22673463,39554,667983224,16788,11
83473,KATNAL2,chr18,F,46917601,47102243,22858105,184642,668167866,16789,20
83539,CHST9,chr18,R,26908753,27185338,23134690,276585,668444451,16790,9
83608,C18orf21,chr18,F,35972624,35979287,23141353,6663,668451114,16791,3
83876,MRO,chr18,R,50795119,50825421,23171655,30302,668481416,16792,8
84034,EMILIN2,chr18,F,2846230,2914092,23239517,67862,668549278,16793,10
84064,HDHD2,chr18,R,47107409,47150515,23282623,43106,668592384,16794,9
84203,TXNDC2,chr18,F,9885725,9888159,23285057,2434,668594818,16795,1
84307,ZNF397,chr18,F,35240717,35258433,23302773,17716,668612534,16796,6
84322,C18orf12,chr18,F,48252295,48252837,23303315,542,668613076,16797,0
84552,PARD6G,chr18,R,80157231,80247514,23393598,90283,668703359,16798,2
84617,TUBB6,chr18,F,12307668,12329826,23415756,22158,668725517,16799,6
84735,CNDP1,chr18,F,74534456,74585025,23466325,50569,668776086,16800,11
84777,DLGAP1-AS2,chr18,F,3603736,3610089,23472678,6353,668782439,16801,2
85019,TMEM241,chr18,R,23295780,23437969,23614867,142189,668924628,16802,22
89777,SERPINB12,chr18,F,63519089,63569329,23665107,50240,668974868,16803,11
89778,SERPINB11,chr18,F,63702303,63723893,23686697,21590,668996458,16804,9
90701,SEC11C,chr18,F,59139883,59158837,23705651,18954,669015412,16805,6
91133,L3MBTL4,chr18,R,5954702,6414911,24165860,460209,669475621,16806,29
91768,CABLES1,chr18,F,23134563,23260470,24291767,125907,669601528,16807,11
92126,DSEL,chr18,R,67506581,67516730,24301916,10149,669611677,16808,1
103910,MYL12B,chr18,F,3262112,3278284,24318088,16172,669627849,16809,4
114799,ESCO1,chr18,R,21529280,21600736,24389544,71456,669699305,16810,12
114876,OSBPL1A,chr18,R,24162044,24397882,24625382,235838,669935143,16811,30
115106,HAUS1,chr18,F,46104331,46128333,24649384,24002,669959145,16812,8
115701,ALPK2,chr18,R,58481246,58629188,24797326,147942,670107087,16813,16
125228,FAM210A,chr18,R,13663346,13726592,24860572,63246,670170333,16814,5
125336,LOXHD1,chr18,R,46476960,46657114,25040726,180154,670350487,16815,47
125476,INO80C,chr18,R,35468326,35497991,25070391,29665,670380152,16816,7
125488,TTC39C,chr18,F,23992772,24135610,25213229,142838,670522990,16817,18
125704,FAM69C,chr18,R,74435727,74464715,25242217,28988,670551978,16818,5
143471,PSMA8,chr18,F,26133835,26193355,25301737,59520,670611498,16819,7
147323,STARD6,chr18,R,54324591,54357890,25335036,33299,670644797,16820,8
147339,C18orf25,chr18,F,46173552,46266992,25428476,93440,670738237,16821,5
147372,CCBE1,chr18,R,59430938,59697643,25695181,266705,671004942,16822,11
147381,CBLN2,chr18,R,72535897,72638477,25797761,102580,671107522,16823,7
147407,SLC25A52,chr18,R,31759695,31760880,25798946,1185,671108707,16824,0
147409,DSG4,chr18,F,31376776,31415791,25837961,39015,671147722,16825,15
147429,AQP4-AS1,chr18,F,26865307,26935946,25908600,70639,671218361,16826,7
147463,ANKRD29,chr18,R,23598925,23662892,25972567,63967,671282328,16827,12
147495,APCDD1,chr18,F,10454627,10488701,26006641,34074,671316402,16828,5
147525,LINC00526,chr18,R,5236723,5238029,26007947,1306,671317708,16829,0
162655,ZNF519,chr18,R,14056323,14132490,26084114,76167,671393875,16830,11
162681,C18orf54,chr18,F,54357904,54385218,26111428,27314,671421189,16831,12
162699,TCEB3C,chr18,R,47028201,47030078,26113305,1877,671423066,16832,0
171586,ABHD3,chr18,R,21650896,21704805,26167214,53909,671476975,16833,9
201456,FBXO15,chr18,R,74073342,74147865,26241737,74523,671551498,16834,12
201475,RAB12,chr18,F,8609444,8639383,26271676,29939,671581437,16835,6
201477,DLGAP1-AS3,chr18,F,3878179,3897069,26290566,18890,671600327,16836,2
201501,ZBTB7C,chr18,R,48026863,48409422,26673125,382559,671982886,16837,11
220134,SKA1,chr18,F,50375021,50394168,26692272,19147,672002033,16838,6
220136,CFAP53,chr18,R,50227192,50266495,26731575,39303,672041336,16839,7
220158,GTSCR1,chr18,R,70630518,70670875,26771932,40357,672081693,16840,4
220164,DOK6,chr18,F,69401047,69849087,27219972,448040,672529733,16841,10
220441,RNF152,chr18,R,61808066,61894432,27306338,86366,672616099,16842,7
221241,LINC00305,chr18,R,64080008,64149026,27375356,69018,672685117,16843,3
252884,ZNF396,chr18,R,35366696,35377337,27385997,10641,672695758,16844,7
284215,DLGAP1-AS5,chr18,F,4264601,4296000,27417396,31399,672727157,16845,2
284217,LAMA1,chr18,R,6941743,7117814,27593467,176071,672903228,16846,63
284233,CYP4F35P,chr18,F,14337422,14342524,27598569,5102,672908330,16847,3
284240,LOC284240,chr18,F,79574634,79591858,27615793,17224,672925554,16848,3
284241,LOC284241,chr18,R,79641550,79679775,27654018,38225,672963779,16849,2
284252,KCTD1,chr18,R,26454909,26657401,27856510,202492,673166271,16850,9
284254,DYNAP,chr18,F,54532712,54599493,27923291,66781,673233052,16851,6
284257,BOD1L2,chr18,F,57147061,57150408,27926638,3347,673236399,16852,0
284260,LINC00907,chr18,F,42186667,42691426,28431397,504759,673741158,16853,17
284266,SIGLEC15,chr18,F,45825579,45842556,28448374,16977,673758135,16854,5
284273,ZADH2,chr18,R,75197322,75209326,28460378,12004,673770139,16855,4
284274,SMIM21,chr18,R,75409475,75455653,28506556,46178,673816317,16856,6
284276,LINC00908,chr18,F,76528654,76559827,28537729,31173,673847490,16857,2
284293,HMSD,chr18,F,63949249,63961821,28550301,12572,673860062,16858,4
284294,LOC284294,chr18,F,64104090,64423601,28869812,319511,674179573,16859,9
339290,LINC00667,chr18,F,5238099,5246508,28878221,8409,674187982,16860,2
339291,LRRC30,chr18,F,7231138,7232044,28879127,906,674188888,16861,0
339298,LOC339298,chr18,F,76122997,76145255,28901385,22258,674211146,16862,5
339302,CPLX4,chr18,R,59295401,59318649,28924633,23248,674234394,16863,2
342850,ANKRD62,chr18,F,12072532,12129764,28981865,57232,674291626,16864,18
374860,ANKRD30B,chr18,F,14748159,14855465,29089171,107306,674398932,16865,45
374864,CCDC178,chr18,R,32937401,33441040,29592810,503639,674902571,16866,29
374868,ATP9B,chr18,F,79047593,79378283,29923500,330690,675233261,16867,40
388456,LOC388456,chr18,R,926082,927993,29925411,1911,675235172,16868,1
388468,POTEC,chr18,R,14509777,14543600,29959234,33823,675268995,16869,13
390858,OACYLP,chr18,F,59035678,59053214,29976770,17536,675286531,16870,4
400643,LINC00668,chr18,R,6925473,6929869,29981166,4396,675290927,16871,6
400644,LINC01443,chr18,F,14946266,14973756,30008656,27490,675318417,16872,3
400654,LINC01538,chr18,R,64213081,64260055,30055630,46974,675365391,16873,2
400655,LOC400655,chr18,R,73154057,73264498,30166071,110441,675475832,16874,5
400657,LINC00909,chr18,R,74591773,74597835,30172133,6062,675481894,16875,1
400658,C18orf65,chr18,F,76495520,76498088,30174701,2568,675484462,16876,1
400660,LINC00683,chr18,F,76619776,76623559,30178484,3783,675488245,16877,1
400661,LOC400661,chr18,F,76690028,76693636,30182092,3608,675491853,16878,1
406905,MIR1-2,chr18,R,21829003,21829088,30182177,85,675491938,16879,0
406906,MIR122,chr18,F,58451073,58451158,30182262,85,675492023,16880,0
406922,MIR133A1,chr18,R,21825697,21825785,30182350,88,675492111,16881,0
406963,MIR187,chr18,R,35904817,35904926,30182459,109,675492220,16882,0
440224,CXADRP3,chr18,R,14477951,14498706,30203214,20755,675512975,16883,2
440482,ANKRD20A5P,chr18,F,14179096,14227050,30251168,47954,675560929,16884,15
440498,HSBP1L1,chr18,F,79964581,79970822,30257409,6241,675567170,16885,3
441818,WBP11P1,chr18,F,32511662,32514634,30260381,2972,675570142,16886,0
494470,RNF165,chr18,F,46334223,46461412,30387570,127189,675697331,16887,9
494514,TYMSOS,chr18,R,649619,658340,30396291,8721,675706052,16888,1
497259,C18orf61,chr18,F,12200778,12224711,30420224,23933,675729985,16889,4
497661,C18orf32,chr18,R,49481177,49487274,30426321,6097,675736082,16890,2
641516,KC6,chr18,R,41480270,41520597,30466648,40327,675776409,16891,5
642484,LOC642484,chr18,R,56003289,56027819,30491178,24530,675800939,16892,2
642597,C18orf42,chr18,R,5143672,5198203,30545709,54531,675855470,16893,2
643542,LOC643542,chr18,F,67516545,67899619,30928783,383074,676238544,16894,4
644041,C18orf63,chr18,F,74315874,74359187,30972096,43313,676281857,16895,13
644669,LOC644669,chr18,R,15313555,15325919,30984460,12364,676294221,16896,5
645158,CBX3P2,chr18,R,2652169,2655395,30987686,3226,676297447,16897,1
645321,LOC645321,chr18,R,78976813,78979526,30990399,2713,676300160,16898,3
645355,MIR3976HG,chr18,F,5748818,5795901,31037482,47083,676347243,16899,4
645369,TMEM200C,chr18,R,5889411,5897101,31045172,7690,676354933,16900,2
646000,SLC35G4,chr18,F,11609557,11610612,31046227,1055,676355988,16901,0
647946,LINC00669,chr18,R,39206923,39751995,31591299,545072,676901060,16902,3
649446,DLGAP1-AS1,chr18,F,3594113,3597379,31594565,3266,676904326,16903,2
652991,SKOR2,chr18,R,47206202,47249630,31637993,43428,676947754,16904,8
677769,SCARNA17,chr18,F,49814022,49814443,31638414,421,676948175,16905,0
677819,SNORA37,chr18,R,54222283,54222412,31638543,129,676948304,16906,0
727758,ROCK1P1,chr18,F,109064,122219,31651698,13155,676961459,16907,4
727896,LOC727896,chr18,R,2943211,2946623,31655110,3412,676964871,16908,0
728606,PCAT18,chr18,R,26687620,26703638,31671128,16018,676980889,16909,1
728929,TCEB3CL,chr18,R,46968694,46969912,31672346,1218,676982107,16910,0
729950,LOC729950,chr18,F,24628181,24662198,31706363,34017,677016124,16911,2
100101467,ZSCAN30,chr18,R,35251057,35290259,31745565,39202,677055326,16912,6
100124516,SNORD58C,chr18,R,49489234,49489324,31745655,90,677055416,16913,0
100126323,MIR924,chr18,R,39622122,39622175,31745708,53,677055469,16914,0
100128893,GATA6-AS1,chr18,R,22166897,22168968,31747779,2071,677057540,16915,1
100129878,LOC100129878,chr18,F,49024627,49048469,31771621,23842,677081382,16916,2
100130480,LINC01387,chr18,F,6511415,6590653,31850859,79238,677160620,16917,5
100130522,PARD6G-AS1,chr18,F,80147923,80178432,31881368,30509,677191129,16918,4
100131655,LOC100131655,chr18,R,76794731,76822295,31908932,27564,677218693,16919,2
100132501,LINC01415,chr18,R,55774600,55781721,31916053,7121,677225814,16920,4
100188995,TRK-CTT6-1,chr18,R,46089304,46089377,31916126,73,677225887,16921,0
100192426,LOC100192426,chr18,R,8360819,8367034,31922341,6215,677232102,16922,3
100287082,GACAT2,chr18,R,8695855,8707621,31934107,11766,677243868,16923,1
100287225,LOC100287225,chr18,F,51392041,51562469,32104535,170428,677414296,16924,3
100288122,LDLRAD4-AS1,chr18,R,13419498,13427534,32112571,8036,677422332,16925,3
100302131,MIR302F,chr18,F,30298909,30298960,32112622,51,677422383,16926,0
100302135,MIR320C1,chr18,F,21683509,21683597,32112710,88,677422471,16927,0
100302195,MIR320C2,chr18,F,24321685,24321735,32112760,50,677422521,16928,0
100302257,MIR1539,chr18,F,49487372,49487422,32112810,50,677422571,16929,0
100422829,MIR4319,chr18,R,44970081,44970166,32112895,85,677422656,16930,0
100422840,MIR4317,chr18,R,6374360,6374425,32112960,65,677422721,16931,0
100422857,MIR4318,chr18,F,37657134,37657215,32113041,81,677422802,16932,0
100422865,MIR4320,chr18,R,50126498,50126563,32113106,65,677422867,16933,0
100422907,MIR3156-2,chr18,F,14830165,14830242,32113183,77,677422944,16934,0
100500864,MIR3929,chr18,R,35934087,35934142,32113238,55,677422999,16935,0
100505474,LINC01539,chr18,R,56083355,56137536,32167419,54181,677477180,16936,10
100505549,LOC100505549,chr18,F,57630301,57669276,32206394,38975,677516155,16937,2
100505592,GAPLINC,chr18,F,3466249,3478978,32219123,12729,677528884,16938,2
100505776,LINC01541,chr18,R,71519963,71578956,32278116,58993,677587877,16939,6
100505797,LOC100505797,chr18,F,72867266,72881399,32292249,14133,677602010,16940,5
100505817,LOC100505817,chr18,F,73324940,73349889,32317198,24949,677626959,16941,2
100505853,LOC100505853,chr18,R,75696082,75712403,32333519,16321,677643280,16942,1
100506070,RBFADN,chr18,F,80067255,80081304,32347568,14049,677657329,16943,3
100506787,LINC01543,chr18,F,26422994,26438044,32362618,15050,677672379,16944,3
100506888,TCEB3CL2,chr18,R,46962767,46964644,32364495,1877,677674256,16945,0
100526842,RPL17-C18orf32,chr18,R,49481177,49492565,32375883,11388,677685644,16946,6
100616130,MIR4526,chr18,F,13611113,13611200,32375970,87,677685731,16947,0
100616139,MIR4741,chr18,F,22933348,22933438,32376060,90,677685821,16948,0
100616232,MIR4528,chr18,F,53237100,53237190,32376150,90,677685911,16949,0
100616244,MIR3976,chr18,F,5840694,5840833,32376289,139,677686050,16950,0
100616257,MIR3975,chr18,F,35591736,35591806,32376359,70,677686120,16951,0
100616264,MIR4527,chr18,F,47380495,47380565,32376429,70,677686190,16952,0
100616290,MIR4529,chr18,F,55479220,55479298,32376507,78,677686268,16953,0
100616357,MIR3591,chr18,R,58451079,58451152,32376580,73,677686341,16954,0
100616366,MIR4743,chr18,F,48670599,48670668,32376649,69,677686410,16955,0
100616420,MIR4744,chr18,R,49049686,49049768,32376731,82,677686492,16956,0
100652770,DSG2-AS1,chr18,R,31542145,31556911,32391497,14766,677701258,16957,5
100846997,MIR5583-2,chr18,R,39676718,39676777,32391556,59,677701317,16958,0
100847002,MIR5011,chr18,F,67081583,67081686,32391659,103,677701420,16959,0
100847025,MIR5583-1,chr18,F,39676720,39676779,32391718,59,677701479,16960,0
100847080,MIR5190,chr18,F,13459946,13460026,32391798,80,677701559,16961,0
100847083,MIR548AV,chr18,R,72853320,72853382,32391860,62,677701621,16962,0
100873758,RNU6-39P,chr18,F,68858933,68859040,32391967,107,677701728,16963,0
100885779,LINC-ROR,chr18,R,57054570,57072119,32409516,17549,677719277,16964,3
100996274,LOC100996274,chr18,F,79144751,79149693,32414458,4942,677724219,16965,0
100996324,LOC100996324,chr18,R,12739485,12749422,32424395,9937,677734156,16966,1
100996669,LINC01544,chr18,F,61748175,61754695,32430915,6520,677740676,16967,3
101060542,LOC101060542,chr18,R,70380139,70384591,32435367,4452,677745128,16968,2
101410534,DLGAP1-AS4,chr18,F,3962352,4013943,32486958,51591,677796719,16969,4
101926997,LOC101926997,chr18,R,2517249,2519260,32488969,2011,677798730,16970,1
101927044,LOC101927044,chr18,F,3196903,3247341,32539407,50438,677849168,16971,3
101927094,LOC101927094,chr18,R,3445791,3448489,32542105,2698,677851866,16972,1
101927150,L3MBTL4-AS1,chr18,F,6256743,6260934,32546296,4191,677856057,16973,2
101927168,LOC101927168,chr18,R,6728926,6729862,32547232,936,677856993,16974,1
101927188,LOC101927188,chr18,F,6954676,6957419,32549975,2743,677859736,16975,1
101927229,LOC101927229,chr18,R,55105903,55124306,32568378,18403,677878139,16976,2
101927273,LOC101927273,chr18,R,55881687,55920199,32606890,38512,677916651,16977,3
101927275,NDUFV2-AS1,chr18,R,9121264,9136720,32622346,15456,677932107,16978,3
101927322,LOC101927322,chr18,R,58670008,58671873,32624211,1865,677933972,16979,1
101927323,PPP4R1-AS1,chr18,F,9614806,9619363,32628768,4557,677938529,16980,3
101927350,LINC01254,chr18,R,10405132,10414370,32638006,9238,677947767,16981,2
101927376,LOC101927376,chr18,F,10589365,10606403,32655044,17038,677964805,16982,1
101927387,LOC101927387,chr18,F,61755709,61756647,32655982,938,677965743,16983,1
101927404,LOC101927404,chr18,R,64871871,64993037,32777148,121166,678086909,16984,9
101927410,LOC101927410,chr18,F,10661932,10666887,32782103,4955,678091864,16985,2
101927430,LOC101927430,chr18,R,67808506,67814822,32788419,6316,678098180,16986,1
101927433,LINC01255,chr18,F,11488569,11506983,32806833,18414,678116594,16987,4
101927481,LOC101927481,chr18,F,70335438,70352459,32823854,17021,678133615,16988,3
101927496,LOC101927496,chr18,R,21240699,21242698,32825853,1999,678135614,16989,3
101927511,LOC101927511,chr18,R,11910411,11948090,32863532,37679,678173293,16990,4
101927521,LOC101927521,chr18,R,21363297,21451054,32951289,87757,678261050,16991,7
101927548,LOC101927548,chr18,R,22297804,22312015,32965500,14211,678275261,16992,2
101927571,LOC101927571,chr18,R,22723490,22786837,33028847,63347,678338608,16993,1
101927606,LOC101927606,chr18,F,74409447,74413209,33032609,3762,678342370,16994,1
101927642,LINC01444,chr18,R,14969606,14970468,33033471,862,678343232,16995,1
101927651,LOC101927651,chr18,R,76622780,76639011,33049702,16231,678359463,16996,4
101927652,LOC101927652,chr18,R,26708161,26742116,33083657,33955,678393418,16997,6
101927698,DSCAS,chr18,F,31101587,31162789,33144859,61202,678454620,16998,3
101927715,LINC01029,chr18,R,77971293,77993727,33167293,22434,678477054,16999,1
101927718,DSG1-AS1,chr18,R,31343367,31426988,33250914,83621,678560675,17000,4
101927757,LOC101927757,chr18,R,34907055,34943680,33287539,36625,678597300,17001,7
101927779,LOC101927779,chr18,F,79358485,79358780,33287834,295,678597595,17002,2
101927807,LOC101927807,chr18,F,79357541,79358234,33288527,693,678598288,17003,5
101927809,LOC101927809,chr18,R,36180000,36187438,33295965,7438,678605726,17004,1
101927857,LOC101927857,chr18,F,39655610,39669012,33309367,13402,678619128,17005,5
101927879,LOC101927879,chr18,F,39313888,39328008,33323487,14120,678633248,17006,3
101927897,LOC101927897,chr18,R,79456752,79467434,33334169,10682,678643930,17007,1
101927900,LINC01477,chr18,F,40066285,40099233,33367117,32948,678676878,17008,3
101927921,LINC01478,chr18,R,44323434,44531697,33575380,208263,678885141,17009,4
101927943,LOC101927943,chr18,R,44676926,44679911,33578365,2985,678888126,17010,1
101927961,LOC101927961,chr18,R,45168542,45181394,33591217,12852,678900978,17011,3
101927980,SLC14A2-AS1,chr18,R,45438182,45507036,33660071,68854,678969832,17012,7
101927989,LOC101927989,chr18,F,76491969,76493918,33662020,1949,678971781,17013,1
101928144,LOC101928144,chr18,F,49499319,49527494,33690195,28175,678999956,17014,3
101928167,LOC101928167,chr18,R,53579622,53581059,33691632,1437,679001393,17015,1
101930171,LOC101930171,chr18,R,47021725,47024244,33694151,2519,679003912,17016,0
102465430,MIR6718,chr18,F,3885352,3885432,33694231,80,679003992,17017,0
102465690,MIR7153,chr18,R,11654884,11654941,33694288,57,679004049,17018,0
102466735,MIR6788,chr18,R,10759583,10759649,33694354,66,679004115,17019,0
102466874,MIR8057,chr18,R,26591466,26591535,33694423,69,679004184,17020,0
102466878,MIR8078,chr18,R,112255,112339,33694507,84,679004268,17021,0
102723167,MIR133A1HG,chr18,R,21825478,21831406,33700435,5928,679010196,17022,2
102723506,LOC102723506,chr18,R,79515803,79527402,33712034,11599,679021795,17023,3
102724119,LOC102724119,chr18,R,13920,21166,33719280,7246,679029041,17024,2
102724130,LOC102724130,chr18,F,11146,16350,33724484,5204,679034245,17025,3
102724208,LOC102724208,chr18,F,21975280,22043478,33792682,68198,679102443,17026,3
102724246,TTC39C-AS1,chr18,R,23994212,24015460,33813930,21248,679123691,17027,5
102724383,LOC102724383,chr18,R,9146488,9171264,33838706,24776,679148467,17028,3
102724397,LOC102724397,chr18,R,9318621,9334475,33854560,15854,679164321,17029,2
102724417,LOC102724417,chr18,F,37722771,37725864,33857653,3093,679167414,17030,2
102724470,LOC102724470,chr18,R,10612676,10629072,33874049,16396,679183810,17031,7
102724534,LOC102724534,chr18,R,11695143,11714338,33893244,19195,679203005,17032,2
102724615,LOC102724615,chr18,F,13542042,13543623,33894825,1581,679204586,17033,1
102724634,LOC102724634,chr18,F,13471714,13484018,33907129,12304,679216890,17034,2
102724651,LOC102724651,chr18,F,53568446,53597851,33936534,29405,679246295,17035,5
102724676,LOC102724676,chr18,R,15182241,15197810,33952103,15569,679261864,17036,3
102724698,LOC102724698,chr18,F,56063166,56097451,33986388,34285,679296149,17037,10
102724733,LOC102724733,chr18,F,57735551,57738674,33989511,3123,679299272,17038,1
102724745,LOC102724745,chr18,F,58658587,58669329,34000253,10742,679310014,17039,5
102724895,LOC102724895,chr18,R,70335507,70337711,34002457,2204,679312218,17040,1
102724913,LOC102724913,chr18,R,71732614,71782226,34052069,49612,679361830,17041,4
102725148,LOC102725148,chr18,F,71810531,71839298,34080836,28767,679390597,17042,2
102725227,LOC102725227,chr18,F,26654483,26689436,34115789,34953,679425550,17043,3
103091864,SNHG22,chr18,F,49814022,49851059,34152826,37037,679462587,17044,3
104968399,LOC104968399,chr18,R,3255435,3262359,34159750,6924,679469511,17045,3
105369156,LOC105369156,chr18,R,24516882,24541831,34184699,24949,679494460,17046,2
105371950,LOC105371950,chr18,F,43087,47016,34188628,3929,679498389,17047,6
105371951,LOC105371951,chr18,F,151412,158169,34195385,6757,679505146,17048,3
105371952,LOC105371952,chr18,R,623688,632709,34204406,9021,679514167,17049,3
105371953,LOC105371953,chr18,F,1099259,1183954,34289101,84695,679598862,17050,4
105371954,LOC105371954,chr18,R,1365916,1392185,34315370,26269,679625131,17051,3
105371955,LOC105371955,chr18,F,2054822,2061617,34322165,6795,679631926,17052,2
105371956,LOC105371956,chr18,R,2034171,2126369,34414363,92198,679724124,17053,2
105371957,LOC105371957,chr18,F,2020958,2038349,34431754,17391,679741515,17054,5
105371958,LOC105371958,chr18,R,1906015,1923073,34448812,17058,679758573,17055,3
105371959,LOC105371959,chr18,F,1779901,1782253,34451164,2352,679760925,17056,2
105371960,LOC105371960,chr18,R,1513961,1522174,34459377,8213,679769138,17057,2
105371961,LOC105371961,chr18,F,2350578,2371117,34479916,20539,679789677,17058,7
105371962,LOC105371962,chr18,R,2506628,2512439,34485727,5811,679795488,17059,1
105371963,LOC105371963,chr18,F,2966999,2980463,34499191,13464,679808952,17060,3
105371964,LOC105371964,chr18,R,3347702,3350608,34502097,2906,679811858,17061,2
105371965,LOC105371965,chr18,R,3461843,3481678,34521932,19835,679831693,17062,2
105371966,LOC105371966,chr18,F,3877728,3886864,34531068,9136,679840829,17063,3
105371967,LOC105371967,chr18,F,3652732,3656282,34534618,3550,679844379,17064,2
105371968,LOC105371968,chr18,R,4493152,4496393,34537859,3241,679847620,17065,2
105371969,LOC105371969,chr18,F,5081181,5098756,34555434,17575,679865195,17066,3
105371970,LOC105371970,chr18,R,5353831,5374753,34576356,20922,679886117,17067,5
105371971,LOC105371971,chr18,F,6336321,6367247,34607282,30926,679917043,17068,3
105371972,LOC105371972,chr18,F,6558572,6569397,34618107,10825,679927868,17069,1
105371973,LOC105371973,chr18,R,7247704,7268603,34639006,20899,679948767,17070,3
105371974,LOC105371974,chr18,F,7272318,7279040,34645728,6722,679955489,17071,3
105371975,LOC105371975,chr18,R,7327448,7359778,34678058,32330,679987819,17072,2
105371976,LOC105371976,chr18,R,7502049,7509270,34685279,7221,679995040,17073,3
105371977,LOC105371977,chr18,F,8625007,8627627,34687899,2620,679997660,17074,1
105371978,LOC105371978,chr18,F,8950483,8952858,34690274,2375,680000035,17075,2
105371979,LOC105371979,chr18,R,9008806,9017644,34699112,8838,680008873,17076,2
105371980,LOC105371980,chr18,F,9404663,9407494,34701943,2831,680011704,17077,2
105371981,LOC105371981,chr18,F,9708712,9716356,34709587,7644,680019348,17078,1
105371982,LOC105371982,chr18,R,9895226,9897899,34712260,2673,680022021,17079,3
105371983,LOC105371983,chr18,R,10027197,10028945,34714008,1748,680023769,17080,2
105371984,LOC105371984,chr18,F,10085726,10093894,34722176,8168,680031937,17081,2
105371985,LOC105371985,chr18,R,10308372,10323653,34737457,15281,680047218,17082,5
105371986,LOC105371986,chr18,R,10327066,10373392,34783783,46326,680093544,17083,4
105371987,LOC105371987,chr18,F,10375062,10378308,34787029,3246,680096790,17084,1
105371988,LOC105371988,chr18,F,10404803,10425250,34807476,20447,680117237,17085,2
105371989,LOC105371989,chr18,F,10380434,10401145,34828187,20711,680137948,17086,2
105371990,LOC105371990,chr18,F,10598742,10601177,34830622,2435,680140383,17087,2
105371992,LOC105371992,chr18,F,11093726,11094682,34831578,956,680141339,17088,1
105371993,LOC105371993,chr18,R,11316435,11319015,34834158,2580,680143919,17089,2
105371994,LOC105371994,chr18,F,11454493,11466385,34846050,11892,680155811,17090,3
105371995,LOC105371995,chr18,R,11390032,11391767,34847785,1735,680157546,17091,1
105371996,LOC105371996,chr18,F,12254963,12257456,34850278,2493,680160039,17092,1
105371997,LOC105371997,chr18,F,12288215,12291591,34853654,3376,680163415,17093,1
105371998,LOC105371998,chr18,F,12437611,12449298,34865341,11687,680175102,17094,3
105371999,LOC105371999,chr18,R,13526176,13528376,34867541,2200,680177302,17095,1
105372003,LOC105372003,chr18,R,14403005,14431347,34895883,28342,680205644,17096,3
105372004,LOC105372004,chr18,R,14555208,14642507,34983182,87299,680292943,17097,8
105372005,LOC105372005,chr18,F,14724762,14725929,34984349,1167,680294110,17098,2
105372006,LOC105372006,chr18,R,14711261,14728178,35001266,16917,680311027,17099,3
105372007,LOC105372007,chr18,R,14729250,14747353,35019369,18103,680329130,17100,3
105372008,LOC105372008,chr18,R,14758928,14768083,35028524,9155,680338285,17101,4
105372009,LOC105372009,chr18,F,14902199,14941129,35067454,38930,680377215,17102,7
105372010,LOC105372010,chr18,R,14910357,14917464,35074561,7107,680384322,17103,2
105372011,LOC105372011,chr18,F,14877792,14888646,35085415,10854,680395176,17104,2
105372013,LOC105372013,chr18,F,4454757,4485704,35116362,30947,680426123,17105,5
105372014,LOC105372014,chr18,F,5629966,5630924,35117320,958,680427081,17106,1
105372015,LOC105372015,chr18,R,6406090,6414772,35126002,8682,680435763,17107,3
105372016,LOC105372016,chr18,F,21896935,21916648,35145715,19713,680455476,17108,3
105372017,LOC105372017,chr18,F,22215924,22236380,35166171,20456,680475932,17109,2
105372018,LOC105372018,chr18,R,22242198,22267655,35191628,25457,680501389,17110,3
105372019,LOC105372019,chr18,R,22347845,22349645,35193428,1800,680503189,17111,1
105372020,LOC105372020,chr18,R,22458888,22465011,35199551,6123,680509312,17112,2
105372021,LOC105372021,chr18,R,22609556,22641001,35230996,31445,680540757,17113,2
105372022,LOC105372022,chr18,R,23133585,23135761,35233172,2176,680542933,17114,1
105372023,LOC105372023,chr18,R,23959974,23967824,35241022,7850,680550783,17115,2
105372024,LOC105372024,chr18,R,24135300,24138868,35244590,3568,680554351,17116,1
105372025,LOC105372025,chr18,F,24326552,24401591,35319629,75039,680629390,17117,5
105372026,LOC105372026,chr18,F,24499998,24504142,35323773,4144,680633534,17118,2
105372027,LOC105372027,chr18,R,24667978,24671701,35327496,3723,680637257,17119,3
105372028,LOC105372028,chr18,F,24725780,24766728,35368444,40948,680678205,17120,2
105372029,LOC105372029,chr18,F,24793153,24800110,35375401,6957,680685162,17121,2
105372030,LOC105372030,chr18,R,24932778,24987979,35430602,55201,680740363,17122,4
105372031,LOC105372031,chr18,F,25233720,25258818,35455700,25098,680765461,17123,3
105372032,LOC105372032,chr18,F,25124068,25127069,35458701,3001,680768462,17124,2
105372033,LOC105372033,chr18,R,25957983,25960503,35461221,2520,680770982,17125,2
105372034,LOC105372034,chr18,R,26405857,26409379,35464743,3522,680774504,17126,2
105372035,LOC105372035,chr18,R,26822341,26825158,35467560,2817,680777321,17127,3
105372037,LOC105372037,chr18,F,27224716,27247181,35490025,22465,680799786,17128,4
105372038,LOC105372038,chr18,R,27336941,27342690,35495774,5749,680805535,17129,3
105372039,LOC105372039,chr18,F,27342779,27344256,35497251,1477,680807012,17130,2
105372040,LOC105372040,chr18,F,27344299,27346111,35499063,1812,680808824,17131,1
105372041,LOC105372041,chr18,F,27375350,27401903,35525616,26553,680835377,17132,4
105372042,LOC105372042,chr18,F,27786526,27805267,35544357,18741,680854118,17133,5
105372043,LOC105372043,chr18,R,28719196,28724767,35549928,5571,680859689,17134,2
105372044,LOC105372044,chr18,R,29180741,29236720,35605907,55979,680915668,17135,4
105372045,LOC105372045,chr18,F,29629843,29651532,35627596,21689,680937357,17136,3
105372046,LOC105372046,chr18,F,30317402,30323796,35633990,6394,680943751,17137,2
105372047,LOC105372047,chr18,R,30325738,30333984,35642236,8246,680951997,17138,1
105372048,LOC105372048,chr18,R,31257313,31280655,35665578,23342,680975339,17139,2
105372049,LOC105372049,chr18,F,31228113,31259438,35696903,31325,681006664,17140,3
105372050,LOC105372050,chr18,R,31510568,31513674,35700009,3106,681009770,17141,2
105372051,LOC105372051,chr18,F,31556980,31586451,35729480,29471,681039241,17142,2
105372052,LOC105372052,chr18,F,31725359,31778950,35783071,53591,681092832,17143,4
105372053,LOC105372053,chr18,R,32022454,32031914,35792531,9460,681102292,17144,3
105372054,LOC105372054,chr18,F,32175744,32185169,35801956,9425,681111717,17145,2
105372055,LOC105372055,chr18,F,32772100,32778697,35808553,6597,681118314,17146,1
105372056,LOC105372056,chr18,F,32680611,32738451,35866393,57840,681176154,17147,3
105372057,LOC105372057,chr18,R,32886751,32903419,35883061,16668,681192822,17148,2
105372058,LOC105372058,chr18,F,32833432,32925895,35975524,92463,681285285,17149,13
105372059,LOC105372059,chr18,F,32938098,32958140,35995566,20042,681305327,17150,5
105372060,LOC105372060,chr18,F,33911244,33922191,36006513,10947,681316274,17151,2
105372061,LOC105372061,chr18,R,34891104,34907066,36022475,15962,681332236,17152,5
105372062,LOC105372062,chr18,R,34735770,34760073,36046778,24303,681356539,17153,3
105372063,LOC105372063,chr18,R,35397057,35409074,36058795,12017,681368556,17154,2
105372064,LOC105372064,chr18,R,35690075,35696982,36065702,6907,681375463,17155,1
105372065,LOC105372065,chr18,R,35666624,35677584,36076662,10960,681386423,17156,1
105372066,LOC105372066,chr18,R,35951811,35972527,36097378,20716,681407139,17157,2
105372067,LOC105372067,chr18,R,35984623,35989502,36102257,4879,681412018,17158,2
105372068,LOC105372068,chr18,F,37274459,37275728,36103526,1269,681413287,17159,1
105372069,LOC105372069,chr18,R,36845223,36923835,36182138,78612,681491899,17160,5
105372070,LOC105372070,chr18,R,36693430,36714289,36202997,20859,681512758,17161,6
105372071,LOC105372071,chr18,R,36660267,36663555,36206285,3288,681516046,17162,2
105372072,LOC105372072,chr18,F,37753614,37776383,36229054,22769,681538815,17163,4
105372073,LOC105372073,chr18,R,37734472,37774707,36269289,40235,681579050,17164,2
105372074,LOC105372074,chr18,R,38466642,38490284,36292931,23642,681602692,17165,2
105372075,LOC105372075,chr18,R,38591682,38594635,36295884,2953,681605645,17166,2
105372076,LOC105372076,chr18,R,38655253,38733691,36374322,78438,681684083,17167,6
105372077,LOC105372077,chr18,F,38784909,38807562,36396975,22653,681706736,17168,3
105372078,LOC105372078,chr18,R,39275635,39340995,36462335,65360,681772096,17169,5
105372079,LOC105372079,chr18,F,39840334,39882483,36504484,42149,681814245,17170,7
105372080,LOC105372080,chr18,R,39909542,39924690,36519632,15148,681829393,17171,2
105372081,LOC105372081,chr18,R,40064401,40066465,36521696,2064,681831457,17172,2
105372082,LOC105372082,chr18,F,40246272,40249626,36525050,3354,681834811,17173,2
105372083,LOC105372083,chr18,F,41449764,41506866,36582152,57102,681891913,17174,2
105372084,LOC105372084,chr18,R,41406798,41421138,36596492,14340,681906253,17175,3
105372085,LOC105372085,chr18,R,41873592,41908263,36631163,34671,681940924,17176,4
105372086,LOC105372086,chr18,R,41994944,42004349,36640568,9405,681950329,17177,2
105372087,LOC105372087,chr18,F,43884164,43889199,36645603,5035,681955364,17178,3
105372088,LOC105372088,chr18,R,43810687,43933363,36768279,122676,682078040,17179,2
105372089,LOC105372089,chr18,R,44658454,44664659,36774484,6205,682084245,17180,3
105372090,LOC105372090,chr18,F,44793925,44800836,36781395,6911,682091156,17181,2
105372091,LOC105372091,chr18,R,45069275,45156463,36868583,87188,682178344,17182,4
105372092,LOC105372092,chr18,F,45713193,45723234,36878624,10041,682188385,17183,3
105372093,LOC105372093,chr18,R,45731212,45782818,36930230,51606,682239991,17184,6
105372094,LOC105372094,chr18,F,46407755,46415426,36937901,7671,682247662,17185,4
105372095,LOC105372095,chr18,R,46388106,46389512,36939307,1406,682249068,17186,3
105372096,LOC105372096,chr18,R,46660209,46663217,36942315,3008,682252076,17187,2
105372097,LOC105372097,chr18,F,46757442,46769135,36954008,11693,682263769,17188,2
105372098,LOC105372098,chr18,R,47077366,47100870,36977512,23504,682287273,17189,5
105372100,LOC105372100,chr18,F,47668150,47694841,37004203,26691,682313964,17190,5
105372101,LOC105372101,chr18,R,47955470,47958018,37006751,2548,682316512,17191,2
105372102,LOC105372102,chr18,F,48362581,48396796,37040966,34215,682350727,17192,3
105372103,LOC105372103,chr18,F,48342651,48354203,37052518,11552,682362279,17193,3
105372104,LOC105372104,chr18,F,48162403,48185405,37075520,23002,682385281,17194,6
105372105,LOC105372105,chr18,R,48817795,48841796,37099521,24001,682409282,17195,3
105372106,LOC105372106,chr18,R,48794109,48798095,37103507,3986,682413268,17196,2
105372107,LOC105372107,chr18,R,48673574,48692858,37122791,19284,682432552,17197,5
105372108,LOC105372108,chr18,R,48962085,48964745,37125451,2660,682435212,17198,2
105372109,LOC105372109,chr18,R,49017678,49019771,37127544,2093,682437305,17199,0
105372110,LOC105372110,chr18,F,49016026,49023814,37135332,7788,682445093,17200,2
105372111,LOC105372111,chr18,F,49205490,49209136,37138978,3646,682448739,17201,2
105372112,LOC105372112,chr18,F,49612708,49738560,37264830,125852,682574591,17202,5
105372113,LOC105372113,chr18,F,50142299,50144992,37267523,2693,682577284,17203,2
105372114,LOC105372114,chr18,R,50354140,50374866,37288249,20726,682598010,17204,2
105372116,LOC105372116,chr18,R,50748168,50752661,37292742,4493,682602503,17205,3
105372117,LOC105372117,chr18,R,51025095,51030169,37297816,5074,682607577,17206,1
105372118,LOC105372118,chr18,R,51192905,51196548,37301459,3643,682611220,17207,2
105372120,LOC105372120,chr18,R,51645002,51656433,37312890,11431,682622651,17208,3
105372121,LOC105372121,chr18,F,52048254,52217260,37481896,169006,682791657,17209,6
105372122,LOC105372122,chr18,R,53884525,53887309,37484680,2784,682794441,17210,2
105372124,LOC105372124,chr18,F,54987755,54993394,37490319,5639,682800080,17211,2
105372125,LOC105372125,chr18,R,55079049,55085363,37496633,6314,682806394,17212,1
105372126,LOC105372126,chr18,F,55589898,55606698,37513433,16800,682823194,17213,3
105372127,LOC105372127,chr18,F,55480433,55482944,37515944,2511,682825705,17214,1
105372128,LOC105372128,chr18,R,55331235,55340409,37525118,9174,682834879,17215,1
105372129,LOC105372129,chr18,R,55294261,55297148,37528005,2887,682837766,17216,1
105372130,LOC105372130,chr18,F,55665543,55839862,37702324,174319,683012085,17217,9
105372131,LOC105372131,chr18,F,55863351,55870232,37709205,6881,683018966,17218,2
105372132,LOC105372132,chr18,F,56137598,56150102,37721709,12504,683031470,17219,6
105372133,LOC105372133,chr18,R,56059827,56063078,37724960,3251,683034721,17220,1
105372134,LOC105372134,chr18,R,56259891,56306892,37771961,47001,683081722,17221,2
105372135,LOC105372135,chr18,F,56573517,56575165,37773609,1648,683083370,17222,1
105372136,LOC105372136,chr18,F,57050095,57051426,37774940,1331,683084701,17223,2
105372137,LOC105372137,chr18,R,57158835,57169318,37785423,10483,683095184,17224,2
105372138,LOC105372138,chr18,R,57169402,57334332,37950353,164930,683260114,17225,4
105372139,LOC105372139,chr18,F,57444375,57469778,37975756,25403,683285517,17226,2
105372140,LOC105372140,chr18,R,57896334,57901924,37981346,5590,683291107,17227,3
105372141,LOC105372141,chr18,F,57731838,57735388,37984896,3550,683294657,17228,2
105372142,LOC105372142,chr18,F,57686552,57731619,38029963,45067,683339724,17229,3
105372143,LOC105372143,chr18,R,58188246,58195710,38037427,7464,683347188,17230,3
105372144,LOC105372144,chr18,F,58612582,58615835,38040680,3253,683350441,17231,2
105372145,LOC105372145,chr18,F,58557021,58566678,38050337,9657,683360098,17232,1
105372146,LOC105372146,chr18,R,58671922,58780234,38158649,108312,683468410,17233,4
105372147,LOC105372147,chr18,F,58812695,58834525,38180479,21830,683490240,17234,3
105372148,LOC105372148,chr18,F,59685825,59690928,38185582,5103,683495343,17235,2
105372149,LOC105372149,chr18,F,59563761,59572450,38194271,8689,683504032,17236,3
105372150,LOC105372150,chr18,F,59516652,59521996,38199615,5344,683509376,17237,2
105372151,LOC105372151,chr18,F,59927370,59951306,38223551,23936,683533312,17238,4
105372152,LOC105372152,chr18,F,60027148,60044469,38240872,17321,683550633,17239,1
105372153,LOC105372153,chr18,R,60167696,60173163,38246339,5467,683556100,17240,3
105372154,LOC105372154,chr18,R,60173197,60177855,38250997,4658,683560758,17241,2
105372155,LOC105372155,chr18,F,60294439,60301145,38257703,6706,683567464,17242,3
105372156,LOC105372156,chr18,F,60637966,60646250,38265987,8284,683575748,17243,4
105372157,LOC105372157,chr18,F,61652004,61662445,38276428,10441,683586189,17244,2
105372158,LOC105372158,chr18,R,61897668,62018119,38396879,120451,683706640,17245,4
105372159,LOC105372159,chr18,F,61894555,61905636,38407960,11081,683717721,17246,2
105372160,LOC105372160,chr18,R,62756306,62774027,38425681,17721,683735442,17247,8
105372161,LOC105372161,chr18,F,63088531,63097162,38434312,8631,683744073,17248,2
105372162,LOC105372162,chr18,R,63226871,63228857,38436298,1986,683746059,17249,2
105372163,LOC105372163,chr18,F,63397259,63403695,38442734,6436,683752495,17250,2
105372164,LOC105372164,chr18,R,63724288,63737861,38456307,13573,683766068,17251,3
105372165,LOC105372165,chr18,R,63966380,63969891,38459818,3511,683769579,17252,2
105372166,LOC105372166,chr18,R,64538099,64539134,38460853,1035,683770614,17253,1
105372167,LOC105372167,chr18,R,64630289,64631350,38461914,1061,683771675,17254,1
105372168,LOC105372168,chr18,F,65131919,65144128,38474123,12209,683783884,17255,2
105372169,LOC105372169,chr18,R,65464891,65506660,38515892,41769,683825653,17256,4
105372170,LOC105372170,chr18,R,66110544,66111996,38517344,1452,683827105,17257,2
105372172,LOC105372172,chr18,F,67767173,67782176,38532347,15003,683842108,17258,3
105372173,LOC105372173,chr18,R,67672260,67767068,38627155,94808,683936916,17259,4
105372174,LOC105372174,chr18,R,67587244,67623863,38663774,36619,683973535,17260,2
105372175,LOC105372175,chr18,R,68258077,68264803,38670500,6726,683980261,17261,3
105372176,LOC105372176,chr18,R,68753295,68784216,38701421,30921,684011182,17262,2
105372177,LOC105372177,chr18,R,69816895,69835053,38719579,18158,684029340,17263,4
105372178,LOC105372178,chr18,R,69715332,69733135,38737382,17803,684047143,17264,2
105372179,LOC105372179,chr18,F,69469931,69471736,38739187,1805,684048948,17265,1
105372180,LOC105372180,chr18,F,70205813,70209778,38743152,3965,684052913,17266,2
105372181,LOC105372181,chr18,R,70411986,70430178,38761344,18192,684071105,17267,3
105372184,LOC105372184,chr18,F,70756206,70770863,38776001,14657,684085762,17268,1
105372185,LOC105372185,chr18,F,70773434,70786753,38789320,13319,684099081,17269,2
105372186,LOC105372186,chr18,F,71642690,71646621,38793251,3931,684103012,17270,2
105372187,LOC105372187,chr18,R,71215625,71217974,38795600,2349,684105361,17271,1
105372188,LOC105372188,chr18,F,71197957,71203688,38801331,5731,684111092,17272,3
105372189,LOC105372189,chr18,R,72147668,72184725,38838388,37057,684148149,17273,3
105372190,LOC105372190,chr18,R,73681324,73691316,38848380,9992,684158141,17274,2
105372191,LOC105372191,chr18,F,73756383,73784702,38876699,28319,684186460,17275,4
105372192,LOC105372192,chr18,R,74454601,74456948,38879046,2347,684188807,17276,1
105372193,LOC105372193,chr18,R,74495482,74496163,38879727,681,684189488,17277,1
105372194,LOC105372194,chr18,R,75070196,75073950,38883481,3754,684193242,17278,1
105372195,LOC105372195,chr18,F,75066353,75074205,38891333,7852,684201094,17279,1
105372196,LOC105372196,chr18,R,74895670,74936725,38932388,41055,684242149,17280,3
105372197,LOC105372197,chr18,R,74731557,74741271,38942102,9714,684251863,17281,2
105372198,LOC105372198,chr18,R,75112182,75125551,38955471,13369,684265232,17282,1
105372200,LOC105372200,chr18,F,75406946,75425040,38973565,18094,684283326,17283,5
105372201,LOC105372201,chr18,F,75472803,75478187,38978949,5384,684288710,17284,3
105372202,LOC105372202,chr18,R,75506282,75509972,38982639,3690,684292400,17285,2
105372203,LOC105372203,chr18,R,76005037,76015412,38993014,10375,684302775,17286,4
105372204,LOC105372204,chr18,R,76053683,76056412,38995743,2729,684305504,17287,2
105372206,LOC105372206,chr18,R,76197308,76207220,39005655,9912,684315416,17288,2
105372207,LOC105372207,chr18,F,76209202,76217864,39014317,8662,684324078,17289,4
105372208,LOC105372208,chr18,F,76218198,76221719,39017838,3521,684327599,17290,1
105372209,LOC105372209,chr18,F,76233240,76260114,39044712,26874,684354473,17291,8
105372210,LOC105372210,chr18,R,76225184,76232107,39051635,6923,684361396,17292,2
105372211,LOC105372211,chr18,R,76279574,76318803,39090864,39229,684400625,17293,2
105372212,LOC105372212,chr18,R,76683330,76687030,39094564,3700,684404325,17294,2
105372213,LOC105372213,chr18,F,76722363,76727967,39100168,5604,684409929,17295,2
105372214,LOC105372214,chr18,R,76842731,76858167,39115604,15436,684425365,17296,2
105372215,LOC105372215,chr18,F,77087367,77094009,39122246,6642,684432007,17297,2
105372216,LOC105372216,chr18,R,77062782,77065933,39125397,3151,684435158,17298,1
105372217,LOC105372217,chr18,F,76980477,76984157,39129077,3680,684438838,17299,1
105372218,LOC105372218,chr18,R,77974557,77984809,39139329,10252,684449090,17300,2
105372219,LOC105372219,chr18,F,78518574,78522246,39143001,3672,684452762,17301,1
105372220,LOC105372220,chr18,R,78556093,78558962,39145870,2869,684455631,17302,3
105372221,LOC105372221,chr18,F,78639293,78641237,39147814,1944,684457575,17303,1
105372222,LOC105372222,chr18,R,78669936,78670997,39148875,1061,684458636,17304,2
105372223,LOC105372223,chr18,R,78816094,78818911,39151692,2817,684461453,17305,2
105372224,LOC105372224,chr18,R,78908611,78927373,39170454,18762,684480215,17306,3
105372226,LOC105372226,chr18,R,79272305,79300810,39198959,28505,684508720,17307,3
105372227,LOC105372227,chr18,R,79253576,79255641,39201024,2065,684510785,17308,1
105372228,LOC105372228,chr18,F,79610657,79615136,39205503,4479,684515264,17309,2
105372229,LOC105372229,chr18,R,79582885,79586633,39209251,3748,684519012,17310,3
105372230,LOC105372230,chr18,R,80179223,80185369,39215397,6146,684525158,17311,1
105376851,LOC105376851,chr18,R,11635708,11641066,39220755,5358,684530516,17312,1
105376852,LOC105376852,chr18,F,13942342,13947553,39225966,5211,684535727,17313,2
105376853,LOC105376853,chr18,F,14860170,14863223,39229019,3053,684538780,17314,1
105376854,LOC105376854,chr18,R,508395,531912,39252536,23517,684562297,17315,3
105376855,LOC105376855,chr18,F,12431365,12436206,39257377,4841,684567138,17316,4
105376866,LOC105376866,chr18,F,21704847,21706061,39258591,1214,684568352,17317,1
105376868,LOC105376868,chr18,R,44577962,44579937,39260566,1975,684570327,17318,1
105376869,LOC105376869,chr18,R,50255760,50261055,39265861,5295,684575622,17319,2
105376870,LOC105376870,chr18,F,57763790,57794459,39296530,30669,684606291,17320,4
105376872,LOC105376872,chr18,F,70470173,70531730,39358087,61557,684667848,17321,4
105376873,LOC105376873,chr18,F,71777918,71799893,39380062,21975,684689823,17322,2
105376874,LOC105376874,chr18,F,75165614,75168258,39382706,2644,684692467,17323,1
105376875,LOC105376875,chr18,F,79680360,79688319,39390665,7959,684700426,17324,4
1,A1BG,chr19,R,58346805,58353499,6694,6694,6694,17325,7
54,ACP5,chr19,R,11574659,11578986,11021,4327,11021,17326,7
81,ACTN4,chr19,F,38647615,38730531,93937,82916,93937,17327,22
160,AP2A1,chr19,F,49766922,49807112,134127,40190,134127,17328,24
166,AES,chr19,R,3052909,3063107,144325,10198,144325,17329,7
208,AKT2,chr19,R,40230316,40285531,199540,55215,199540,17330,22
268,AMH,chr19,F,2249113,2252073,202500,2960,202500,17331,4
333,APLP1,chr19,F,35868498,35879797,213799,11299,213799,17332,16
341,APOC1,chr19,F,44914324,44919349,218824,5025,218824,17333,4
342,APOC1P1,chr19,F,44926802,44931386,223408,4584,223408,17334,2
344,APOC2,chr19,F,44945981,44949565,226992,3584,226992,17335,5
346,APOC4,chr19,F,44942237,44945496,230251,3259,230251,17336,2
348,APOE,chr19,F,44905748,44909395,233898,3647,233898,17337,5
354,KLK3,chr19,F,50854914,50877702,256686,22788,256686,17338,5
439,ASNA1,chr19,F,12737491,12748323,267518,10832,267518,17339,6
478,ATP1A3,chr19,R,41966581,41994276,295213,27695,295213,17340,23
495,ATP4A,chr19,R,35550192,35563658,308679,13466,308679,17341,21
513,ATP5D,chr19,F,1241749,1244825,311755,3076,311755,17342,3
558,AXL,chr19,F,41219198,41261767,354324,42569,354324,17343,20
566,AZU1,chr19,F,827830,832017,358511,4187,358511,17344,4
581,BAX,chr19,F,48954859,48961798,365450,6939,365450,17345,6
587,BCAT2,chr19,R,48795061,48811063,381452,16002,381452,17346,11
593,BCKDHA,chr19,F,41397788,41425005,408669,27217,408669,17347,8
602,BCL3,chr19,F,44748044,44760044,420669,12000,420669,17348,10
610,HCN2,chr19,F,589892,617159,447936,27267,447936,17349,7
634,CEACAM1,chr19,R,42507305,42528509,469140,21204,469140,17350,9
645,BLVRB,chr19,R,40447783,40465818,487175,18035,487175,17351,4
682,BSG,chr19,F,571276,583493,499392,12217,499392,17352,9
684,BST2,chr19,R,17402938,17405648,502102,2710,502102,17353,4
718,C3,chr19,R,6677834,6720682,544950,42848,544950,17354,40
728,C5AR1,chr19,F,47307744,47322070,559276,14326,559276,17355,3
770,CA11,chr19,R,48638014,48646194,567456,8180,567456,17356,8
773,CACNA1A,chr19,R,13206441,13506460,867475,300019,867475,17357,48
808,CALM3,chr19,F,46601254,46610782,877003,9528,877003,17358,5
811,CALR,chr19,F,12938599,12944490,882894,5891,882894,17359,8
826,CAPNS1,chr19,F,36139925,36150353,893322,10428,893322,17360,11
828,CAPS,chr19,F,5913647,5916211,895886,2564,895886,17361,4
898,CCNE1,chr19,F,29811897,29824312,908301,12415,908301,17362,11
933,CD22,chr19,F,35329165,35347361,926497,18196,926497,17363,13
945,CD33,chr19,F,51215536,51240019,950980,24483,950980,17364,10
946,SIGLEC6,chr19,R,51519529,51531863,963314,12334,963314,17365,10
951,CD37,chr19,F,49335364,49340606,968556,5242,968556,17366,7
970,CD70,chr19,R,6585838,6591152,973870,5314,973870,17367,2
973,CD79A,chr19,F,41877119,41881372,978123,4253,978123,17368,4
976,ADGRE5,chr19,F,14381143,14408725,1005705,27582,1005705,17369,19
997,CDC34,chr19,F,531718,542088,1016075,10370,1016075,17370,5
1032,CDKN2D,chr19,R,10566461,10568979,1018593,2518,1018593,17371,1
1048,CEACAM5,chr19,F,41708610,41730433,1040416,21823,1040416,17372,9
1050,CEBPA,chr19,R,33299933,33302564,1043047,2631,1043047,17373,0
1054,CEBPG,chr19,F,33373668,33382686,1052065,9018,1052065,17374,2
1082,CGB,chr19,R,49022868,49024375,1053572,1507,1053572,17375,2
1084,CEACAM3,chr19,F,41796589,41811553,1068536,14964,1068536,17376,7
1087,CEACAM7,chr19,R,41673306,41688277,1083507,14971,1083507,17377,4
1088,CEACAM8,chr19,R,42580242,42594939,1098204,14697,1098204,17378,7
1089,CEACAM4,chr19,R,41616985,41627084,1108303,10099,1108303,17379,6
1153,CIRBP,chr19,F,1269265,1274810,1113848,5545,1113848,17380,5
1155,TBCB,chr19,F,36114985,36125948,1124811,10963,1124811,17381,6
1158,CKM,chr19,R,45306412,45322977,1141376,16565,1141376,17382,7
1175,AP2S1,chr19,R,46838157,46850995,1154214,12838,1154214,17383,5
1178,CLC,chr19,R,39731252,39738029,1160991,6777,1160991,17384,3
1209,CLPTM1,chr19,F,44954584,44993346,1199753,38762,1199753,17385,15
1264,CNN1,chr19,F,11538763,11550323,1211313,11560,1211313,17386,10
1265,CNN2,chr19,F,1026274,1039068,1224107,12794,1224107,17387,6
1311,COMP,chr19,R,18782772,18791305,1232640,8533,1232640,17388,18
1340,COX6B1,chr19,F,35648222,35658784,1243202,10562,1243202,17389,3
1346,COX7A1,chr19,R,36150921,36152869,1245150,1948,1245150,17390,3
1406,CRX,chr19,F,47821841,47843330,1266639,21489,1266639,17391,3
1455,CSNK1G2,chr19,F,1941148,1981338,1306829,40190,1306829,17392,11
1463,NCAN,chr19,F,19211963,19252252,1347118,40289,1347118,17393,14
1548,CYP2A6,chr19,R,40843537,40850447,1354028,6910,1354028,17394,8
1549,CYP2A7,chr19,R,40875438,40882752,1361342,7314,1361342,17395,7
1553,CYP2A13,chr19,F,41088450,41096195,1369087,7745,1369087,17396,8
1555,CYP2B6,chr19,F,40991228,41018398,1396257,27170,1396257,17397,10
1556,CYP2B7P,chr19,F,40924264,40950660,1422653,26396,1422653,17398,8
1572,CYP2F1,chr19,F,41114291,41128381,1436743,14090,1436743,17399,9
1613,DAPK3,chr19,R,3958452,3971123,1449414,12671,1449414,17400,8
1628,DBP,chr19,R,48630559,48637550,1456405,6991,1456405,17401,3
1675,CFD,chr19,F,859664,863624,1460365,3960,1460365,17402,4
1725,DHPS,chr19,R,12672857,12681887,1469395,9030,1469395,17403,12
1760,DMPK,chr19,R,45769708,45782557,1482244,12849,1482244,17404,14
1762,DMWD,chr19,R,45783005,45792802,1492041,9797,1492041,17405,4
1777,DNASE2,chr19,R,12875210,12881521,1498352,6311,1498352,17406,5
1785,DNM2,chr19,F,10718052,10831910,1612210,113858,1612210,17407,21
1786,DNMT1,chr19,R,10133344,10195079,1673945,61735,1673945,17408,41
1820,ARID3A,chr19,F,926036,972816,1720725,46780,1720725,17409,10
1891,ECH1,chr19,R,38815421,38831857,1737161,16436,1737161,17410,9
1938,EEF2,chr19,R,3976055,3985463,1746569,9408,1746569,17411,14
1943,EFNA2,chr19,F,1286153,1301431,1761847,15278,1761847,17412,3
1954,MEGF8,chr19,F,42325608,42378769,1815008,53161,1815008,17413,41
1991,ELANE,chr19,F,850996,856250,1820262,5254,1820262,17414,5
1994,ELAVL1,chr19,R,7958572,8005645,1867335,47073,1867335,17415,6
1995,ELAVL3,chr19,R,11451325,11481046,1897056,29721,1897056,17416,6
2014,EMP3,chr19,F,48325369,48330555,1902242,5186,1902242,17417,5
2015,ADGRE1,chr19,F,6887548,6940453,1955147,52905,1955147,17418,22
2057,EPOR,chr19,R,11377204,11384342,1962285,7138,1962285,17419,7
2063,NR2F6,chr19,R,17231884,17245342,1975743,13458,1975743,17420,3
2067,ERCC1,chr19,R,45407332,45478820,2047231,71488,2047231,17421,11
2068,ERCC2,chr19,R,45351390,45370646,2066487,19256,2066487,17422,22
2077,ERF,chr19,R,42247560,42255164,2074091,7604,2074091,17423,7
2091,FBL,chr19,R,39834452,39846414,2086053,11962,2086053,17424,8
2109,ETFB,chr19,R,51345154,51366418,2107317,21264,2107317,17425,5
2116,ETV2,chr19,F,35641212,35644871,2110976,3659,2110976,17426,5
2193,FARSA,chr19,R,12922469,12933744,2122251,11275,2122251,17427,12
2204,FCAR,chr19,F,54874092,54891420,2139579,17328,2139579,17428,5
2208,FCER2,chr19,R,7688756,7702310,2153133,13554,2153133,17429,11
2217,FCGRT,chr19,F,49512278,49526428,2167283,14150,2167283,17430,8
2282,FKBP1AP1,chr19,R,57825279,57827462,2169466,2183,2169466,17431,1
2323,FLT3LG,chr19,F,49474171,49486234,2181529,12063,2181529,17432,11
2354,FOSB,chr19,F,45467994,45475179,2188714,7185,2188714,17433,3
2357,FPR1,chr19,R,51745769,51751897,2194842,6128,2194842,17434,2
2358,FPR2,chr19,F,51760919,51770670,2204593,9751,2204593,17435,2
2359,FPR3,chr19,F,51795157,51826474,2235910,31317,2235910,17436,2
2512,FTL,chr19,F,48965308,48966879,2237481,1571,2237481,17437,3
2523,FUT1,chr19,R,48748010,48755390,2244861,7380,2244861,17438,3
2524,FUT2,chr19,F,48695970,48705934,2254825,9964,2254825,17439,1
2525,FUT3,chr19,R,5842887,5851474,2263412,8587,2263412,17440,4
2527,FUT5,chr19,R,5865825,5870540,2268127,4715,2268127,17441,1
2528,FUT6,chr19,R,5830625,5839753,2277255,9128,2277255,17442,5
2593,GAMT,chr19,R,1397025,1401570,2281800,4545,2281800,17443,5
2639,GCDH,chr19,F,12891128,12914630,2305302,23502,2305302,17444,14
2657,GDF1,chr19,R,18868545,18896144,2332901,27599,2332901,17445,7
2696,GIPR,chr19,F,45668192,45682504,2347213,14312,2347213,17446,13
2767,GNA11,chr19,F,3094409,3124002,2376806,29593,2376806,17447,6
2769,GNA15,chr19,F,3136031,3163769,2404544,27738,2404544,17448,6
2788,GNG7,chr19,R,2511219,2702748,2596073,191529,2596073,17449,4
2821,GPI,chr19,F,34359591,34402413,2638895,42822,2638895,17450,20
2828,GPR4,chr19,R,45589763,45602208,2651340,12445,2651340,17451,1
2854,GPR32,chr19,F,50770463,50771732,2652609,1269,2652609,17452,0
2864,FFAR1,chr19,F,35351541,35352464,2653532,923,2653532,17453,0
2865,FFAR3,chr19,F,35358208,35360489,2655813,2281,2655813,17454,2
2867,FFAR2,chr19,F,35449714,35451767,2657866,2053,2657866,17455,0
2872,MKNK2,chr19,R,2037470,2051244,2671640,13774,2671640,17456,13
2879,GPX4,chr19,F,1103925,1106789,2674504,2864,2674504,17457,7
2901,GRIK5,chr19,R,41998315,42071804,2747993,73489,2747993,17458,25
2906,GRIN2D,chr19,F,48394874,48444937,2798056,50063,2798056,17459,12
2909,ARHGAP35,chr19,F,46918566,47005077,2884567,86511,2884567,17460,7
2931,GSK3A,chr19,R,42230185,42242584,2896966,12399,2896966,17461,10
2962,GTF2F1,chr19,R,6379568,6393280,2910678,13712,2910678,17462,12
2997,GYS1,chr19,R,48968124,48993353,2935907,25229,2935907,17463,15
3004,GZMM,chr19,F,544033,549920,2941794,5887,2941794,17464,4
3036,HAS1,chr19,R,51713111,51723992,2952675,10881,2952675,17465,4
3171,FOXA3,chr19,F,45864259,45873797,2962213,9538,2962213,17466,1
3191,HNRNPL,chr19,R,38836377,38852339,2978175,15962,2978175,17467,16
3249,HPN,chr19,F,35040505,35066577,3004247,26072,3004247,17468,13
3270,HRC,chr19,R,49151197,49155429,3008479,4232,3008479,17469,5
3276,PRMT1,chr19,F,49677151,49688450,3019778,11299,3019778,17470,11
3337,DNAJB1,chr19,R,14514763,14529711,3034726,14948,3034726,17471,6
3383,ICAM1,chr19,F,10270840,10286615,3050501,15775,3050501,17472,6
3385,ICAM3,chr19,R,10333775,10339829,3056555,6054,3056555,17473,6
3386,ICAM4,chr19,F,10286966,10288584,3058173,1618,3058173,17474,1
3589,IL11,chr19,R,55364381,55370463,3064255,6082,3064255,17475,4
3594,IL12RB1,chr19,R,18058994,18098986,3104247,39992,3104247,17476,19
3609,ILF3,chr19,F,10654260,10692419,3142406,38159,3142406,17477,20
3640,INSL3,chr19,R,17816512,17821574,3147468,5062,3147468,17478,2
3643,INSR,chr19,R,7112254,7294000,3329214,181746,3329214,17479,21
3661,IRF3,chr19,R,49659568,49665875,3335521,6307,3335521,17480,8
3718,JAK3,chr19,R,17824779,17848071,3358813,23292,3358813,17481,25
3726,JUNB,chr19,F,12791495,12793311,3360629,1816,3360629,17482,0
3727,JUND,chr19,R,18279693,18281656,3362592,1963,3362592,17483,0
3743,KCNA7,chr19,R,49067417,49072941,3368116,5524,3368116,17484,1
3748,KCNC3,chr19,R,50311941,50333515,3389690,21574,3389690,17485,7
3770,KCNJ14,chr19,F,48455706,48466110,3400094,10404,3400094,17486,2
3780,KCNN1,chr19,F,17951301,17999121,3447914,47820,3447914,17487,13
3783,KCNN4,chr19,R,43766532,43782139,3463521,15607,3463521,17488,9
3802,KIR2DL1,chr19,F,54769804,54784326,3478043,14522,3478043,17489,8
3804,KIR2DL3,chr19,F,54738508,54753052,3492587,14544,3492587,17490,7
3805,KIR2DL4,chr19,F,54803611,54814517,3503493,10906,3503493,17491,7
3809,KIR2DS4,chr19,F,54832675,54848569,3519387,15894,3519387,17492,7
3811,KIR3DL1,chr19,F,54816437,54830778,3533728,14341,3533728,17493,8
3812,KIR3DL2,chr19,F,54850442,54867215,3550501,16773,3550501,17494,8
3816,KLK1,chr19,R,50819145,50823787,3555143,4642,3555143,17495,5
3817,KLK2,chr19,F,50873432,50880567,3562278,7135,3562278,17496,4
3903,LAIR1,chr19,R,54353623,54370556,3579211,16933,3579211,17497,11
3904,LAIR2,chr19,F,54502796,54510690,3587105,7894,3587105,17498,4
3949,LDLR,chr19,F,11089361,11133830,3631574,44469,3631574,17499,17
3960,LGALS4,chr19,R,38801670,38813544,3643448,11874,3643448,17500,9
3963,LGALS7,chr19,R,38770967,38773517,3645998,2550,3645998,17501,3
3972,LHB,chr19,R,49015979,49017090,3647109,1111,3647109,17502,2
3978,LIG1,chr19,R,48115443,48170603,3702269,55160,3702269,17503,27
3982,LIM2,chr19,R,51379908,51387956,3710317,8048,3710317,17504,4
3991,LIPE,chr19,R,42401506,42427426,3736237,25920,3736237,17505,15
4037,LRP3,chr19,F,33194692,33208867,3750412,14175,3750412,17506,6
4051,CYP4F3,chr19,F,15640896,15660760,3770276,19864,3770276,17507,13
4059,BCAM,chr19,F,44809058,44821421,3782639,12363,3782639,17508,13
4066,LYL1,chr19,R,13097187,13103160,3788612,5973,3788612,17509,5
4099,MAG,chr19,F,35292085,35313807,3810334,21722,3810334,17510,12
4125,MAN2B1,chr19,R,12646507,12666777,3830604,20270,3830604,17511,23
4145,MATK,chr19,R,3777968,3801812,3854448,23844,3854448,17512,16
4207,MEF2BNB-MEF2B,chr19,R,19145566,19192591,3901473,47025,3901473,17513,12
4218,RAB8A,chr19,F,16111679,16133635,3923429,21956,3923429,17514,8
4294,MAP3K10,chr19,F,40191649,40215580,3947360,23931,3947360,17515,11
4298,MLLT1,chr19,R,6210380,6279948,4016928,69568,4016928,17516,13
4542,MYO1F,chr19,R,8520789,8577447,4073586,56658,4073586,17517,27
4606,MYBPC2,chr19,F,50432902,50466326,4107010,33424,4107010,17518,27
4616,GADD45B,chr19,F,2476124,2478259,4109145,2135,4109145,17519,3
4650,MYO9B,chr19,F,17075778,17215277,4248644,139499,4248644,17520,42
4670,HNRNPM,chr19,F,8444574,8489118,4293188,44544,4293188,17521,15
4680,CEACAM6,chr19,F,41755420,41772211,4309979,16791,4309979,17522,5
4696,NDUFA3,chr19,F,54102851,54106974,4314102,4123,4314102,17523,3
4701,NDUFA7,chr19,R,8308761,8321396,4326737,12635,4326737,17524,4
4713,NDUFB7,chr19,R,14566077,14572077,4332737,6000,4332737,17525,3
4782,NFIC,chr19,F,3359562,3469217,4442392,109655,4442392,17526,11
4784,NFIX,chr19,F,12995755,13098796,4545433,103041,4545433,17527,12
4793,NFKBIB,chr19,F,38899656,38908894,4554671,9238,4554671,17528,5
4818,NKG7,chr19,R,51371614,51372728,4555785,1114,4555785,17529,3
4849,CNOT3,chr19,F,54137688,54155708,4573805,18020,4573805,17530,19
4854,NOTCH3,chr19,R,15159632,15200981,4615154,41349,4615154,17531,32
4858,NOVA2,chr19,R,45933733,45973399,4654820,39666,4654820,17532,7
4861,NPAS1,chr19,F,47019819,47045775,4680776,25956,4680776,17533,13
4868,NPHS1,chr19,R,35825371,35851993,4707398,26622,4707398,17534,28
4902,NRTN,chr19,F,5805358,5828324,4730364,22966,4730364,17535,2
4909,NTF4,chr19,R,49061079,49065076,4734361,3997,4734361,17536,4
4924,NUCB1,chr19,F,48900049,48923283,4757595,23234,4757595,17537,12
4946,OAZ1,chr19,F,2269485,2273488,4761598,4003,4761598,17538,4
5032,P2RY11,chr19,F,10111520,10115389,4765467,3869,4765467,17539,12
5050,PAFAH1B3,chr19,R,42297032,42302800,4771235,5768,4771235,17540,4
5064,PALM,chr19,F,708952,748330,4810613,39378,4810613,17541,12
5141,PDE4A,chr19,F,10416772,10469631,4863472,52859,4863472,17542,21
5143,PDE4C,chr19,R,18207960,18248200,4903712,40240,4903712,17543,19
5178,PEG3,chr19,R,56810076,56840726,4934362,30650,4934362,17544,9
5184,PEPD,chr19,R,33386948,33521893,5069307,134945,5069307,17545,14
5296,PIK3R2,chr19,F,18153177,18170533,5086663,17356,5086663,17546,15
5300,PIN1,chr19,F,9835206,9849689,5101146,14483,5101146,17547,5
5329,PLAUR,chr19,R,43646094,43670346,5125398,24252,5125398,17548,8
5348,FXYD1,chr19,F,35138788,35143055,5129665,4267,5129665,17549,10
5349,FXYD3,chr19,F,35115815,35124324,5138174,8509,5138174,17550,10
5424,POLD1,chr19,F,50384289,50418018,5171903,33729,5171903,17551,28
5434,POLR2E,chr19,R,1086578,1095392,5180717,8814,5180717,17552,7
5438,POLR2I,chr19,R,36113708,36115304,5182313,1596,5182313,17553,5
5442,POLRMT,chr19,R,617222,633592,5198683,16370,5198683,17554,20
5452,POU2F2,chr19,R,42086109,42132473,5245047,46364,5245047,17555,13
5518,PPP2R1A,chr19,F,52189801,52226425,5281671,36624,5281671,17556,14
5536,PPP5C,chr19,F,46346993,46390975,5325653,43982,5325653,17557,12
5566,PRKACA,chr19,R,14091687,14117747,5351713,26060,5351713,17558,11
5582,PRKCG,chr19,F,53882212,53907652,5377153,25440,5377153,17559,18
5585,PKN1,chr19,F,14433052,14471867,5415968,38815,5415968,17560,24
5589,PRKCSH,chr19,F,11435256,11450968,5431680,15712,5431680,17561,17
5605,MAP2K2,chr19,R,4090320,4124184,5465544,33864,5465544,17562,11
5609,MAP2K7,chr19,F,7903779,7914483,5476248,10704,5476248,17563,11
5623,PSPN,chr19,R,6375293,6375849,5476804,556,5476804,17564,1
5639,PRRG2,chr19,F,49580616,49591008,5487196,10392,5487196,17565,7
5650,KLK7,chr19,R,50976478,50984064,5494782,7586,5494782,17566,6
5653,KLK6,chr19,R,50958630,50969673,5505825,11043,5505825,17567,6
5655,KLK10,chr19,R,51012743,51020175,5513257,7432,5513257,17568,8
5657,PRTN3,chr19,F,840964,848175,5520468,7211,5520468,17569,4
5669,PSG1,chr19,R,42866460,42879719,5533727,13259,5533727,17570,5
5670,PSG2,chr19,R,43064209,43082741,5552259,18532,5552259,17571,5
5671,PSG3,chr19,R,42721641,42740516,5571134,18875,5571134,17572,6
5672,PSG4,chr19,R,43192701,43205774,5584207,13073,5584207,17573,6
5673,PSG5,chr19,R,43032809,43186536,5737934,153727,5737934,17574,7
5675,PSG6,chr19,R,42902081,42917924,5753777,15843,5753777,17575,6
5676,PSG7,chr19,R,42924131,42937178,5766824,13047,5766824,17576,5
5678,PSG9,chr19,R,43253281,43269563,5783106,16282,5783106,17577,5
5680,PSG11,chr19,R,43007656,43026479,5801929,18823,5801929,17578,5
5704,PSMC4,chr19,F,39971004,39981764,5812689,10760,5812689,17579,10
5714,PSMD8,chr19,F,38374549,38383824,5821964,9275,5821964,17580,6
5725,PTBP1,chr19,F,797391,812327,5836900,14936,5836900,17581,15
5731,PTGER1,chr19,R,14472465,14475362,5839797,2897,5839797,17582,2
5739,PTGIR,chr19,R,46610039,46625118,5854876,15079,5854876,17583,4
5794,PTPRH,chr19,R,55181246,55209506,5883136,28260,5883136,17584,21
5802,PTPRS,chr19,R,5205502,5340803,6018437,135301,6018437,17585,39
5817,PVR,chr19,F,44643797,44666161,6040801,22364,6040801,17586,7
5819,PVRL2,chr19,F,44846135,44889228,6083894,43093,6083894,17587,9
5864,RAB3A,chr19,R,18196798,18204064,6091160,7266,6091160,17588,5
5886,RAD23A,chr19,F,12945813,12953643,6098990,7830,6098990,17589,8
5971,RELB,chr19,F,45001448,45038198,6135740,36750,6135740,17590,11
5976,UPF1,chr19,F,18831934,18868232,6172038,36298,6172038,17591,23
5989,RFX1,chr19,R,13961529,14007514,6218023,45985,6218023,17592,23
5990,RFX2,chr19,R,5993163,6110653,6335513,117490,6335513,17593,18
6141,RPL18,chr19,R,48615326,48619418,6339605,4092,6339605,17594,6
6142,RPL18A,chr19,F,17859877,17863324,6343052,3447,6343052,17595,4
6158,RPL28,chr19,F,55385100,55403245,6361197,18145,6361197,17596,5
6183,MRPS12,chr19,F,38930707,38933020,6363510,2313,6363510,17597,1
6193,RPS5,chr19,F,58387268,58394804,6371046,7536,6371046,17598,5
6203,RPS9,chr19,F,54200556,54207647,6378137,7091,6378137,17599,4
6205,RPS11,chr19,F,49496364,49499712,6381485,3348,6381485,17600,4
6209,RPS15,chr19,F,1438363,1440494,6383616,2131,6383616,17601,3
6217,RPS16,chr19,R,39433206,39436020,6386430,2814,6386430,17602,3
6223,RPS19,chr19,F,41859917,41871416,6397929,11499,6397929,17603,5
6234,RPS28,chr19,F,8321499,8322396,6398826,897,6398826,17604,3
6237,RRAS,chr19,R,49635294,49640143,6403675,4849,6403675,17605,5
6253,RTN2,chr19,R,45485287,45497055,6415443,11768,6415443,17606,10
6261,RYR1,chr19,F,38433699,38587564,6569308,153865,6569308,17607,105
6294,SAFB,chr19,F,5623034,5668478,6614752,45444,6614752,17608,20
6320,CLEC11A,chr19,F,50723347,50725724,6617129,2377,6617129,17609,3
6324,SCN1B,chr19,F,35030687,35040449,6626891,9762,6626891,17610,6
6370,CCL25,chr19,F,8052339,8062663,6637215,10324,6637215,17611,6
6415,SEPW1,chr19,F,47778584,47784682,6643313,6098,6643313,17612,5
6449,SGTA,chr19,R,2754712,2783356,6671957,28644,6671957,17613,12
6455,SH3GL1,chr19,R,4360366,4400568,6712159,40202,6712159,17614,10
6510,SLC1A5,chr19,R,46759697,46788649,6741111,28952,6741111,17615,10
6511,SLC1A6,chr19,R,14950032,15010643,6801722,60611,6801722,17616,13
6528,SLC5A5,chr19,F,17871410,17895174,6825486,23764,6825486,17617,15
6543,SLC8A2,chr19,R,47428016,47472050,6869520,44034,6869520,17618,9
6597,SMARCA4,chr19,F,10960921,11062282,6970881,101361,6970881,17619,37
6618,SNAPC2,chr19,F,7920308,7923251,6973824,2943,6973824,17620,5
6625,SNRNP70,chr19,F,49085139,49108613,6997298,23474,6997298,17621,12
6626,SNRPA,chr19,F,40750853,40765392,7011837,14539,7011837,17622,5
6633,SNRPD2,chr19,R,45687453,45692311,7016695,4858,7016695,17623,3
6689,SPIB,chr19,F,50418937,50431053,7028811,12116,7028811,17624,5
6794,STK11,chr19,F,1205798,1228435,7051448,22637,7051448,17625,12
6795,AURKC,chr19,F,57230359,57235550,7056639,5191,7056639,17626,6
6813,STXBP2,chr19,F,7637100,7647874,7067413,10774,7067413,17627,20
6820,SULT2B1,chr19,F,48552171,48599427,7114669,47256,7114669,17628,7
6822,SULT2A1,chr19,R,47870465,47886397,7130601,15932,7130601,17629,5
6829,SUPT5H,chr19,F,39445545,39476670,7161726,31125,7161726,17630,29
6861,SYT5,chr19,R,55173095,55180441,7169072,7346,7169072,17631,9
6915,TBXA2R,chr19,R,3594505,3606851,7181418,12346,7181418,17632,3
6929,TCF3,chr19,R,1609289,1652426,7224555,43137,7224555,17633,18
7001,PRDX2,chr19,R,12796819,12801910,7229646,5091,7229646,17634,5
7040,TGFB1,chr19,R,41330530,41353933,7253049,23403,7253049,17635,6
7064,THOP1,chr19,F,2785507,2813601,7281143,28094,7281143,17636,14
7087,ICAM5,chr19,F,10289434,10296778,7288487,7344,7288487,17637,11
7089,TLE2,chr19,R,2997637,3047635,7338485,49998,7338485,17638,22
7137,TNNI3,chr19,R,55151766,55157732,7344451,5966,7344451,17639,7
7138,TNNT1,chr19,R,55132697,55149354,7361108,16657,7361108,17640,14
7171,TPM4,chr19,F,16067506,16103005,7396607,35499,7396607,17641,13
7197,TRG-TCC1-1,chr19,F,4724069,4724141,7396679,72,7396679,17642,0
7234,TRU-TCA1-1,chr19,R,45478601,45478687,7396765,86,7396765,17643,0
7288,TULP2,chr19,R,48880821,48900184,7416128,19363,7416128,17644,14
7297,TYK2,chr19,R,10350527,10380572,7446173,30045,7446173,17645,28
7305,TYROBP,chr19,R,35904400,35908309,7450082,3909,7450082,17646,4
7311,UBA52,chr19,F,18563765,18577460,7463777,13695,7463777,17647,5
7376,NR1H2,chr19,F,50376422,50383028,7470383,6606,7470383,17648,9
7386,UQCRFS1,chr19,R,29207259,29213229,7476353,5970,7476353,17649,1
7392,USF2,chr19,F,35268992,35279815,7487176,10823,7487176,17650,10
7408,VASP,chr19,F,45507429,45526989,7506736,19560,7506736,17651,12
7409,VAV1,chr19,F,6772667,6857366,7591435,84699,7591435,17652,27
7515,XRCC1,chr19,R,43543311,43575578,7623702,32267,7623702,17653,16
7538,ZFP36,chr19,F,39406846,39409412,7626268,2566,7626268,17654,1
7554,ZNF8,chr19,F,58278951,58295888,7643205,16937,7643205,17655,3
7561,ZNF14,chr19,R,19710471,19733112,7665846,22641,7665846,17656,3
7562,ZNF708,chr19,R,21291159,21329439,7704126,38280,7704126,17657,4
7565,ZNF17,chr19,F,57411160,57421953,7714919,10793,7714919,17658,4
7568,ZNF20,chr19,R,12131349,12140407,7723977,9058,7723977,17659,3
7576,ZNF28,chr19,R,52797407,52821678,7748248,24271,7748248,17660,6
7593,MZF1,chr19,R,58561916,58574439,7760771,12523,7760771,17661,7
7594,ZNF43,chr19,R,21804948,21852068,7807891,47120,7807891,17662,10
7596,ZNF45,chr19,R,43912623,43935280,7830548,22657,7830548,17663,11
7620,ZNF69,chr19,F,11887785,11914551,7857314,26766,7857314,17664,5
7638,ZNF221,chr19,F,43951222,43967600,7873692,16378,7873692,17665,5
7639,ZNF85,chr19,F,20923220,20950697,7901169,27477,7901169,17666,7
7643,ZNF90,chr19,F,20077993,20121168,7944344,43175,7944344,17667,3
7644,ZNF91,chr19,R,23357695,23395560,7982209,37865,7982209,17668,3
7652,ZNF99,chr19,R,22752182,22784171,8014198,31989,8014198,17669,3
7673,ZNF222,chr19,F,44025331,44033110,8021977,7779,8021977,17670,4
7675,ZNF121,chr19,R,9565615,9584545,8040907,18930,8040907,17671,6
7691,ZNF132,chr19,R,58432806,58440222,8048323,7416,8048323,17672,3
7693,ZNF134,chr19,F,57614461,57622268,8056130,7807,8056130,17673,2
7694,ZNF135,chr19,F,58059238,58069755,8066647,10517,8066647,17674,5
7695,ZNF136,chr19,F,12163056,12189249,8092840,26193,8092840,17675,4
7696,ZNF137P,chr19,F,52596683,52600152,8096309,3469,8096309,17676,2
7705,ZNF146,chr19,F,36214601,36238774,8120482,24173,8120482,17677,3
7710,ZNF154,chr19,R,57696274,57709211,8133419,12937,8133419,17678,2
7711,ZNF155,chr19,F,43967702,43998326,8164043,30624,8164043,17679,6
7728,ZNF175,chr19,F,51571277,51592510,8185276,21233,8185276,17680,4
7730,ZNF177,chr19,F,9363019,9382617,8204874,19598,8204874,17681,12
7733,ZNF180,chr19,R,44474427,44501750,8232197,27323,8232197,17682,9
7757,ZNF208,chr19,R,21966094,22010943,8277046,44849,8277046,17683,3
7766,ZNF223,chr19,F,44052010,44067994,8293030,15984,8293030,17684,4
7767,ZNF224,chr19,F,44094328,44109831,8308533,15503,8308533,17685,5
7768,ZNF225,chr19,F,44112075,44134816,8331274,22741,8331274,17686,8
7769,ZNF226,chr19,F,44165061,44177685,8343898,12624,8343898,17687,8
7770,ZNF227,chr19,F,44207546,44237268,8373620,29722,8373620,17688,7
7771,ZNF112,chr19,R,44326552,44356704,8403772,30152,8403772,17689,4
7772,ZNF229,chr19,R,44426250,44448725,8426247,22475,8426247,17690,5
7773,ZNF230,chr19,F,44002924,44013926,8437249,11002,8437249,17691,4
8174,MADCAM1,chr19,F,496489,505343,8446103,8854,8446103,17692,4
8175,SF3A2,chr19,F,2236816,2248679,8457966,11863,8457966,17693,8
8178,ELL,chr19,R,18442662,18522129,8537433,79467,8537433,17694,13
8189,SYMPK,chr19,R,45815441,45863290,8585282,47849,8585282,17695,28
8190,MIA,chr19,F,40775176,40777493,8587599,2317,8587599,17696,4
8192,CLPP,chr19,F,6361451,6368904,8595052,7453,8595052,17697,5
8193,DPF1,chr19,R,38211005,38229714,8613761,18709,8613761,17698,13
8425,LTBP4,chr19,F,40592887,40629820,8650694,36933,8650694,17699,34
8463,TEAD2,chr19,R,49340594,49362457,8672557,21863,8672557,17700,16
8498,RANBP3,chr19,R,5916138,5978309,8734728,62171,8734728,17701,18
8529,CYP4F2,chr19,R,15878023,15898120,8754825,20097,8754825,17702,12
8541,PPFIA3,chr19,F,49119388,49151030,8786467,31642,8786467,17703,29
8570,KHSRP,chr19,R,6413103,6424811,8798175,11708,8798175,17704,18
8605,PLA2G4C,chr19,R,48047842,48110853,8861186,63011,8861186,17705,19
8612,PPAP2C,chr19,R,281039,291435,8871582,10396,8871582,17706,6
8625,RFXANK,chr19,F,19192198,19201869,8881253,9671,8881253,17707,11
8666,EIF3G,chr19,R,10115013,10119923,8886163,4910,8886163,17708,10
8677,STX10,chr19,R,13144057,13151334,8893440,7277,8893440,17709,7
8698,S1PR4,chr19,F,3178737,3180332,8895035,1595,8895035,17710,0
8725,URI1,chr19,F,29923643,30016612,8988004,92969,8988004,17711,11
8740,TNFSF14,chr19,R,6658134,6670588,9000458,12454,9000458,17712,5
8744,TNFSF9,chr19,F,6528561,6535928,9007825,7367,9007825,17713,3
8775,NAPA,chr19,R,47487633,47515258,9035450,27625,9035450,17714,11
8778,SIGLEC5,chr19,R,51610956,51630474,9054968,19518,9054968,17715,8
8857,FCGBP,chr19,R,39863322,39934626,9126272,71304,9126272,17716,31
8907,AP1M1,chr19,F,16197853,16235345,9163764,37492,9163764,17717,14
8943,AP3D1,chr19,R,2100987,2151620,9214397,50633,9214397,17718,31
8993,PGLYRP1,chr19,R,46019152,46023298,9218543,4146,9218543,17719,2
9002,F2RL3,chr19,F,16889014,16892019,9221548,3005,9221548,17720,1
9040,UBE2M,chr19,R,58555711,58558976,9224813,3265,9224813,17721,5
9138,ARHGEF1,chr19,F,41883172,41907454,9249095,24282,9249095,17722,31
9141,PDCD5,chr19,F,32581169,32587452,9255378,6283,9255378,17723,5
9149,DYRK1B,chr19,R,39825346,39834233,9264265,8887,9264265,17724,12
9170,LPAR2,chr19,R,19623654,19628930,9269541,5276,9269541,17725,4
9230,RAB11B,chr19,F,8390320,8404434,9283655,14114,9283655,17726,4
9244,CRLF1,chr19,R,18593224,18606850,9297281,13626,9297281,17727,10
9253,NUMBL,chr19,R,40665904,40691675,9323052,25771,9323052,17728,12
9266,CYTH2,chr19,F,48469207,48482314,9336159,13107,9336159,17729,12
9294,S1PR2,chr19,R,10221432,10231807,9346534,10375,9346534,17730,1
9310,ZNF235,chr19,R,44286347,44305707,9365894,19360,9365894,17731,4
9322,TRIP10,chr19,F,6739681,6751526,9377739,11845,9377739,17732,15
9361,LONP1,chr19,R,5691833,5720452,9406358,28619,9406358,17733,18
9422,ZNF264,chr19,F,57191478,57222846,9437726,31368,9437726,17734,6
9424,KCNK6,chr19,F,38319813,38329014,9446927,9201,9446927,17735,4
9437,NCR1,chr19,F,54905991,54938208,9479144,32217,9479144,17736,8
9441,MED26,chr19,R,16574906,16628204,9532442,53298,9532442,17737,2
9454,HOMER3,chr19,R,18929200,18941258,9544500,12058,9544500,17738,11
9466,IL27RA,chr19,F,14031739,14052919,9565680,21180,9565680,17739,13
9476,NAPSA,chr19,R,50358471,50369331,9576540,10860,9576540,17740,9
9518,GDF15,chr19,F,18386157,18389176,9579559,3019,9579559,17741,1
9524,TECR,chr19,F,14527767,14565980,9617772,38213,9617772,17742,14
9534,ZNF254,chr19,F,24033404,24129968,9714336,96564,9714336,17743,12
9535,GMFG,chr19,R,39328356,39336086,9722066,7730,9722066,17744,6
9545,RAB3D,chr19,R,11322045,11339668,9739689,17623,9739689,17745,4
9546,APBA3,chr19,R,3750772,3761698,9750615,10926,9750615,17746,9
9592,IER2,chr19,F,13150467,13154908,9755056,4441,9755056,17747,1
9622,KLK4,chr19,R,50906351,50910749,9759454,4398,9759454,17748,5
9667,SAFB2,chr19,R,5586992,5622927,9795389,35935,9795389,17749,21
9668,ZNF432,chr19,R,52031377,52048820,9812832,17443,9812832,17750,5
9704,DHX34,chr19,F,47349280,47382704,9846256,33424,9846256,17751,20
9710,KIAA0355,chr19,F,34254550,34355566,9947272,101016,9947272,17752,14
9745,ZNF536,chr19,F,30225043,30713538,10435767,488495,10435767,17753,12
9757,KMT2B,chr19,F,35717994,35738880,10456653,20886,10456653,17754,37
9817,KEAP1,chr19,R,10486119,10503378,10473912,17259,10473912,17755,8
10025,MED16,chr19,R,867961,893218,10499169,25257,10499169,17756,16
10036,CHAF1A,chr19,F,4402611,4448308,10544866,45697,10544866,17757,17
10045,SH2D3A,chr19,R,6752159,6767512,10560219,15353,10560219,17758,9
10053,AP1M2,chr19,R,10572670,10587315,10574864,14645,10574864,17759,12
10054,UBA2,chr19,F,34428175,34469893,10616582,41718,10616582,17760,17
10055,SAE1,chr19,F,47130822,47210636,10696396,79814,10696396,17761,11
10147,SUGP2,chr19,R,18990887,19033571,10739080,42684,10739080,17762,12
10148,EBI3,chr19,F,4229301,4237542,10747321,8241,10747321,17763,5
10155,TRIM28,chr19,F,58544468,58550715,10753568,6247,10753568,17764,16
10172,ZNF256,chr19,R,57940832,57947747,10760483,6915,10760483,17765,2
10212,DDX39A,chr19,R,14408797,14419383,10771069,10586,10771069,17766,12
10224,ZNF443,chr19,R,12429705,12457521,10798885,27816,10798885,17767,5
10226,PLIN3,chr19,R,4838333,4867768,10828320,29435,10828320,17768,7
10270,AKAP8,chr19,R,15353520,15379828,10854628,26308,10854628,17769,14
10272,FSTL3,chr19,F,676388,683392,10861632,7004,10861632,17770,4
10288,LILRB2,chr19,R,54273811,54281178,10868999,7367,10868999,17771,15
10297,APC2,chr19,F,1446267,1473244,10895976,26977,10895976,17772,16
10298,PAK4,chr19,F,39125779,39179406,10949603,53627,10949603,17773,13
10331,B3GNT3,chr19,F,17794827,17813576,10968352,18749,10968352,17774,4
10332,CLEC4M,chr19,F,7763053,7770558,10975857,7505,10975857,17775,6
10347,ABCA7,chr19,F,1040102,1065572,11001327,25470,11001327,17776,46
10362,HMG20B,chr19,F,3572944,3579083,11007466,6139,11007466,17777,9
10365,KLF2,chr19,F,16324839,16327534,11010161,2695,11010161,17778,2
10382,TUBB4A,chr19,R,6494318,6502848,11018691,8530,11018691,17779,4
10430,TMEM147,chr19,F,35545599,35547527,11020619,1928,11020619,17780,5
10437,IFI30,chr19,F,18173779,18178124,11024964,4345,11024964,17781,6
10452,TOMM40,chr19,F,44891219,44903689,11037434,12470,11037434,17782,9
10469,TIMM44,chr19,R,7926717,7943823,11054540,17106,11054540,17783,12
10498,CARM1,chr19,F,10871576,10922775,11105739,51199,11105739,17784,17
10501,SEMA6B,chr19,R,4542586,4581602,11144755,39016,11144755,17785,17
10520,ZNF211,chr19,F,57633166,57642779,11154368,9613,11154368,17786,5
10523,CHERP,chr19,R,16517888,16542452,11178932,24564,11178932,17787,16
10535,RNASEH2A,chr19,F,12802053,12813648,11190527,11595,11190527,17788,9
10567,RABAC1,chr19,R,41956680,41959376,11193223,2696,11193223,17789,4
10597,TRAPPC2B,chr19,F,57363510,57365353,11195066,1843,11195066,17790,1
10653,SPINT2,chr19,F,38264457,38292614,11223223,28157,11223223,17791,6
10661,KLF1,chr19,R,12884421,12887203,11226005,2782,11226005,17792,2
10683,DLL3,chr19,F,39498916,39508481,11235570,9565,11235570,17793,7
10715,CERS1,chr19,R,18868545,18896727,11263752,28182,11263752,17794,8
10755,GIPC1,chr19,R,14477758,14496149,11282143,18391,11282143,17795,8
10775,POP4,chr19,F,29606262,29617255,11293136,10993,11293136,17796,6
10780,ZNF234,chr19,F,44141529,44160309,11311916,18780,11311916,17797,6
10781,ZNF266,chr19,R,9412425,9435578,11335069,23153,11335069,17798,9
10782,ZNF274,chr19,F,58182988,58213562,11365643,30574,11365643,17799,7
10794,ZNF460,chr19,F,57279407,57294075,11380311,14668,11380311,17800,3
10848,PPP1R13L,chr19,R,45379633,45406349,11407027,26716,11407027,17801,13
10849,CD3EAP,chr19,F,45406208,45410766,11411585,4558,11411585,17802,2
10856,RUVBL2,chr19,F,48993352,49015926,11434159,22574,11434159,17803,15
10859,LILRB1,chr19,F,54616929,54638167,11455397,21238,11455397,17804,15
10870,HCST,chr19,F,35902479,35904271,11457189,1792,11457189,17805,3
10908,PNPLA6,chr19,F,7534151,7561767,11484805,27616,11484805,17806,36
10945,KDELR1,chr19,R,48382569,48397689,11499925,15120,11499925,17807,6
10975,UQCR11,chr19,R,1597154,1605484,11508255,8330,11508255,17808,2
10990,LILRB5,chr19,R,54250404,54257308,11515159,6904,11515159,17809,12
10994,ILVBL,chr19,R,15114973,15125799,11525985,10826,11525985,17810,16
10998,SLC27A5,chr19,R,58498332,58512065,11539718,13733,11539718,17811,9
11006,LILRB4,chr19,F,54643834,54670359,11566243,26525,11566243,17812,12
11012,KLK11,chr19,R,51022230,51028034,11572047,5804,11572047,17813,9
11018,TMED1,chr19,R,10832066,10836307,11576288,4241,11576288,17814,5
11024,LILRA1,chr19,F,54593575,54602724,11585437,9149,11585437,17815,10
11025,LILRB3,chr19,R,54216277,54223087,11592247,6810,11592247,17816,13
11027,LILRA2,chr19,F,54572996,54587560,11606811,14564,11606811,17817,9
11045,UPK1A,chr19,F,35666515,35678485,11618781,11970,11618781,17818,8
11100,HNRNPUL1,chr19,F,41262475,41307693,11663999,45218,11663999,17819,16
11129,CLASRP,chr19,F,45039039,45070956,11695916,31917,11695916,17820,20
11133,KPTN,chr19,R,47475140,47486791,11707567,11651,11707567,17821,15
11136,SLC7A9,chr19,R,32830510,32870167,11747224,39657,11747224,17822,12
11140,CDC37,chr19,R,10391130,10403595,11759689,12465,11759689,17823,7
11184,MAP4K1,chr19,R,38587639,38618035,11790085,30396,11790085,17824,32
11202,KLK8,chr19,R,50996007,51001702,11795780,5695,11795780,17825,5
11283,CYP4F8,chr19,F,15615217,15631867,11812430,16650,11812430,17826,12
11284,PNKP,chr19,R,49861202,49867565,11818793,6363,11818793,17827,16
11316,COPE,chr19,R,18899513,18919464,11838744,19951,11838744,17828,10
11338,U2AF2,chr19,F,55654049,55674716,11859411,20667,11859411,17829,13
22809,ATF5,chr19,F,49928701,49933936,11864646,5235,11864646,17830,4
22835,ZFP30,chr19,R,37632486,37657285,11889445,24799,11889445,17831,6
22847,ZNF507,chr19,F,32345607,32387667,11931505,42060,11931505,17832,6
22859,ADGRL1,chr19,R,14147736,14206248,11990017,58512,11990017,17833,26
22870,PPP6R1,chr19,R,55229778,55258670,12018909,28892,12018909,17834,23
22900,CARD8,chr19,R,48190370,48256277,12084816,65907,12084816,17835,25
22904,SBNO2,chr19,R,1107633,1174283,12151466,66650,12151466,17836,35
22933,SIRT2,chr19,R,38878554,38899862,12172774,21308,12172774,17837,17
22952,CYP2G1P,chr19,F,40890825,40900508,12182457,9683,12182457,17838,4
22983,MAST1,chr19,F,12833933,12874953,12223477,41020,12223477,17839,29
23025,UNC13A,chr19,R,17601327,17688353,12310503,87026,12310503,17840,45
23030,KDM4B,chr19,F,4969111,5153598,12494990,184487,12494990,17841,31
23031,MAST3,chr19,F,18097763,18151692,12548919,53929,12548919,17842,32
23094,SIPA1L3,chr19,F,37907220,38208372,12850071,301152,12850071,17843,24
23149,FCHO1,chr19,F,17747717,17788568,12890922,40851,12890922,17844,29
23152,CIC,chr19,F,42268536,42295796,12918182,27260,12918182,17845,22
23211,ZC3H4,chr19,R,47064186,47113752,12967748,49566,12967748,17846,20
23217,ZFR2,chr19,R,3804023,3869029,13032754,65006,13032754,17847,21
23309,SIN3B,chr19,F,16829386,16880355,13083723,50969,13083723,17848,19
23354,HAUS5,chr19,F,35612743,35625349,13096329,12606,13096329,17849,18
23370,ARHGEF18,chr19,F,7348910,7476990,13224409,128080,13224409,17850,34
23373,CRTC1,chr19,F,18683614,18782333,13323128,98719,13323128,17851,14
23383,MAU2,chr19,F,19320816,19358754,13361066,37938,13361066,17852,19
23396,PIP5K1C,chr19,R,3630180,3700492,13431378,70312,13431378,17853,23
23403,FBXO46,chr19,R,45710628,45730893,13451643,20265,13451643,17854,1
23474,ETHE1,chr19,R,43506718,43527244,13472169,20526,13472169,17855,6
23476,BRD4,chr19,R,15236835,15332543,13567877,95708,13567877,17856,22
23521,RPL13A,chr19,F,49487553,49492308,13572632,4755,13572632,17857,7
23526,HMHA1,chr19,F,1065922,1087831,13594541,21909,13594541,17858,25
23546,SYNGR4,chr19,F,48364280,48376377,13606638,12097,13606638,17859,6
23547,LILRA4,chr19,R,54333184,54339169,13612623,5985,13612623,17860,7
23574,PRG1,chr19,F,43349055,43349548,13613116,493,13613116,17861,0
23581,CASP14,chr19,F,15049479,15058293,13621930,8814,13621930,17862,6
23619,ZIM2,chr19,R,56774546,56840729,13688113,66183,13688113,17863,11
23624,CBLC,chr19,F,44777860,44800646,13710899,22786,13710899,17864,12
23636,NUP62,chr19,R,49906824,49929731,13733806,22907,13733806,17865,2
23640,HSPBP1,chr19,R,55262221,55280383,13751968,18162,13751968,17866,7
23645,PPP1R15A,chr19,F,48872391,48876062,13755639,3671,13755639,17867,2
23646,PLD3,chr19,F,40348424,40378490,13785705,30066,13785705,17868,13
23770,FKBP8,chr19,R,18531757,18544077,13798025,12320,13798025,17869,9
24139,EML2,chr19,R,45609399,45645601,13834227,36202,13834227,17870,26
25759,SHC2,chr19,R,416582,461024,13878669,44442,13878669,17871,15
25789,TMEM59L,chr19,F,18607434,18621039,13892274,13605,13892274,17872,8
25796,PGLS,chr19,F,17511622,17521288,13901940,9666,13901940,17873,5
25799,ZNF324,chr19,F,58467044,58473578,13908474,6534,13908474,17874,4
25804,LSM4,chr19,R,18306229,18323191,13925436,16962,13925436,17875,4
25818,KLK5,chr19,R,50943298,50953088,13935226,9790,13935226,17876,5
25850,ZNF345,chr19,F,36850357,36893218,13978087,42861,13978087,17877,8
25865,PRKD2,chr19,R,46674315,46717127,14020899,42812,14020899,17878,17
25873,RPL36,chr19,F,5690260,5691667,14022306,1407,14022306,17879,3
25888,ZNF473,chr19,F,50025382,50048776,14045700,23394,14045700,17880,4
25959,KANK2,chr19,R,11164266,11197567,14079001,33301,14079001,17881,12
25999,CLIP3,chr19,R,36014659,36032895,14097237,18236,14097237,17882,13
26017,FAM32A,chr19,F,16185183,16192046,14104100,6863,14104100,17883,3
26065,LSM14A,chr19,F,34172446,34229515,14161169,57069,14161169,17884,10
26085,KLK13,chr19,R,51056205,51065110,14170074,8905,14170074,17885,4
26093,CCDC9,chr19,F,47256473,47271953,14185554,15480,14185554,17886,11
26121,PRPF31,chr19,F,54115375,54131719,14201898,16344,14201898,17887,13
26145,IRF2BP1,chr19,R,45883606,45886170,14204462,2564,14204462,17888,0
26291,FGF21,chr19,F,48755558,48758330,14207234,2772,14207234,17889,3
26330,GAPDHS,chr19,F,35533411,35545319,14219142,11908,14219142,17890,10
26333,OR7A17,chr19,R,14880425,14881355,14220072,930,14220072,17891,0
26517,TIMM13,chr19,R,2425623,2427916,14222365,2293,14222365,17892,2
26526,TSPAN16,chr19,F,11296138,11326996,14253223,30858,14253223,17893,8
26528,DAZAP1,chr19,F,1407568,1435687,14281342,28119,14281342,17894,14
26532,OR10H3,chr19,F,15741392,15742343,14282293,951,14282293,17895,0
26538,OR10H2,chr19,F,15728023,15729052,14283322,1029,14283322,17896,0
26539,OR10H1,chr19,R,15806956,15808759,14285125,1803,14285125,17897,1
26648,OR7E24,chr19,F,9251043,9252063,14286145,1020,14286145,17898,0
26658,OR7C2,chr19,F,14941488,14942448,14287105,960,14287105,17899,0
26659,OR7A5,chr19,R,14825741,14833245,14294609,7504,14294609,17900,2
26664,OR7C1,chr19,R,14797567,14835376,14332418,37809,14332418,17901,4
26780,SNORA68,chr19,F,17862587,17862720,14332551,133,14332551,17902,0
26810,SNORD41,chr19,R,12706448,12706518,14332621,70,14332621,17903,0
26812,SNORD37,chr19,R,3982506,3982572,14332687,66,14332687,17904,0
26816,SNORD35A,chr19,F,49491174,49491260,14332773,86,14332773,17905,0
26817,SNORD34,chr19,F,49490906,49490972,14332839,66,14332839,17906,0
26818,SNORD33,chr19,F,49490616,49490699,14332922,83,14332922,17907,0
26819,SNORD32A,chr19,F,49489965,49490047,14333004,82,14333004,17908,0
26974,ZNF285,chr19,R,44385645,44401611,14348970,15966,14348970,17909,4
26993,AKAP8L,chr19,R,15380047,15419121,14388044,39074,14388044,17910,15
27006,FGF22,chr19,F,639894,643703,14391853,3809,14391853,17911,2
27033,ZBTB32,chr19,F,35704491,35717048,14404410,12557,14404410,17912,7
27036,SIGLEC7,chr19,F,51142293,51153526,14415643,11233,14415643,17913,6
27076,LYPD3,chr19,R,43460793,43465679,14420529,4886,14420529,17914,4
27106,ARRDC2,chr19,F,18001131,18014102,14433500,12971,14433500,17915,8
27113,BBC3,chr19,R,47220821,47232996,14445675,12175,14445675,17916,6
27120,DKKL1,chr19,F,49360494,49375119,14460300,14625,14460300,17917,9
27134,TJP3,chr19,F,3708336,3750813,14502777,42477,14502777,17918,21
27151,CPAMD8,chr19,R,16892950,17026818,14636645,133868,14636645,17919,42
27180,SIGLEC9,chr19,F,51124879,51141020,14652786,16141,14652786,17920,12
27181,SIGLEC8,chr19,R,51450996,51458454,14660244,7458,14660244,17921,6
27202,C5AR2,chr19,F,47331840,47342080,14670484,10240,14670484,17922,4
27231,NMRK2,chr19,F,3933102,3942416,14679798,9314,14679798,17923,7
27243,CHMP2A,chr19,R,58551565,58555128,14683361,3563,14683361,17924,4
27294,DHDH,chr19,F,48933638,48944969,14694692,11331,14694692,17925,6
27300,ZNF544,chr19,F,58227782,58263644,14730554,35862,14730554,17926,9
27335,EIF3K,chr19,F,38618418,38636959,14749095,18541,14749095,17927,7
27338,UBE2S,chr19,R,55401281,55408146,14755960,6865,14755960,17928,5
28968,SLC6A16,chr19,R,49289631,49331701,14798030,42070,14798030,17929,14
28974,C19orf53,chr19,F,13774442,13778773,14802361,4331,14802361,17930,2
29086,BABAM1,chr19,F,17267375,17279353,14814339,11978,14814339,17931,8
29124,LGALS13,chr19,F,39602358,39607474,14819455,5116,14819455,17932,3
29128,UHRF1,chr19,F,4903079,4962154,14878530,59075,14878530,17933,18
29785,CYP2S1,chr19,F,41193206,41207539,14892863,14333,14892863,17934,8
29844,TFPT,chr19,R,54107012,54115675,14901526,8663,14901526,17935,6
29888,STRN4,chr19,R,46719508,46746475,14928493,26967,14928493,17936,21
29903,CCDC106,chr19,F,55647567,55653161,14934087,5594,14934087,17937,5
29911,HOOK2,chr19,R,12763002,12778484,14949569,15482,14949569,17938,24
29924,EPN1,chr19,F,55675194,55695767,14970142,20573,14970142,17939,12
29946,SERTAD3,chr19,R,40440840,40444375,14973677,3535,14973677,17940,3
29950,SERTAD1,chr19,R,40422500,40426025,14977202,3525,14977202,17941,1
29985,SLC39A3,chr19,R,2732523,2740076,14984755,7553,14984755,17942,2
29997,GLTSCR2,chr19,F,47745535,47757066,14996286,11531,14996286,17943,12
29998,GLTSCR1,chr19,F,47608195,47703277,15091368,95082,15091368,17944,16
30000,TNPO2,chr19,R,12699193,12723996,15116171,24803,15116171,17945,27
30817,ADGRE2,chr19,R,14724169,14778541,15170543,54372,15170543,17946,24
30835,CD209,chr19,R,7739987,7747605,15178161,7618,15178161,17947,5
30846,EHD2,chr19,F,47713343,47743134,15207952,29791,15207952,17948,5
43847,KLK14,chr19,R,51077878,51086458,15216532,8580,15216532,17949,8
43849,KLK12,chr19,R,51028959,51035652,15223225,6693,15223225,17950,5
50509,COL5A3,chr19,R,9959560,10010538,15274203,50978,15274203,17951,66
50700,RDH8,chr19,F,10013248,10022278,15283233,9030,15283233,17952,5
50944,SHANK1,chr19,R,50659263,50719783,15343753,60520,15343753,17953,24
51070,NOSIP,chr19,R,49555467,49580601,15368887,25134,15368887,17954,11
51073,MRPL4,chr19,F,10251963,10260060,15376984,8097,15376984,17955,7
51079,NDUFA13,chr19,F,19516209,19528204,15388979,11995,15388979,17956,4
51129,ANGPTL4,chr19,F,8364126,8374375,15399228,10249,15399228,17957,6
51157,ZNF580,chr19,F,55634902,55643470,15407796,8568,15407796,17958,3
51171,HSD17B14,chr19,R,48813016,48836703,15431483,23687,15431483,17959,8
51206,GP6,chr19,R,55013704,55038264,15456043,24560,15456043,17960,7
51231,VRK3,chr19,R,49976466,50026017,15505594,49551,15505594,17961,16
51257,MARCH2,chr19,F,8413271,8439017,15531340,25746,15531340,17962,5
51276,ZNF571,chr19,R,37564252,37594792,15561880,30540,15561880,17963,3
51291,GMIP,chr19,R,19629472,19643667,15576075,14195,15576075,17964,20
51293,CD320,chr19,R,8302126,8308356,15582305,6230,15582305,17965,4
51295,ECSIT,chr19,R,11505915,11529172,15605562,23257,15605562,17966,8
51298,THEG,chr19,R,362056,376703,15620209,14647,15620209,17967,9
51341,ZBTB7A,chr19,R,4043302,4066818,15643725,23516,15643725,17968,5
51343,FZR1,chr19,F,3506064,3538539,15676200,32475,15676200,17969,15
51398,WDR83OS,chr19,R,12668066,12669651,15677785,1585,15677785,17970,3
51477,ISYNA1,chr19,R,18434387,18438301,15681699,3914,15681699,17971,8
51545,ZNF581,chr19,F,55643619,55645623,15683703,2004,15683703,17972,2
51548,SIRT6,chr19,R,4174108,4182599,15692194,8491,15692194,17973,7
51588,PIAS4,chr19,F,4007597,4039386,15723983,31789,15723983,17974,11
51599,LSR,chr19,F,35248655,35267964,15743292,19309,15743292,17975,9
51690,LSM7,chr19,R,2321520,2328615,15750387,7095,15750387,17976,4
51710,ZNF44,chr19,R,12247243,12294899,15798043,47656,15798043,17977,9
53345,TM6SF2,chr19,R,19264364,19273265,15806944,8901,15806944,17978,9
53615,MBD3,chr19,R,1576670,1592761,15823035,16091,15823035,17979,6
53635,PTOV1,chr19,F,49848843,49860742,15834934,11899,15834934,17980,14
53637,S1PR5,chr19,R,10512741,10517992,15840185,5251,15840185,17981,2
53822,FXYD7,chr19,F,35143249,35154302,15851238,11053,15851238,17982,5
53827,FXYD5,chr19,F,35154715,35169885,15866408,15170,15866408,17983,7
53916,RAB4B,chr19,F,40778218,40796944,15885134,18726,15885134,17984,9
54531,MIER2,chr19,R,305572,344793,15924355,39221,15924355,17985,18
54555,DDX49,chr19,F,18919674,18928633,15933314,8959,15933314,17986,13
54623,PAF1,chr19,R,39385628,39391195,15938881,5567,15938881,17987,14
54760,PCSK4,chr19,R,1481427,1490888,15948342,9461,15948342,17988,16
54776,PPP1R12C,chr19,R,55090912,55117600,15975030,26688,15975030,17989,21
54795,TRPM4,chr19,F,49157758,49211841,16029113,54083,16029113,17990,24
54807,ZNF586,chr19,F,57769651,57780616,16040078,10965,16040078,17991,3
54811,ZNF562,chr19,R,9648653,9675302,16066727,26649,16066727,17992,6
54814,QPCTL,chr19,F,45692380,45703990,16078337,11610,16078337,17993,6
54815,GATAD2A,chr19,F,19385832,19508932,16201437,123100,16201437,17994,17
54831,BEST2,chr19,F,12751675,12758458,16208220,6783,16208220,17995,9
54850,FBXL12,chr19,R,9810266,9819425,16217379,9159,16217379,17996,5
54854,FAM83E,chr19,R,48600599,48614841,16231621,14242,16231621,17997,5
54858,PGPEP1,chr19,F,18340581,18369953,16260993,29372,16260993,17998,6
54862,CC2D1A,chr19,F,13906142,13930880,16285731,24738,16285731,17999,28
54869,EPS8L1,chr19,F,55075852,55087923,16297802,12071,16297802,18000,21
54922,RASIP1,chr19,R,48720584,48740813,16318031,20229,16318031,18001,12
54929,TMEM161A,chr19,R,19119615,19138554,16336970,18939,16336970,18002,12
54938,SARS2,chr19,R,38915263,38930896,16352603,15633,16352603,18003,16
54958,TMEM160,chr19,R,47045908,47048784,16355479,2876,16355479,18004,3
55009,C19orf24,chr19,F,1275520,1279244,16359203,3724,16359203,18005,2
55011,PIH1D1,chr19,R,49446292,49452028,16364939,5736,16364939,18006,8
55049,C19orf60,chr19,F,18588684,18592337,16368592,3653,16368592,18007,4
55094,GPATCH1,chr19,F,33080879,33130412,16418125,49533,16418125,18008,20
55095,SAMD4B,chr19,F,39342458,39390760,16466427,48302,16466427,18009,17
55101,ATP5SL,chr19,R,41431317,41447827,16482937,16510,16482937,18010,7
55111,PLEKHJ1,chr19,R,2229951,2237405,16490391,7454,16490391,18011,7
55150,C19orf73,chr19,R,49118396,49119140,16491135,744,16491135,18012,0
55201,MAP1S,chr19,F,17719493,17734515,16506157,15022,16506157,18013,7
55228,PNMAL1,chr19,R,46466490,46471563,16511230,5073,16511230,18014,2
55260,TMEM143,chr19,R,48332355,48364237,16543112,31882,16543112,18015,7
55295,KLHL26,chr19,F,18637027,18670492,16576577,33465,16576577,18016,2
55311,ZNF444,chr19,F,56140950,56160893,16596520,19943,16596520,18017,8
55337,C19orf66,chr19,F,10086118,10093252,16603654,7134,16603654,18018,9
55422,ZNF331,chr19,F,53503879,53580269,16680044,76390,16680044,18019,17
55527,FEM1A,chr19,F,4791715,4795559,16683888,3844,16683888,18020,0
55552,ZNF823,chr19,R,11721264,11739009,16701633,17745,16701633,18021,3
55554,KLK15,chr19,R,50825288,50836035,16712380,10747,16712380,18022,7
55588,MED29,chr19,F,39391322,39400563,16721621,9241,16721621,18023,3
55620,STAP2,chr19,R,4324042,4338877,16736456,14835,16736456,18024,12
55621,TRMT1,chr19,R,13104899,13117567,16749124,12668,16749124,18025,17
55643,BTBD2,chr19,R,1985437,2015703,16779390,30266,16779390,18026,10
55655,NLRP2,chr19,F,54965283,55001142,16815249,35859,16815249,18027,13
55658,RNF126,chr19,R,647525,663313,16831037,15788,16831037,18028,8
55659,ZNF416,chr19,R,57571009,57579180,16839208,8171,16839208,18029,4
55663,ZNF446,chr19,F,58474542,58489533,16854199,14991,16854199,18030,7
55702,CCDC94,chr19,F,4247113,4269088,16876174,21975,16876174,18031,7
55723,ASF1B,chr19,R,14119508,14136628,16893294,17120,16893294,18032,3
55762,ZNF701,chr19,F,52570272,52587174,16910196,16902,16910196,18033,5
55769,ZNF83,chr19,R,52612363,52690581,16988414,78218,16988414,18034,12
55786,ZNF415,chr19,R,53107878,53133077,17013613,25199,17013613,18035,8
55850,USE1,chr19,F,17215345,17219829,17018097,4484,17018097,18036,7
55851,PSENEN,chr19,F,35745576,35747155,17019676,1579,17019676,18037,3
55900,ZNF302,chr19,F,34677638,34686397,17028435,8759,17028435,18038,4
55908,C19orf80,chr19,F,11239618,11241943,17030760,2325,17030760,18039,3
55957,LIN37,chr19,F,35748360,35754519,17036919,6159,17036919,18040,8
56005,MYDGF,chr19,R,4657544,4670403,17049778,12859,17049778,18041,5
56006,SMG9,chr19,R,43727991,43754990,17076777,26999,17076777,18042,14
56242,ZNF253,chr19,F,19865829,19894449,17105397,28620,17105397,18043,3
56269,IRGC,chr19,F,43716057,43720036,17109376,3979,17109376,18044,2
56301,SLC7A10,chr19,R,33208663,33225850,17126563,17187,17126563,18045,8
56342,PPAN,chr19,F,10106222,10111299,17131640,5077,17131640,18046,11
56344,CABP5,chr19,R,48029382,48044054,17146312,14672,17146312,18047,6
56729,RETN,chr19,F,7669085,7670454,17147681,1369,17147681,18048,3
56848,SPHK2,chr19,F,48619290,48630407,17158798,11117,17158798,18049,9
56891,LGALS14,chr19,F,39704305,39709448,17163941,5143,17163941,18050,4
56915,EXOSC5,chr19,R,41386369,41397351,17174923,10982,17174923,18051,5
56917,MEIS3,chr19,R,47403117,47422265,17194071,19148,17194071,18052,15
56926,NCLN,chr19,F,3185876,3209575,17217770,23699,17217770,18053,14
56927,GPR108,chr19,R,6729913,6737622,17225479,7709,17225479,18054,18
56928,SPPL2B,chr19,F,2328613,2355102,17251968,26489,17251968,18055,14
56931,DUS3L,chr19,R,5785139,5791238,17258067,6099,17258067,18056,12
56949,XAB2,chr19,R,7619524,7629553,17268096,10029,17268096,18057,18
56961,SHD,chr19,F,4278600,4290723,17280219,12123,17280219,18058,5
56971,CEACAM19,chr19,F,44666591,44684359,17297987,17768,17297987,18059,8
57030,SLC17A7,chr19,R,49429397,49441551,17310141,12154,17310141,18060,11
57106,NAT14,chr19,F,55485189,55487568,17312520,2379,17312520,18061,2
57126,CD177,chr19,F,43353658,43363172,17322034,9514,17322034,18062,8
57130,ATP13A1,chr19,R,19645197,19667823,17344660,22626,17344660,18063,25
57139,RGL3,chr19,R,11394055,11419342,17369947,25287,17369947,18064,18
57153,SLC44A2,chr19,F,10602444,10644559,17412062,42115,17412062,18065,23
57191,VN1R1,chr19,R,57455173,57456739,17413628,1566,17413628,18066,0
57192,MCOLN1,chr19,F,7522609,7534009,17425028,11400,17425028,18067,13
57333,RCN3,chr19,F,49527578,49543638,17441088,16060,17441088,18068,7
57343,ZNF304,chr19,F,57351244,57359898,17449742,8654,17449742,18069,5
57348,TTYH1,chr19,F,54415425,54436719,17471036,21294,17471036,18070,14
57418,WDR18,chr19,F,984327,994570,17481279,10243,17481279,18071,9
57455,REXO1,chr19,R,1815245,1848488,17514522,33243,17514522,18072,17
57469,PNMAL2,chr19,R,46491190,46495912,17519244,4722,17519244,18073,0
57474,ZNF490,chr19,R,12576105,12610809,17553948,34704,17553948,18074,4
57479,PRR12,chr19,F,49591654,49626439,17588733,34785,17588733,18075,13
57572,DOCK6,chr19,R,11199292,11262501,17651942,63209,17651942,18076,52
57573,ZNF471,chr19,F,56507842,56530212,17674312,22370,17674312,18077,5
57615,ZNF492,chr19,F,22634323,22667670,17707659,33347,17707659,18078,3
57616,TSHZ3,chr19,R,31274944,31349284,17781999,74340,17781999,18079,1
57622,LRFN1,chr19,R,39306816,39320854,17796037,14038,17796037,18080,4
57655,GRAMD1A,chr19,F,34994783,35026471,17827725,31688,17827725,18081,26
57662,CAMSAP3,chr19,F,7595901,7618310,17850134,22409,17850134,18082,18
57663,USP29,chr19,F,57120140,57131926,17861920,11786,17861920,18083,3
57664,PLEKHA4,chr19,R,48837091,48868627,17893456,31536,17893456,18084,20
57677,ZFP14,chr19,R,36334452,36379203,17938207,44751,17938207,18085,5
57693,ZNF317,chr19,F,9140379,9163415,17961243,23036,17961243,18086,7
57711,ZNF529,chr19,R,36534517,36605411,18032137,70894,18032137,18087,11
57716,PRX,chr19,R,40393763,40414718,18053092,20955,18053092,18088,6
57719,ANO8,chr19,R,17323222,17334834,18064704,11612,18064704,18089,17
57731,SPTBN4,chr19,F,40466106,40576459,18175057,110353,18175057,18090,37
57787,MARK4,chr19,F,45251257,45305283,18229083,54026,18229083,18091,17
57794,SUGP1,chr19,R,19276510,19320512,18273085,44002,18273085,18092,13
57817,HAMP,chr19,F,35282506,35285143,18275722,2637,18275722,18093,2
57828,CATSPERG,chr19,F,38335782,38370949,18310889,35167,18310889,18094,29
57834,CYP4F11,chr19,R,15912369,15934866,18333386,22497,18333386,18095,11
58491,ZNF71,chr19,F,56595295,56624481,18362572,29186,18362572,18096,3
58492,ZNF77,chr19,R,2933217,2945279,18374634,12062,18374634,18097,4
58506,SCAF1,chr19,F,49640502,49658649,18392781,18147,18392781,18098,12
58509,CACTIN,chr19,R,3610627,3626815,18408969,16188,18408969,18099,10
58510,PRODH2,chr19,R,35799989,35813299,18422279,13310,18422279,18100,10
58513,EPS15L1,chr19,R,16355243,16472012,18539048,116769,18539048,18101,23
58525,WIZ,chr19,R,15421506,15449956,18567498,28450,18567498,18102,15
59283,CACNG8,chr19,F,53963035,53990215,18594678,27180,18594678,18103,3
59284,CACNG7,chr19,F,53909424,53943715,18628969,34291,18628969,18104,5
59285,CACNG6,chr19,F,53991148,54012666,18650487,21518,18650487,18105,6
59286,UBL5,chr19,F,9827879,9830121,18652729,2242,18652729,18106,4
59348,ZNF350,chr19,R,51964339,51986856,18675246,22517,18675246,18107,4
60385,TSKS,chr19,R,49739752,49763328,18698822,23576,18698822,18108,10
60680,CELF5,chr19,F,3224675,3297076,18771223,72401,18771223,18109,14
63934,ZNF667,chr19,R,56438511,56478065,18810777,39554,18810777,18110,8
63946,DMRTC2,chr19,F,41844742,41852330,18818365,7588,18818365,18111,12
64073,C19orf33,chr19,F,38304163,38305006,18819208,843,18819208,18112,3
64100,ELSPBP1,chr19,F,47994649,48025156,18849715,30507,18849715,18113,6
64130,LIN7B,chr19,F,49114360,49118460,18853815,4100,18853815,18114,5
64344,HIF3A,chr19,F,46297045,46343433,18900203,46388,18900203,18115,17
64377,CHST8,chr19,F,33621954,33773509,19051758,151555,19051758,18116,9
64748,LPPR2,chr19,F,11355385,11365698,19062071,10313,19062071,18117,9
64763,ZNF574,chr19,F,42074904,42081567,19068734,6663,19068734,18118,5
64857,PLEKHG2,chr19,F,39412581,39428415,19084568,15834,19084568,18119,18
64926,RASAL3,chr19,R,15451623,15464571,19097516,12948,19097516,18120,17
64981,MRPL34,chr19,F,17292777,17306847,19111586,14070,19111586,18121,3
65095,KRI1,chr19,R,10553084,10566031,19124533,12947,19124533,18122,18
65249,ZSWIM4,chr19,F,13795433,13832254,19161354,36821,19161354,18123,13
65251,ZNF649,chr19,R,51888537,51905052,19177869,16515,19177869,18124,5
65982,ZSCAN18,chr19,R,58083833,58118433,19212469,34600,19212469,18125,10
65996,CENPBD1P1,chr19,F,58575398,58584395,19221466,8997,19221466,18126,1
66002,CYP4F12,chr19,F,15673017,15698819,19247268,25802,19247268,18127,12
78992,YIPF2,chr19,R,10922767,10929012,19253513,6245,19253513,18128,9
79002,C19orf43,chr19,R,12730639,12734715,19257589,4076,19257589,18129,2
79016,DDA1,chr19,F,17309527,17323298,19271360,13771,19271360,18130,4
79036,KXD1,chr19,F,18557761,18569387,19282986,11626,19282986,18131,8
79041,TMEM38A,chr19,F,16661126,16689019,19310879,27893,19310879,18132,5
79042,TSEN34,chr19,F,54189516,54194536,19315899,5020,19315899,18133,7
79047,KCTD15,chr19,F,33796845,33815761,19334815,18916,19334815,18134,8
79085,SLC25A23,chr19,R,6436080,6460221,19358956,24141,19358956,18135,13
79086,SMIM7,chr19,R,16630742,16660157,19388371,29415,19388371,18136,6
79088,ZNF426,chr19,R,9526550,9538645,19400466,12095,19400466,18137,6
79090,TRAPPC6A,chr19,R,45162927,45178243,19415782,15316,19415782,18138,5
79143,MBOAT7,chr19,R,54173411,54189882,19432253,16471,19432253,18139,7
79147,FKRP,chr19,F,46744605,46758575,19446223,13970,19446223,18140,8
79149,ZSCAN5A,chr19,R,56221302,56230399,19455320,9097,19455320,18141,5
79156,PLEKHF1,chr19,F,29665419,29675477,19465378,10058,19465378,18142,2
79165,LENG1,chr19,R,54155638,54159743,19469483,4105,19469483,18143,3
79166,LILRP2,chr19,F,54707915,54713452,19475020,5537,19475020,18144,6
79168,LILRA6,chr19,R,54236591,54242768,19481197,6177,19481197,18145,9
79171,RBM42,chr19,F,35629077,35637685,19489805,8608,19489805,18146,9
79173,C19orf57,chr19,R,13882347,13906099,19513557,23752,19513557,18147,8
79177,ZNF576,chr19,F,43596391,43600435,19517601,4044,19517601,18148,3
79187,FSD1,chr19,F,4304593,4323846,19536854,19253,19536854,18149,12
79230,ZNF557,chr19,F,7069459,7087968,19555363,18509,19555363,18150,7
79414,LRFN3,chr19,F,35937119,35945195,19563439,8076,19563439,18151,2
79575,ABHD8,chr19,R,17292130,17303473,19574782,11343,19574782,18152,4
79603,CERS4,chr19,F,8209328,8262421,19627875,53093,19627875,18153,15
79629,OCEL1,chr19,F,17226203,17229219,19630891,3016,19630891,18154,5
79673,ZNF329,chr19,R,58126327,58155110,19659674,28783,19659674,18155,7
79709,COLGALT1,chr19,F,17555701,17583162,19687135,27461,19687135,18156,15
79713,IGFLR1,chr19,R,35739249,35742450,19690336,3201,19690336,18157,4
79735,TBC1D17,chr19,F,49877424,49888750,19701662,11326,19701662,18158,17
79744,ZNF419,chr19,F,57487710,57494680,19708632,6970,19708632,18159,4
79760,GEMIN7,chr19,F,45075738,45091524,19724418,15786,19724418,18160,4
79763,ISOC2,chr19,R,55452977,55461682,19733123,8705,19733123,18161,5
79784,MYH14,chr19,F,50188185,50310544,19855482,122359,19855482,18162,45
79788,ZNF665,chr19,R,53163298,53193396,19885580,30098,19885580,18163,5
79816,TLE6,chr19,F,2977414,2995184,19903350,17770,19903350,18164,20
79818,ZNF552,chr19,R,57807081,57815188,19911457,8107,19911457,18165,2
79852,EPHX3,chr19,R,15226918,15233047,19917586,6129,19917586,18166,7
79883,PODNL1,chr19,R,13931186,13953392,19939792,22206,19939792,18167,8
79891,ZNF671,chr19,R,57719746,57727627,19947673,7881,19947673,18168,4
79898,ZNF613,chr19,F,51927146,51945758,19966285,18612,19966285,18169,6
79934,ADCK4,chr19,R,40691528,40716960,19991717,25432,19991717,18170,19
79935,CNTD2,chr19,R,40222207,40227095,19996605,4888,19996605,18171,4
79939,SLC35E1,chr19,R,16549836,16572382,20019151,22546,20019151,18172,5
79948,LPPR3,chr19,R,812487,824243,20030907,11756,20030907,18173,7
79958,DENND1C,chr19,R,6467203,6481808,20045512,14605,20045512,18174,22
79973,ZNF442,chr19,R,12349370,12365985,20062127,16615,20062127,18175,6
79986,ZNF702P,chr19,R,52968250,52993531,20087408,25281,20087408,18176,3
80032,ZNF556,chr19,F,2867334,2878517,20098591,11183,20098591,18177,3
80054,CEBPA-AS1,chr19,F,33302856,33305057,20100792,2201,20100792,18178,0
80095,ZNF606,chr19,R,57977071,58003346,20127067,26275,20127067,18179,6
80110,ZNF614,chr19,R,52013323,52028427,20142171,15104,20142171,18180,4
80131,LRRC8E,chr19,F,7888504,7902023,20155690,13519,20155690,18181,4
80164,PRR36,chr19,R,7868718,7874441,20161413,5723,20161413,18182,5
80199,FUZ,chr19,R,49806865,49817376,20171924,10511,20171924,18183,16
80207,OPA3,chr19,R,45526862,45584864,20229926,58002,20229926,18184,4
80264,ZNF430,chr19,F,21020619,21060055,20269362,39436,20269362,18185,4
80271,ITPKC,chr19,F,40716979,40740860,20293243,23881,20293243,18186,6
80700,UBXN6,chr19,R,4445005,4457794,20306032,12789,20306032,18187,11
80714,PBX4,chr19,R,19561706,19618916,20363242,57210,20363242,18188,9
80726,KIAA1683,chr19,R,18257095,18274509,20380656,17414,20380656,18189,3
80776,B9D2,chr19,R,41354416,41364540,20390780,10124,20390780,18190,4
81099,OR4F17,chr19,F,107151,111690,20395319,4539,20395319,18191,2
81492,RSPH6A,chr19,R,45795709,45815347,20414957,19638,20414957,18192,5
81576,CCDC130,chr19,F,13731762,13763292,20446487,31530,20446487,18193,12
81616,ACSBG2,chr19,F,6135632,6193103,20503958,57471,20503958,18194,15
81794,ADAMTS10,chr19,R,8580239,8610753,20534472,30514,20534472,18195,25
81856,ZNF611,chr19,R,52702812,52735054,20566714,32242,20566714,18196,8
81857,MED25,chr19,F,49818278,49840384,20588820,22106,20588820,18197,18
81890,QTRT1,chr19,F,10701435,10713367,20600752,11932,20600752,18198,9
81926,ABHD17A,chr19,R,1876975,1885519,20609296,8544,20609296,18199,6
81931,ZNF93,chr19,F,19900912,19935998,20644382,35086,20644382,18200,4
83475,DOHH,chr19,R,3490820,3505918,20659480,15098,20659480,18201,6
83483,PLVAP,chr19,R,17351447,17377349,20685382,25902,20685382,18202,5
83546,RTBDN,chr19,R,12825476,12838267,20698173,12791,20698173,18203,13
83596,BCL2L12,chr19,F,49665141,49673916,20706948,8775,20706948,18204,6
83636,C19orf12,chr19,R,29698885,29715789,20723852,16904,20723852,18205,5
83639,TEX101,chr19,F,43388610,43418615,20753857,30005,20753857,18206,9
83743,GRWD1,chr19,F,48445772,48453907,20761992,8135,20761992,18207,6
83854,ANGPTL6,chr19,R,10092336,10106209,20775865,13873,20775865,18208,8
83855,KLF16,chr19,R,1852398,1863565,20787032,11167,20787032,18209,1
83878,USHBP1,chr19,R,17250020,17264796,20801808,14776,20801808,18210,13
83889,WDR87,chr19,R,37884572,37906706,20823942,22134,20823942,18211,5
83983,TSSK6,chr19,R,19514218,19515660,20825384,1442,20825384,18212,0
83987,CCDC8,chr19,R,46410328,46413662,20828718,3334,20828718,18213,0
84063,KIRREL2,chr19,F,35851634,35867146,20844230,15512,20844230,18214,15
84079,ANKRD27,chr19,R,32597000,32675196,20922426,78196,20922426,18215,29
84106,PRAM1,chr19,R,8490054,8502654,20935026,12600,20935026,18216,9
84167,C19orf44,chr19,F,16496310,16521369,20960085,25059,20960085,18217,9
84215,ZNF541,chr19,R,47520684,47573238,21012639,52554,21012639,18218,19
84245,MRI1,chr19,F,13764491,13774282,21022430,9791,21022430,18219,6
84258,SYT3,chr19,R,50621859,50658127,21058698,36268,21058698,18220,11
84261,FBXW9,chr19,R,12688915,12696868,21066651,7953,21066651,18221,9
84266,ALKBH7,chr19,F,6372432,6375250,21069469,2818,21069469,18222,4
84292,WDR83,chr19,F,12666803,12675832,21078498,9029,21078498,18223,10
84306,PDCD2L,chr19,F,34404397,34426168,21100269,21771,21100269,18224,6
84330,ZNF414,chr19,R,8510577,8514164,21103856,3587,21103856,18225,7
84335,AKT1S1,chr19,R,49869032,49878356,21113180,9324,21113180,18226,6
84337,ELOF1,chr19,R,11553042,11559236,21119374,6194,21119374,18227,3
84436,ZNF528,chr19,F,52397867,52418408,21139915,20541,21139915,18228,8
84444,DOT1L,chr19,F,2164126,2232578,21208367,68452,21208367,18229,30
84446,BRSK1,chr19,F,55284165,55312562,21236764,28397,21236764,18230,19
84449,ZNF333,chr19,F,14689786,14733746,21280724,43960,21280724,18231,17
84467,FBN3,chr19,R,8065401,8149012,21364335,83611,21364335,18232,63
84503,ZNF527,chr19,F,37371047,37393066,21386354,22019,21386354,18233,4
84518,CNFN,chr19,R,42387018,42390317,21389653,3299,21389653,18234,4
84527,ZNF559,chr19,F,9323771,9343845,21409727,20074,21409727,18235,7
84546,SNORD35B,chr19,F,49497718,49497806,21409815,88,21409815,18236,0
84634,KISS1R,chr19,F,917341,921015,21413489,3674,21413489,18237,4
84658,ADGRE3,chr19,R,14619116,14674918,21469291,55802,21469291,18238,15
84671,ZNF347,chr19,R,53138299,53163938,21494930,25639,21494930,18239,8
84699,CREB3L3,chr19,F,4153600,4173054,21514384,19454,21514384,18240,9
84705,GTPBP3,chr19,F,17334981,17342731,21522134,7750,21522134,18241,8
84717,HDGFRP2,chr19,F,4472195,4502220,21552159,30025,21552159,18242,16
84765,ZNF577,chr19,R,51855802,51890916,21587273,35114,21587273,18243,11
84769,MPV17L2,chr19,F,18193229,18196742,21590786,3513,21590786,18244,4
84775,ZNF607,chr19,R,37696362,37719790,21614214,23428,21614214,18245,5
84787,SUV420H2,chr19,F,55339209,55348121,21623126,8912,21623126,18246,10
84798,C19orf48,chr19,R,50797692,50804853,21630287,7161,21630287,18247,6
84807,NFKBID,chr19,R,35887128,35902334,21645493,15206,21645493,18248,13
84823,LMNB2,chr19,R,2427906,2456968,21674555,29062,21674555,18249,13
84839,RAX2,chr19,R,3769088,3772221,21677688,3133,21677688,18250,2
84878,ZBTB45,chr19,R,58513529,58520823,21684982,7294,21684982,18251,3
84902,CEP89,chr19,R,32878997,32972029,21778014,93032,21778014,18252,20
84911,ZNF382,chr19,F,36605304,36628597,21801307,23293,21801307,18253,4
84914,ZNF587,chr19,F,57849812,57865123,21816618,15311,21816618,18254,2
84922,FIZ1,chr19,R,55591370,55599696,21824944,8326,21824944,18255,3
84924,ZNF566,chr19,R,36436033,36489902,21878813,53869,21878813,18256,6
84939,MUM1,chr19,F,1354976,1378431,21902268,23455,21902268,18257,19
84941,HSH2D,chr19,F,16134027,16158575,21926816,24548,21926816,18258,8
84954,MPND,chr19,F,4343526,4360086,21943376,16560,21943376,18259,12
84964,ALKBH6,chr19,R,36009115,36014243,21948504,5128,21948504,18260,6
84971,ATG4D,chr19,F,10543893,10553423,21958034,9530,21958034,18261,9
85300,ATCAY,chr19,F,3880619,3928082,22005497,47463,22005497,18262,12
85360,SYDE1,chr19,F,15107363,15114988,22013122,7625,22013122,18263,7
85415,RHPN2,chr19,R,32978591,33064918,22099449,86327,22099449,18264,14
85509,MBD3L1,chr19,F,8842592,8843340,22100197,748,22100197,18265,0
85569,GALP,chr19,F,56176019,56185775,22109953,9756,22109953,18266,5
89790,SIGLEC10,chr19,R,51410020,51417803,22117736,7783,22117736,18267,10
89858,SIGLEC12,chr19,R,51491226,51501789,22128299,10563,22128299,18268,7
89887,ZNF628,chr19,F,55476331,55484487,22136455,8156,22136455,18269,2
90007,MIDN,chr19,F,1248552,1259143,22147046,10591,22147046,18270,8
90011,KIR3DX1,chr19,F,54532691,54545768,22160123,13077,22160123,18271,8
90075,ZNF30,chr19,F,34926902,34945172,22178393,18270,22178393,18272,7
90233,ZNF551,chr19,F,57681968,57689811,22186236,7843,22186236,18273,2
90273,CEACAM21,chr19,F,41549249,41586844,22223831,37595,22223831,18274,19
90317,ZNF616,chr19,R,52114399,52139938,22249370,25539,22249370,18275,3
90321,ZNF766,chr19,F,52269570,52292726,22272526,23156,22272526,18276,4
90324,CCDC97,chr19,F,41310188,41324883,22287221,14695,22287221,18277,5
90332,EXOC3L2,chr19,R,45212620,45234211,22308812,21591,22308812,18278,9
90333,ZNF468,chr19,R,52838531,52857649,22327930,19118,22327930,18279,5
90338,ZNF160,chr19,R,53064881,53103471,22366520,38590,22366520,18280,9
90353,CTU1,chr19,R,51097605,51108390,22377305,10785,22377305,18281,2
90378,SAMD1,chr19,R,14088416,14090420,22379309,2004,22379309,18282,5
90379,DCAF15,chr19,F,13952506,13961444,22388247,8938,22388247,18283,12
90480,GADD45GIP1,chr19,R,12954155,12957254,22391346,3099,22391346,18284,1
90485,ZNF835,chr19,R,56662651,56671783,22400478,9132,22400478,18285,1
90522,YIF1B,chr19,R,38303559,38315976,22412895,12417,22412895,18286,9
90576,ZNF799,chr19,R,12390013,12413983,22436865,23970,22436865,18287,5
90580,C19orf52,chr19,F,10928747,10930241,22438359,1494,22438359,18288,1
90589,ZNF625,chr19,R,12144889,12156731,22450201,11842,22450201,18289,3
90592,ZNF700,chr19,F,11925067,11950773,22475907,25706,22475907,18290,3
90594,ZNF439,chr19,F,11848529,11869491,22496869,20962,22496869,18291,4
90649,ZNF486,chr19,F,20167213,20200490,22530146,33277,22530146,18292,3
91039,DPP9,chr19,R,4675225,4723843,22578764,48618,22578764,18293,26
91120,ZNF682,chr19,R,20004417,20039526,22613873,35109,22613873,18294,8
91300,R3HDM4,chr19,R,896502,913225,22630596,16723,22630596,18295,7
91304,TMEM259,chr19,R,1009650,1021169,22642115,11519,22642115,18296,9
91442,C19orf40,chr19,F,32972216,32977495,22647394,5279,22647394,18297,4
91646,TDRD12,chr19,F,32719772,32827415,22755037,107643,22755037,18298,34
91661,ZNF765,chr19,F,53387859,53412009,22779187,24150,22779187,18299,4
91662,NLRP12,chr19,R,53793583,53824403,22810007,30820,22810007,18300,9
91663,MYADM,chr19,F,53865583,53876435,22820859,10852,22820859,18301,6
91664,ZNF845,chr19,F,53333713,53354869,22842015,21156,22842015,18302,4
91978,TPGS1,chr19,F,507496,519654,22854173,12158,22854173,18303,1
92283,ZNF461,chr19,R,36636682,36667131,22884622,30449,22884622,18304,7
92285,ZNF585B,chr19,R,37181578,37210549,22913593,28971,22913593,18305,4
92359,CRB3,chr19,F,6463776,6467221,22917038,3445,22917038,18306,4
92609,TIMM50,chr19,F,39480411,39493018,22929645,12607,22929645,18307,11
92799,SHKBP1,chr19,F,40576850,40591399,22944194,14549,22944194,18308,17
92840,REEP6,chr19,F,1491165,1497925,22950954,6760,22950954,18309,4
92960,PEX11G,chr19,R,7476869,7497485,22971570,20616,22971570,18310,12
93099,DMKN,chr19,R,35497216,35513668,22988022,16452,22988022,18311,25
93134,ZNF561,chr19,R,9607325,9621240,23001937,13915,23001937,18312,6
93145,OLFM2,chr19,R,9853717,9936552,23084772,82835,23084772,18313,7
93233,CCDC114,chr19,R,48296451,48322795,23111116,26344,23111116,18314,19
93323,HAUS8,chr19,R,17049760,17075608,23136964,25848,23136964,18315,10
93343,MVB12A,chr19,F,17405685,17425339,23156618,19654,23156618,18316,10
93429,DKFZp434J0226,chr19,F,46210241,46214838,23161215,4597,23161215,18317,5
93436,ARMC6,chr19,F,19033577,19058178,23185816,24601,23185816,18318,10
93650,ACPT,chr19,F,50790414,50795224,23190626,4810,23190626,18319,10
93659,CGB5,chr19,F,49043844,49045311,23192093,1467,23192093,18320,2
94025,MUC16,chr19,R,8848843,8981342,23324592,132499,23324592,18321,83
94027,CGB7,chr19,R,49054273,49057788,23328107,3515,23328107,18322,4
94030,LRRC4B,chr19,R,50516891,50568219,23379435,51328,23379435,18323,4
94039,ZNF101,chr19,F,19668152,19683506,23394789,15354,23394789,18324,4
94059,LENG9,chr19,R,54461795,54463711,23396705,1916,23396705,18325,0
94115,CGB8,chr19,R,49047637,49049111,23398179,1474,23398179,18326,2
94235,GNG8,chr19,R,46633933,46635534,23399780,1601,23399780,18327,2
94274,PPP1R14A,chr19,R,38251236,38256591,23405135,5355,23405135,18328,3
112398,EGLN2,chr19,F,40799142,40808441,23414434,9299,23414434,18329,6
112401,BIRC8,chr19,R,53289600,53291622,23416456,2022,23416456,18330,0
112703,FAM71E1,chr19,R,50466642,50476746,23426560,10104,23426560,18331,4
112724,RDH13,chr19,R,55041318,55069774,23455016,28456,23455016,18332,11
112812,FDX1L,chr19,R,10310210,10316015,23460821,5805,23460821,18333,4
112939,NACC1,chr19,F,13116846,13141147,23485122,24301,23485122,18334,7
113091,PTH2,chr19,R,49422413,49426263,23488972,3850,23488972,18335,2
113177,IZUMO4,chr19,F,2096597,2099587,23491962,2990,23491962,18336,9
113178,SCAMP4,chr19,F,1905373,1926013,23512602,20640,23512602,18337,6
113179,ADAT3,chr19,F,1905371,1913447,23520678,8076,23520678,18338,1
113230,LOC113230,chr19,F,14073008,14075062,23522732,2054,23522732,18339,2
113835,ZNF257,chr19,F,22048131,22091109,23565710,42978,23565710,18340,6
114026,ZIM3,chr19,R,57134095,57145202,23576817,11107,23576817,18341,4
114132,SIGLEC11,chr19,R,49948992,49961172,23588997,12180,23588997,18342,10
114335,CGB1,chr19,R,49035568,49036934,23590363,1366,23590363,18343,2
114336,CGB2,chr19,F,49031872,49033238,23591729,1366,23591729,18344,2
114770,PGLYRP2,chr19,R,15468644,15479504,23602589,10860,23602589,18345,4
114783,LMTK3,chr19,R,48485270,48513905,23631224,28635,23631224,18346,16
114823,LENG8,chr19,F,54448718,54462046,23644552,13328,23644552,18347,16
115098,CCDC124,chr19,F,17933014,17943985,23655523,10971,23655523,18348,5
115196,ZNF554,chr19,F,2819873,2836735,23672385,16862,23672385,18349,7
115290,FBXO17,chr19,R,38941400,38975813,23706798,34413,23706798,18350,6
115653,KIR3DL3,chr19,F,54724446,54736536,23718888,12090,23718888,18351,7
115703,ARHGAP33,chr19,F,35775514,35788822,23732196,13308,23732196,18352,21
115704,EVI5L,chr19,F,7830272,7864976,23766900,34704,23766900,18353,19
115727,RASGRP4,chr19,R,38409057,38426305,23784148,17248,23784148,18354,16
115861,NXNL1,chr19,R,17455424,17460916,23789640,5492,23789640,18355,1
115948,CCDC151,chr19,R,11420604,11435782,23804818,15178,23804818,18356,13
115950,ZNF653,chr19,R,11483426,11505923,23827315,22497,23827315,18357,8
116115,ZNF526,chr19,F,42220339,42228201,23835177,7862,23835177,18358,2
116412,ZNF837,chr19,R,58367622,58381022,23848577,13400,23848577,18359,2
116444,GRIN3B,chr19,F,1000437,1010223,23858363,9786,23858363,18360,7
116541,MRPL54,chr19,F,3762666,3767565,23863262,4899,23863262,18361,2
116844,LRG1,chr19,R,4537214,4540024,23866072,2810,23866072,18362,1
117286,CIB3,chr19,R,16161367,16173525,23878230,12158,23878230,18363,6
117579,RLN3,chr19,F,14028204,14030971,23880997,2767,23880997,18364,1
125875,CLDND2,chr19,R,51366956,51369241,23883282,2285,23883282,18365,2
125893,ZNF816,chr19,R,52949378,52962911,23896815,13533,23896815,18366,4
125919,ZNF543,chr19,F,57320496,57330776,23907095,10280,23907095,18367,3
125931,CEACAM20,chr19,R,44504832,44529945,23932208,25113,23932208,18368,13
125950,RAVER1,chr19,R,10316211,10333638,23949635,17427,23949635,18369,13
125958,OR7D4,chr19,R,9213849,9214871,23950657,1022,23950657,18370,0
125962,OR7G1,chr19,R,9114827,9115763,23951593,936,23951593,18371,0
125963,OR1M1,chr19,F,9093244,9094186,23952535,942,23952535,18372,0
125965,COX6B2,chr19,R,55349701,55354814,23957648,5113,23957648,18373,4
125972,CALR3,chr19,R,16479056,16496192,23974784,17136,23974784,18374,8
125981,ACER1,chr19,R,6306141,6353444,24022087,47303,24022087,18375,6
125988,C19orf70,chr19,R,5678418,5680900,24024569,2482,24024569,18376,5
125997,MBD3L2,chr19,F,7049339,7051735,24026965,2396,24026965,18377,1
126003,TRAPPC5,chr19,F,7680820,7682862,24029007,2042,24029007,18378,1
126006,PCP2,chr19,R,7631613,7636967,24034361,5354,24034361,18379,5
126014,OSCAR,chr19,R,54094667,54102686,24042380,8019,24042380,18380,5
126017,ZNF813,chr19,F,53467734,53494292,24068938,26558,24068938,18381,3
126068,ZNF441,chr19,F,11766999,11784078,24086017,17079,24086017,18382,3
126069,ZNF491,chr19,F,11798476,11809622,24097163,11146,24097163,18383,3
126070,ZNF440,chr19,F,11814283,11835617,24118497,21334,24118497,18384,3
126074,SWSAP1,chr19,F,11374706,11376951,24120742,2245,24120742,18385,1
126075,CCDC159,chr19,F,11346504,11354944,24129182,8440,24129182,18386,10
126119,JOSD2,chr19,R,50505996,50511355,24134541,5359,24134541,18387,4
126123,IZUMO2,chr19,R,50152547,50163281,24145275,10734,24145275,18388,9
126129,CPT1C,chr19,F,49690877,49713731,24168129,22854,24168129,18389,23
126133,ALDH16A1,chr19,F,49453215,49471050,24185964,17835,24185964,18390,18
126147,NTN5,chr19,R,48661406,48673081,24197639,11675,24197639,18391,7
126204,NLRP13,chr19,R,55891691,55932336,24238284,40645,24238284,18392,11
126205,NLRP8,chr19,F,55947831,55988629,24279082,40798,24279082,18393,9
126206,NLRP5,chr19,F,55986782,56061813,24354113,75031,24354113,18394,15
126208,ZNF787,chr19,R,56087362,56121373,24388124,34011,24388124,18395,3
126231,ZNF573,chr19,R,37735130,37779636,24432630,44506,24432630,18396,10
126248,WDR88,chr19,F,33132028,33175799,24476401,43771,24476401,18397,12
126259,TMIGD2,chr19,R,4292226,4302582,24486757,10356,24486757,18398,4
126272,EID2B,chr19,R,39531532,39532867,24488092,1335,24488092,18399,0
126282,TNFAIP8L1,chr19,F,4639513,4655568,24504147,16055,24504147,18400,3
126295,ZNF57,chr19,F,2900897,2918646,24521896,17749,24521896,18401,5
126298,IRGQ,chr19,R,43584366,43596229,24533759,11863,24533759,18402,3
126299,ZNF428,chr19,R,43607223,43619862,24546398,12639,24546398,18403,3
126306,JSRP1,chr19,R,2252250,2256423,24550571,4173,24550571,18404,6
126308,MOB3A,chr19,R,2071031,2096502,24576042,25471,24576042,18405,5
126321,MFSD12,chr19,R,3538272,3557588,24595358,19316,24595358,18406,11
126326,GIPC3,chr19,F,3585540,3593541,24603359,8001,24603359,18407,5
126328,NDUFA11,chr19,R,5891275,5904013,24616097,12738,24616097,18408,5
126353,MISP,chr19,F,748420,764318,24631995,15898,24631995,18409,6
126364,LRRC25,chr19,R,18391136,18397625,24638484,6489,24638484,18410,1
126370,OR1I1,chr19,F,15087065,15088133,24639552,1068,24639552,18411,0
126374,WTIP,chr19,F,34481900,34509133,24666785,27233,24666785,18412,10
126375,ZNF792,chr19,R,34956353,34964282,24674714,7929,24674714,18413,3
126382,NR2C2AP,chr19,R,19201408,19203435,24676741,2027,24676741,18414,4
126393,HSPB6,chr19,R,35754565,35757029,24679205,2464,24679205,18415,2
126402,CCDC105,chr19,F,15010726,15023271,24691750,12545,24691750,18416,6
126410,CYP4F22,chr19,F,15508483,15552317,24735584,43834,24735584,18417,15
126432,RINL,chr19,R,38867829,38878279,24746034,10450,24746034,18418,11
126433,FBXO27,chr19,R,39024020,39032596,24754610,8576,24754610,18419,5
126520,PLK5,chr19,F,1524073,1535456,24765993,11383,24765993,18420,13
126526,C19orf47,chr19,R,40295270,40348527,24819250,53257,24819250,18421,13
126536,LINC00661,chr19,F,16015633,16027462,24831079,11829,24831079,18422,8
126541,OR10H4,chr19,F,15949007,15949958,24832030,951,24832030,18423,0
126549,ANKLE1,chr19,F,17281644,17287646,24838032,6002,24838032,18424,8
126567,C2CD4C,chr19,R,405434,409170,24841768,3736,24841768,18425,1
140467,ZNF358,chr19,F,7515281,7521025,24847512,5744,24847512,18426,3
140612,ZFP28,chr19,F,56537715,56556810,24866607,19095,24866607,18427,9
147645,VSIG10L,chr19,R,51331540,51342124,24877191,10584,24877191,18428,9
147646,C19orf84,chr19,R,51388288,51390574,24879477,2286,24879477,18429,1
147650,SPACA6P,chr19,F,51693339,51705190,24891328,11851,24891328,18430,7
147657,ZNF480,chr19,F,52297168,52325927,24920087,28759,24920087,18431,5
147658,ZNF534,chr19,F,52429320,52451939,24942706,22619,24942706,18432,5
147660,ZNF578,chr19,F,52453505,52516878,25006079,63373,25006079,18433,10
147664,ERVV-1,chr19,F,53014090,53016580,25008569,2490,25008569,18434,0
147670,SMIM17,chr19,F,56643158,56657246,25022657,14088,25022657,18435,3
147685,C19orf18,chr19,R,57958436,57974534,25038755,16098,25038755,18436,5
147686,ZNF418,chr19,R,57921883,57935408,25052280,13525,25052280,18437,6
147687,ZNF417,chr19,R,57905773,57916616,25063123,10843,25063123,18438,3
147694,ZNF548,chr19,F,57389849,57402551,25075825,12702,25075825,18439,3
147699,PPM1N,chr19,F,45497974,45502510,25080361,4536,25080361,18440,4
147700,KLC3,chr19,F,45340739,45351559,25091181,10820,25091181,18441,11
147710,IGSF23,chr19,F,44613589,44636781,25114373,23192,25114373,18442,7
147719,LYPD4,chr19,R,41833685,41844862,25125550,11177,25125550,18443,8
147727,ILF3-AS1,chr19,R,10651861,10653872,25127561,2011,25127561,18444,0
147741,ZNF560,chr19,R,9445825,9506689,25188425,60864,25188425,18445,13
147744,TMEM190,chr19,F,55376835,55378244,25189834,1409,25189834,18446,4
147746,HIPK4,chr19,R,40379270,40390221,25200785,10951,25200785,18447,3
147798,TMC4,chr19,R,54160094,54173250,25213941,13156,25213941,18448,14
147804,TPM3P9,chr19,F,53431973,53444672,25226640,12699,25226640,18449,1
147807,ZNF524,chr19,F,55599754,55603138,25230024,3384,25230024,18450,2
147808,ZNF784,chr19,R,55620740,55624575,25233859,3835,25233859,18451,1
147837,ZNF563,chr19,R,12317476,12348130,25264513,30654,25264513,18452,5
147841,SPC24,chr19,R,11145497,11156002,25275018,10505,25275018,18453,5
147872,CCDC155,chr19,F,49388217,49417999,25304800,29782,25304800,18454,23
147906,DACT3,chr19,R,46647563,46661138,25318375,13575,25318375,18455,7
147912,SIX5,chr19,R,45764784,45769239,25322830,4455,25322830,18456,2
147920,IGFL2,chr19,F,46078527,46195097,25439400,116570,25439400,18457,9
147923,ZNF420,chr19,F,37007812,37130324,25561912,122512,25561912,18458,7
147929,ZNF565,chr19,R,36182059,36215084,25594937,33025,25594937,18459,8
147945,NLRP4,chr19,F,55836085,55881855,25640707,45770,25640707,18460,10
147947,ZNF542P,chr19,F,56368098,56379828,25652437,11730,25652437,18461,6
147948,ZNF582,chr19,R,56374831,56393585,25671191,18754,25671191,18462,5
147949,ZNF583,chr19,F,56404013,56425031,25692209,21018,25692209,18463,7
147965,FAM98C,chr19,F,38403124,38409088,25698173,5964,25698173,18464,7
147968,CAPN12,chr19,R,38730191,38744474,25712456,14283,25712456,18465,18
147991,DPY19L3,chr19,F,32405748,32485893,25792601,80145,25792601,18466,20
148003,LGALS16,chr19,F,39655893,39660647,25797355,4754,25797355,18467,3
148014,TTC9B,chr19,R,40216057,40218399,25799697,2342,25799697,18468,2
148022,TICAM1,chr19,R,4815923,4831742,25815516,15819,25815516,18469,1
148046,CIRBP-AS1,chr19,R,1267470,1270260,25818306,2790,25818306,18470,1
148066,ZNRF4,chr19,F,5455414,5456856,25819748,1442,25819748,18471,0
148103,ZNF599,chr19,R,34758073,34773229,25834904,15156,25834904,18472,3
148109,FAM187B,chr19,R,35224800,35228725,25838829,3925,25838829,18473,1
148113,CILP2,chr19,F,19538264,19546659,25847224,8395,25847224,18474,7
148137,PROSER3,chr19,F,35758142,35769371,25858453,11229,25858453,18475,10
148145,LINC00906,chr19,F,28965130,28969148,25862471,4018,25862471,18476,1
148156,ZNF558,chr19,R,8809573,8832304,25885202,22731,25885202,18477,9
148170,CDC42EP5,chr19,R,54465024,54473290,25893468,8266,25893468,18478,2
148189,LINC00662,chr19,R,27790492,27793940,25896916,3448,25896916,18479,2
148198,ZNF98,chr19,R,22391010,22422362,25928268,31352,25928268,18480,3
148203,ZNF738,chr19,F,21358932,21388582,25957918,29650,25957918,18481,4
148206,ZNF714,chr19,F,21082146,21125094,26000866,42948,26000866,18482,5
148213,ZNF681,chr19,R,23739194,23758891,26020563,19697,26020563,18483,3
148223,C19orf25,chr19,R,1473200,1479229,26026592,6029,26026592,18484,2
148229,ATP8B3,chr19,R,1782069,1812276,26056799,30207,26056799,18485,28
148231,LINC00905,chr19,F,16033712,16042135,26065222,8423,26065222,18486,5
148252,DIRAS1,chr19,R,2714566,2721392,26072048,6826,26072048,18487,2
148254,ZNF555,chr19,F,2841434,2860474,26091088,19040,26091088,18488,5
148266,ZNF569,chr19,R,37410875,37469064,26149277,58189,26149277,18489,9
148268,ZNF570,chr19,F,37467464,37485358,26167171,17894,26167171,18490,7
162962,ZNF836,chr19,R,52154611,52171667,26184227,17056,26184227,18491,4
162963,ZNF610,chr19,F,52331862,52367123,26219488,35261,26219488,18492,9
162966,ZNF600,chr19,R,52765470,52833628,26287646,68158,26287646,18493,10
162967,ZNF320,chr19,R,52876171,52897693,26309168,21522,26309168,18494,4
162968,ZNF497,chr19,R,58354356,58362848,26317660,8492,26317660,18495,2
162972,ZNF550,chr19,R,57541835,57561647,26337472,19812,26337472,18496,5
162979,ZNF296,chr19,R,45071499,45076430,26342403,4931,26342403,18497,2
162989,DEDD2,chr19,R,42198592,42220152,26363963,21560,26363963,18498,7
162993,ZNF846,chr19,R,9752144,9786177,26397996,34033,26397996,18499,8
162998,OR7D2,chr19,F,9185593,9188817,26401220,3224,26401220,18500,0
163033,ZNF579,chr19,R,55577522,55580899,26404597,3377,26404597,18501,1
163049,ZNF791,chr19,F,12610917,12629862,26423542,18945,26423542,18502,3
163050,ZNF564,chr19,R,12525369,12551542,26449715,26173,26449715,18503,3
163051,ZNF709,chr19,R,12461183,12484818,26473350,23635,26473350,18504,3
163059,ZNF433,chr19,R,12014716,12035710,26494344,20994,26494344,18505,9
163071,ZNF114,chr19,F,48270098,48287608,26511854,17510,26511854,18506,8
163081,ZNF567,chr19,F,36687563,36723358,26547649,35795,26547649,18507,10
163087,ZNF383,chr19,F,37217925,37243926,26573650,26001,26573650,18508,11
163115,ZNF781,chr19,R,37667748,37692315,26598217,24567,26598217,18509,6
163126,EID2,chr19,R,39538805,39540198,26599610,1393,26599610,18510,0
163131,ZNF780B,chr19,R,40028259,40059027,26630378,30768,26630378,18511,7
163154,PRR22,chr19,R,5782959,5784765,26632184,1806,26632184,18512,2
163175,LGI4,chr19,R,35124512,35139451,26647123,14939,26647123,18513,10
163183,SYNE4,chr19,R,36002999,36008793,26652917,5794,26652917,18514,7
163223,ZNF676,chr19,R,22178935,22248018,26722000,69083,26722000,18515,10
163227,ZNF100,chr19,R,21724040,21767628,26765588,43588,26765588,18516,7
163255,ZNF540,chr19,F,37551370,37614179,26828397,62809,26828397,18517,5
170463,SSBP4,chr19,F,18418660,18434562,26844299,15902,26844299,18518,20
170958,ZNF525,chr19,F,53365714,53386590,26865175,20876,26865175,18519,3
170959,ZNF431,chr19,F,21142003,21186002,26909174,43999,26909174,18520,10
170961,ANKRD24,chr19,F,4182624,4224814,26951364,42190,26951364,18521,28
171169,SPACA4,chr19,F,48606742,48607714,26952336,972,26952336,18522,0
171392,ZNF675,chr19,R,23652780,23687215,26986771,34435,26986771,18523,6
199675,MCEMP1,chr19,F,7677056,7679833,26989548,2777,26989548,18524,6
199692,ZNF627,chr19,F,11575271,11619159,27033436,43888,27033436,18525,5
199699,DAND5,chr19,F,12969617,12974753,27038572,5136,27038572,18526,1
199704,ZNF585A,chr19,R,37147437,37172741,27063876,25304,27063876,18527,6
199713,NLRP7,chr19,R,54923508,54969965,27110333,46457,27110333,18528,14
199720,GGN,chr19,R,38384348,38388583,27114568,4235,27114568,18529,4
199731,CADM4,chr19,R,43622366,43639839,27132041,17473,27132041,18530,8
199745,THAP8,chr19,R,36034983,36054762,27151820,19779,27151820,18531,3
199746,U2AF1L4,chr19,R,35742526,35745442,27154736,2916,27154736,18532,6
199777,ZNF626,chr19,R,20619938,20661596,27196394,41658,27196394,18533,4
199786,FAM129C,chr19,F,17523300,17555545,27228639,32245,27228639,18534,20
199800,ADM5,chr19,F,49688684,49690990,27230945,2306,27230945,18535,1
201514,ZNF584,chr19,F,58407872,58418327,27241400,10455,27241400,18536,4
201516,ZSCAN4,chr19,F,57651503,57679152,27269049,27649,27269049,18537,7
204801,NLRP11,chr19,R,55785396,55836762,27320415,51366,27320415,18538,11
255043,TMEM86B,chr19,R,55226633,55229264,27323046,2631,27323046,18539,2
255057,C19orf26,chr19,R,1229947,1241763,27334862,11816,27334862,18540,9
255193,CSNK1G2-AS1,chr19,R,1952526,1954549,27336885,2023,27336885,18541,2
255783,INAFM1,chr19,F,47274401,47275723,27338207,1322,27338207,18542,1
255809,C19orf38,chr19,F,10836652,10869791,27371346,33139,27371346,18543,7
256051,ZNF549,chr19,F,57527080,57540886,27385152,13806,27385152,18544,3
256126,SYCE2,chr19,R,12899075,12919343,27405420,20268,27405420,18545,5
256236,NAPSB,chr19,R,50333799,50344748,27416369,10949,27416369,18546,8
256949,KANK3,chr19,R,8322581,8343262,27437050,20681,27437050,18547,13
257000,TINCR,chr19,R,5558166,5568034,27446918,9868,27446918,18548,2
257062,CATSPERD,chr19,F,5720400,5778734,27505252,58334,27505252,18549,24
259307,IL4I1,chr19,R,49889653,49929539,27545138,39886,27545138,18550,11
282616,IFNL2,chr19,F,39265882,39270092,27549348,4210,27549348,18551,6
282617,IFNL3,chr19,R,39243605,39247034,27552777,3429,27552777,18552,6
282618,IFNL1,chr19,F,39296324,39298672,27555125,2348,27555125,18553,4
284297,SSC5D,chr19,F,55488496,55519099,27585728,30603,27585728,18554,15
284306,ZNF547,chr19,F,57363434,57379559,27601853,16125,27601853,18555,3
284307,ZIK1,chr19,F,57583641,57593888,27612100,10247,27612100,18556,4
284309,ZNF776,chr19,F,57746795,57758159,27623464,11364,27623464,18557,2
284312,ZSCAN1,chr19,F,58033988,58058907,27648383,24919,27648383,18558,6
284323,ZNF780A,chr19,R,40069151,40091736,27670968,22585,27670968,18559,9
284325,C19orf54,chr19,R,40740855,40750713,27680826,9858,27680826,18560,5
284338,PRR19,chr19,F,42302131,42310821,27689516,8690,27689516,18561,5
284339,TMEM145,chr19,F,42313324,42325064,27701256,11740,27701256,18562,14
284340,CXCL17,chr19,R,42428542,42442984,27715698,14442,27715698,18563,3
284344,LOC284344,chr19,R,43211790,43248646,27752554,36856,27752554,18564,8
284346,ZNF575,chr19,F,43531804,43536138,27756888,4334,27756888,18565,5
284348,LYPD5,chr19,R,43795926,43827199,27788161,31273,27788161,18566,6
284349,ZNF283,chr19,F,43827291,43848898,27809768,21607,27809768,18567,9
284352,PPP1R37,chr19,F,45093172,45147285,27863881,54113,27863881,18568,12
284353,NKPD1,chr19,R,45149110,45162841,27877612,13731,27877612,18569,4
284355,TPRX1,chr19,R,47801242,47803604,27879974,2362,27879974,18570,1
284358,MAMSTR,chr19,R,48712721,48719778,27887031,7057,27887031,18571,9
284359,IZUMO1,chr19,R,48740887,48747650,27893794,6763,27893794,18572,10
284361,EMC10,chr19,F,50476456,50505909,27923247,29453,27923247,18573,10
284365,MGC45922,chr19,F,50817680,50818878,27924445,1198,27924445,18574,2
284366,KLK9,chr19,R,51002512,51009634,27931567,7122,27931567,18575,4
284367,SIGLEC17P,chr19,F,51167327,51173524,27937764,6197,27937764,18576,6
284369,SIGLECL1,chr19,F,51251025,51269330,27956069,18305,27956069,18577,8
284370,ZNF615,chr19,R,51991331,52008238,27972976,16907,27972976,18578,8
284371,ZNF841,chr19,R,52064362,52095773,28004387,31411,28004387,18579,5
284379,LOC284379,chr19,R,53599630,53603497,28008254,3867,28008254,18580,3
284382,ACTL9,chr19,R,8697396,8698830,28009688,1434,28009688,18581,0
284383,OR2Z1,chr19,F,8730953,8732009,28010744,1056,28010744,18582,0
284385,ZNF561-AS1,chr19,F,9621481,9634862,28024125,13381,28024125,18583,3
284390,ZNF763,chr19,F,11965053,11980399,28039471,15346,28039471,18584,3
284391,ZNF844,chr19,F,12064730,12077812,28052553,13082,28052553,18585,3
284395,LOC284395,chr19,R,29287010,29525752,28291295,238742,28291295,18586,9
284402,SCGB2B2,chr19,R,34576739,34675731,28390287,98992,28390287,18587,14
284403,WDR62,chr19,F,36054880,36105111,28440518,50231,28440518,18588,33
284406,ZFP82,chr19,R,36390331,36418658,28468845,28327,28468845,18589,4
284408,ZNF790-AS1,chr19,F,36797549,36828111,28499407,30562,28499407,18590,5
284412,LOC284412,chr19,R,37265938,37269010,28502479,3072,28502479,18591,1
284415,VSTM1,chr19,R,54040824,54063966,28525621,23142,28525621,18592,12
284417,TMEM150B,chr19,R,55308885,55334043,28550779,25158,28550779,18593,11
284418,FAM71E2,chr19,R,55354907,55363252,28559124,8345,28559124,18594,10
284422,SMIM24,chr19,R,3474406,3480542,28565260,6136,28565260,18595,3
284424,MIR7-3HG,chr19,F,4769104,4772556,28568712,3452,28568712,18596,2
284427,SLC25A41,chr19,R,6426036,6436267,28578943,10231,28578943,18597,8
284428,MBD3L5,chr19,F,7029929,7033011,28582025,3082,28582025,18598,2
284433,OR10H5,chr19,F,15794048,15794996,28582973,948,28582973,18599,0
284434,NWD1,chr19,F,16719852,16817963,28681084,98111,28681084,18600,21
284439,SLC25A42,chr19,F,19063965,19113030,28730149,49065,28730149,18601,9
284440,LINC00663,chr19,R,19756370,19776413,28750192,20043,28750192,18602,2
284443,ZNF493,chr19,F,21397118,21427495,28780569,30377,28780569,18603,7
284451,ODF3L2,chr19,R,463345,474983,28792207,11638,28792207,18604,4
284454,LOC284454,chr19,R,13834515,13836289,28793981,1774,28793981,18605,0
284459,HKR1,chr19,F,37334677,37364455,28823759,29778,28823759,18606,5
317701,VN1R2,chr19,F,53258291,53259602,28825070,1311,28825070,18607,0
317703,VN1R4,chr19,R,53266759,53267907,28826218,1148,28826218,18608,1
326342,ADGRE4P,chr19,R,6952499,6990846,28864565,38347,28864565,18609,15
338321,NLRP9,chr19,R,55708431,55745528,28901662,37097,28901662,18610,11
339318,ZNF181,chr19,F,34733315,34742872,28911219,9557,28911219,18611,3
339324,ZNF260,chr19,R,36510686,36528346,28928879,17660,28928879,18612,4
339327,ZNF546,chr19,F,39995629,40021041,28954291,25412,28954291,18613,8
339344,MYPOP,chr19,R,45890022,45902696,28966965,12674,28966965,18614,4
339345,NANOS2,chr19,R,45913213,45914778,28968530,1565,28968530,18615,0
339366,ADAMTSL5,chr19,R,1505017,1513189,28976702,8172,28976702,18616,12
339390,CLEC4G,chr19,R,7728956,7732171,28979917,3215,28979917,18617,8
342865,VSTM2B,chr19,F,29525430,29564551,29019038,39121,29019038,18618,7
342892,ZNF850,chr19,R,36743477,36772814,29048375,29337,29048375,18619,4
342897,NCCRP1,chr19,F,39196963,39201882,29053294,4919,29053294,18620,6
342898,SYCN,chr19,R,39202921,39204266,29054639,1345,29054639,18621,1
342900,LEUTX,chr19,F,39776593,39786135,29064181,9542,29064181,18622,2
342908,ZNF404,chr19,R,43872362,43883964,29075783,11602,29075783,18623,2
342909,ZNF284,chr19,F,44072143,44087470,29091110,15327,29091110,18624,5
342918,C19orf81,chr19,F,50632766,50659310,29117654,26544,29117654,18625,8
342926,ZNF677,chr19,R,53235384,53254858,29137128,19474,29137128,18626,6
342931,RFPL4A,chr19,F,55757429,55763419,29143118,5990,29143118,18627,3
342933,ZSCAN5B,chr19,R,56189688,56208038,29161468,18350,29161468,18628,5
342945,ZSCAN22,chr19,F,58327018,58342349,29176799,15331,29176799,18629,5
342977,NANOS3,chr19,F,13876405,13880757,29181151,4352,29181151,18630,1
342979,PALM3,chr19,R,14053366,14062111,29189896,8745,29189896,18631,6
348303,SELV,chr19,F,39515112,39520686,29195470,5574,29195470,18632,5
348327,ZNF530,chr19,F,57599884,57612722,29208308,12838,29208308,18633,4
352909,DNAAF3,chr19,R,55158660,55166722,29216370,8062,29216370,18634,11
353088,ZNF429,chr19,F,21505634,21538277,29249013,32643,29249013,18635,3
353355,ZNF233,chr19,F,44259879,44275317,29264451,15438,29264451,18636,4
353514,LILRA5,chr19,R,54307069,54313139,29270521,6070,29270521,18637,6
360200,TMPRSS9,chr19,F,2385234,2426261,29311548,41027,29311548,18638,19
374291,NDUFS7,chr19,F,1383883,1395589,29323254,11706,29323254,18639,8
374872,C19orf35,chr19,R,2274631,2282182,29330805,7551,29330805,18640,3
374875,HSD11B1L,chr19,F,5680764,5688523,29338564,7759,29338564,18641,8
374877,C19orf45,chr19,F,7497558,7515233,29356239,17675,29356239,18642,12
374879,ZNF699,chr19,R,9293924,9309766,29372081,15842,29372081,18643,5
374882,TMEM205,chr19,R,11342775,11346414,29375720,3639,29375720,18644,3
374887,YJEFN3,chr19,F,19528860,19537584,29384444,8724,29384444,18645,7
374890,LOC374890,chr19,R,22615556,22623971,29392859,8415,29392859,18646,3
374897,SBSN,chr19,R,35523366,35528351,29397844,4985,29397844,18647,3
374899,ZNF829,chr19,R,36888123,36916387,29426108,28264,29426108,18648,5
374900,ZNF568,chr19,F,36916328,36997932,29507712,81604,29507712,18649,10
374907,B3GNT8,chr19,R,41425358,41428856,29511210,3498,29511210,18650,1
374918,IGFL1,chr19,F,46229751,46231243,29512702,1492,29512702,18651,3
374920,C19orf68,chr19,F,48170661,48197621,29539662,26960,29539662,18652,6
374928,ZNF773,chr19,F,57499853,57518437,29558246,18584,29558246,18653,6
375690,WASH5P,chr19,R,60950,70966,29568262,10016,29568262,18654,2
376497,SLC27A1,chr19,F,17468773,17506168,29605657,37395,29605657,18655,14
386758,ZNF582-AS1,chr19,F,56393675,56399175,29611157,5500,29611157,18656,1
388499,LYPLA2P2,chr19,R,7878618,7880232,29612771,1614,29612771,18657,0
388503,C3P1,chr19,F,10041355,10074138,29645554,32783,29645554,18658,29
388507,ZNF788,chr19,F,12092262,12114678,29667970,22416,29667970,18659,2
388512,CLEC17A,chr19,F,14582913,14611144,29696201,28231,29696201,18660,15
388514,CYP4F24P,chr19,R,15759333,15779988,29716856,20655,29716856,18661,9
388523,ZNF728,chr19,R,22974882,23003208,29745182,28326,29745182,18662,4
388524,RPSAP58,chr19,F,23763013,23828135,29810304,65122,29810304,18663,3
388531,RGS9BP,chr19,F,32675406,32678300,29813198,2894,29813198,18664,0
388533,KRTDAP,chr19,R,35487323,35490531,29816406,3208,29816406,18665,5
388536,ZNF790,chr19,R,36818321,36850787,29848872,32466,29848872,18666,10
388550,CEACAM22P,chr19,R,44537057,44556917,29868732,19860,29868732,18667,7
388551,CEACAM16,chr19,F,44697503,44710714,29881943,13211,29881943,18668,7
388552,BLOC1S3,chr19,F,45178744,45217078,29920277,38334,29920277,18669,6
388553,BHMG1,chr19,F,45723891,45764539,29960925,40648,29960925,18670,16
388555,IGFL3,chr19,R,46119862,46124705,29965768,4843,29965768,18671,3
388558,ZNF808,chr19,F,52527651,52570178,30008295,42527,30008295,18672,8
388559,ZNF888,chr19,R,52905892,52923452,30025855,17560,30025855,18673,5
388561,ZNF761,chr19,F,53431973,53458261,30052143,26288,30052143,18674,6
388564,TMEM238,chr19,R,55379243,55384259,30057159,5016,30057159,18675,1
388566,ZNF470,chr19,F,56567080,56588903,30078982,21823,30078982,18676,7
388567,ZNF749,chr19,F,57428567,57447485,30097900,18918,30097900,18677,4
388569,ZNF324B,chr19,F,58418559,58457832,30137173,39273,30137173,18678,8
390874,ONECUT3,chr19,F,1753662,1775445,30158956,21783,30158956,18679,1
390877,LOC390877,chr19,F,6393249,6412404,30178111,19155,30178111,18680,6
390882,OR7G2,chr19,R,9102268,9103306,30179149,1038,30179149,18681,0
390883,OR7G3,chr19,R,9126011,9126950,30180088,939,30180088,18682,0
390892,OR7A10,chr19,R,14840947,14841877,30181018,930,30181018,18683,0
390916,NUDT19,chr19,F,32666295,32713796,30228519,47501,30228519,18684,4
390927,ZNF793,chr19,F,37506446,37543337,30265410,36891,30265410,18685,12
390928,PAPL,chr19,F,39084304,39111489,30292595,27185,30292595,18686,13
390937,LOC390937,chr19,R,41907534,41928122,30313183,20588,30313183,18687,5
390940,PINLYP,chr19,F,43576799,43582104,30318488,5305,30318488,18688,8
390963,ZNF818P,chr19,F,53212947,53216102,30321643,3155,30321643,18689,0
390980,ZNF805,chr19,F,57240684,57262738,30343697,22054,30343697,18690,3
399473,SPRED3,chr19,F,38388740,38399884,30354841,11144,30354841,18691,6
399664,MEX3D,chr19,R,1554668,1568058,30368231,13390,30368231,18692,2
399669,ZNF321P,chr19,R,52927134,52942594,30383691,15460,30383691,18693,1
399844,LINC01002,chr19,R,197015,202209,30388885,5194,30388885,18694,2
400668,PRSS57,chr19,R,685545,695531,30398871,9986,30398871,18695,4
400673,VMAC,chr19,F,5904840,5910252,30404283,5412,30404283,18696,1
400680,LINC00664,chr19,F,21483714,21503238,30423807,19524,30423807,18697,10
400682,LOC400682,chr19,F,21637370,21657708,30444145,20338,30444145,18698,3
400684,LOC400684,chr19,R,32390049,32405539,30459635,15490,30459635,18699,2
400685,LOC400685,chr19,R,34816153,34832869,30476351,16716,30476351,18700,5
400696,LGALS17A,chr19,F,39679373,39686373,30483351,7000,30483351,18701,7
400706,LOC400706,chr19,R,46057677,46077629,30503303,19952,30503303,18702,1
400709,SIGLEC16,chr19,F,49969654,49975819,30509468,6165,30509468,18703,3
400710,FLJ26850,chr19,F,50050679,50066795,30525584,16116,30525584,18704,2
400713,ZNF880,chr19,F,52369916,52385795,30541463,15879,30541463,18705,3
400720,ZNF772,chr19,R,57469585,57477570,30549448,7985,30549448,18706,4
401898,ZNF833P,chr19,F,11673997,11686569,30562020,12572,30562020,18707,2
402665,IGLON5,chr19,F,51311847,51330848,30581021,19001,30581021,18708,7
404037,HAPLN4,chr19,R,19255640,19262787,30588168,7147,30588168,18709,4
404217,CTXN1,chr19,R,7924495,7926166,30589839,1671,30589839,18710,1
404665,CACTIN-AS1,chr19,F,3607246,3613930,30596523,6684,30596523,18711,3
406887,MIRLET7E,chr19,F,51692785,51692864,30596602,79,30596602,18712,0
406910,MIR125A,chr19,F,51693253,51693339,30596688,86,30596688,18713,0
406942,MIR150,chr19,R,49500784,49500868,30596772,84,30596772,18714,0
406957,MIR181C,chr19,F,13874698,13874808,30596882,110,30596882,18715,0
406976,MIR199A1,chr19,R,10817425,10817496,30596953,71,30596953,18716,0
407010,MIR23A,chr19,R,13836586,13836659,30597026,73,30597026,18717,0
407013,MIR24-2,chr19,R,13836286,13836359,30597099,73,30597099,18718,0
407018,MIR27A,chr19,R,13836439,13836517,30597177,78,30597177,18719,0
407045,MIR7-3,chr19,F,4770669,4770779,30597287,110,30597287,18720,0
407056,MIR99B,chr19,F,51692611,51692681,30597357,70,30597357,18721,0
440503,PLIN5,chr19,R,4522530,4535196,30610023,12666,30610023,18722,7
440508,CLEC4GP1,chr19,F,7787483,7791012,30613552,3529,30613552,18723,6
440515,ZNF506,chr19,R,19792710,19821751,30642593,29041,30642593,18724,3
440518,GOLGA2P9,chr19,F,22596256,22603550,30649887,7294,30649887,18725,9
440519,ZNF724P,chr19,R,23223804,23250370,30676453,26566,30676453,18726,3
440533,PSG8,chr19,R,42752686,42765692,30689459,13006,30689459,18727,6
441864,TARM1,chr19,R,54069486,54081365,30701338,11879,30701338,18728,5
442902,MIR330,chr19,R,45638993,45639087,30701432,94,30701432,18729,0
442916,MIR371A,chr19,F,53787674,53787741,30701499,67,30701499,18730,0
442917,MIR372,chr19,F,53787889,53787956,30701566,67,30701566,18731,0
442918,MIR373,chr19,F,53788704,53788773,30701635,69,30701635,18732,0
444882,IGFL4,chr19,R,46039747,46057132,30719020,17385,30719020,18733,4
497049,FLJ25758,chr19,R,7004952,7006415,30720483,1463,30720483,18734,0
503538,A1BG-AS1,chr19,F,58351969,58355183,30723697,3214,30723697,18735,3
503834,DPRX,chr19,F,53601118,53637038,30759617,35920,30759617,18736,4
503835,DUXA,chr19,R,57151725,57167488,30775380,15763,30775380,18737,5
554235,ASPDH,chr19,R,50511599,50514690,30778471,3091,30778471,18738,7
574457,MIR181D,chr19,F,13874874,13875011,30778608,137,30778608,18739,0
574458,MIR512-1,chr19,F,53666678,53666762,30778692,84,30778692,18740,0
574459,MIR512-2,chr19,F,53669156,53669254,30778790,98,30778790,18741,0
574460,MIR498,chr19,F,53674196,53674320,30778914,124,30778914,18742,0
574461,MIR520E,chr19,F,53675710,53675797,30779001,87,30779001,18743,0
574462,MIR515-1,chr19,F,53679002,53679085,30779084,83,30779084,18744,0
574463,MIR519E,chr19,F,53679939,53680023,30779168,84,30779168,18745,0
574464,MIR520F,chr19,F,53682158,53682245,30779255,87,30779255,18746,0
574465,MIR515-2,chr19,F,53685008,53685091,30779338,83,30779338,18747,0
574466,MIR519C,chr19,F,53686468,53686555,30779425,87,30779425,18748,0
574467,MIR520A,chr19,F,53690880,53690965,30779510,85,30779510,18749,0
574468,MIR526B,chr19,F,53694392,53694475,30779593,83,30779593,18750,0
574469,MIR519B,chr19,F,53695212,53695293,30779674,81,30779674,18751,0
574470,MIR525,chr19,F,53697532,53697617,30779759,85,30779759,18752,0
574471,MIR523,chr19,F,53698384,53698471,30779846,87,30779846,18753,0
574472,MIR518F,chr19,F,53700014,53700101,30779933,87,30779933,18754,0
574473,MIR520B,chr19,F,53701226,53701287,30779994,61,30779994,18755,0
574474,MIR518B,chr19,F,53702736,53702819,30780077,83,30780077,18756,0
574475,MIR526A1,chr19,F,53706251,53706336,30780162,85,30780162,18757,0
574476,MIR520C,chr19,F,53707452,53707539,30780249,87,30780249,18758,0
574477,MIR518C,chr19,F,53708734,53708835,30780350,101,30780350,18759,0
574478,MIR524,chr19,F,53711001,53711088,30780437,87,30780437,18760,0
574479,MIR517A,chr19,F,53712267,53712354,30780524,87,30780524,18761,0
574480,MIR519D,chr19,F,53713346,53713434,30780612,88,30780612,18762,0
574481,MIR521-2,chr19,F,53716593,53716680,30780699,87,30780699,18763,0
574482,MIR520D,chr19,F,53720095,53720182,30780786,87,30780786,18764,0
574483,MIR517B,chr19,F,53721075,53721142,30780853,67,30780853,18765,0
574484,MIR520G,chr19,F,53722165,53722255,30780943,90,30780943,18766,0
574485,MIR516B2,chr19,F,53725441,53725526,30781028,85,30781028,18767,0
574486,MIR526A2,chr19,F,53726921,53726986,30781093,65,30781093,18768,0
574487,MIR518E,chr19,F,53729837,53729925,30781181,88,30781181,18769,0
574488,MIR518A1,chr19,F,53731005,53731090,30781266,85,30781266,18770,0
574489,MIR518D,chr19,F,53734876,53734963,30781353,87,30781353,18771,0
574490,MIR516B1,chr19,F,53736844,53736934,30781443,90,30781443,18772,0
574491,MIR518A2,chr19,F,53739332,53739419,30781530,87,30781530,18773,0
574492,MIR517C,chr19,F,53741312,53741407,30781625,95,30781625,18774,0
574493,MIR520H,chr19,F,53742511,53742599,30781713,88,30781713,18775,0
574494,MIR521-1,chr19,F,53748635,53748722,30781800,87,30781800,18776,0
574495,MIR522,chr19,F,53751210,53751297,30781887,87,30781887,18777,0
574496,MIR519A1,chr19,F,53752396,53752481,30781972,85,30781972,18778,0
574497,MIR527,chr19,F,53754017,53754102,30782057,85,30782057,18779,0
574498,MIR516A1,chr19,F,53756740,53756830,30782147,90,30782147,18780,0
574499,MIR516A2,chr19,F,53761132,53761222,30782237,90,30782237,18781,0
574500,MIR519A2,chr19,F,53762343,53762430,30782324,87,30782324,18782,0
606293,KLKP1,chr19,R,50882095,50896398,30796627,14303,30796627,18783,4
641367,LOC641367,chr19,F,21750744,21753438,30799321,2694,30799321,18784,0
641649,TMEM91,chr19,F,41363965,41384083,30819439,20118,30819439,18785,5
641702,FAM138F,chr19,R,76219,77690,30820910,1471,30820910,18786,2
643669,CCER2,chr19,R,38908979,38914370,30826301,5391,30826301,18787,5
643719,SCGB1B2P,chr19,R,34576732,34577691,30827260,959,30827260,18788,2
644050,LINC01529,chr19,R,35788875,35797909,30836294,9034,30836294,18789,7
644096,SDHAF1,chr19,F,35995187,35996318,30837425,1131,30837425,18790,0
644189,LOC644189,chr19,F,36421173,36422897,30839149,1724,30839149,18791,0
644554,LOC644554,chr19,F,37817410,37826638,30848377,9228,30848377,18792,4
645191,LINGO3,chr19,R,2289774,2308157,30866760,18383,30866760,18793,1
645432,ARRDC5,chr19,R,4890436,4916820,30893144,26384,30893144,18794,4
645553,LOC645553,chr19,R,46189028,46230374,30934490,41346,30934490,18795,4
646457,C19orf67,chr19,R,14081600,14085795,30938685,4195,30938685,18796,5
646508,FAM90A27P,chr19,F,53282289,53284349,30940745,2060,30940745,18797,2
646643,SBK2,chr19,R,55529335,55537174,30948584,7839,30948584,18798,4
646862,RNF225,chr19,F,58395656,58398954,30951882,3298,30951882,18799,1
652995,UCA1,chr19,F,15828946,15836321,30959257,7375,30959257,18800,2
653492,PSG10P,chr19,R,42836996,42855718,30977979,18722,30977979,18801,6
653499,LGALS7B,chr19,F,38789209,38791754,30980524,2545,30980524,18802,3
653583,PHLDB3,chr19,R,43474340,43504920,31011104,30580,31011104,18803,16
653656,MBD3L4,chr19,R,7037743,7040826,31014187,3083,31014187,18804,2
653657,MBD3L3,chr19,R,7056204,7069615,31027598,13411,31027598,18805,3
653677,SEC1P,chr19,F,48638038,48682245,31071805,44207,31071805,18806,4
664701,ZNF826P,chr19,R,20398657,20424965,31098113,26308,31098113,18807,2
664709,HNRNPA1P10,chr19,R,11665735,11667089,31099467,1354,31099467,18808,0
692091,SNORD23,chr19,F,47755852,47755962,31099577,110,31099577,18809,0
692202,SNORD88A,chr19,R,50799438,50799535,31099674,97,31099674,18810,0
692203,SNORD88B,chr19,R,50799028,50799125,31099771,97,31099771,18811,0
692204,SNORD88C,chr19,R,50802324,50802421,31099868,97,31099868,18812,0
692229,SNORD105,chr19,F,10107650,10107735,31099953,85,31099953,18813,0
692312,PPAN-P2RY11,chr19,F,10106222,10115389,31109120,9167,31109120,18814,12
693222,MIR637,chr19,R,3961413,3961512,31109219,99,31109219,18815,0
693223,MIR638,chr19,F,10718403,10718503,31109319,100,31109319,18816,0
693224,MIR639,chr19,F,14529542,14529640,31109417,98,31109417,18817,0
693225,MIR640,chr19,F,19435062,19435158,31109513,96,31109513,18818,0
693226,MIR641,chr19,R,40282542,40282641,31109612,99,31109612,18819,0
693227,MIR642A,chr19,F,45674927,45675024,31109709,97,31109709,18820,0
693228,MIR643,chr19,F,52281796,52281893,31109806,97,31109806,18821,0
723805,LOC723805,chr19,F,39439263,39442019,31112562,2756,31112562,18822,2
728361,OVOL3,chr19,F,36108828,36113720,31117454,4892,31117454,18823,4
728485,LOC728485,chr19,F,36773117,36777078,31121415,3961,31121415,18824,1
728752,LOC728752,chr19,F,36489626,36491040,31122829,1414,31122829,18825,0
729359,PLIN4,chr19,R,4502179,4518541,31139191,16362,31139191,18826,8
729440,CCDC61,chr19,F,45995450,46018616,31162357,23166,31162357,18827,15
729648,ZNF812,chr19,R,9688854,9700817,31174320,11963,31174320,18828,6
729747,ZNF878,chr19,R,12043647,12052967,31183640,9320,31183640,18829,4
729767,CEACAM18,chr19,F,51478546,51491261,31196355,12715,31196355,18830,6
729956,SHISA7,chr19,R,55428737,55442863,31210481,14126,31210481,18831,3
729966,LOC729966,chr19,R,18249949,18255419,31215951,5470,31215951,18832,3
729974,RFPL4AL1,chr19,F,55769117,55773423,31220257,4306,31220257,18833,2
729975,LINC01530,chr19,R,51591782,51594380,31222855,2598,31222855,18834,1
729991,MEF2BNB,chr19,R,19176903,19192591,31238543,15688,31238543,18835,12
730051,ZNF814,chr19,R,57869378,57889074,31258239,19696,31258239,18836,2
730087,ZNF726,chr19,F,23914881,23933967,31277325,19086,31277325,18837,3
768217,MIR769,chr19,F,46018931,46019049,31277443,118,31277443,18838,0
100049587,SIGLEC14,chr19,R,51642552,51646879,31281770,4327,31281770,18839,7
100073347,MIMT1,chr19,F,56840901,56848554,31289423,7653,31289423,18840,1
100101266,HAVCR1P1,chr19,R,24162192,24163447,31290678,1255,31290678,18841,0
100113382,SNORD105B,chr19,F,10109748,10109840,31290770,92,31290770,18842,0
100125288,ZGLP1,chr19,R,10304802,10309557,31295525,4755,31295525,18843,3
100126325,MIR935,chr19,F,53982306,53982397,31295616,91,31295616,18844,0
100126780,SNAR-G1,chr19,F,49037019,49037147,31295744,128,31295744,18845,0
100126781,SNAR-F,chr19,F,50604962,50605085,31295867,123,31295867,18846,0
100126798,SNAR-A1,chr19,F,47918428,47918550,31295989,122,31295989,18847,0
100126799,SNAR-A2,chr19,F,47934180,47934302,31296111,122,31296111,18848,0
100126800,SNAR-A12,chr19,F,47907677,47907799,31296233,122,31296233,18849,0
100128139,LINC01233,chr19,F,22532625,22533494,31297102,869,31297102,18850,1
100128252,ZNF667-AS1,chr19,F,56477873,56495437,31314666,17564,31314666,18851,1
100128398,LOC100128398,chr19,F,58002893,58007206,31318979,4313,31318979,18852,3
100128568,LOC100128568,chr19,F,5978402,6020363,31360940,41961,31360940,18853,3
100128569,C19orf71,chr19,F,3539156,3544030,31365814,4874,31365814,18854,4
100128573,LOC100128573,chr19,R,7472836,7473361,31366339,525,31366339,18855,0
100128675,HPN-AS1,chr19,R,35059058,35106304,31413585,47246,31413585,18856,5
100128682,LINC01531,chr19,F,35405606,35416840,31424819,11234,31424819,18857,4
100129083,LOC100129083,chr19,F,51415905,51417425,31426339,1520,31426339,18858,2
100129543,ZNF730,chr19,F,23116974,23147212,31456577,30238,31456577,18859,3
100129800,ZNF807,chr19,R,34541691,34545404,31460290,3713,31460290,18860,2
100129842,ZNF737,chr19,R,20531223,20565847,31494914,34624,31494914,18861,6
100129935,LOC100129935,chr19,F,39638684,39642401,31498631,3717,31498631,18862,3
100130342,SCGB2B3P,chr19,F,34645872,34646052,31498811,180,31498811,18863,0
100130519,TMEM221,chr19,R,17435508,17448660,31511963,13152,31511963,18864,2
100130827,SBK3,chr19,R,55540558,55545543,31516948,4985,31516948,18865,4
100131094,DPP9-AS1,chr19,F,4679281,4685948,31523615,6667,31523615,18866,2
100131137,BSPH1,chr19,R,47968045,47992170,31547740,24125,31547740,18867,6
100131691,MZF1-AS1,chr19,F,58559185,58574797,31563352,15612,31563352,18868,5
100131801,PET100,chr19,F,7629784,7631624,31565192,1840,31565192,18869,4
100132815,IPO5P1,chr19,R,23255052,23274251,31584391,19199,31584391,18870,4
100134317,LOC100134317,chr19,F,36311342,36312668,31585717,1326,31585717,18871,1
100169890,PEG3-AS1,chr19,F,56812479,56813793,31587031,1314,31587031,18872,0
100169951,SNAR-A3,chr19,F,47923778,47923899,31587152,121,31587152,18873,0
100169952,SNAR-A5,chr19,R,50100890,50101011,31587273,121,31587273,18874,0
100169953,SNAR-A7,chr19,R,50107013,50107134,31587394,121,31587394,18875,0
100169954,SNAR-A11,chr19,R,50128401,50128522,31587515,121,31587515,18876,0
100169955,SNAR-A9,chr19,R,50117719,50117840,31587636,121,31587636,18877,0
100169956,SNAR-A4,chr19,R,50092488,50092609,31587757,121,31587757,18878,0
100169957,SNAR-A6,chr19,R,50103954,50104075,31587878,121,31587878,18879,0
100169958,SNAR-A8,chr19,R,50112367,50112488,31587999,121,31587999,18880,0
100169959,SNAR-A13,chr19,F,47944921,47945043,31588121,122,31588121,18881,0
100170216,SNAR-A10,chr19,R,50123073,50123194,31588242,121,31588242,18882,0
100170217,SNAR-B2,chr19,R,50139117,50139237,31588362,120,31588362,18883,0
100170218,SNAR-C2,chr19,F,47928817,47928937,31588482,120,31588482,18884,0
100170219,SNAR-C4,chr19,F,47939540,47939660,31588602,120,31588602,18885,0
100170220,SNAR-E,chr19,R,46830584,46830704,31588722,120,31588722,18886,0
100170223,SNAR-C5,chr19,F,47913050,47913170,31588842,120,31588842,18887,0
100170224,SNAR-B1,chr19,R,50133744,50133864,31588962,120,31588962,18888,0
100170225,SNAR-C1,chr19,F,47955681,47955801,31589082,120,31589082,18889,0
100170226,SNAR-C3,chr19,F,47950295,47950414,31589201,119,31589201,18890,0
100170227,SNAR-D,chr19,R,50140201,50140320,31589320,119,31589320,18891,0
100170228,SNAR-G2,chr19,R,49031668,49031787,31589439,119,31589439,18892,0
100170229,SRRM5,chr19,F,43612100,43614498,31591837,2398,31591837,18893,0
100170765,ERICH4,chr19,F,41443157,41444765,31593445,1608,31593445,18894,1
100189006,TRT-AGT1-3,chr19,F,33177056,33177130,31593519,74,31593519,18895,0
100189195,TRN-GTT2-6,chr19,F,1383562,1383636,31593593,74,31593593,18896,0
100189306,TRF-GAA1-4,chr19,R,1383361,1383434,31593666,73,31593666,18897,0
100189324,TRI-TAT1-1,chr19,R,39412167,39412260,31593759,93,31593759,18898,1
100189416,TRV-CAC3-1,chr19,R,4724634,4724707,31593832,73,31593832,18899,0
100191063,SNAR-A14,chr19,R,50097825,50097946,31593953,121,31593953,18900,0
100271846,ERVV-2,chr19,F,53044737,53051127,31600343,6390,31600343,18901,1
100271849,MEF2B,chr19,R,19145566,19170289,31625066,24723,31625066,18902,8
100287177,C19orf83,chr19,F,45641493,45642840,31626413,1347,31626413,18903,2
100287226,ZNF729,chr19,F,22286449,22317176,31657140,30727,31657140,18904,3
100287477,LOC100287477,chr19,R,50058265,50060497,31659372,2232,31659372,18905,1
100288123,LOC100288123,chr19,F,1822088,1824543,31661827,2455,31661827,18906,2
100289333,LOC100289333,chr19,F,12195014,12207574,31674387,12560,31674387,18907,1
100289650,LOC100289650,chr19,F,42821862,42826878,31679403,5016,31679403,18908,3
100293516,ZNF587B,chr19,F,57830293,57846238,31695348,15945,31695348,18909,3
100302127,MIR1470,chr19,F,15449547,15449608,31695409,61,31695409,18910,0
100302179,MIR1270,chr19,R,20399271,20399354,31695492,83,31695492,18911,0
100302205,MIR1283-2,chr19,F,53758231,53758318,31695579,87,31695579,18912,0
100302210,MIR1909,chr19,R,1816158,1816238,31695659,80,31695659,18913,0
100302213,MIR1181,chr19,R,10403457,10403538,31695740,81,31695740,18914,0
100302226,MIR1238,chr19,F,10552121,10552204,31695823,83,31695823,18915,0
100302255,MIR1323,chr19,F,53671967,53672040,31695896,73,31695896,18916,0
100302265,MIR1283-1,chr19,F,53688480,53688567,31695983,87,31695983,18917,0
100302283,MIR1227,chr19,R,2234061,2234149,31696071,88,31696071,18918,0
100379224,LOC100379224,chr19,R,44105338,44113183,31703916,7845,31703916,18919,1
100420587,LOC100420587,chr19,R,28435387,28727694,31996223,292307,31996223,18920,9
100422832,MIR3191,chr19,R,47226943,47227019,31996299,76,31996299,18921,0
100422833,MIR3188,chr19,F,18282076,18282161,31996384,85,31996384,18922,0
100422854,MIR3187,chr19,F,813583,813653,31996454,70,31996454,18923,0
100422899,MIR3190,chr19,F,47226941,47227021,31996534,80,31996534,18924,0
100422913,MIR320E,chr19,R,46709292,46709345,31996587,53,31996587,18925,0
100422919,MIR1302-11,chr19,F,71972,72110,31996725,138,31996725,18926,0
100422925,MIR4322,chr19,F,10230412,10230485,31996798,73,31996798,18927,0
100422943,MIR3189,chr19,F,18386561,18386634,31996871,73,31996871,18928,0
100422979,MIR4324,chr19,R,49308796,49308868,31996943,72,31996943,18929,0
100422980,MIR4323,chr19,R,42133444,42133513,31997012,69,31997012,18930,0
100423031,MIR4321,chr19,F,2250638,2250718,31997092,80,31997092,18931,0
100500845,MIR642B,chr19,R,45674931,45675008,31997169,77,31997169,18932,0
100500888,MIR3940,chr19,R,6416409,6416511,31997271,102,31997271,18933,0
100505495,PCAT19,chr19,R,41454168,41500644,32043747,46476,32043747,18934,3
100505555,LOC100505555,chr19,R,9787405,9793381,32049723,5976,32049723,18935,1
100505585,LOC100505585,chr19,F,41928819,41930136,32051040,1317,32051040,18936,1
100505622,LOC100505622,chr19,F,42132628,42137099,32055511,4471,32055511,18937,2
100505681,NAPA-AS1,chr19,F,47484281,47501597,32072827,17316,32072827,18938,3
100505715,LOC100505715,chr19,R,43891803,43901803,32082827,10000,32082827,18939,2
100505812,CARD8-AS1,chr19,F,48255674,48258194,32085347,2520,32085347,18940,1
100505835,LINC01532,chr19,F,29002554,29013955,32096748,11401,32096748,18941,4
100505851,LOC100505851,chr19,R,23937828,23957930,32116850,20102,32116850,18942,3
100506012,PPP5D1,chr19,R,46480787,46601200,32237263,120413,32237263,18943,4
100506033,PTOV1-AS1,chr19,R,49838644,49851676,32250295,13032,32250295,18944,3
100506068,DACT3-AS1,chr19,F,46660363,46677456,32267388,17093,32267388,18945,4
100506114,LOC100506114,chr19,R,50486559,50488086,32268915,1527,32268915,18946,1
100506374,LOC100506374,chr19,F,56264259,56310454,32315110,46195,32315110,18947,14
100506469,TMEM147-AS1,chr19,R,35540737,35546029,32320402,5292,32320402,18948,3
100506634,LOC100506634,chr19,R,58403203,58408457,32325656,5254,32325656,18949,1
100506930,LINC00665,chr19,R,36313060,36331718,32344314,18658,32344314,18950,7
100507003,GFY,chr19,F,49421317,49428977,32351974,7660,32351974,18951,5
100507290,ZNF865,chr19,F,55613592,55618545,32356927,4953,32356927,18952,0
100507373,LOC100507373,chr19,F,14137151,14171264,32391040,34113,32391040,18953,2
100507433,ZNF571-AS1,chr19,F,37548948,37587348,32429440,38400,32429440,18954,7
100507527,THEG5,chr19,F,31588188,31593550,32434802,5362,32434802,18955,3
100507567,RAB11B-AS1,chr19,R,8374375,8390691,32451118,16316,32451118,18956,2
100507588,TGFBR3L,chr19,F,7915454,7919097,32454761,3643,32454761,18957,3
100529215,ZNF559-ZNF177,chr19,F,9324225,9382617,32513153,58392,32513153,18958,12
100529240,ZNF816-ZNF321P,chr19,R,52927134,52962911,32548930,35777,32548930,18959,4
100529262,MIA-RAB4B,chr19,F,40775536,40796944,32570338,21408,32570338,18960,9
100529264,RAB4B-EGLN2,chr19,F,40778218,40808441,32600561,30223,32600561,18961,6
100529855,ZNF625-ZNF20,chr19,R,12131349,12156731,32625943,25382,32625943,18962,3
100533990,APOC4-APOC2,chr19,F,44942237,44949565,32633271,7328,32633271,18963,5
100616163,MIR4530,chr19,R,39409622,39409678,32633327,56,32633327,18964,0
100616168,MIR4754,chr19,R,58386769,58386858,32633416,89,32633416,18965,0
100616171,MIR4752,chr19,F,54282108,54282180,32633488,72,32633488,18966,0
100616185,MIR371B,chr19,R,53787676,53787742,32633554,66,32633554,18967,0
100616313,MIR4749,chr19,F,49854590,49854651,32633615,61,32633615,18968,0
100616314,MIR4750,chr19,F,49888174,49888230,32633671,56,32633671,18969,0
100616337,MIR4747,chr19,F,4932686,4932740,32633725,54,32633725,18970,0
100616355,MIR4531,chr19,R,44653685,44653732,32633772,47,32633772,18971,0
100616371,MIR4746,chr19,F,4445977,4446048,32633843,71,32633843,18972,0
100616425,MIR4748,chr19,F,10780253,10780335,32633925,82,32633925,18973,0
100616459,MIR4745,chr19,F,804939,805001,32633987,62,32633987,18974,0
100616483,MIR4751,chr19,F,49933063,49933137,32634061,74,32634061,18975,0
100631378,LOC100631378,chr19,R,37823721,37855196,32665536,31475,32665536,18976,5
100652909,LINC00904,chr19,R,34892028,34898943,32672451,6915,32672451,18977,2
100652911,LOC100652911,chr19,F,34905285,34908191,32675357,2906,32675357,18978,1
100847016,MIR5695,chr19,F,12920319,12920404,32675442,85,32675442,18979,0
100847049,MIR4999,chr19,R,8389289,8389380,32675533,91,32675533,18980,0
100847070,MIR5196,chr19,F,35345512,35345627,32675648,115,32675648,18981,0
100847071,MIR5684,chr19,F,12787127,12787192,32675713,65,32675713,18982,0
100847074,MIR5088,chr19,F,49682116,49682195,32675792,79,32675792,18983,0
100847093,MIR5589,chr19,F,10038353,10038413,32675852,60,32675852,18984,0
100862728,UPK1A-AS1,chr19,R,35667947,35673291,32681196,5344,32681196,18985,1
100874085,NUCB1-AS1,chr19,R,48910929,48918891,32689158,7962,32689158,18986,1
100996288,LOC100996288,chr19,R,9834078,9835147,32690227,1069,32690227,18987,1
100996307,LIPE-AS1,chr19,F,42397147,42652355,32945435,255208,32945435,18988,3
100996349,LOC100996349,chr19,F,22608015,22608501,32945921,486,32945921,18989,0
100996351,LOC100996351,chr19,R,3141575,3155175,32959521,13600,32959521,18990,3
100996665,LINC01533,chr19,F,32025861,32048899,32982559,23038,32982559,18991,5
100996681,LOC100996681,chr19,F,33553112,33557506,32986953,4394,32986953,18992,2
101059948,LOC101059948,chr19,R,49018247,49019484,32988190,1237,32988190,18993,2
101060177,LOC101060177,chr19,F,52588525,52621724,33021389,33199,33021389,18994,4
101060181,LOC101060181,chr19,R,12247243,12267038,33041184,19795,33041184,18995,3
101060187,LOC101060187,chr19,R,19745228,19753407,33049363,8179,33049363,18996,2
101180976,IFNL4,chr19,R,39246313,39248856,33051906,2543,33051906,18997,4
101669766,ZNF350-AS1,chr19,F,51949133,51981367,33084140,32234,33084140,18998,2
101927151,LOC101927151,chr19,F,27793466,27806782,33097456,13316,33097456,18999,3
101927210,LOC101927210,chr19,R,28491863,28632728,33238321,140865,33238321,19000,1
101927254,LOC101927254,chr19,R,31149949,31232298,33320670,82349,33320670,19001,4
101927277,LOC101927277,chr19,R,31588039,31595720,33328351,7681,33328351,19002,1
101927411,LOC101927411,chr19,R,32102087,32105916,33332180,3829,33332180,19003,3
101927522,LOC101927522,chr19,R,35418953,35434707,33347934,15754,33347934,19004,4
101927572,LOC101927572,chr19,F,36014498,36045997,33379433,31499,33379433,19005,3
101927599,ZNF529-AS1,chr19,F,36573069,36594716,33401080,21647,33401080,19006,5
101927621,LINC01534,chr19,R,36685438,36687449,33403091,2011,33403091,19007,2
101927667,LINC01535,chr19,F,37251884,37265535,33416742,13651,33416742,19008,9
101927720,ZNF793-AS1,chr19,R,37497158,37507087,33426671,9929,33426671,19009,2
101927931,LINC01480,chr19,F,41535497,41536904,33428078,1407,33428078,19010,2
101928063,LOC101928063,chr19,R,43996895,44002870,33434053,5975,33434053,19011,2
101928238,LOC101928238,chr19,F,9538738,9539728,33435043,990,33435043,19012,1
101928295,LOC101928295,chr19,R,49368704,49388081,33454420,19377,33454420,19013,2
101928344,LOC101928344,chr19,R,204024,246533,33496929,42509,33496929,19014,18
101928378,PTOV1-AS2,chr19,R,49856464,49859289,33499754,2825,33499754,19015,4
101928450,LOC101928450,chr19,R,781001,782290,33501043,1289,33501043,19016,1
101928464,LOC101928464,chr19,F,11987602,12046276,33559717,58674,33559717,19017,7
101928517,LOC101928517,chr19,R,51152922,51181966,33588761,29044,33588761,19018,4
101928543,LOC101928543,chr19,R,1763692,1781351,33606420,17659,33606420,19019,7
101928571,ZNF649-AS1,chr19,F,51888024,51900464,33618860,12440,33618860,19020,2
101928572,LOC101928572,chr19,F,2302314,2304225,33620771,1911,33620771,19021,1
101928574,LOC101928574,chr19,R,12207434,12242746,33656083,35312,33656083,19022,7
101928602,LOC101928602,chr19,R,2458936,2462185,33659332,3249,33659332,19023,1
101928631,LOC101928631,chr19,R,2908627,2926778,33677483,18151,33677483,19024,4
101928804,LOC101928804,chr19,R,54769421,54771064,33679126,1643,33679126,19025,2
101928844,LOC101928844,chr19,F,5847466,5858239,33689899,10773,33689899,19026,3
101928845,LOC101928845,chr19,F,14333741,14343913,33700071,10172,33700071,19027,1
101928872,LOC101928872,chr19,F,6066875,6077118,33710314,10243,33710314,19028,1
101928886,LOC101928886,chr19,F,56066683,56078801,33722432,12118,33722432,19029,3
101928926,LOC101928926,chr19,F,19763516,19789213,33748129,25697,33748129,19030,6
101928982,LOC101928982,chr19,R,56536157,56538750,33750722,2593,33750722,19031,3
101929007,LOC101929007,chr19,R,21587404,21594699,33758017,7295,33758017,19032,1
101929059,ZIM2-AS1,chr19,F,56765321,56799646,33792342,34325,33792342,19033,3
101929060,LOC101929060,chr19,R,301436,304505,33795411,3069,33795411,19034,1
101929097,LOC101929097,chr19,R,2511217,2513571,33797765,2354,33797765,19035,2
101929124,LOC101929124,chr19,R,22520994,22527949,33804720,6955,33804720,19036,4
101929144,LOC101929144,chr19,R,23054822,23061265,33811163,6443,33811163,19037,7
101929164,LOC101929164,chr19,R,23015074,23023697,33819786,8623,33819786,19038,3
101929206,LOC101929206,chr19,F,23832188,23871182,33858780,38994,33858780,19039,3
101929818,LOC101929818,chr19,F,54515663,54527372,33870489,11709,33870489,19040,4
101930071,LOC101930071,chr19,F,42397127,42408452,33881814,11325,33881814,19041,1
101930593,LOC101930593,chr19,F,55160023,55166322,33888113,6299,33888113,19042,4
101954271,RNU6-9,chr19,F,893483,893590,33888220,107,33888220,19043,0
102238594,SPACA6P-AS,chr19,R,51685362,51693456,33896314,8094,33896314,19044,1
102464836,MIR6088,chr19,F,45436653,45436704,33896365,51,33896365,19045,0
102465473,MIR6790,chr19,R,6392920,6392983,33896428,63,33896428,19046,0
102465474,MIR6791,chr19,R,6736711,6736778,33896495,67,33896495,19047,0
102465475,MIR6792,chr19,F,7617438,7617505,33896562,67,33896562,19048,0
102465476,MIR6795,chr19,R,15179282,15179350,33896630,68,33896630,19049,0
102465477,MIR6796,chr19,F,40369845,40369907,33896692,62,33896692,19050,0
102465478,MIR6797,chr19,F,41869626,41869698,33896764,72,33896764,19051,0
102465479,MIR6799,chr19,F,49791865,49791934,33896833,69,33896833,19052,0
102465480,MIR6800,chr19,F,49832017,49832099,33896915,82,33896915,19053,0
102465481,MIR6802,chr19,R,55239911,55239976,33896980,65,33896980,19054,0
102465482,MIR6804,chr19,R,55230884,55230952,33897048,68,33897048,19055,0
102465483,MIR6805,chr19,F,55388180,55388242,33897110,62,33897110,19056,0
102465484,MIR6806,chr19,F,58334687,58334751,33897174,64,33897174,19057,0
102465533,MIR6885,chr19,R,6389637,6389703,33897240,66,33897240,19058,0
102465534,MIR6886,chr19,F,11113473,11113534,33897301,61,33897301,19059,0
102465838,MIR7850,chr19,F,2630714,2630793,33897380,79,33897380,19060,0
102465856,MIR7974,chr19,R,11495543,11495622,33897459,79,33897459,19061,0
102465873,MIR8074,chr19,R,51206928,51207009,33897540,81,33897540,19062,0
102465875,MIR8077,chr19,F,42351130,42351205,33897615,75,33897615,19063,0
102465879,MIR8085,chr19,F,44758656,44758721,33897680,65,33897680,19064,0
102465974,MIR6719,chr19,R,39829715,39829802,33897767,87,33897767,19065,0
102465976,MIR6807,chr19,F,58550284,58550376,33897859,92,33897859,19066,0
102466196,MIR6794,chr19,F,12852259,12852327,33897927,68,33897927,19067,0
102466205,MIR6887,chr19,F,35122699,35122764,33897992,65,33897992,19068,0
102466251,MIR8061,chr19,F,54645308,54645383,33898067,75,33898067,19069,0
102466515,MIR1199,chr19,F,14073360,14073479,33898186,119,33898186,19070,0
102466659,MIR6515,chr19,F,12940483,12940540,33898243,57,33898243,19071,0
102466736,MIR6789,chr19,R,2235828,2235926,33898341,98,33898341,19072,0
102466737,MIR6793,chr19,F,10828972,10829035,33898404,63,33898404,19073,0
102466738,MIR6798,chr19,F,49009905,49009972,33898471,67,33898471,19074,0
102466739,MIR6803,chr19,R,55245185,55245250,33898536,65,33898536,19075,0
102466806,MIR7108,chr19,R,2434913,2435000,33898623,87,33898623,19076,0
102466872,MIR7975,chr19,R,55123224,55123292,33898691,68,33898691,19077,0
102466984,MIR6801,chr19,F,52222019,52222098,33898770,79,33898770,19078,0
102723513,ZNF30-AS1,chr19,R,34923014,34926826,33902582,3812,33902582,19079,2
102723540,LOC102723540,chr19,R,34849047,34860269,33913804,11222,33913804,19080,2
102723617,LOC102723617,chr19,F,35597894,35601501,33917411,3607,33917411,19081,2
102723798,LOC102723798,chr19,F,1162444,1168687,33923654,6243,33923654,19082,4
102723811,LOC102723811,chr19,R,1246267,1248504,33925891,2237,33925891,19083,1
102724105,ZNF528-AS1,chr19,R,52388838,52397757,33934810,8919,33934810,19084,6
102724273,LOC102724273,chr19,R,54146663,54152219,33940366,5556,33940366,19085,3
102724279,LOC102724279,chr19,R,15851992,15864904,33953278,12912,33953278,19086,2
102724290,LOC102724290,chr19,F,54671428,54672828,33954678,1400,33954678,19087,2
102724300,LOC102724300,chr19,R,54785868,54817653,33986463,31785,33986463,19088,2
102724352,LOC102724352,chr19,F,55175310,55177540,33988693,2230,33988693,19089,1
102724360,LOC102724360,chr19,F,18946127,18946836,33989402,709,33989402,19090,1
102724427,LOC102724427,chr19,F,20247267,20257291,33999426,10024,33999426,19091,7
102724436,LOC102724436,chr19,R,20397439,20398579,34000566,1140,34000566,19092,0
102724908,LOC102724908,chr19,F,28606687,28615229,34009108,8542,34009108,19093,3
102724958,LOC102724958,chr19,F,28968467,28970672,34011313,2205,34011313,19094,3
102725176,LOC102725176,chr19,R,47863250,47869359,34017422,6109,34017422,19095,3
102725180,LOC102725180,chr19,F,1168954,1174735,34023203,5781,34023203,19096,2
102725254,LOC102725254,chr19,F,18204738,18205569,34024034,831,34024034,19097,1
103625684,RNU6-2,chr19,F,1021521,1021628,34024141,107,34024141,19098,0
104355426,LENG8-AS1,chr19,R,54444815,54449038,34028364,4223,34028364,19099,2
104472717,LINC01224,chr19,R,23399232,23416074,34045206,16842,34045206,19100,5
105221694,BISPR,chr19,F,17405685,17415736,34055257,10051,34055257,19101,3
105369157,LOC105369157,chr19,R,159549,203999,34099707,44450,34099707,19102,4
105369197,LOC105369197,chr19,R,51803357,51847484,34143834,44127,34143834,19103,5
105369202,LOC105369202,chr19,R,15855339,15863863,34152358,8524,34152358,19104,2
105369211,LOC105369211,chr19,F,11559332,11564088,34157114,4756,34157114,19105,2
105372232,LOC105372232,chr19,R,490309,507459,34174264,17150,34174264,19106,3
105372233,LOC105372233,chr19,R,567432,572148,34178980,4716,34178980,19107,3
105372234,LOC105372234,chr19,F,633859,634335,34179456,476,34179456,19108,1
105372235,LOC105372235,chr19,R,1007926,1008665,34180195,739,34180195,19109,2
105372236,LOC105372236,chr19,R,1262101,1264602,34182696,2501,34182696,19110,2
105372237,LOC105372237,chr19,F,1747995,1748745,34183446,750,34183446,19111,1
105372238,LOC105372238,chr19,R,1940113,1940782,34184115,669,34184115,19112,1
105372239,LOC105372239,chr19,R,2214470,2221969,34191614,7499,34191614,19113,2
105372240,LOC105372240,chr19,R,2268492,2269421,34192543,929,34192543,19114,2
105372241,LOC105372241,chr19,F,2621725,2632747,34203565,11022,34203565,19115,3
105372242,LOC105372242,chr19,R,3065621,3075468,34213412,9847,34213412,19116,4
105372243,LOC105372243,chr19,R,3121310,3125016,34217118,3706,34217118,19117,2
105372244,LOC105372244,chr19,R,3296764,3306949,34227303,10185,34227303,19118,5
105372245,LOC105372245,chr19,F,3496114,3500521,34231710,4407,34231710,19119,5
105372246,LOC105372246,chr19,F,3481893,3490729,34240546,8836,34240546,19120,4
105372247,LOC105372247,chr19,F,3668167,3674402,34246781,6235,34246781,19121,2
105372248,LOC105372248,chr19,R,3761753,3762640,34247668,887,34247668,19122,2
105372249,LOC105372249,chr19,F,4580695,4586023,34252996,5328,34252996,19123,3
105372250,LOC105372250,chr19,F,4722941,4725174,34255229,2233,34255229,19124,4
105372251,LOC105372251,chr19,F,4776493,4782243,34260979,5750,34260979,19125,2
105372252,LOC105372252,chr19,F,5336446,5338448,34262981,2002,34262981,19126,3
105372253,LOC105372253,chr19,F,5293412,5294681,34264250,1269,34264250,19127,1
105372254,LOC105372254,chr19,F,5692218,5693257,34265289,1039,34265289,19128,1
105372255,LOC105372255,chr19,R,6126372,6199572,34338489,73200,34338489,19129,7
105372256,LOC105372256,chr19,R,6901991,6938790,34375288,36799,34375288,19130,2
105372257,LOC105372257,chr19,F,6953210,6954912,34376990,1702,34376990,19131,1
105372258,LOC105372258,chr19,F,7006641,7012524,34382873,5883,34382873,19132,1
105372259,LOC105372259,chr19,R,7075751,7092337,34399459,16586,34399459,19133,2
105372261,LOC105372261,chr19,R,7514352,7524954,34410061,10602,34410061,19134,3
105372262,LOC105372262,chr19,R,7703079,7707221,34414203,4142,34414203,19135,4
105372263,LOC105372263,chr19,F,7770621,7785167,34428749,14546,34428749,19136,5
105372264,LOC105372264,chr19,R,7902648,7903716,34429817,1068,34429817,19137,1
105372265,LOC105372265,chr19,F,7925687,7926793,34430923,1106,34430923,19138,1
105372266,LOC105372266,chr19,F,8008389,8015581,34438115,7192,34438115,19139,3
105372267,LOC105372267,chr19,F,8630644,8677993,34485464,47349,34485464,19140,7
105372268,LOC105372268,chr19,R,9507810,9514673,34492327,6863,34492327,19141,1
105372269,LOC105372269,chr19,F,9435606,9462529,34519250,26923,34519250,19142,3
105372270,LOC105372270,chr19,F,9709645,9722410,34532015,12765,34532015,19143,1
105372271,LOC105372271,chr19,F,10037576,10041022,34535461,3446,34535461,19144,7
105372272,LOC105372272,chr19,R,10260102,10283474,34558833,23372,34558833,19145,4
105372273,LOC105372273,chr19,F,11203627,11216176,34571382,12549,34571382,19146,2
105372274,LOC105372274,chr19,R,11300776,11321262,34591868,20486,34591868,19147,2
105372275,LOC105372275,chr19,F,12116358,12147765,34623275,31407,34623275,19148,2
105372276,LOC105372276,chr19,F,12450439,12460839,34633675,10400,34633675,19149,2
105372277,LOC105372277,chr19,R,12379216,12386256,34640715,7040,34640715,19150,3
105372278,LOC105372278,chr19,F,12552416,12553644,34641943,1228,34641943,19151,1
105372279,LOC105372279,chr19,R,12633082,12640696,34649557,7614,34649557,19152,3
105372280,LOC105372280,chr19,R,12687443,12688820,34650934,1377,34650934,19153,1
105372281,LOC105372281,chr19,F,12826784,12833089,34657239,6305,34657239,19154,1
105372282,LOC105372282,chr19,F,13104204,13105328,34658363,1124,34658363,19155,2
105372283,LOC105372283,chr19,F,13409195,13438775,34687943,29580,34687943,19156,4
105372284,LOC105372284,chr19,R,13684208,13724394,34728129,40186,34728129,19157,9
105372285,LOC105372285,chr19,F,14006899,14008223,34729453,1324,34729453,19158,2
105372286,LOC105372286,chr19,F,14114285,14119432,34734600,5147,34734600,19159,3
105372287,LOC105372287,chr19,R,14267815,14292913,34759698,25098,34759698,19160,4
105372288,LOC105372288,chr19,R,14305457,14325431,34779672,19974,34779672,19161,2
105372289,LOC105372289,chr19,R,14542587,14562887,34799972,20300,34799972,19162,2
105372290,LOC105372290,chr19,R,15827044,15835604,34808532,8560,34808532,19163,2
105372291,LOC105372291,chr19,R,16014135,16015056,34809453,921,34809453,19164,1
105372292,LOC105372292,chr19,F,16065691,16066302,34810064,611,34810064,19165,2
105372293,LOC105372293,chr19,R,16186279,16190513,34814298,4234,34814298,19166,2
105372294,LOC105372294,chr19,R,16382988,16385122,34816432,2134,34816432,19167,1
105372295,LOC105372295,chr19,F,16572506,16578448,34822374,5942,34822374,19168,2
105372296,LOC105372296,chr19,F,16628411,16629722,34823685,1311,34823685,19169,1
105372298,LOC105372298,chr19,R,17378789,17379772,34824668,983,34824668,19170,2
105372299,LOC105372299,chr19,R,17733337,17750695,34842026,17358,34842026,19171,4
105372300,LOC105372300,chr19,F,18317572,18321997,34846451,4425,34846451,19172,2
105372301,LOC105372301,chr19,R,19060830,19063511,34849132,2681,34849132,19173,2
105372304,LOC105372304,chr19,F,19708399,19710547,34851280,2148,34851280,19174,1
105372305,LOC105372305,chr19,R,19700474,19708190,34858996,7716,34858996,19175,2
105372306,LOC105372306,chr19,R,19785838,19791747,34864905,5909,34864905,19176,1
105372307,LOC105372307,chr19,R,19938671,19941223,34867457,2552,34867457,19177,1
105372308,LOC105372308,chr19,R,20030716,20033053,34869794,2337,34869794,19178,2
105372309,LOC105372309,chr19,R,20042287,20053287,34880794,11000,34880794,19179,2
105372310,LOC105372310,chr19,R,20125490,20238810,34994114,113320,34994114,19180,7
105372311,LOC105372311,chr19,F,20214522,20221781,35001373,7259,35001373,19181,2
105372312,LOC105372312,chr19,F,20126124,20127032,35002281,908,35002281,19182,1
105372313,LOC105372313,chr19,R,20238991,20271893,35035183,32902,35035183,19183,2
105372314,LOC105372314,chr19,F,20276133,20284676,35043726,8543,35043726,19184,2
105372315,LOC105372315,chr19,F,20358180,20371817,35057363,13637,35057363,19185,2
105372316,LOC105372316,chr19,F,20473002,20570882,35155243,97880,35155243,19186,2
105372317,LOC105372317,chr19,F,20422250,20454892,35187885,32642,35187885,19187,5
105372318,LOC105372318,chr19,F,20611222,20617784,35194447,6562,35194447,19188,1
105372320,LOC105372320,chr19,R,20864383,20972138,35302202,107755,35302202,19189,6
105372321,LOC105372321,chr19,R,21444103,21464220,35322319,20117,35322319,19190,8
105372322,LOC105372322,chr19,R,21432484,21443021,35332856,10537,35332856,19191,1
105372323,LOC105372323,chr19,F,21594740,21629790,35367906,35050,35367906,19192,5
105372324,LOC105372324,chr19,R,21858669,21874496,35383733,15827,35383733,19193,3
105372325,LOC105372325,chr19,F,21922335,21937618,35399016,15283,35399016,19194,8
105372326,LOC105372326,chr19,F,21902527,21917829,35414318,15302,35414318,19195,6
105372327,LOC105372327,chr19,R,22018222,22046295,35442391,28073,35442391,19196,20
105372329,LOC105372329,chr19,F,22348771,22352462,35446082,3691,35446082,19197,2
105372330,LOC105372330,chr19,R,22328482,22331600,35449200,3118,35449200,19198,2
105372331,LOC105372331,chr19,R,22595381,22596049,35449868,668,35449868,19199,2
105372332,LOC105372332,chr19,F,22900593,22920493,35469768,19900,35469768,19200,5
105372333,LOC105372333,chr19,F,23074944,23102535,35497359,27591,35497359,19201,6
105372334,LOC105372334,chr19,R,23479677,23489468,35507150,9791,35507150,19202,2
105372335,LOC105372335,chr19,F,23402528,23438216,35542838,35688,35542838,19203,4
105372336,LOC105372336,chr19,F,23520826,23522928,35544940,2102,35544940,19204,2
105372337,LOC105372337,chr19,R,23525630,23532679,35551989,7049,35551989,19205,2
105372338,LOC105372338,chr19,F,23549824,23557899,35560064,8075,35560064,19206,2
105372339,LOC105372339,chr19,F,23565584,23569321,35563801,3737,35563801,19207,2
105372340,LOC105372340,chr19,F,23937668,23947817,35573950,10149,35573950,19208,2
105372342,LOC105372342,chr19,F,9405650,9408256,35576556,2606,35576556,19209,2
105372343,LOC105372343,chr19,R,17389068,17394158,35581646,5090,35581646,19210,4
105372345,LOC105372345,chr19,R,27681258,27685262,35585650,4004,35585650,19211,3
105372346,LOC105372346,chr19,R,27983488,28000401,35602563,16913,35602563,19212,5
105372347,LOC105372347,chr19,R,27886280,27909543,35625826,23263,35625826,19213,8
105372348,LOC105372348,chr19,R,27849464,27861940,35638302,12476,35638302,19214,2
105372349,LOC105372349,chr19,F,28444159,28448976,35643119,4817,35643119,19215,2
105372350,LOC105372350,chr19,F,28869399,28879160,35652880,9761,35652880,19216,3
105372351,LOC105372351,chr19,R,29083095,29093051,35662836,9956,35662836,19217,1
105372352,LOC105372352,chr19,F,29213234,29223137,35672739,9903,35672739,19218,4
105372353,LOC105372353,chr19,R,29630263,29665243,35707719,34980,35707719,19219,6
105372354,LOC105372354,chr19,R,30716099,30719674,35711294,3575,35711294,19220,2
105372355,LOC105372355,chr19,F,31023358,31030274,35718210,6916,35718210,19221,1
105372356,LOC105372356,chr19,R,31125852,31139925,35732283,14073,35732283,19222,6
105372357,LOC105372357,chr19,F,31117799,31125767,35740251,7968,35740251,19223,1
105372358,LOC105372358,chr19,F,31143415,31147663,35744499,4248,35744499,19224,2
105372359,LOC105372359,chr19,R,31437566,31438645,35745578,1079,35745578,19225,2
105372360,LOC105372360,chr19,F,31520147,31554795,35780226,34648,35780226,19226,2
105372361,LOC105372361,chr19,F,31713012,31718834,35786048,5822,35786048,19227,4
105372362,LOC105372362,chr19,R,31791074,31797986,35792960,6912,35792960,19228,2
105372363,LOC105372363,chr19,R,32071511,32072099,35793548,588,35793548,19229,2
105372364,LOC105372364,chr19,F,31980164,31985978,35799362,5814,35799362,19230,3
105372365,LOC105372365,chr19,R,31837379,31850720,35812703,13341,35812703,19231,3
105372366,LOC105372366,chr19,R,32347484,32349700,35814919,2216,35814919,19232,1
105372367,LOC105372367,chr19,R,32687088,32691759,35819590,4671,35819590,19233,1
105372368,LOC105372368,chr19,R,32718297,32719801,35821094,1504,35821094,19234,1
105372369,LOC105372369,chr19,R,33304497,33323203,35839800,18706,35839800,19235,2
105372370,LOC105372370,chr19,F,33521941,33525662,35843521,3721,35843521,19236,2
105372371,LOC105372371,chr19,R,34000325,34005416,35848612,5091,35848612,19237,2
105372372,LOC105372372,chr19,R,34348048,34359413,35859977,11365,35859977,19238,2
105372374,LOC105372374,chr19,F,34555937,34558329,35862369,2392,35862369,19239,2
105372375,LOC105372375,chr19,F,34772336,34774689,35864722,2353,35864722,19240,3
105372376,LOC105372376,chr19,F,34710925,34725895,35879692,14970,35879692,19241,2
105372377,LOC105372377,chr19,R,34898964,34905231,35885959,6267,35885959,19242,5
105372378,LOC105372378,chr19,R,35042533,35055066,35898492,12533,35898492,19243,2
105372379,LOC105372379,chr19,F,35205057,35216008,35909443,10951,35909443,19244,3
105372380,LOC105372380,chr19,F,35259070,35261404,35911777,2334,35911777,19245,1
105372381,LOC105372381,chr19,F,35417939,35419382,35913220,1443,35913220,19246,1
105372382,LOC105372382,chr19,F,35447901,35448862,35914181,961,35914181,19247,1
105372383,LOC105372383,chr19,F,35956821,35959285,35916645,2464,35916645,19248,2
105372384,LOC105372384,chr19,F,35959290,35964064,35921419,4774,35921419,19249,1
105372385,LOC105372385,chr19,R,36127954,36140023,35933488,12069,35933488,19250,2
105372388,LOC105372388,chr19,F,36528759,36535689,35940418,6930,35940418,19251,2
105372390,LOC105372390,chr19,R,37076086,37078071,35942403,1985,35942403,19252,1
105372391,LOC105372391,chr19,F,36667116,36686820,35962107,19704,35962107,19253,2
105372392,LOC105372392,chr19,F,37328187,37329717,35963637,1530,35963637,19254,1
105372393,LOC105372393,chr19,R,37558648,37561008,35965997,2360,35965997,19255,1
105372394,LOC105372394,chr19,R,37807811,37817611,35975797,9800,35975797,19256,3
105372395,LOC105372395,chr19,F,37855776,37896673,36016694,40897,36016694,19257,4
105372396,LOC105372396,chr19,R,38024950,38028428,36020172,3478,36020172,19258,2
105372397,LOC105372397,chr19,F,38597318,38601694,36024548,4376,36024548,19259,1
105372398,LOC105372398,chr19,R,39014031,39014508,36025025,477,36025025,19260,1
105372399,LOC105372399,chr19,F,39547467,39555859,36033417,8392,36033417,19261,2
105372400,LOC105372400,chr19,F,40286430,40293192,36040179,6762,36040179,19262,1
105372401,LOC105372401,chr19,R,41307205,41310135,36043109,2930,36043109,19263,1
105372402,LOC105372402,chr19,R,41261288,41264282,36046103,2994,36046103,19264,1
105372403,LOC105372403,chr19,R,41331700,41332121,36046524,421,36046524,19265,1
105372404,LOC105372404,chr19,F,41600524,41605984,36051984,5460,36051984,19266,2
105372405,LOC105372405,chr19,R,41641320,41663250,36073914,21930,36073914,19267,2
105372406,LOC105372406,chr19,R,42590072,42590848,36074690,776,36074690,19268,2
105372407,LOC105372407,chr19,F,42522768,42525966,36077888,3198,36077888,19269,1
105372408,LOC105372408,chr19,F,42510905,42533791,36100774,22886,36100774,19270,2
105372409,LOC105372409,chr19,R,43364067,43369094,36105801,5027,36105801,19271,1
105372410,LOC105372410,chr19,F,43636861,43638028,36106968,1167,36106968,19272,1
105372411,LOC105372411,chr19,F,43619578,43634407,36121797,14829,36121797,19273,3
105372412,LOC105372412,chr19,F,43687590,43700078,36134285,12488,36134285,19274,7
105372414,LOC105372414,chr19,R,44022975,44025263,36136573,2288,36136573,19275,2
105372415,LOC105372415,chr19,F,44194510,44198475,36140538,3965,36140538,19276,1
105372416,LOC105372416,chr19,R,44714603,44739637,36165572,25034,36165572,19277,2
105372417,LOC105372417,chr19,F,44742614,44748454,36171412,5840,36171412,19278,4
105372418,LOC105372418,chr19,R,44950048,44950970,36172334,922,36172334,19279,1
105372419,LOC105372419,chr19,R,45085328,45090275,36177281,4947,36177281,19280,1
105372420,LOC105372420,chr19,F,45153502,45157364,36181143,3862,36181143,19281,1
105372421,LOC105372421,chr19,F,46023347,46028489,36186285,5142,36186285,19282,2
105372422,LOC105372422,chr19,F,46198211,46204862,36192936,6651,36192936,19283,4
105372423,LOC105372423,chr19,F,46195232,46197647,36195351,2415,36195351,19284,2
105372424,LOC105372424,chr19,R,46160874,46181210,36215687,20336,36215687,19285,5
105372426,LOC105372426,chr19,R,46390453,46405338,36230572,14885,36230572,19286,1
105372427,LOC105372427,chr19,F,47280118,47292076,36242530,11958,36242530,19287,3
105372428,LOC105372428,chr19,R,47887209,47887564,36242885,355,36242885,19288,1
105372429,LOC105372429,chr19,R,48262827,48271720,36251778,8893,36251778,19289,3
105372430,LOC105372430,chr19,R,48465470,48469261,36255569,3791,36255569,19290,4
105372431,LOC105372431,chr19,R,48673260,48677067,36259376,3807,36259376,19291,1
105372432,LOC105372432,chr19,F,48807080,48810798,36263094,3718,36263094,19292,2
105372433,LOC105372433,chr19,R,49412951,49416158,36266301,3207,36266301,19293,1
105372434,LOC105372434,chr19,F,49748411,49757894,36275784,9483,36275784,19294,2
105372435,LOC105372435,chr19,F,49808831,49809816,36276769,985,36276769,19295,1
105372436,LOC105372436,chr19,R,50137495,50148459,36287733,10964,36287733,19296,2
105372437,LOC105372437,chr19,F,50329709,50353028,36311052,23319,36311052,19297,3
105372438,LOC105372438,chr19,F,50511417,50534776,36334411,23359,36334411,19298,2
105372439,LOC105372439,chr19,R,50788406,50793288,36339293,4882,36339293,19299,3
105372440,LOC105372440,chr19,R,50775644,50786198,36349847,10554,36349847,19300,4
105372441,LOC105372441,chr19,F,50830465,50852956,36372338,22491,36372338,19301,3
105372442,LOC105372442,chr19,F,50963555,50974726,36383509,11171,36383509,19302,8
105372443,LOC105372443,chr19,R,51209830,51212934,36386613,3104,36386613,19303,2
105372444,LOC105372444,chr19,F,51271236,51295425,36410802,24189,36410802,19304,7
105372445,LOC105372445,chr19,F,51370194,51373876,36414484,3682,36414484,19305,2
105372446,LOC105372446,chr19,F,51394483,51414415,36434416,19932,36434416,19306,5
105372447,LOC105372447,chr19,F,51612438,51615841,36437819,3403,36437819,19307,2
105372448,LOC105372448,chr19,R,51779698,51783610,36441731,3912,36441731,19308,2
105372449,LOC105372449,chr19,F,52230528,52264453,36475656,33925,36475656,19309,4
105372450,LOC105372450,chr19,R,52225968,52231294,36480982,5326,36480982,19310,1
105372451,LOC105372451,chr19,R,52751655,52763185,36492512,11530,36492512,19311,3
105372452,LOC105372452,chr19,F,52744588,52754098,36502022,9510,36502022,19312,1
105372453,LOC105372453,chr19,F,52981523,52985003,36505502,3480,36505502,19313,1
105372454,LOC105372454,chr19,F,53132893,53136470,36509079,3577,36509079,19314,2
105372455,LOC105372455,chr19,F,53738999,53746389,36516469,7390,36516469,19315,2
105372456,LOC105372456,chr19,F,53746909,53752139,36521699,5230,36521699,19316,2
105372457,LOC105372457,chr19,R,53853559,53869721,36537861,16162,36537861,19317,3
105372458,LOC105372458,chr19,F,54108401,54110037,36539497,1636,36539497,19318,2
105372459,LOC105372459,chr19,F,54210789,54216055,36544763,5266,36544763,19319,2
105372461,LOC105372461,chr19,F,54561977,54571720,36554506,9743,36554506,19320,2
105372462,LOC105372462,chr19,F,55409432,55428232,36573306,18800,36573306,19321,3
105372463,LOC105372463,chr19,F,55553866,55555350,36574790,1484,36574790,19322,2
105372465,LOC105372465,chr19,F,55753670,55755370,36576490,1700,36576490,19323,2
105372466,LOC105372466,chr19,R,56148099,56149645,36578036,1546,36578036,19324,1
105372467,LOC105372467,chr19,R,56347035,56368062,36599063,21027,36599063,19325,7
105372468,LOC105372468,chr19,F,56314998,56316029,36600094,1031,36600094,19326,1
105372469,LOC105372469,chr19,R,56311790,56314597,36602901,2807,36602901,19327,2
105372470,LOC105372470,chr19,R,56280598,56283805,36606108,3207,36606108,19328,1
105372471,LOC105372471,chr19,R,56485522,56507755,36628341,22233,36628341,19329,4
105372472,LOC105372472,chr19,R,56689281,56759721,36698781,70440,36698781,19330,2
105372473,LOC105372473,chr19,F,56672324,56709836,36736293,37512,36736293,19331,4
105372474,LOC105372474,chr19,F,56863395,56894601,36767499,31206,36767499,19332,2
105372475,LOC105372475,chr19,F,57074599,57078880,36771780,4281,36771780,19333,2
105372476,LOC105372476,chr19,R,57264032,57280483,36788231,16451,36788231,19334,8
105372477,LOC105372477,chr19,R,57582896,57584944,36790279,2048,36790279,19335,2
105372478,LOC105372478,chr19,R,58019301,58025640,36796618,6339,36796618,19336,1
105372479,LOC105372479,chr19,R,58216033,58217927,36798512,1894,36798512,19337,1
105372480,LOC105372480,chr19,R,58314779,58327277,36811010,12498,36811010,19338,3
105372481,LOC105372481,chr19,F,58305336,58315653,36821327,10317,36821327,19339,3
105372482,LOC105372482,chr19,R,58258987,58278791,36841131,19804,36841131,19340,1
105372483,LOC105372483,chr19,F,58361588,58367615,36847158,6027,36847158,19341,2
105372484,LOC105372484,chr19,F,58377585,58379025,36848598,1440,36848598,19342,1
105372485,LOC105372485,chr19,F,58499696,58509961,36858863,10265,36858863,19343,1
105372486,LOC105372486,chr19,F,58514263,58516426,36861026,2163,36861026,19344,2
105372487,LOC105372487,chr19,F,31349234,31383997,36895789,34763,36895789,19345,2
105372488,LOC105372488,chr19,R,34675953,34678661,36898497,2708,36898497,19346,1
105372489,LOC105372489,chr19,F,40443183,40445263,36900577,2080,36900577,19347,3
105372490,LOC105372490,chr19,R,51559869,51564820,36905528,4951,36905528,19348,5
105376899,LOC105376899,chr19,F,32072218,32074122,36907432,1904,36907432,19349,2
105376900,LOC105376900,chr19,F,36266807,36269037,36909662,2230,36909662,19350,1
105376901,LOC105376901,chr19,R,46144647,46158277,36923292,13630,36923292,19351,1
105376902,LOC105376902,chr19,R,49056588,49060965,36927669,4377,36927669,19352,3
105376903,LOC105376903,chr19,R,52835760,52837792,36929701,2032,36929701,19353,1
105376904,LOC105376904,chr19,F,54271186,54271747,36930262,561,36930262,19354,1
105376905,LOC105376905,chr19,F,55605752,55610280,36934790,4528,36934790,19355,1
105376906,LOC105376906,chr19,R,27520103,27642524,37057211,122421,37057211,19356,3
105376907,LOC105376907,chr19,F,36269530,36278351,37066032,8821,37066032,19357,5
105376908,LOC105376908,chr19,R,41135637,41193052,37123447,57415,37123447,19358,2
105376909,LOC105376909,chr19,F,43901659,43935219,37157007,33560,37157007,19359,3
105376912,LOC105376912,chr19,F,71140,72759,37158626,1619,37158626,19360,2
105376913,LOC105376913,chr19,F,93536,95391,37160481,1855,37160481,19361,1
105376914,LOC105376914,chr19,R,9590468,9596320,37166333,5852,37166333,19362,1
105376915,LOC105376915,chr19,R,19822943,19867098,37210488,44155,37210488,19363,7
105376916,LOC105376916,chr19,F,20858205,20863696,37215979,5491,37215979,19364,2
105376917,LOC105376917,chr19,R,22455375,22532491,37293095,77116,37293095,19365,8
105376918,LOC105376918,chr19,F,23988717,24001346,37305724,12629,37305724,19366,2
14,AAMP,chr2,R,218264128,218270209,6081,6081,37311805,19367,10
33,ACADL,chr2,R,210187989,210225491,43583,37502,37349307,19368,11
52,ACP1,chr2,F,264139,278283,57727,14144,37363451,19369,6
72,ACTG2,chr2,F,73892965,73919653,84415,26688,37390139,19370,8
90,ACVR1,chr2,R,157736443,157875862,223834,139419,37529558,19371,17
92,ACVR2A,chr2,F,147844516,147930827,310145,86311,37615869,19372,11
98,ACYP2,chr2,F,54115272,54305300,500173,190028,37805897,19373,3
109,ADCY3,chr2,R,24819168,24919733,600738,100565,37906462,19374,25
119,ADD2,chr2,R,70661201,70768243,707780,107042,38013504,19375,19
151,ADRA2B,chr2,R,96112874,96116245,711151,3371,38016875,19376,0
189,AGXT,chr2,F,240868744,240879119,721526,10375,38027250,19377,10
238,ALK,chr2,R,29192773,29921611,1450364,728838,38756088,19378,28
248,ALPI,chr2,F,232456111,232460745,1454998,4634,38760722,19379,10
250,ALPP,chr2,F,232378533,232382889,1459354,4356,38765078,19380,10
251,ALPPL2,chr2,F,232406841,232410714,1463227,3873,38768951,19381,10
274,BIN1,chr2,R,127048022,127107400,1522605,59378,38828329,19382,21
307,ANXA4,chr2,F,69644099,69826464,1704970,182365,39010694,19383,15
316,AOX1,chr2,F,200585951,200682241,1801260,96290,39106984,19384,37
338,APOB,chr2,R,20999217,21044073,1846116,44856,39151840,19385,29
388,RHOB,chr2,F,20447070,20449445,1848491,2375,39154215,19386,0
390,RND3,chr2,R,150468192,150487695,1867994,19503,39173718,19387,4
471,ATIC,chr2,F,215311955,215349773,1905812,37818,39211536,19388,15
518,ATP5G3,chr2,R,175176257,175181762,1911317,5505,39217041,19389,2
525,ATP6V1B1,chr2,F,70935867,70965431,1940881,29564,39246605,19390,14
547,KIF1A,chr2,R,240713763,240821025,2048143,107262,39353867,19391,53
550,AUP1,chr2,R,74526647,74529897,2051393,3250,39357117,19392,9
580,BARD1,chr2,R,214725645,214809711,2135459,84066,39441183,19393,12
617,BCS1L,chr2,F,218659655,218663443,2139247,3788,39444971,19394,6
618,BCYRN1,chr2,F,47335314,47335514,2139447,200,39445171,19395,0
659,BMPR2,chr2,F,202376309,202567751,2330889,191442,39636613,19396,12
666,BOK,chr2,F,241558063,241574138,2346964,16075,39652688,19397,7
678,ZFP36L2,chr2,R,43222401,43226606,2351169,4205,39656893,19398,1
699,BUB1,chr2,R,110637526,110678107,2391750,40581,39697474,19399,24
785,CACNB4,chr2,R,151832770,152099988,2658968,267218,39964692,19400,20
790,CAD,chr2,F,27217389,27243792,2685371,26403,39991095,19401,44
805,CALM2,chr2,R,47160081,47176601,2701891,16520,40007615,19402,5
822,CAPG,chr2,R,85394747,85418467,2725611,23720,40031335,19403,13
841,CASP8,chr2,F,201233442,201287711,2779880,54269,40085604,19404,14
843,CASP10,chr2,F,201182897,201229406,2826389,46509,40132113,19405,12
905,CCNT2,chr2,F,134918821,134959345,2866913,40524,40172637,19406,10
925,CD8A,chr2,R,86784604,86808396,2890705,23792,40196429,19407,8
926,CD8B,chr2,R,86815336,86861924,2937293,46588,40243017,19408,7
940,CD28,chr2,F,203706474,203738912,2969731,32438,40275455,19409,3
1058,CENPA,chr2,F,26786013,26794589,2978307,8576,40284031,19410,4
1123,CHN1,chr2,R,174799313,175005379,3184373,206066,40490097,19411,12
1134,CHRNA1,chr2,R,174747591,174764472,3201254,16881,40506978,19412,9
1144,CHRND,chr2,F,232526159,232536665,3211760,10506,40517484,19413,11
1146,CHRNG,chr2,F,232539726,232546328,3218362,6602,40524086,19414,11
1195,CLK1,chr2,R,200853008,200864744,3230098,11736,40535822,19415,11
1261,CNGA3,chr2,F,98346154,98399154,3283098,53000,40588822,19416,8
1281,COL3A1,chr2,F,188974372,189012746,3321472,38374,40627196,19417,50
1285,COL4A3,chr2,F,227164564,227314792,3471700,150228,40777424,19418,52
1286,COL4A4,chr2,R,226967531,227164559,3668728,197028,40974452,19419,55
1290,COL5A2,chr2,R,189031914,189225314,3862128,193400,41167852,19420,54
1293,COL6A3,chr2,R,237324011,237414370,3952487,90359,41258211,19421,43
1329,COX5B,chr2,F,97646057,97648194,3954624,2137,41260348,19422,3
1373,CPS1,chr2,F,210477681,210679107,4156050,201426,41461774,19423,42
1385,CREB1,chr2,F,207529891,207605560,4231719,75669,41537443,19424,14
1386,ATF2,chr2,R,175072249,175168206,4327676,95957,41633400,19425,16
1412,CRYBA2,chr2,R,218990189,218993556,4331043,3367,41636767,19426,4
1418,CRYGA,chr2,R,208160739,208163573,4333877,2834,41639601,19427,2
1419,CRYGB,chr2,R,208142572,208146153,4337458,3581,41643182,19428,2
1420,CRYGC,chr2,R,208128136,208139738,4349060,11602,41654784,19429,4
1421,CRYGD,chr2,R,208121606,208124589,4352043,2983,41657767,19430,2
1493,CTLA4,chr2,F,203867787,203873960,4358216,6173,41663940,19431,3
1496,CTNNA2,chr2,F,79512933,80648868,5494151,1135935,42799875,19432,24
1545,CYP1B1,chr2,R,38067602,38076181,5502730,8579,42808454,19433,2
1593,CYP27A1,chr2,F,218781748,218815293,5536275,33545,42841999,19434,8
1615,DARS,chr2,R,135905880,135985684,5616079,79804,42921803,19435,15
1622,DBI,chr2,F,119366923,119372551,5621707,5628,42927431,19436,5
1639,DCTN1,chr2,R,74361153,74392087,5652641,30934,42958365,19437,31
1653,DDX1,chr2,F,15591620,15631111,5692132,39491,42997856,19438,25
1674,DES,chr2,F,219418376,219426739,5700495,8363,43006219,19439,8
1716,DGUOK,chr2,F,73926825,73958961,5732631,32136,43038355,19440,7
1720,LOC1720,chr2,F,82856802,82857769,5733598,967,43039322,19441,0
1745,DLX1,chr2,F,172085479,172089674,5737793,4195,43043517,19442,2
1746,DLX2,chr2,R,172099437,172102750,5741106,3313,43046830,19443,2
1768,DNAH6,chr2,F,84459539,84819589,6101156,360050,43406880,19444,82
1781,DYNC1I2,chr2,F,171687408,171750158,6163906,62750,43469630,19445,18
1788,DNMT3A,chr2,R,25232960,25342590,6273536,109630,43579260,19446,32
1796,DOK1,chr2,F,74548204,74557551,6282883,9347,43588607,19447,5
1803,DPP4,chr2,R,161992240,162074542,6365185,82302,43670909,19448,25
1838,DTNB,chr2,R,25377197,25673647,6661635,296450,43967359,19449,26
1841,DTYMK,chr2,R,241675741,241686968,6672862,11227,43978586,19450,4
1844,DUSP2,chr2,R,96143168,96145440,6675134,2272,43980858,19451,3
1876,E2F6,chr2,R,11444374,11466177,6696937,21803,44002661,19452,8
1933,EEF1B2,chr2,F,206159593,206162929,6700273,3336,44005997,19453,5
1961,EGR4,chr2,R,73290928,73293701,6703046,2773,44008770,19454,1
2016,EMX1,chr2,F,72911147,72934891,6726790,23744,44032514,19455,5
2019,EN1,chr2,R,118842170,118848183,6732803,6013,44038527,19456,1
2034,EPAS1,chr2,F,46297401,46386703,6822105,89302,44127829,19457,16
2043,EPHA4,chr2,R,221418026,221574202,6978281,156176,44284005,19458,18
2066,ERBB4,chr2,R,211375716,212539155,8141720,1163439,45447444,19459,28
2071,ERCC3,chr2,R,127257289,127294176,8178607,36887,45484331,19460,14
2168,FABP1,chr2,R,88122981,88128131,8183757,5150,45489481,19461,3
2181,ACSL3,chr2,F,222860983,222943401,8266175,82418,45571899,19462,16
2191,FAP,chr2,R,162170683,162243535,8339027,72852,45644751,19463,29
2202,EFEMP1,chr2,R,55865961,55924163,8397229,58202,45702953,19464,11
2274,FHL2,chr2,R,105360814,105438773,8475188,77959,45780912,19465,10
2281,FKBP1B,chr2,F,24049705,24067743,8493226,18038,45798950,19466,5
2335,FN1,chr2,R,215360453,215436167,8568940,75714,45874664,19467,45
2355,FOSL2,chr2,F,28392758,28417312,8593494,24554,45899218,19468,5
2487,FRZB,chr2,R,182833274,182866770,8626990,33496,45932714,19469,5
2492,FSHR,chr2,R,48866434,49154527,8915083,288093,46220807,19470,16
2498,FTH1P3,chr2,R,27392622,27393576,8916037,954,46221761,19471,0
2571,GAD1,chr2,F,170813209,170861151,8963979,47942,46269703,19472,18
2591,GALNT3,chr2,R,165747802,165794650,9010827,46848,46316551,19473,12
2637,GBX2,chr2,R,236165235,236168009,9013601,2774,46319325,19474,2
2641,GCG,chr2,R,162142868,162152404,9023137,9536,46328861,19475,5
2646,GCKR,chr2,F,27496838,27523689,9049988,26851,46355712,19476,18
2660,MSTN,chr2,R,190055699,190062729,9057018,7030,46362742,19477,3
2673,GFPT1,chr2,R,69319768,69387254,9124504,67486,46430228,19478,19
2677,GGCX,chr2,R,85544854,85561534,9141184,16680,46446908,19479,14
2736,GLI2,chr2,F,120797290,120992653,9336547,195363,46642271,19480,16
2744,GLS,chr2,F,190880820,190965552,9421279,84732,46727003,19481,20
2817,GPC1,chr2,F,240435697,240468078,9453660,32381,46759384,19482,9
2820,GPD2,chr2,F,156435289,156586403,9604774,151114,46910498,19483,22
2825,GPR1,chr2,R,206175315,206218047,9647506,42732,46953230,19484,5
2840,GPR17,chr2,F,127645863,127652639,9654282,6776,46960006,19485,3
2859,GPR35,chr2,F,240605407,240631259,9680134,25852,46985858,19486,6
2863,GPR39,chr2,F,132416160,132646596,9910570,230436,47216294,19487,2
2888,GRB14,chr2,R,164492405,164621850,10040015,129445,47345739,19488,15
2956,MSH6,chr2,F,47783081,47806953,10063887,23872,47369611,19489,12
2976,GTF3C2,chr2,R,27325848,27357034,10095073,31186,47400797,19490,20
2995,GYPC,chr2,F,126655934,126696675,10135814,40741,47441538,19491,5
3030,HADHA,chr2,R,26190634,26244726,10189906,54092,47495630,19492,19
3032,HADHB,chr2,F,26244747,26290465,10235624,45718,47541348,19493,16
3069,HDLBP,chr2,R,241227266,241315700,10324058,88434,47629782,19494,35
3099,HK2,chr2,F,74832654,74893354,10384758,60700,47690482,19495,17
3176,HNMT,chr2,F,137964237,138016364,10436885,52127,47742609,19496,7
3196,TLX2,chr2,F,74514468,74517148,10439565,2680,47745289,19497,2
3231,HOXD1,chr2,F,176188578,176190907,10441894,2329,47747618,19498,2
3232,HOXD3,chr2,F,176136920,176173102,10478076,36182,47783800,19499,8
3233,HOXD4,chr2,F,176150393,176153223,10480906,2830,47786630,19500,1
3234,HOXD8,chr2,F,176129693,176132695,10483908,3002,47789632,19501,1
3235,HOXD9,chr2,F,176122684,176124917,10486141,2233,47791865,19502,1
3236,HOXD10,chr2,F,176116763,176119942,10489320,3179,47795044,19503,1
3237,HOXD11,chr2,F,176107355,176109588,10491553,2233,47797277,19504,1
3238,HOXD12,chr2,F,176098512,176103770,10496811,5258,47802535,19505,2
3239,HOXD13,chr2,F,176087504,176095938,10505245,8434,47810969,19506,3
3241,HPCAL1,chr2,F,10302888,10427617,10629974,124729,47935698,19507,14
3267,AGFG1,chr2,F,227472171,227561222,10719025,89051,48024749,19508,16
3300,DNAJB2,chr2,F,219279317,219286900,10726608,7583,48032332,19509,8
3329,HSPD1,chr2,R,197486583,197500274,10740299,13691,48046023,19510,12
3336,HSPE1,chr2,F,197499996,197503463,10743766,3467,48049490,19511,3
3344,FOXN2,chr2,F,48314643,48379295,10808418,64652,48114142,19512,9
3357,HTR2B,chr2,R,231108229,231125778,10825967,17549,48131691,19513,3
3398,ID2,chr2,F,8681982,8684453,10828438,2471,48134162,19514,2
3417,IDH1,chr2,R,208236226,208255143,10847355,18917,48153079,19515,11
3431,SP110,chr2,R,230167841,230225729,10905243,57888,48210967,19516,22
3485,IGFBP2,chr2,F,216633403,216664436,10936276,31033,48242000,19517,3
3488,IGFBP5,chr2,R,216672104,216695549,10959721,23445,48265445,19518,3
3549,IHH,chr2,R,219054419,219060516,10965818,6097,48271542,19519,2
3552,IL1A,chr2,R,112773914,112785394,10977298,11480,48283022,19520,6
3553,IL1B,chr2,R,112829750,112836779,10984327,7029,48290051,19521,6
3554,IL1R1,chr2,F,102069637,102179874,11094564,110237,48400288,19522,22
3557,IL1RN,chr2,F,113099364,113134016,11129216,34652,48434940,19523,10
3577,CXCR1,chr2,R,218162844,218166993,11133365,4149,48439089,19524,1
3579,CXCR2,chr2,F,218125289,218137253,11145329,11964,48451053,19525,3
3580,CXCR2P1,chr2,R,218059154,218061290,11147465,2136,48453189,19526,0
3623,INHA,chr2,F,219572231,219575713,11150947,3482,48456671,19527,1
3625,INHBB,chr2,F,120346142,120351807,11156612,5665,48462336,19528,1
3628,INPP1,chr2,F,190343469,190371665,11184808,28196,48490532,19529,7
3631,INPP4A,chr2,F,98444857,98594067,11334018,149210,48639742,19530,32
3635,INPP5D,chr2,F,233059966,233207903,11481955,147937,48787679,19531,27
3655,ITGA6,chr2,F,172427585,172506453,11560823,78868,48866547,19532,25
3667,IRS1,chr2,R,226731316,226798790,11628297,67474,48934021,19533,1
3676,ITGA4,chr2,F,181456891,181537747,11709153,80856,49014877,19534,27
3685,ITGAV,chr2,F,186590062,186680902,11799993,90840,49105717,19535,31
3694,ITGB6,chr2,R,160099665,160200313,11900641,100648,49206365,19536,14
3754,KCNF1,chr2,F,10911936,10914225,11902930,2289,49208654,19537,0
3760,KCNJ3,chr2,F,154698580,154858352,12062702,159772,49368426,19538,2
3769,KCNJ13,chr2,R,232765801,232776565,12073466,10764,49379190,19539,2
3777,KCNK3,chr2,F,26692712,26731198,12111952,38486,49417676,19540,2
3790,KCNS3,chr2,F,17877846,17932961,12167067,55115,49472791,19541,4
3795,KHK,chr2,F,27086742,27100751,12181076,14009,49486800,19542,8
3797,KIF3C,chr2,R,25926585,25982574,12237065,55989,49542789,19543,7
3800,KIF5C,chr2,F,148875222,149026759,12388602,151537,49694326,19544,27
3899,AFF3,chr2,R,99545863,100142583,12985322,596720,50291046,19545,31
3938,LCT,chr2,R,135787844,135837180,13034658,49336,50340382,19546,16
3973,LHCGR,chr2,R,48686773,48755741,13103626,68968,50409350,19547,12
3987,LIMS1,chr2,F,108534354,108687246,13256518,152892,50562242,19548,14
4036,LRP2,chr2,R,169127108,169362613,13492023,235505,50797747,19549,80
4052,LTBP1,chr2,F,32947299,33399509,13944233,452210,51249957,19550,35
4065,LY75,chr2,R,159803354,159904756,14045635,101402,51351359,19551,38
4072,EPCAM,chr2,F,47369147,47387028,14063516,17881,51369240,19552,8
4084,MXD1,chr2,F,69915040,69942945,14091421,27905,51397145,19553,5
4118,MAL,chr2,F,95025654,95053992,14119759,28338,51425483,19554,3
4133,MAP2,chr2,F,209424046,209734118,14429831,310072,51735555,19555,21
4144,MAT2A,chr2,F,85538977,85545280,14436134,6303,51741858,19556,8
4148,MATN3,chr2,R,19992051,20012694,14456777,20643,51762501,19557,7
4175,MCM6,chr2,R,135839625,135876477,14493629,36852,51799353,19558,16
4190,MDH1,chr2,F,63588608,63607197,14512218,18589,51817942,19559,9
4211,MEIS1,chr2,F,66435124,66572759,14649853,137635,51955577,19560,14
4249,MGAT5,chr2,F,134119929,134454621,14984545,334692,52290269,19561,23
4358,MPV17,chr2,R,27309489,27325680,15000736,16191,52306460,19562,9
4430,MYO1B,chr2,F,191245184,191425389,15180941,180205,52486665,19563,33
4436,MSH2,chr2,F,47403066,47564579,15342454,161513,52648178,19564,18
4528,MTIF2,chr2,R,55236619,55269303,15375138,32684,52680862,19565,17
4613,MYCN,chr2,F,15940437,15947007,15381708,6570,52687432,19566,2
4632,MYL1,chr2,R,210290143,210315171,15406736,25028,52712460,19567,8
4648,MYO7B,chr2,F,127535692,127637728,15508772,102036,52814496,19568,47
4664,NAB1,chr2,F,190648894,190692766,15552644,43872,52858368,19569,11
4691,NCL,chr2,R,231454747,231464494,15562391,9747,52868115,19570,13
4703,NEB,chr2,R,151485338,151734487,15811540,249149,53117264,19571,181
4705,NDUFA10,chr2,R,239957371,240025402,15879571,68031,53185295,19572,11
4709,NDUFB3,chr2,F,201071738,201085750,15893583,14012,53199307,19573,3
4719,NDUFS1,chr2,R,206123078,206159519,15930024,36441,53235748,19574,19
4735,SEPT2,chr2,F,241315186,241354027,15968865,38841,53274589,19575,19
4759,NEU2,chr2,F,233023055,233035532,15981342,12477,53287066,19576,2
4760,NEUROD1,chr2,R,181676105,181680665,15985902,4560,53291626,19577,1
4780,NFE2L2,chr2,R,177230302,177265131,16020731,34829,53326455,19578,5
4862,NPAS2,chr2,F,100820150,100996827,16197408,176677,53503132,19579,24
4867,NPHP1,chr2,R,110123335,110205062,16279135,81727,53584859,19580,22
4880,NPPC,chr2,R,231922094,231926389,16283430,4295,53589154,19581,3
4929,NR4A2,chr2,R,156324431,156334683,16293682,10252,53599406,19582,7
4953,ODC1,chr2,R,10440370,10448554,16301866,8184,53607590,19583,12
4999,ORC2,chr2,R,200910170,200963703,16355399,53533,53661123,19584,18
5000,ORC4,chr2,R,147930396,148021604,16446607,91208,53752331,19585,16
5013,OTX1,chr2,F,63050056,63057831,16454382,7775,53760106,19586,5
5068,REG3A,chr2,R,79157005,79159754,16457131,2749,53762855,19587,4
5077,PAX3,chr2,R,222199886,222321263,16578508,121377,53884232,19588,12
5093,PCBP1,chr2,F,70087452,70089203,16580259,1751,53885983,19589,0
5133,PDCD1,chr2,R,241849880,241858908,16589287,9028,53895011,19590,5
5136,PDE1A,chr2,R,182140034,182522845,16972098,382811,54277822,19591,22
5147,PDE6D,chr2,R,231732424,231781327,17021001,48903,54326725,19592,5
5163,PDK1,chr2,F,172555372,172670881,17136510,115509,54442234,19593,22
5194,PEX13,chr2,F,61017676,61051990,17170824,34314,54476548,19594,3
5212,VIT,chr2,F,36696689,36814794,17288929,118105,54594653,19595,15
5270,SERPINE2,chr2,R,223975047,224039319,17353201,64272,54658925,19596,13
5281,PIGF,chr2,R,46581273,46617112,17389040,35839,54694764,19597,7
5334,PLCL1,chr2,F,197804601,198149884,17734323,345283,55040047,19598,8
5341,PLEK,chr2,F,68365189,68397453,17766587,32264,55072311,19599,8
5342,PLGLB2,chr2,F,87748086,87759476,17777977,11390,55083701,19600,3
5343,PLGLB1,chr2,R,87010463,87021846,17789360,11383,55095084,19601,3
5378,PMS1,chr2,F,189784084,189877629,17882905,93545,55188629,19602,15
5433,POLR2D,chr2,R,127846265,127858155,17894795,11890,55200519,19603,3
5443,POMC,chr2,R,25160852,25168871,17902814,8019,55208538,19604,3
5455,POU3F3,chr2,F,104855510,104857013,17904317,1503,55210041,19605,0
5495,PPM1B,chr2,F,44168802,44244425,17979940,75623,55285664,19606,7
5496,PPM1G,chr2,R,27381198,27409683,18008425,28485,55314149,19607,9
5500,PPP1CB,chr2,F,28751747,28802940,18059618,51193,55365342,19608,7
5510,PPP1R7,chr2,F,241149572,241183650,18093696,34078,55399420,19609,11
5534,PPP3R1,chr2,R,68178856,68252519,18167359,73663,55473083,19610,5
5581,PRKCE,chr2,F,45651314,46187990,18704035,536676,56009759,19611,33
5610,EIF2AK2,chr2,R,37104682,37157065,18756418,52383,56062142,19612,16
5624,PROC,chr2,F,127418404,127429246,18767260,10842,56072984,19613,7
5707,PSMD1,chr2,F,231056863,231172827,18883224,115964,56188948,19614,24
5746,PTH2R,chr2,F,208359844,208494506,19017886,134662,56323610,19615,14
5757,PTMA,chr2,F,231708524,231713541,19022903,5017,56328627,19616,5
5775,PTPN4,chr2,F,119759630,119984899,19248172,225269,56553896,19617,27
5798,PTPRN,chr2,R,219289622,219309573,19268123,19951,56573847,19618,23
5861,RAB1A,chr2,R,65086853,65130301,19311571,43448,56617295,19619,6
5899,RALB,chr2,F,120240069,120294711,19366213,54642,56671937,19620,7
5903,RANBP2,chr2,F,108719445,108785811,19432579,66366,56738303,19621,30
5937,RBMS1,chr2,R,160272150,160493856,19654285,221706,56960009,19622,16
5966,REL,chr2,F,60881494,60928171,19700962,46677,57006686,19623,11
5967,REG1A,chr2,F,79120457,79123419,19703924,2962,57009648,19624,5
5968,REG1B,chr2,R,79085022,79088024,19706926,3002,57012650,19625,5
5969,REG1P,chr2,R,79135502,79138427,19709851,2925,57015575,19626,0
6082,SNORD20,chr2,R,231456443,231456523,19709931,80,57015655,19627,0
6120,RPE,chr2,F,210002564,210024599,19731966,22035,57037690,19628,8
6160,RPL31,chr2,F,101002228,101019693,19749431,17465,57055155,19629,4
6168,RPL37A,chr2,F,216498796,216501467,19752102,2671,57057826,19630,3
6201,RPS7,chr2,F,3575262,3580919,19757759,5657,57063483,19631,6
6233,RPS27A,chr2,F,55231902,55235853,19761710,3951,57067434,19632,5
6241,RRM2,chr2,F,10122567,10131419,19770562,8852,57076286,19633,9
6242,RTKN,chr2,R,74425860,74441933,19786635,16073,57092359,19634,15
6295,SAG,chr2,F,233304299,233347055,19829391,42756,57135115,19635,20
6323,SCN1A,chr2,R,165989159,166149272,19989504,160113,57295228,19636,30
6326,SCN2A,chr2,F,165130148,165392310,20251666,262162,57557390,19637,32
6328,SCN3A,chr2,R,165087519,165204088,20368235,116569,57673959,19638,30
6332,SCN7A,chr2,R,166403467,166494258,20459026,90791,57764750,19639,28
6335,SCN9A,chr2,R,166195184,166375987,20639829,180803,57945553,19640,27
6344,SCTR,chr2,R,119439842,119524452,20724439,84610,58030163,19641,12
6364,CCL20,chr2,F,227813841,227817564,20728162,3723,58033886,19642,3
6382,SDC1,chr2,R,20200796,20225433,20752799,24637,58058523,19643,8
6432,SRSF7,chr2,R,38743598,38751494,20760695,7896,58066419,19644,7
6439,SFTPB,chr2,R,85657316,85668741,20772120,11425,58077844,19645,12
6496,SIX3,chr2,F,44941728,44966751,20797143,25023,58102867,19646,2
6508,SLC4A3,chr2,F,219627569,219641980,20811554,14411,58117278,19647,23
6509,SLC1A4,chr2,F,64988444,65023865,20846975,35421,58152699,19648,8
6519,SLC3A1,chr2,F,44275457,44320824,20892342,45367,58198066,19649,10
6546,SLC8A1,chr2,R,40112145,40512486,21292683,400341,58598407,19650,19
6549,SLC9A2,chr2,F,102619688,102711350,21384345,91662,58690069,19651,11
6556,SLC11A1,chr2,F,218381765,218396894,21399474,15129,58705198,19652,15
6574,SLC20A1,chr2,F,112645856,112663825,21417443,17969,58723167,19653,11
6637,SNRPG,chr2,R,70281377,70293737,21429803,12360,58735527,19654,3
6654,SOS1,chr2,R,38981548,39124744,21572999,143196,58878723,19655,27
6664,SOX11,chr2,F,5692666,5701385,21581718,8719,58887442,19656,0
6670,SP3,chr2,R,173906458,173965702,21640962,59244,58946686,19657,6
6672,SP100,chr2,F,230416155,230545602,21770409,129447,59076133,19658,31
6683,SPAST,chr2,F,32063551,32157637,21864495,94086,59170219,19659,16
6694,SPP2,chr2,F,234050689,234077134,21890940,26445,59196664,19660,10
6697,SPR,chr2,F,72887382,72892160,21895718,4778,59201442,19661,2
6711,SPTBN1,chr2,F,54456316,54671446,22110848,215130,59416572,19662,37
6716,SRD5A2,chr2,R,31522487,31700784,22289145,178297,59594869,19663,12
6741,SSB,chr2,F,169798811,169812064,22302398,13253,59608122,19664,12
6744,SSFA2,chr2,F,181891715,181930738,22341421,39023,59647145,19665,20
6772,STAT1,chr2,R,190969035,191014250,22386636,45215,59692360,19666,24
6775,STAT4,chr2,R,191029575,191246172,22603233,216597,59908957,19667,35
6801,STRN,chr2,R,36837697,36966557,22732093,128860,60037817,19668,18
6819,SULT1C2,chr2,F,108288638,108310569,22754024,21931,60059748,19669,8
6868,ADAM17,chr2,R,9489262,9555788,22820550,66526,60126274,19670,20
6869,TACR1,chr2,R,75046462,75199519,22973607,153057,60279331,19671,4
6936,GCFC2,chr2,R,75662704,75710986,23021889,48282,60327613,19672,16
7035,TFPI,chr2,R,187464229,187554494,23112154,90265,60417878,19673,12
7039,TGFA,chr2,R,70447279,70554015,23218890,106736,60524614,19674,6
7072,TIA1,chr2,R,70209443,70248707,23258154,39264,60563878,19675,11
7130,TNFAIP6,chr2,F,151357582,151381245,23281817,23663,60587541,19676,6
7141,TNP1,chr2,R,216859457,216860059,23282419,602,60588143,19677,1
7145,TNS1,chr2,R,217799788,217978827,23461458,179039,60767182,19678,40
7173,TPO,chr2,F,1413460,1542727,23590725,129267,60896449,19679,18
7247,TSN,chr2,F,121755544,121767853,23603034,12309,60908758,19680,5
7260,TSSC1,chr2,R,3188969,3377882,23791947,188913,61097671,19681,12
7273,TTN,chr2,R,178525988,178830754,24096713,304766,61402437,19682,366
7277,TUBA4A,chr2,R,219249710,219254608,24101611,4898,61407335,19683,5
7341,SUMO1,chr2,R,202206179,202238599,24134031,32420,61439755,19684,4
7349,UCN,chr2,R,27307396,27308262,24134897,866,61440621,19685,1
7360,UGP2,chr2,F,63840949,63891562,24185510,50613,61491234,19686,12
7429,VIL1,chr2,F,218419114,218449525,24215921,30411,61521645,19687,19
7444,VRK2,chr2,F,57907650,58159920,24468191,252270,61773915,19688,20
7447,VSNL1,chr2,F,17540539,17656439,24584091,115900,61889815,19689,3
7456,WIPF1,chr2,R,174559573,174682899,24707417,123326,62013141,19690,10
7475,WNT6,chr2,F,218859822,218874233,24721828,14411,62027552,19691,4
7498,XDH,chr2,R,31334308,31414749,24802269,80441,62107993,19692,36
7514,XPO1,chr2,R,61477933,61538522,24862858,60589,62168582,19693,28
7520,XRCC5,chr2,F,216109296,216206293,24959855,96997,62265579,19694,20
7535,ZAP70,chr2,F,97713567,97744327,24990615,30760,62296339,19695,17
7549,ZNF2,chr2,F,95165416,95184317,25009516,18901,62315240,19696,4
7701,ZNF142,chr2,R,218637915,218659632,25031233,21717,62336957,19697,10
7781,SLC30A3,chr2,R,27254571,27275366,25052028,20795,62357752,19698,12
7837,PXDN,chr2,R,1631886,1744852,25164994,112966,62470718,19699,25
7840,ALMS1,chr2,F,73385757,73609919,25389156,224162,62694880,19700,22
7841,MOGS,chr2,R,74461056,74465410,25393510,4354,62699234,19701,3
7844,RNF103,chr2,R,86603392,86623877,25413995,20485,62719719,19702,4
7849,PAX8,chr2,R,113215996,113278950,25476949,62954,62782673,19703,11
7850,IL1R2,chr2,F,101991815,102028544,25513678,36729,62819402,19704,14
7851,MALL,chr2,R,110083869,110118139,25547948,34270,62853672,19705,4
7852,CXCR4,chr2,R,136114348,136118155,25551755,3807,62857479,19706,1
7855,FZD5,chr2,R,207762585,207769419,25558589,6834,62864313,19707,1
7857,SCG2,chr2,R,223596939,223602499,25564149,5560,62869873,19708,1
8291,DYSF,chr2,F,71453118,71686763,25797794,233645,63103518,19709,57
8324,FZD7,chr2,F,202034586,202038437,25801645,3851,63107369,19710,0
8436,SDPR,chr2,R,191834304,191847280,25814621,12976,63120345,19711,1
8440,NCK2,chr2,F,105744941,105894274,25963954,149333,63269678,19712,6
8446,DUSP11,chr2,R,73762197,73780157,25981914,17960,63287638,19713,8
8452,CUL3,chr2,R,224470149,224585397,26097162,115248,63402886,19714,20
8462,KLF11,chr2,F,10042984,10054836,26109014,11852,63414738,19715,6
8491,MAP4K3,chr2,R,39249265,39437312,26297061,188047,63602785,19716,33
8502,PKP4,chr2,F,158456879,158681429,26521611,224550,63827335,19717,25
8520,HAT1,chr2,F,171922424,171983686,26582873,61262,63888597,19718,12
8527,DGKD,chr2,F,233354506,233472098,26700465,117592,64006189,19719,43
8540,AGPS,chr2,F,177392742,177543836,26851559,151094,64157283,19720,22
8575,PRKRA,chr2,R,178431413,178451231,26871377,19818,64177101,19721,8
8576,STK16,chr2,F,219245468,219250337,26876246,4869,64181970,19722,7
8604,SLC25A12,chr2,R,171783404,171894306,26987148,110902,64292872,19723,19
8609,KLF7,chr2,R,207074136,207173851,27086863,99715,64392587,19724,10
8647,ABCB11,chr2,R,168922801,169034890,27198952,112089,64504676,19725,28
8648,NCOA1,chr2,F,24492049,24770702,27477605,278653,64783329,19726,23
8673,VAMP8,chr2,F,85577490,85582033,27482148,4543,64787872,19727,2
8685,MARCO,chr2,F,118942165,118994664,27534647,52499,64840371,19728,16
8708,B3GALT1,chr2,F,167293060,167870856,28112443,577796,65418167,19729,6
8745,ADAM23,chr2,F,206443543,206621130,28290030,177587,65595754,19730,26
8802,SUCLG1,chr2,R,84423522,84459462,28325970,35940,65631694,19731,8
8807,IL18RAP,chr2,F,102418557,102452568,28359981,34011,65665705,19732,13
8808,IL1RL2,chr2,F,102186156,102240002,28413827,53846,65719551,19733,13
8809,IL18R1,chr2,F,102356282,102398777,28456322,42495,65762046,19734,12
8828,NRP2,chr2,F,205682448,205798133,28572007,115685,65877731,19735,19
8837,CFLAR,chr2,F,201116153,201172688,28628542,56535,65934266,19736,13
8853,ASAP2,chr2,F,9206764,9405683,28827461,198919,66133185,19737,31
8864,PER2,chr2,R,238244037,238290102,28873526,46065,66179250,19738,24
8869,ST3GAL5,chr2,R,85839146,85889034,28923414,49888,66229138,19739,10
8884,SLC5A6,chr2,R,27199586,27212307,28936135,12721,66241859,19740,17
8886,DDX18,chr2,F,117814678,117832377,28953834,17699,66259558,19741,13
8890,EIF2B4,chr2,R,27364351,27370457,28959940,6106,66265664,19742,12
8941,CDK5R2,chr2,F,218959627,218962155,28962468,2528,66268192,19743,0
8942,KYNU,chr2,F,142748927,143042316,29255857,293389,66561581,19744,22
9014,TAF1B,chr2,F,9843441,9934416,29346832,90975,66652556,19745,16
9027,NAT8,chr2,R,73640722,73642410,29348520,1688,66654244,19746,1
9111,NMI,chr2,R,151270464,151289916,29367972,19452,66673696,19747,8
9125,RQCD1,chr2,F,218568574,218596435,29395833,27861,66701557,19748,10
9167,COX7A2L,chr2,R,42350500,42369010,29414343,18510,66720067,19749,3
9168,TMSB10,chr2,F,84905638,84906675,29415380,1037,66721104,19750,2
9173,IL1RL1,chr2,F,102311501,102352366,29456245,40865,66761969,19751,12
9208,LRRFIP1,chr2,F,237627580,237781647,29610312,154067,66916036,19752,28
9262,STK17B,chr2,R,196133582,196176503,29653233,42921,66958957,19753,12
9270,ITGB1BP1,chr2,R,9405683,9423569,29671119,17886,66976843,19754,8
9290,GPR55,chr2,R,230907317,230961227,29725029,53910,67030753,19755,4
9320,TRIP12,chr2,R,229763836,229923234,29884427,159398,67190151,19756,46
9330,GTF3C3,chr2,R,196763031,196799768,29921164,36737,67226888,19757,18
9360,PPIG,chr2,F,169584339,169641406,29978231,57067,67283955,19758,15
9378,NRXN1,chr2,R,49918504,51032536,31092263,1114032,68397987,19759,29
9381,OTOF,chr2,R,26457202,26558698,31193759,101496,68499483,19760,47
9391,CIAO1,chr2,F,96266145,96274179,31201793,8034,68507517,19761,6
9392,TGFBRAP1,chr2,R,105249403,105329714,31282104,80311,68587828,19762,12
9394,HS6ST1,chr2,R,128265479,128318597,31335222,53118,68640946,19763,1
9419,CRIPT,chr2,F,46617171,46630176,31348227,13005,68653951,19764,4
9427,ECEL1,chr2,R,232479826,232487859,31356260,8033,68661984,19765,17
9448,MAP4K4,chr2,F,101697702,101894690,31553248,196988,68858972,19766,33
9451,EIF2AK3,chr2,R,88556740,88627576,31624084,70836,68929808,19767,18
9470,EIF4E2,chr2,F,232550056,232583645,31657673,33589,68963397,19768,9
9475,ROCK2,chr2,R,11179763,11345363,31823273,165600,69128997,19769,34
9486,CHST10,chr2,R,100391859,100417668,31849082,25809,69154806,19770,8
9540,TP53I3,chr2,R,24077427,24085215,31856870,7788,69162594,19771,4
9541,CIR1,chr2,R,174348149,174395715,31904436,47566,69210160,19772,9
9553,MRPL33,chr2,F,27771716,27779741,31912461,8025,69218185,19773,3
9577,BRE,chr2,F,27890614,28338901,32360748,448287,69666472,19774,14
9581,PREPL,chr2,R,44317606,44361862,32405004,44256,69710728,19775,14
9595,CYTIP,chr2,R,157414618,157444092,32434478,29474,69740202,19776,7
9637,FEZ2,chr2,R,36552238,36598190,32480430,45952,69786154,19777,9
9648,GCC2,chr2,F,108449120,108509398,32540708,60278,69846432,19778,24
9654,TTLL4,chr2,F,218710834,218755416,32585290,44582,69891014,19779,21
9655,SOCS5,chr2,F,46698959,46762788,32649119,63829,69954843,19780,2
9669,EIF5B,chr2,F,99337370,99400265,32712014,62895,70017738,19781,23
9687,GREB1,chr2,F,11534115,11642788,32820687,108673,70126411,19782,38
9689,BZW1,chr2,F,200811543,200823846,32832990,12303,70138714,19783,13
9736,USP34,chr2,R,61187454,61470714,33116250,283260,70421974,19784,79
9741,LAPTM4A,chr2,R,20032649,20052028,33135629,19379,70441353,19785,6
9759,HDAC4,chr2,R,239048167,239401647,33489109,353480,70794833,19786,35
9781,RNF144A,chr2,F,6917391,7076197,33647915,158806,70953639,19787,12
9784,SNX17,chr2,F,27370495,27377533,33654953,7038,70960677,19788,15
9792,SERTAD2,chr2,R,64631620,64751091,33774424,119471,71080148,19789,4
9801,MRPL19,chr2,F,75646782,75662208,33789850,15426,71095574,19790,5
9839,ZEB2,chr2,R,144384374,144520393,33925869,136019,71231593,19791,13
9855,FARP2,chr2,F,241356248,241494842,34064463,138594,71370187,19792,33
9874,TLK1,chr2,R,170990822,171231314,34304955,240492,71610679,19793,24
9913,SUPT7L,chr2,R,27642567,27663973,34326361,21406,71632085,19794,7
9936,CD302,chr2,R,159768627,159798255,34355989,29628,71661713,19795,5
9938,ARHGAP25,chr2,F,68710504,68826833,34472318,116329,71778042,19796,14
10010,TANK,chr2,F,161136926,161236176,34571568,99250,71877292,19797,11
10018,BCL2L11,chr2,F,111120617,111168445,34619396,47828,71925120,19798,14
10056,FARSB,chr2,R,222571442,222656355,34704309,84913,72010033,19799,18
10058,ABCB6,chr2,R,219209765,219218990,34713534,9225,72019258,19800,18
10096,ACTR3,chr2,F,113889933,113961554,34785155,71621,72090879,19801,12
10097,ACTR2,chr2,F,65227694,65271253,34828714,43559,72134438,19802,9
10109,ARPC2,chr2,F,218217093,218254348,34865969,37255,72171693,19803,11
10113,PREB,chr2,R,27130755,27134674,34869888,3919,72175612,19804,8
10120,ACTR1B,chr2,R,97655938,97664098,34878048,8160,72183772,19805,10
10123,ARL4C,chr2,R,234493040,234497053,34882061,4013,72187785,19806,0
10128,LRPPRC,chr2,R,43886223,43996005,34991843,109782,72297567,19807,38
10130,PDIA6,chr2,R,10783390,10837977,35046430,54587,72352154,19808,17
10152,ABI2,chr2,F,203327873,203432173,35150730,104300,72456454,19809,14
10153,CEBPZ,chr2,R,37201628,37231597,35180699,29969,72486423,19810,15
10170,DHRS9,chr2,F,169067034,169096167,35209832,29133,72515556,19811,8
10190,TXNDC9,chr2,R,99319023,99336397,35227206,17374,72532930,19812,4
10199,MPHOSPH10,chr2,F,71130313,71150102,35246995,19789,72552719,19813,10
10203,CALCRL,chr2,R,187341962,187448294,35353327,106332,72659051,19814,16
10213,PSMD14,chr2,F,161308274,161411717,35456770,103443,72762494,19815,11
10254,STAM2,chr2,R,152116800,152175992,35515962,59192,72821686,19816,13
10267,RAMP1,chr2,F,237859543,237912114,35568533,52571,72874257,19817,5
10290,SPEG,chr2,F,219434191,219493632,35627974,59441,72933698,19818,49
10314,LANCL1,chr2,R,210431248,210477618,35674344,46370,72980068,19819,10
10316,NMUR1,chr2,R,231519906,231530471,35684909,10565,72990633,19820,5
10322,SMYD5,chr2,F,73214237,73227227,35697899,12990,73003623,19821,12
10324,KLHL41,chr2,F,169509701,169526262,35714460,16561,73020184,19822,5
10408,MYCNOS,chr2,R,15936264,15941723,35719919,5459,73025643,19823,4
10438,C1D,chr2,R,68042199,68063027,35740747,20828,73046471,19824,5
10461,MERTK,chr2,F,111898478,112039953,35882222,141475,73187946,19825,21
10477,UBE2E3,chr2,F,180980384,181063427,35965265,83043,73270989,19826,8
10494,STK25,chr2,R,241494706,241509730,35980289,15024,73286013,19827,13
10505,SEMA4F,chr2,F,74654227,74694897,36020959,40670,73326683,19828,15
10574,CCT7,chr2,F,73233424,73253022,36040557,19598,73346281,19829,13
10575,CCT4,chr2,R,61868126,61888671,36061102,20545,73366826,19830,13
10578,GNLY,chr2,F,85694290,85698854,36065666,4564,73371390,19831,7
10602,CDC42EP3,chr2,R,37641881,37672535,36096320,30654,73402044,19832,3
10617,STAMBP,chr2,F,73828915,73873656,36141061,44741,73446785,19833,14
10618,TGOLN2,chr2,R,85318017,85328296,36151340,10279,73457064,19834,3
10651,MTX2,chr2,F,176269394,176338025,36219971,68631,73525695,19835,11
10669,CGREF1,chr2,R,27099352,27119127,36239746,19775,73545470,19836,7
10678,B3GNT2,chr2,F,62196126,62224731,36268351,28605,73574075,19837,2
10713,USP39,chr2,F,85602841,85649284,36314794,46443,73620518,19838,15
10716,TBR1,chr2,F,161416108,161425062,36323748,8954,73629472,19839,5
10736,SIX2,chr2,R,45005181,45009610,36328177,4429,73633901,19840,1
10746,MAP3K2,chr2,R,127298668,127343229,36372738,44561,73678462,19841,15
10787,NCKAP1,chr2,R,182924850,183038858,36486746,114008,73792470,19842,31
10791,VAMP5,chr2,F,85584407,85593388,36495727,8981,73801451,19843,2
10797,MTHFD2,chr2,F,74198562,74215298,36512463,16736,73818187,19844,8
10865,ARID5A,chr2,F,96536726,96552634,36528371,15908,73834095,19845,8
10887,PROKR1,chr2,F,68645821,68655576,36538126,9755,73843850,19846,1
10890,RAB10,chr2,F,26033859,26137454,36641721,103595,73947445,19847,5
10913,EDAR,chr2,R,108894470,108989372,36736623,94902,74042347,19848,12
10920,COPS8,chr2,F,237085440,237098846,36750029,13406,74055753,19849,8
10936,GPR75,chr2,R,53852912,53860033,36757150,7121,74062874,19850,9
10971,YWHAQ,chr2,R,9583966,9631055,36804239,47089,74109963,19851,5
10989,IMMT,chr2,R,86143931,86195770,36856078,51839,74161802,19852,14
11017,SNRNP27,chr2,F,69893942,69905236,36867372,11294,74173096,19853,5
11036,GTF2A1L,chr2,F,48617779,48679609,36929202,61830,74234926,19854,8
11037,STON1,chr2,F,48530168,48598515,36997549,68347,74303273,19855,4
11069,RAPGEF4,chr2,F,172735278,173052893,37315164,317615,74620888,19856,34
11117,EMILIN1,chr2,F,27078566,27086404,37323002,7838,74628726,19857,7
11132,CAPN10,chr2,F,240586715,240599109,37335396,12394,74641120,19858,11
11138,TBC1D8,chr2,R,101007227,101195326,37523495,188099,74829219,19859,24
11159,RABL2A,chr2,F,113627236,113643398,37539657,16162,74845381,19860,10
11227,GALNT5,chr2,F,157257827,157311401,37593231,53574,74898955,19861,9
11249,NXPH2,chr2,R,138669156,138780241,37704316,111085,75010040,19862,1
11250,GPR45,chr2,F,105241742,105243467,37706041,1725,75011765,19863,0
11262,SP140,chr2,F,230202741,230316616,37819916,113875,75125640,19864,32
11320,MGAT4A,chr2,R,98619105,98731126,37931937,112021,75237661,19865,16
11321,GPN1,chr2,F,27628647,27650846,37954136,22199,75259860,19866,15
22807,IKZF2,chr2,R,212999683,213154266,38108719,154583,75414443,19867,12
22837,COBLL1,chr2,R,164680184,164842168,38270703,161984,75576427,19868,16
22848,AAK1,chr2,R,69457994,69643845,38456554,185851,75762278,19869,21
22868,FASTKD2,chr2,F,206765387,206796189,38487356,30802,75793080,19870,11
22924,MAPRE3,chr2,F,26970370,27027219,38544205,56849,75849929,19871,7
22925,PLA2R1,chr2,R,159932001,160062902,38675106,130901,75980830,19872,33
22930,RAB3GAP1,chr2,F,135052264,135175584,38798426,123320,76104150,19873,25
22934,RPIA,chr2,F,88691647,88750935,38857714,59288,76163438,19874,9
22950,SLC4A1AP,chr2,F,27663470,27694980,38889224,31510,76194948,19875,13
22979,EFR3B,chr2,F,25042103,25159135,39006256,117032,76311980,19876,23
23020,SNRNP200,chr2,R,96274335,96305569,39037490,31234,76343214,19877,44
23040,MYT1L,chr2,R,1789112,2331375,39579753,542263,76885477,19878,33
23160,WDR43,chr2,F,28894642,28948220,39633331,53578,76939055,19879,17
23175,LPIN1,chr2,F,11677544,11827409,39783196,149865,77088920,19880,28
23177,CEP68,chr2,F,65056360,65087008,39813844,30648,77119568,19881,7
23178,PASK,chr2,R,241106098,241150364,39858110,44266,77163834,19882,25
23190,UBXN4,chr2,F,135741618,135785063,39901555,43445,77207279,19883,12
23192,ATG4B,chr2,F,241637611,241673857,39937801,36246,77243525,19884,14
23198,PSME4,chr2,R,53864066,53970840,40044575,106774,77350299,19885,48
23233,EXOC6B,chr2,R,72175983,72826048,40694640,650065,78000364,19886,25
23301,EHBP1,chr2,F,62673850,63046487,41067277,372637,78373001,19887,28
23314,SATB2,chr2,R,199269499,199471266,41269044,201767,78574768,19888,13
23332,CLASP1,chr2,R,121337775,121649476,41580745,311701,78886469,19889,46
23363,OBSL1,chr2,R,219549402,219571577,41602920,22175,78908644,19890,23
23369,PUM2,chr2,R,20248691,20352229,41706458,103538,79012182,19891,27
23397,NCAPH,chr2,F,96335740,96377095,41747813,41355,79053537,19892,17
23433,RHOQ,chr2,F,46542727,46584688,41789774,41961,79095498,19893,6
23451,SF3B1,chr2,R,197391973,197435091,41832892,43118,79138616,19894,25
23498,HAAO,chr2,R,42767088,42793138,41858942,26050,79164666,19895,10
23505,TMEM131,chr2,R,97756335,97995932,42098539,239597,79404263,19896,41
23518,R3HDM1,chr2,F,135531454,135725270,42292355,193816,79598079,19897,31
23549,DNPEP,chr2,R,219373457,219400017,42318915,26560,79624639,19898,16
23550,PSD4,chr2,F,113157398,113203229,42364746,45831,79670470,19899,17
23559,WBP1,chr2,F,74458399,74460891,42367238,2492,79672962,19900,3
23620,NTSR2,chr2,R,11658177,11670203,42379264,12026,79684988,19901,3
23671,TMEFF2,chr2,R,191949045,192194940,42625159,245895,79930883,19902,9
23677,SH3BP4,chr2,F,234951983,235055714,42728890,103731,80034614,19903,9
23683,PRKD3,chr2,R,37250501,37324772,42803161,74271,80108885,19904,20
23704,KCNE4,chr2,F,223051929,223055637,42806869,3708,80112593,19905,1
25780,RASGRP3,chr2,F,33436348,33564731,42935252,128383,80240976,19906,20
25791,NGEF,chr2,R,232878685,233013241,43069808,134556,80375532,19907,17
25797,QPCT,chr2,F,37344609,37373322,43098521,28713,80404245,19908,6
25801,GCA,chr2,F,162318792,162379989,43159718,61197,80465442,19909,13
25806,VAX2,chr2,F,70900589,70933446,43192575,32857,80498299,19910,5
25826,SNORD82,chr2,R,231460367,231460442,43192650,75,80498374,19911,0
25843,MOB4,chr2,F,197515570,197553699,43230779,38129,80536503,19912,9
25885,POLR1A,chr2,R,86025167,86106155,43311767,80988,80617491,19913,34
25927,CNRIP1,chr2,R,68284170,68320051,43347648,35881,80653372,19914,3
25940,FAM98A,chr2,R,33583660,33599362,43363350,15702,80669074,19915,7
25953,PNKD,chr2,F,218270391,218346793,43439752,76402,80745476,19916,11
25972,UNC50,chr2,F,98608578,98618515,43449689,9937,80755413,19917,6
25992,SNED1,chr2,F,240997596,241094228,43546321,96632,80852045,19918,35
26003,GORASP2,chr2,F,170928437,170967135,43585019,38698,80890743,19919,10
26010,SPATS2L,chr2,F,200305880,200482263,43761402,176383,81067126,19920,17
26056,RAB11FIP5,chr2,R,73073381,73113018,43801039,39637,81106763,19921,6
26058,GIGYF2,chr2,F,232697304,232860577,43964312,163273,81270036,19922,34
26122,EPC2,chr2,F,148644810,148788491,44107993,143681,81413717,19923,15
26146,TRAF3IP1,chr2,F,238320543,238400900,44188350,80357,81494074,19924,21
26154,ABCA12,chr2,R,214931541,215138580,44395389,207039,81701113,19925,54
26160,IFT172,chr2,R,27444372,27489811,44440828,45439,81746552,19926,52
26225,ARL5A,chr2,R,151800965,151828495,44468358,27530,81774082,19927,5
26275,HIBCH,chr2,R,190204633,190320045,44583770,115412,81889494,19928,14
26469,PTPN18,chr2,F,130356006,130375409,44603173,19403,81908897,19929,14
26504,CNNM4,chr2,F,96760901,96811891,44654163,50990,81959887,19930,9
26505,CNNM3,chr2,F,96814951,96837466,44676678,22515,81982402,19931,9
26525,IL36RN,chr2,F,113058637,113064744,44682785,6107,81988509,19932,5
26751,SH3YL1,chr2,R,218135,264866,44729516,46731,82035240,19933,17
26796,SNORD53,chr2,F,28927066,28927142,44729592,76,82035316,19934,0
26798,SNORD51,chr2,F,206161880,206161950,44729662,70,82035386,19935,0
27013,CNPPD1,chr2,R,219171896,219178164,44735930,6268,82041654,19936,10
27148,STK36,chr2,F,218672025,218702717,44766622,30692,82072346,19937,28
27177,IL36B,chr2,R,113022090,113052867,44797399,30777,82103123,19938,7
27178,IL37,chr2,F,112911063,112918882,44805218,7819,82110942,19939,6
27179,IL36A,chr2,F,113005460,113011071,44810829,5611,82116553,19940,5
27233,SULT1C4,chr2,F,108377956,108388989,44821862,11033,82127586,19941,6
27247,NFU1,chr2,R,69396112,69437628,44863378,41516,82169102,19942,7
27248,ERLEC1,chr2,F,53786930,53826928,44903376,39998,82209100,19943,14
27249,MMADHC,chr2,R,149569632,149587816,44921560,18184,82227284,19944,7
27302,BMP10,chr2,R,68865480,68871517,44927597,6037,82233321,19945,1
27332,ZNF638,chr2,F,71331754,71435061,45030904,103307,82336628,19946,28
27347,STK39,chr2,R,167954019,168247595,45324480,293576,82630204,19947,20
27429,HTRA2,chr2,F,74529404,74533556,45328632,4152,82634356,19948,7
27436,EML4,chr2,F,42169337,42332548,45491843,163211,82797567,19949,25
28951,TRIB2,chr2,F,12716871,12742734,45517706,25863,82823430,19950,2
29034,CPS1-IT1,chr2,F,210617570,210619876,45520012,2306,82825736,19951,0
29081,METTL5,chr2,R,169811756,169824931,45533187,13175,82838911,19952,6
29094,LGALSL,chr2,F,64454192,64461383,45540378,7191,82846102,19953,4
29789,OLA1,chr2,R,174072446,174248637,45716569,176191,83022293,19954,10
29798,C2orf27A,chr2,F,131722490,131767404,45761483,44914,83067207,19955,3
29841,GRHL1,chr2,F,9951662,10002284,45812105,50622,83117829,19956,16
29842,TFCP2L1,chr2,R,121216586,121285209,45880728,68623,83186452,19957,16
29851,ICOS,chr2,F,203936730,203961579,45905577,24849,83211301,19958,7
29926,GMPPA,chr2,F,219498864,219506996,45913709,8132,83219433,19959,14
29959,NRBP1,chr2,F,27428605,27442259,45927363,13654,83233087,19960,18
29994,BAZ2B,chr2,R,159315311,159712439,46324491,397128,83630215,19961,49
30061,SLC40A1,chr2,R,189560589,189580811,46344713,20222,83650437,19962,8
30818,KCNIP3,chr2,F,95297323,95386077,46433467,88754,83739191,19963,10
30845,EHD3,chr2,F,31234013,31269451,46468905,35438,83774629,19964,6
50485,SMARCAL1,chr2,F,216412413,216483053,46539545,70640,83845269,19965,18
50489,CD207,chr2,R,70825207,70836601,46550939,11394,83856663,19966,7
50618,ITSN2,chr2,R,24202865,24360528,46708602,157663,84014326,19967,39
50636,ANO7,chr2,F,241188508,241239595,46759689,51087,84065413,19968,24
50649,ARHGEF4,chr2,F,130836915,131047253,46970027,210338,84275751,19969,17
50940,PDE11A,chr2,R,177623248,178108339,47455118,485091,84760842,19970,23
51002,TPRKB,chr2,R,73729829,73740104,47465393,10275,84771117,19971,8
51011,FAHD2A,chr2,F,95402690,95416609,47479312,13919,84785036,19972,10
51052,PRLH,chr2,F,237566573,237567175,47479914,602,84785638,19973,1
51057,WDPCP,chr2,R,63120761,63840825,48199978,720064,85505702,19974,30
51072,MEMO1,chr2,R,31867187,32011052,48343843,143865,85649567,19975,12
51078,THAP4,chr2,R,241584404,241637525,48396964,53121,85702688,19976,7
51112,TRAPPC12,chr2,F,3379671,3479571,48496864,99900,85802588,19977,18
51130,ASB3,chr2,R,53669979,53787009,48613894,117030,85919618,19978,9
51141,INSIG2,chr2,F,118088473,118110027,48635448,21554,85941172,19979,6
51232,CRIM1,chr2,F,36355770,36551135,48830813,195365,86136537,19980,19
51239,ANKRD39,chr2,R,96847984,96858019,48840848,10035,86146572,19981,3
51252,FAM178B,chr2,R,96875881,96986601,48951568,110720,86257292,19982,22
51255,RNF181,chr2,F,85595267,85597708,48954009,2441,86259733,19983,4
51263,MRPL30,chr2,F,99181078,99199557,48972488,18479,86278212,19984,5
51277,DNAJC27,chr2,R,24943635,24972094,49000947,28459,86306671,19985,8
51281,ANKMY1,chr2,R,240479421,240561068,49082594,81647,86388318,19986,24
51315,KRCC1,chr2,R,88027202,88055801,49111193,28599,86416917,19987,3
51318,MRPL35,chr2,F,86199354,86213794,49125633,14440,86431357,19988,4
51374,ATRAID,chr2,F,27212030,27217178,49130781,5148,86436505,19989,6
51449,PCYOX1,chr2,F,70258098,70281185,49153868,23087,86459592,19990,5
51454,GULP1,chr2,F,188291668,188595926,49458126,304258,86763850,19991,21
51455,REV1,chr2,R,99400474,99490030,49547682,89556,86853406,19992,24
51471,NAT8B,chr2,R,73700508,73701340,49548514,832,86854238,19993,0
51540,SCLY,chr2,F,238060923,238099413,49587004,38490,86892728,19994,18
51542,VPS54,chr2,R,63892149,64019080,49713935,126931,87019659,19995,24
51594,NBAS,chr2,R,15166907,15561348,50108376,394441,87414100,19996,52
51601,LIPT1,chr2,F,99154954,99163157,50116579,8203,87422303,19997,6
51602,NOP58,chr2,F,202265791,202303661,50154449,37870,87460173,19998,14
51626,DYNC2LI1,chr2,F,43774038,43827950,50208361,53912,87514085,19999,14
51639,SF3B6,chr2,R,24067583,24076444,50217222,8861,87522946,20000,3
51646,YPEL5,chr2,F,30146883,30160533,50230872,13650,87536596,20001,4
51652,CHMP3,chr2,R,86503429,86563497,50290940,60068,87596664,20002,5
51661,FKBP7,chr2,R,178463663,178480393,50307670,16730,87613394,20003,6
51665,ASB1,chr2,F,238426740,238452250,50333180,25510,87638904,20004,4
51692,CPSF3,chr2,F,9423536,9473110,50382754,49574,87688478,20005,17
51719,CAB39,chr2,F,230712841,230821075,50490988,108234,87796712,20006,10
51776,ZAK,chr2,F,173075836,173268009,50683161,192173,87988885,20007,21
53335,BCL11A,chr2,R,60451166,60553498,50785493,102332,88091217,20008,6
53353,LRP1B,chr2,R,140231426,142132474,52686541,1901048,89992265,20009,90
53632,PRKAG3,chr2,R,218822382,218831789,52695948,9407,90001672,20010,13
53938,PPIL3,chr2,R,200870906,200889333,52714375,18427,90020099,20011,8
54221,SNTG2,chr2,F,950867,1367645,53131153,416778,90436877,20012,20
54431,DNAJC10,chr2,F,182716040,182780025,53195138,63985,90500862,20013,25
54454,ATAD2B,chr2,R,23685228,23927114,53437024,241886,90742748,20014,40
54465,ETAA1,chr2,F,67397309,67410413,53450128,13104,90755852,20015,6
54497,HEATR5B,chr2,R,36980998,37084375,53553505,103377,90859229,20016,36
54520,CCDC93,chr2,R,117915477,118014163,53652191,98686,90957915,20017,25
54529,ASNSD1,chr2,F,189661398,189670831,53661624,9433,90967348,20018,5
54575,UGT1A10,chr2,F,233636476,233773305,53798453,136829,91104177,20019,4
54576,UGT1A8,chr2,F,233617644,233773299,53954108,155655,91259832,20020,4
54577,UGT1A7,chr2,F,233681937,233773299,54045470,91362,91351194,20021,4
54578,UGT1A6,chr2,F,233691674,233773305,54127101,81631,91432825,20022,4
54579,UGT1A5,chr2,F,233712991,233773299,54187409,60308,91493133,20023,4
54600,UGT1A9,chr2,F,233671897,233773305,54288817,101408,91594541,20024,4
54657,UGT1A4,chr2,F,233718791,233773299,54343325,54508,91649049,20025,4
54658,UGT1A1,chr2,F,233760272,233773299,54356352,13027,91662076,20026,4
54659,UGT1A3,chr2,F,233729126,233773299,54400525,44173,91706249,20027,4
54738,FEV,chr2,R,218981086,218985657,54405096,4571,91710820,20028,2
54812,AFTPH,chr2,F,64524304,64593005,54473797,68701,91779521,20029,9
54842,MFSD6,chr2,F,190408354,190502315,54567758,93961,91873482,20030,9
54867,TMEM214,chr2,F,27032905,27041697,54576550,8792,91882274,20031,17
54884,RETSAT,chr2,R,85341954,85354698,54589294,12744,91895018,20032,10
54891,INO80D,chr2,R,205993720,206086182,54681756,92462,91987480,20033,15
54910,SEMA4C,chr2,R,96859735,96870943,54692964,11208,91998688,20034,18
54978,SLC35F6,chr2,F,26764273,26781231,54709922,16958,92015646,20035,5
54980,C2orf42,chr2,R,70149884,70191019,54751057,41135,92056781,20036,10
55006,TRMT61B,chr2,R,28849820,28870309,54771546,20489,92077270,20037,5
55022,PID1,chr2,R,229023972,229271341,55018915,247369,92324639,20038,4
55037,PTCD3,chr2,F,86106181,86142157,55054891,35976,92360615,20039,23
55041,PLEKHB2,chr2,F,131104734,131149852,55100009,45118,92405733,20040,10
55054,ATG16L1,chr2,F,233251570,233295674,55144113,44104,92449837,20041,18
55120,FANCL,chr2,R,58159242,58241681,55226552,82439,92532276,20042,14
55133,SRBD1,chr2,R,45388679,45611295,55449168,222616,92754892,20043,22
55137,FIGN,chr2,R,163604936,163736197,55580429,131261,92886153,20044,6
55139,ANKZF1,chr2,F,219229756,219236669,55587342,6913,92893066,20045,12
55183,RIF1,chr2,F,151409882,151534202,55711662,124320,93017386,20046,38
55230,USP40,chr2,R,233475518,233566787,55802931,91269,93108655,20047,34
55233,MOB1A,chr2,R,74154408,74178886,55827409,24478,93133133,20048,6
55240,STEAP3,chr2,F,119222730,119265652,55870331,42922,93176055,20049,8
55252,ASXL2,chr2,R,25733752,25878474,56015053,144722,93320777,20050,15
55256,ADI1,chr2,R,3497918,3519579,56036714,21661,93342438,20051,4
55258,THNSL2,chr2,F,88170294,88186637,56053057,16343,93358781,20052,9
55289,ACOXL,chr2,F,110732538,111120610,56441129,388072,93746853,20053,37
55339,WDR33,chr2,R,127704233,127811187,56548083,106954,93853807,20054,22
55355,HJURP,chr2,R,233836700,233854566,56565949,17866,93871673,20055,8
55437,STRADB,chr2,F,201451668,201480851,56595132,29183,93900856,20056,11
55471,NDUFAF7,chr2,F,37231630,37249160,56612662,17530,93918386,20057,10
55502,HES6,chr2,R,238238266,238240124,56614520,1858,93920244,20058,3
55515,ASIC4,chr2,F,219514169,219538772,56639123,24603,93944847,20059,11
55571,CNOT11,chr2,F,101252882,101270316,56656557,17434,93962281,20060,6
55577,NAGK,chr2,F,71068240,71078868,56667185,10628,93972909,20061,9
55619,DOCK10,chr2,R,224765089,225042613,56944709,277524,94250433,20062,59
55622,TTC27,chr2,F,32628019,32821051,57137741,193032,94443465,20063,19
55627,SMPD4,chr2,R,130151391,130182750,57169100,31359,94474824,20064,19
55654,TMEM127,chr2,R,96250207,96266013,57184906,15806,94490630,20065,3
55660,PRPF40A,chr2,R,152651592,152717916,57251230,66324,94556954,20066,28
55676,SLC30A6,chr2,F,32165840,32224112,57309502,58272,94615226,20067,16
55677,IWS1,chr2,R,127480806,127526886,57355582,46080,94661306,20068,16
55679,LIMS2,chr2,R,127638420,127681786,57398948,43366,94704672,20069,15
55683,KANSL3,chr2,R,96593154,96638379,57444173,45225,94749897,20070,28
55686,MREG,chr2,R,215942589,216013623,57515207,71034,94820931,20071,6
55704,CCDC88A,chr2,R,55287841,55419921,57647287,132080,94953011,20072,34
55759,WDR12,chr2,R,202880599,202912226,57678914,31627,94984638,20073,12
55777,MBD5,chr2,F,148021010,148513477,58171381,492467,95477105,20074,18
55818,KDM3A,chr2,F,86440646,86492716,58223451,52070,95529175,20075,28
55821,ALLC,chr2,F,3658183,3702671,58267939,44488,95573663,20076,14
55825,PECR,chr2,R,216038387,216081816,58311368,43429,95617092,20077,8
55843,ARHGAP15,chr2,F,143070967,143768352,59008753,697385,96314477,20078,20
55854,ZC3H15,chr2,F,186486157,186509361,59031957,23204,96337681,20079,10
55997,CFC1,chr2,R,130592164,130599575,59039368,7411,96345092,20080,6
56171,DNAH7,chr2,R,195737702,196075186,59376852,337484,96682576,20081,69
56287,GKN1,chr2,F,68974572,68980980,59383260,6408,96688984,20082,5
56300,IL36G,chr2,F,112972328,112985672,59396604,13344,96702328,20083,6
56475,RPRM,chr2,R,153477337,153478808,59398075,1471,96703799,20084,0
56603,CYP26B1,chr2,R,72129237,72147862,59416700,18625,96722424,20085,7
56655,POLE4,chr2,F,74958647,74969732,59427785,11085,96733509,20086,3
56660,KCNK12,chr2,R,47516573,47570331,59481543,53758,96787267,20087,2
56886,UGGT1,chr2,F,128091179,128195677,59586041,104498,96891765,20088,40
56888,KCMF1,chr2,F,84971107,85059472,59674406,88365,96980130,20089,7
56896,DPYSL5,chr2,F,26848100,26950351,59776657,102251,97082381,20090,14
56902,PNO1,chr2,F,68157872,68175959,59794744,18087,97100468,20091,6
56910,STARD7,chr2,R,96184858,96208846,59818732,23988,97124456,20092,7
56918,C2orf83,chr2,R,227610089,227633320,59841963,23231,97147687,20093,3
56947,MFF,chr2,F,227325150,227357836,59874649,32686,97180373,20094,11
56969,RPL23AP32,chr2,F,54529221,54529841,59875269,620,97180993,20095,0
57007,ACKR3,chr2,F,236537125,236582358,59920502,45233,97226226,20096,5
57140,RNPEPL1,chr2,F,240568540,240578732,59930694,10192,97236418,20097,10
57142,RTN4,chr2,R,54972188,55112616,60071122,140428,97376846,20098,14
57159,TRIM54,chr2,F,27282428,27307439,60096133,25011,97401857,20099,9
57162,PELI1,chr2,R,64092651,64144471,60147953,51820,97453677,20100,10
57181,SLC39A10,chr2,F,195575976,195737702,60309679,161726,97615403,20101,16
57217,TTC7A,chr2,F,46916128,47076136,60469687,160008,97775411,20102,28
57223,SMEK2,chr2,R,55547291,55617725,60540121,70434,97845845,20103,18
57282,SLC4A10,chr2,F,161624334,161985276,60901063,360942,98206787,20104,29
57404,CYP20A1,chr2,F,203238440,203305840,60968463,67400,98274187,20105,13
57405,SPC25,chr2,R,168865143,168890434,60993754,25291,98299478,20106,7
57448,BIRC6,chr2,F,32357027,32618899,61255626,261872,98561350,20107,77
57471,ERMN,chr2,R,157318612,157327713,61264727,9101,98570451,20108,4
57498,KIDINS220,chr2,R,8728856,8837625,61373496,108769,98679220,20109,29
57504,MTA3,chr2,F,42494568,42795030,61673958,300462,98979682,20110,22
57520,HECW2,chr2,R,196198999,196593692,62068651,394693,99374375,20111,30
57539,WDR35,chr2,R,19910259,19990123,62148515,79864,99454239,20112,28
57574,MARCH4,chr2,R,216257861,216372027,62262681,114166,99568405,20113,4
57590,WDFY1,chr2,R,223875342,223945387,62332726,70045,99638450,20114,11
57624,NYAP2,chr2,F,225399709,225703653,62636670,303944,99942394,20115,8
57628,DPP10,chr2,F,114442321,115845752,64040101,1403431,101345825,20116,31
57665,RDH14,chr2,R,18554722,18560693,64046072,5971,101351796,20117,1
57669,EPB41L5,chr2,F,120013027,120179121,64212166,166094,101517890,20118,25
57679,ALS2,chr2,R,201700262,201781172,64293076,80910,101598800,20119,37
57683,ZDBF2,chr2,F,206274640,206314438,64332874,39798,101638598,20120,9
57695,USP37,chr2,R,218450250,218568366,64450990,118116,101756714,20121,29
57703,CWC22,chr2,R,179944875,180007297,64513412,62422,101819136,20122,20
57730,ANKRD36B,chr2,R,97492662,97590245,64610995,97583,101916719,20123,47
57818,G6PC2,chr2,F,168901239,168910000,64619756,8761,101925480,20124,4
57835,SLC4A5,chr2,R,74216241,74343407,64746922,127166,102052646,20125,31
58190,CTDSP1,chr2,F,218398337,218405941,64754526,7604,102060250,20126,8
58484,NLRC4,chr2,R,32224448,32265743,64795821,41295,102101545,20127,9
58538,MPP4,chr2,R,201644873,201698834,64849782,53961,102155506,20128,21
60482,SLC5A7,chr2,F,107986486,108014207,64877503,27721,102183227,20129,9
60491,NIF3L1,chr2,F,200889326,200903932,64892109,14606,102197833,20130,7
60509,AGBL5,chr2,F,27051422,27070622,64911309,19200,102217033,20131,17
60526,C2orf43,chr2,R,20684013,20823137,65050433,139124,102356157,20132,6
63892,THADA,chr2,R,43230835,43596056,65415654,365221,102721378,20133,40
64002,PCGEM1,chr2,F,192749844,192776899,65442709,27055,102748433,20134,2
64080,RBKS,chr2,R,27781363,27890396,65551742,109033,102857466,20135,8
64090,GAL3ST2,chr2,F,241776824,241804287,65579205,27463,102884929,20136,3
64114,TMBIM1,chr2,R,218274193,218292557,65597569,18364,102903293,20137,15
64135,IFIH1,chr2,R,162267078,162318764,65649255,51686,102954979,20138,16
64172,OSGEPL1,chr2,R,189746659,189763198,65665794,16539,102971518,20139,9
64225,ATL2,chr2,R,38294093,38378139,65749840,84046,103055564,20140,19
64240,ABCG5,chr2,R,43806154,43838865,65782551,32711,103088275,20141,13
64241,ABCG8,chr2,F,43828953,43880189,65833787,51236,103139511,20142,14
64284,RAB17,chr2,R,237574321,237591126,65850592,16805,103156316,20143,5
64320,RNF25,chr2,R,218663863,218672058,65858787,8195,103164511,20144,9
64342,HS1BP3,chr2,R,20617803,20651104,65892088,33301,103197812,20145,6
64395,GMCL1,chr2,F,69829641,69881386,65943833,51745,103249557,20146,14
64427,TTC31,chr2,F,74483031,74494564,65955366,11533,103261090,20147,12
64682,ANAPC1,chr2,R,111767636,111884186,66071916,116550,103377640,20148,48
64708,COPS7B,chr2,F,231781670,231809254,66099500,27584,103405224,20149,11
64795,RMND5A,chr2,F,86720290,86778041,66157251,57751,103462975,20150,8
64838,FNDC4,chr2,R,27491882,27495296,66160665,3414,103466389,20151,6
64844,MARCH7,chr2,F,159712456,159768583,66216792,56127,103522516,20152,12
64859,NABP1,chr2,F,191678071,191688522,66227243,10451,103532967,20153,7
64895,PAPOLG,chr2,F,60756229,60802086,66273100,45857,103578824,20154,21
64965,MRPS9,chr2,F,105038024,105099960,66335036,61936,103640760,20155,12
64969,MRPS5,chr2,R,95087206,95122009,66369839,34803,103675563,20156,11
65055,REEP1,chr2,R,86213992,86338418,66494265,124426,103799989,20157,11
65059,RAPH1,chr2,R,203433681,203535335,66595919,101654,103901643,20158,19
65061,CDK15,chr2,F,201790458,201895550,66701011,105092,104006735,20159,25
65062,TMEM237,chr2,R,201620183,201643529,66724357,23346,104030081,20160,13
65065,NBEAL1,chr2,F,203014616,203226353,66936094,211737,104241818,20161,61
65072,CFLAR-AS1,chr2,R,201140288,201157792,66953598,17504,104259322,20162,6
65080,MRPL44,chr2,F,223950889,223967714,66970423,16825,104276147,20163,4
65124,SOWAHC,chr2,F,109614333,109618987,66975077,4654,104280801,20164,0
65977,PLEKHA3,chr2,F,178480409,178505586,67000254,25177,104305978,20165,8
66008,TRAK2,chr2,R,201377206,201451596,67074644,74390,104380368,20166,17
66037,BOLL,chr2,R,197726878,197786574,67134340,59696,104440064,20167,14
78989,COLEC11,chr2,F,3594831,3644644,67184153,49813,104489877,20168,11
79031,PDCL3,chr2,F,100562955,100576739,67197937,13784,104503661,20169,5
79054,TRPM8,chr2,F,233917361,234019522,67300098,102161,104605822,20170,25
79065,ATG9A,chr2,R,219219379,219229688,67310407,10309,104616131,20171,15
79074,C2orf49,chr2,F,105337358,105359940,67332989,22582,104638713,20172,4
79083,MLPH,chr2,F,237486409,237555318,67401898,68909,104707622,20173,19
79134,TMEM185B,chr2,R,120217470,120223408,67407836,5938,104713560,20174,0
79137,FAM134A,chr2,F,219178216,219185475,67415095,7259,104720819,20175,8
79172,CENPO,chr2,F,24793305,24822376,67444166,29071,104749890,20176,7
79315,OR7E91P,chr2,F,71024074,71029931,67450023,5857,104755747,20177,2
79411,GLB1L,chr2,R,219236597,219245429,67458855,8832,104764579,20178,16
79568,C2orf47,chr2,F,199955316,199964125,67467664,8809,104773388,20179,6
79582,SPAG16,chr2,F,213284378,214410501,68593787,1126123,105899511,20180,33
79586,CHPF,chr2,R,219538946,219543765,68598606,4819,105904330,20181,5
79595,SAP130,chr2,R,127941216,128028093,68685483,86877,105991207,20182,21
79623,GALNT14,chr2,R,30910464,31161688,68936707,251224,106242431,20183,22
79634,SCRN3,chr2,F,174395728,174429575,68970554,33847,106276278,20184,7
79635,CCDC121,chr2,R,27625637,27629031,68973948,3394,106279672,20185,2
79675,FASTKD1,chr2,R,169527879,169573921,69019990,46042,106325714,20186,15
79677,SMC6,chr2,R,17663811,17753829,69110008,90018,106415732,20187,29
79712,GTDC1,chr2,R,143945786,144332534,69496756,386748,106802480,20188,25
79745,CLIP4,chr2,F,29097675,29183813,69582894,86138,106888618,20189,22
79781,IQCA1,chr2,R,236324146,236507552,69766300,183406,107072024,20190,20
79800,CARF,chr2,F,202912217,202987857,69841940,75640,107147664,20191,20
79809,TTC21B,chr2,R,165873361,165953838,69922417,80477,107228141,20192,30
79823,CAMKMT,chr2,F,44361903,44772592,70333106,410689,107638830,20193,16
79828,METTL8,chr2,R,171317401,171434802,70450507,117401,107756231,20194,12
79833,GEMIN6,chr2,F,38778184,38782456,70454779,4272,107760503,20195,3
79840,NHEJ1,chr2,R,219075323,219160865,70540321,85542,107846045,20196,7
79843,FAM124B,chr2,R,224378697,224401994,70563618,23297,107869342,20197,2
79853,TM4SF20,chr2,R,227362155,227379306,70580769,17151,107886493,20198,4
79901,CYBRD1,chr2,F,171522246,171558133,70616656,35887,107922380,20199,4
79919,C2orf54,chr2,R,240886047,240896889,70627498,10842,107933222,20200,6
79954,NOL10,chr2,R,10570765,10689987,70746720,119222,108052444,20201,24
79998,ANKRD53,chr2,F,70977209,70986674,70756185,9465,108061909,20202,6
80034,CSRNP3,chr2,F,165469646,165689407,70975946,219761,108281670,20203,8
80055,PGAP1,chr2,R,196833003,196926995,71069938,93992,108375662,20204,27
80059,LRRTM4,chr2,R,76747456,77522376,71844858,774920,109150582,20205,4
80067,DCAF17,chr2,F,171434172,171491027,71901713,56855,109207437,20206,16
80086,TUBA4B,chr2,F,219253242,219272188,71920659,18946,109226383,20207,3
80097,MZT2B,chr2,F,130181543,130204794,71943910,23251,109249634,20208,7
80122,MAP3K19,chr2,R,134964289,135047444,72027065,83155,109332789,20209,19
80146,UXS1,chr2,R,106093302,106194339,72128102,101037,109433826,20210,17
80204,FBXO11,chr2,R,47806919,47906535,72227718,99616,109533442,20211,22
80210,ARMC9,chr2,F,231198545,231394991,72424164,196446,109729888,20212,35
80219,COQ10B,chr2,F,197453506,197475135,72445793,21629,109751517,20213,5
80255,SLC35F5,chr2,R,113712791,113756823,72489825,44032,109795549,20214,16
80303,EFHD1,chr2,F,232606056,232682781,72566550,76725,109872274,20215,5
80304,C2orf44,chr2,R,24029335,24047426,72584641,18091,109890365,20216,3
80309,SPHKAP,chr2,R,227979953,228181962,72786650,202009,110092374,20217,15
80326,WNT10A,chr2,F,218874322,218893931,72806259,19609,110111983,20218,5
80704,SLC19A3,chr2,R,227685209,227718029,72839079,32820,110144803,20219,8
80705,TSGA10,chr2,R,98997260,99154920,72996739,157660,110302463,20220,26
80731,THSD7B,chr2,F,136765561,137677717,73908895,912156,111214619,20221,29
80745,THUMPD2,chr2,R,39736059,39779276,73952112,43217,111257836,20222,12
80775,TMEM177,chr2,F,119679166,119682118,73955064,2952,111260788,20223,1
80856,KIAA1715,chr2,R,175923861,176005388,74036591,81527,111342315,20224,18
80895,ILKAP,chr2,R,238170400,238203702,74069893,33302,111375617,20225,11
81553,FAM49A,chr2,R,16549458,16665866,74186301,116408,111492025,20226,13
81562,LMAN2L,chr2,R,96705928,96740082,74220455,34154,111526179,20227,9
81606,LBH,chr2,F,30231530,30260033,74248958,28503,111554682,20228,2
81615,TMEM163,chr2,R,134455758,134736424,74529624,280666,111835348,20229,10
81618,ITM2C,chr2,F,230864597,230879254,74544281,14657,111850005,20230,6
83439,TCF7L1,chr2,F,85133459,85310388,74721210,176929,112026934,20231,11
83444,INO80B,chr2,F,74455022,74457960,74724148,2938,112029872,20232,4
83607,AMMECR1L,chr2,R,127861629,127888570,74751089,26941,112056813,20233,10
83879,CDCA7,chr2,F,173354016,173368990,74766063,14974,112071787,20234,10
84058,WDR54,chr2,F,74421732,74425755,74770086,4023,112075810,20235,9
84083,ZRANB3,chr2,R,135196968,135531322,75104440,334354,112410164,20236,29
84084,RAB6C,chr2,F,129979661,129982738,75107517,3077,112413241,20237,0
84128,WDR75,chr2,F,189441432,189475562,75141647,34130,112447371,20238,21
84140,FAM161A,chr2,R,61744555,61855402,75252494,110847,112558218,20239,11
84141,EVA1A,chr2,R,75492317,75569722,75329899,77405,112635623,20240,4
84168,ANTXR1,chr2,F,69013143,69249327,75566083,236184,112871807,20241,21
84172,POLR1B,chr2,F,112541914,112577153,75601322,35239,112907046,20242,15
84173,ELMOD3,chr2,F,85354719,85391752,75638355,37033,112944079,20243,15
84220,RGPD5,chr2,F,109760606,109857691,75735440,97085,113041164,20244,30
84226,C2orf16,chr2,F,27576521,27582722,75741641,6201,113047365,20245,0
84236,RHBDD1,chr2,F,226835935,226999210,75904916,163275,113210640,20246,13
84269,CHCHD5,chr2,F,112583605,112589040,75910351,5435,113216075,20247,4
84272,YIPF4,chr2,F,32277888,32307364,75939827,29476,113245551,20248,5
84279,PRADC1,chr2,R,73228005,73233228,75945050,5223,113250774,20249,4
84281,C2orf88,chr2,F,189879552,190203484,76268982,323932,113574706,20250,11
84289,ING5,chr2,F,241700592,241729481,76297871,28889,113603595,20251,12
84317,CCDC115,chr2,R,130337932,130342810,76302749,4878,113608473,20252,5
84365,NIFK,chr2,R,121726944,121736927,76312732,9983,113618456,20253,6
84417,C2orf40,chr2,F,106063293,106078155,76327594,14862,113633318,20254,5
84450,ZNF512,chr2,F,27582968,27623215,76367841,40247,113673565,20255,14
84524,ZC3H8,chr2,R,112215676,112255101,76407266,39425,113712990,20256,10
84542,KIAA1841,chr2,F,61065869,61157942,76499339,92073,113805063,20257,28
84620,ST6GAL2,chr2,R,106794127,106887265,76592477,93138,113898201,20258,14
84639,IL1F10,chr2,F,113067969,113075850,76600358,7881,113906082,20259,4
84661,DPY30,chr2,R,32021079,32039840,76619119,18761,113924843,20260,7
84693,MCEE,chr2,R,71109675,71130288,76639732,20613,113945456,20261,3
84695,LOXL3,chr2,R,74532257,74555887,76663362,23630,113969086,20262,14
84696,ABHD1,chr2,F,27123779,27130991,76670574,7212,113976298,20263,8
84759,PCGF1,chr2,R,74505042,74507694,76673226,2652,113978950,20264,9
84771,DDX11L2,chr2,R,113599027,113603717,76677916,4690,113983640,20265,2
84804,MFSD9,chr2,R,102714629,102736882,76700169,22253,114005893,20266,6
84812,PLCD4,chr2,F,218607764,218637186,76729591,29422,114035315,20267,16
84826,SFT2D3,chr2,F,127701022,127703833,76732402,2811,114038126,20268,0
84865,CCDC142,chr2,R,74472831,74483230,76742801,10399,114048525,20269,8
84874,ZNF514,chr2,R,95130109,95165187,76777879,35078,114083603,20270,7
84908,FAM136A,chr2,R,70295975,70302088,76783992,6113,114089716,20271,3
84910,TMEM87B,chr2,F,112055222,112119318,76848088,64096,114153812,20272,19
84913,ATOH8,chr2,F,85753785,85791383,76885686,37598,114191410,20273,6
84931,LINC01101,chr2,R,120464334,120466349,76887701,2015,114193425,20274,0
85009,MGC16025,chr2,R,239193330,239195457,76889828,2127,114195552,20275,0
85461,TANC1,chr2,F,158968633,159232663,77153858,264030,114459582,20276,33
85465,EPT1,chr2,F,26346085,26395891,77203664,49806,114509388,20277,9
85474,LBX2,chr2,R,74497516,74503316,77209464,5800,114515188,20278,2
87178,PNPT1,chr2,R,55634062,55693910,77269312,59848,114575036,20279,28
90134,KCNH7,chr2,R,162371406,162838747,77736653,467341,115042377,20280,16
90342,FER1L5,chr2,F,96642710,96706220,77800163,63510,115105887,20281,55
90411,MCFD2,chr2,R,46901869,46941855,77840149,39986,115145873,20282,6
90423,ATP6V1E2,chr2,R,46489354,46542412,77893207,53058,115198931,20283,9
90499,FAM95A,chr2,R,94755325,94761184,77899066,5859,115204790,20284,2
90557,CCDC74A,chr2,F,131522640,131533670,77910096,11030,115215820,20285,9
90784,LOC90784,chr2,R,86020215,86023868,77913749,3653,115219473,20286,0
90957,DHX57,chr2,R,38797728,38875883,77991904,78155,115297628,20287,25
91149,RAPGEF4-AS1,chr2,R,172723188,172736206,78004922,13018,115310646,20288,3
91404,SESTD1,chr2,R,179101691,179264623,78167854,162932,115473578,20289,18
91409,CCDC74B,chr2,R,130139282,130145134,78173706,5852,115479430,20290,7
91461,PKDCC,chr2,F,42048020,42058528,78184214,10508,115489938,20291,6
91526,ANKRD44,chr2,R,196962616,197310797,78532395,348181,115838119,20292,32
91543,RSAD2,chr2,F,6865839,6898232,78564788,32393,115870512,20293,6
91752,ZNF804A,chr2,F,184598365,184939487,78905910,341122,116211634,20294,3
92104,TTC30A,chr2,R,177614297,177618966,78910579,4669,116216303,20295,0
92196,DAPL1,chr2,F,158795316,158827457,78942720,32141,116248444,20296,5
92291,CAPN13,chr2,R,30722770,30807484,79027434,84714,116333158,20297,27
92691,TMEM169,chr2,F,216081865,216102783,79048352,20918,116354076,20298,4
92737,DNER,chr2,R,229357628,229714570,79405294,356942,116711018,20299,12
92749,DRC1,chr2,F,26401915,26456713,79460092,54798,116765816,20300,16
92856,IMP4,chr2,F,130342896,130346625,79463821,3729,116769545,20301,8
92906,HNRNPLL,chr2,R,38561977,38603036,79504880,41059,116810604,20302,15
92935,MARS2,chr2,F,197705303,197708390,79507967,3087,116813691,20303,0
93010,B3GNT7,chr2,F,231395623,231408801,79521145,13178,116826869,20304,3
93034,NT5C1B,chr2,R,18562870,18589580,79547855,26710,116853579,20305,9
93082,NEURL3,chr2,R,96497642,96508136,79558349,10494,116864073,20306,6
93349,SP140L,chr2,F,230327165,230403730,79634914,76565,116940638,20307,20
93463,LOC93463,chr2,R,237048598,237056167,79642483,7569,116948207,20308,6
94097,SFXN5,chr2,R,72942035,73071836,79772284,129801,117078008,20309,18
94101,ORMDL1,chr2,R,189767219,189784371,79789436,17152,117095160,20310,6
96626,LIMS3,chr2,F,109898431,109925625,79816630,27194,117122354,20311,9
112597,LINC00152,chr2,F,87455454,87521518,79882694,66064,117188418,20312,4
112714,TUBA3E,chr2,R,130191744,130198461,79889411,6717,117195135,20313,4
112942,CFAP36,chr2,F,55519594,55545080,79914897,25486,117220621,20314,11
113419,TEX261,chr2,R,70985937,70994873,79923833,8936,117229557,20315,6
113457,TUBA3D,chr2,F,131476006,131482934,79930761,6928,117236485,20316,4
114790,STK11IP,chr2,F,219597870,219616451,79949342,18581,117255066,20317,28
114793,FMNL2,chr2,F,152335169,152649834,80264007,314665,117569731,20318,30
114800,CCDC85A,chr2,F,56184122,56386174,80466059,202052,117771783,20319,5
114805,GALNT13,chr2,F,153871897,154453977,81048139,582080,118353863,20320,14
114818,KLHL29,chr2,F,23385426,23708613,81371326,323187,118677050,20321,15
114880,OSBPL6,chr2,F,178194480,178399433,81576279,204953,118882003,20322,26
115677,NOSTRIN,chr2,F,168786538,168865339,81655080,78801,118960804,20323,24
116093,DIRC1,chr2,R,188733737,188839420,81760763,105683,119066487,20324,2
116143,WDR92,chr2,R,68130148,68157560,81788175,27412,119093899,20325,7
116255,MOGAT1,chr2,F,222671737,222709930,81826368,38193,119132092,20326,5
116372,LYPD1,chr2,R,132644763,132671497,81853102,26734,119158826,20327,4
116540,MRPL53,chr2,R,74471957,74472815,81853960,858,119159684,20328,2
116987,AGAP1,chr2,F,235494088,236131800,82491672,637712,119797396,20329,21
117581,TWIST2,chr2,F,238847933,238910548,82554287,62615,119860011,20330,3
117583,PARD3B,chr2,F,204545792,205620162,83628657,1074370,120934381,20331,26
118433,RPL23AP7,chr2,R,113611238,113627138,83644557,15900,120950281,20332,5
129285,PPP1R21,chr2,F,48440768,48515392,83719181,74624,121024905,20333,23
129293,TRABD2A,chr2,R,84821649,84881975,83779507,60326,121085231,20334,8
129303,TMEM150A,chr2,R,85598546,85602699,83783660,4153,121089384,20335,9
129401,NUP35,chr2,F,183117489,183161684,83827855,44195,121133579,20336,12
129446,XIRP2,chr2,F,166888486,167259753,84199122,371267,121504846,20337,12
129450,TYW5,chr2,R,199928910,199955736,84225948,26826,121531672,20338,7
129521,NMS,chr2,F,100470481,100483280,84238747,12799,121544471,20339,9
129530,LYG1,chr2,R,99284237,99304742,84259252,20505,121564976,20340,10
129531,MITD1,chr2,R,99161426,99181061,84278887,19635,121584611,20341,8
129563,DIS3L2,chr2,F,231961582,232343968,84661273,382386,121966997,20342,20
129607,CMPK2,chr2,R,6840416,6866635,84687492,26219,121993216,20343,7
129642,MBOAT2,chr2,R,8852689,9003747,84838550,151058,122144274,20344,13
129684,CNTNAP5,chr2,F,124025286,124921201,85734465,895915,123040189,20345,23
129787,TMEM18,chr2,R,667972,677439,85743932,9467,123049656,20346,4
129804,FBLN7,chr2,F,112138384,112188218,85793766,49834,123099490,20347,9
129807,NEU4,chr2,F,241809064,241817413,85802115,8349,123107839,20348,5
129831,RBM45,chr2,F,178112416,178129656,85819355,17240,123125079,20349,9
129852,C2orf73,chr2,F,54330012,54383673,85873016,53661,123178740,20350,9
129868,TRIM43,chr2,F,95592017,95599771,85880770,7754,123186494,20351,8
129880,BBS5,chr2,F,169479495,169506655,85907930,27160,123213654,20352,11
129881,CCDC173,chr2,R,169645424,169694421,85956927,48997,123262651,20353,9
130013,ACMSD,chr2,F,134838347,134902076,86020656,63729,123326380,20354,11
130026,ICA1L,chr2,R,202773149,202871985,86119492,98836,123425216,20355,14
130074,FAM168B,chr2,R,131047875,131093431,86165048,45556,123470772,20356,10
130106,CIB4,chr2,R,26573763,26641411,86232696,67648,123538420,20357,9
130120,REG3G,chr2,F,79025685,79028504,86235515,2819,123541239,20358,6
130132,RFTN2,chr2,R,197570799,197676045,86340761,105246,123646485,20359,10
130162,CLHC1,chr2,R,55172546,55232563,86400778,60017,123706502,20360,18
130271,PLEKHH2,chr2,F,43637299,43767987,86531466,130688,123837190,20361,30
130340,AP1S3,chr2,R,223755329,223837602,86613739,82273,123919463,20362,5
130355,C2orf76,chr2,R,119300441,119366826,86680124,66385,123985848,20363,7
130367,SGPP2,chr2,F,222424051,222561842,86817915,137791,124123639,20364,5
130399,ACVR1C,chr2,R,157526766,157628887,86920036,102121,124225760,20365,9
130497,OSR1,chr2,R,19351484,19358611,86927163,7127,124232887,20366,3
130502,TTC32,chr2,R,19896752,19901986,86932397,5234,124238121,20367,2
130507,UBR3,chr2,F,169827469,170084131,87189059,256662,124494783,20368,42
130535,KCTD18,chr2,R,200488951,200510094,87210202,21143,124515926,20369,6
130540,ALS2CR12,chr2,R,201288270,201357398,87279330,69128,124585054,20370,14
130557,ZNF513,chr2,R,27377230,27380866,87282966,3636,124588690,20371,4
130560,SPATA3,chr2,F,230996123,231025056,87311899,28933,124617623,20372,14
130574,LYPD6,chr2,F,149329984,149474148,87456063,144164,124761787,20373,5
130576,LYPD6B,chr2,F,149038466,149215262,87632859,176796,124938583,20374,19
130589,GALM,chr2,F,38665909,38734767,87701717,68858,125007441,20375,8
130612,TMEM198,chr2,F,219543662,219550595,87708650,6933,125014374,20376,4
130617,ZFAND2B,chr2,F,219206783,219209651,87711518,2868,125017242,20377,8
130733,TMEM178A,chr2,F,39665497,39717963,87763984,52466,125069708,20378,4
130749,CPO,chr2,F,206879382,206971064,87855666,91682,125161390,20379,13
130752,MDH1B,chr2,R,206737762,206765549,87883453,27787,125189177,20380,12
130813,C2orf50,chr2,F,11133052,11154564,87904965,21512,125210689,20381,6
130814,PQLC3,chr2,F,11155371,11178874,87928468,23503,125234192,20382,7
130827,TMEM182,chr2,F,102736907,102843838,88035399,106931,125341123,20383,11
130872,AHSA2,chr2,F,61177419,61188573,88046553,11154,125352277,20384,6
130888,FBXO36,chr2,F,229922490,230013109,88137172,90619,125442896,20385,4
130916,MTERF4,chr2,R,241074679,241102359,88164852,27680,125470576,20386,8
130940,CCDC148,chr2,R,158171355,158456824,88450321,285469,125756045,20387,15
130951,M1AP,chr2,R,74557882,74648852,88541291,90970,125847015,20388,15
140469,MYO3B,chr2,F,170178144,170655164,89018311,477020,126324035,20389,42
140738,TMEM37,chr2,F,119429911,119438520,89026920,8609,126332644,20390,4
140739,UBE2F,chr2,F,237966944,238042782,89102758,75838,126408482,20391,11
142679,DUSP19,chr2,F,183078223,183100008,89124543,21785,126430267,20392,3
150465,TTL,chr2,F,112482165,112532770,89175148,50605,126480872,20393,7
150468,CKAP2L,chr2,R,112736348,112764677,89203477,28329,126509201,20394,8
150472,CBWD2,chr2,F,113437690,113496204,89261991,58514,126567715,20395,19
150483,TEKT4,chr2,F,94867766,94876829,89271054,9063,126576778,20396,5
150527,TISP43,chr2,F,130570845,130584161,89284370,13316,126590094,20397,2
150538,SATB2-AS1,chr2,F,199468097,199472758,89289031,4661,126594755,20398,1
150568,LINC01102,chr2,F,104434346,104512757,89367442,78411,126673166,20399,3
150572,SMYD1,chr2,F,88067779,88113384,89413047,45605,126718771,20400,9
150577,LINC01104,chr2,F,100208253,100251484,89456278,43231,126762002,20401,2
150590,C2orf15,chr2,F,99141721,99151487,89466044,9766,126771768,20402,3
150596,LOC150596,chr2,R,149803512,149858207,89520739,54695,126826463,20403,3
150622,LINC01105,chr2,F,5932686,5980218,89568271,47532,126873995,20404,1
150677,OTOS,chr2,R,240139028,240140656,89569899,1628,126875623,20405,3
150678,MYEOV2,chr2,R,240126562,240136347,89579684,9785,126885408,20406,4
150681,OR6B3,chr2,R,240044635,240053711,89588760,9076,126894484,20407,2
150684,COMMD1,chr2,F,61888727,62136070,89836103,247343,127141827,20408,5
150696,PROM2,chr2,F,95274415,95291320,89853008,16905,127158732,20409,24
150709,ANKAR,chr2,F,189674291,189763058,89941775,88767,127247499,20410,29
150726,FBXO41,chr2,R,73254681,73284453,89971547,29772,127277271,20411,16
150737,TTC30B,chr2,R,177550151,177552796,89974192,2645,127279916,20412,0
150759,LINC00342,chr2,R,95807051,95826981,89994122,19930,127299846,20413,2
150763,GPAT2,chr2,R,96021945,96035245,90007422,13300,127313146,20414,20
150771,ITPRIPL1,chr2,F,96325323,96328353,90010452,3030,127316176,20415,2
150776,LOC150776,chr2,F,131492812,131521576,90039216,28764,127344940,20416,17
150786,WTH3DI,chr2,R,131360491,131364158,90042883,3667,127348607,20417,0
150864,FAM117B,chr2,F,202635177,202769757,90177463,134580,127483187,20418,7
150921,TCF23,chr2,F,27148932,27153576,90182107,4644,127487831,20419,2
150935,LOC150935,chr2,F,239762859,239800664,90219912,37805,127525636,20420,2
150946,GAREML,chr2,F,26173090,26202529,90249351,29439,127555075,20421,10
150962,PUS10,chr2,R,60938351,61020031,90331031,81680,127636755,20422,26
150967,PKI55,chr2,F,216216888,216220192,90334335,3304,127640059,20423,0
150992,LINC00309,chr2,R,64185077,64205485,90354743,20408,127660467,20424,5
151009,LINC01106,chr2,R,110375108,110384536,90364171,9428,127669895,20425,1
151011,SEPT10,chr2,R,109542796,109614206,90435581,71410,127741305,20426,12
151050,KANSL1L,chr2,R,210020710,210171344,90586215,150634,127891939,20427,22
151056,PLB1,chr2,F,28488718,28643788,90741285,155070,128047009,20428,75
151112,ZSWIM2,chr2,R,186827479,186849170,90762976,21691,128068700,20429,9
151121,LOC151121,chr2,R,129242172,129273891,90794695,31719,128100419,20430,4
151126,ZNF385B,chr2,R,179441981,179862321,91215035,420340,128520759,20431,21
151171,LINC01107,chr2,R,238510689,238555499,91259845,44810,128565569,20432,2
151174,LOC151174,chr2,R,238225112,238231677,91266410,6565,128572134,20433,2
151176,FAM132B,chr2,F,238159007,238168890,91276293,9883,128582017,20434,7
151188,ARL6IP6,chr2,F,152717892,152761253,91319654,43361,128625378,20435,5
151194,METTL21A,chr2,R,207580634,207625928,91364948,45294,128670672,20436,9
151195,CCNYL1,chr2,F,207711539,207756174,91409583,44635,128715307,20437,9
151230,KLHL23,chr2,F,169733845,169751886,91427624,18041,128733348,20438,3
151234,SULT1C2P1,chr2,F,108322237,108353799,91459186,31562,128764910,20439,3
151242,PPP1R1C,chr2,F,181954240,182131382,91636328,177142,128942052,20440,7
151246,SGOL2,chr2,F,200524801,200584095,91695622,59294,129001346,20441,12
151254,ALS2CR11,chr2,R,201487420,201619183,91827385,131763,129133109,20442,16
151258,SLC38A11,chr2,R,164897744,164955560,91885201,57816,129190925,20443,15
151278,CCDC140,chr2,F,222298146,222305217,91892272,7071,129197996,20444,1
151295,SLC23A3,chr2,R,219161458,219170095,91900909,8637,129206633,20445,11
151300,LINC00608,chr2,F,218976283,218977922,91902548,1639,129208272,20446,1
151306,GPBAR1,chr2,F,218259495,218263861,91906914,4366,129212638,20447,2
151313,FAHD2B,chr2,R,97082403,97094882,91919393,12479,129225117,20448,11
151325,MYADML,chr2,R,33726060,33728217,91921550,2157,129227274,20449,0
151354,FAM84A,chr2,F,14632685,14640046,91928911,7361,129234635,20450,1
151393,RMDN2,chr2,F,37920844,38069970,92078037,149126,129383761,20451,20
151449,GDF7,chr2,F,20666663,20671490,92082864,4827,129388588,20452,1
151473,SLC16A14,chr2,R,230034973,230068999,92116890,34026,129422614,20453,6
151475,LOC151475,chr2,R,230690920,230700529,92126499,9609,129432223,20454,3
151477,LINC00471,chr2,R,231508425,231514339,92132413,5914,129438137,20455,2
151484,LOC151484,chr2,F,230886545,230904517,92150385,17972,129456109,20456,3
151507,MSL3P1,chr2,R,233865436,233868409,92153358,2973,129459082,20457,1
151516,ASPRV1,chr2,R,69960088,69962265,92155535,2177,129461259,20458,0
151525,WDSUB1,chr2,R,159235792,159286793,92206536,51001,129512260,20459,10
151531,UPP2,chr2,F,157995178,158136154,92347512,140976,129653236,20460,11
151534,LBX2-AS1,chr2,F,74502616,74505065,92349961,2449,129655685,20461,0
151556,GPR155,chr2,R,174431570,174487088,92405479,55518,129711203,20462,17
164781,DAW1,chr2,F,227871053,227924347,92458773,53294,129764497,20463,13
164832,LONRF2,chr2,R,100273290,100322733,92508216,49443,129813940,20464,11
165055,CCDC138,chr2,F,108786749,108876769,92598236,90020,129903960,20465,16
165082,ADGRF3,chr2,R,26308172,26346817,92636881,38645,129942605,20466,15
165100,C2orf57,chr2,F,231592863,231594283,92638301,1420,129944025,20467,0
165140,OXER1,chr2,R,42762498,42764261,92640064,1763,129945788,20468,0
165186,FAM179A,chr2,F,28981297,29052230,92710997,70933,130016721,20469,20
165215,FAM171B,chr2,F,186694061,186765959,92782895,71898,130088619,20470,9
165257,C1QL2,chr2,R,119156242,119158895,92785548,2653,130091272,20471,1
165324,UBXN2A,chr2,F,23927270,24001000,92859278,73730,130165002,20472,10
165530,CLEC4F,chr2,R,70808642,70823764,92874400,15122,130180124,20473,6
165545,DQX1,chr2,R,74518130,74526281,92882551,8151,130188275,20474,11
170850,KCNG3,chr2,R,42442016,42494097,92934632,52081,130240356,20475,1
192668,CYS1,chr2,R,10056798,10080411,92958245,23613,130263969,20476,2
200350,FOXD4L1,chr2,F,113499083,113501150,92960312,2067,130266036,20477,0
200373,CFAP221,chr2,F,119544422,119660321,93076211,115899,130381935,20478,30
200403,VWA3B,chr2,F,98087131,98330681,93319761,243550,130625485,20479,32
200407,CREG2,chr2,R,101348353,101387988,93359396,39635,130665120,20480,4
200420,ALMS1P,chr2,F,73644918,73685572,93400050,40654,130705774,20481,6
200424,TET3,chr2,F,73983334,74108176,93524892,124842,130830616,20482,14
200504,GKN2,chr2,R,68945231,68952970,93532631,7739,130838355,20483,5
200523,TEX37,chr2,F,88524316,88529585,93537900,5269,130843624,20484,4
200539,ANKRD23,chr2,R,96837913,96844021,93544008,6108,130849732,20485,8
200558,APLF,chr2,F,68467558,68580162,93656612,112604,130962336,20486,9
200576,PIKFYVE,chr2,F,208265752,208358751,93749611,92999,131055335,20487,42
200634,KRTCAP3,chr2,F,27442350,27446481,93753742,4131,131059466,20488,7
200726,LOC200726,chr2,F,206642417,206649449,93760774,7032,131066498,20489,2
200728,TMEM17,chr2,R,62447594,62506469,93819649,58875,131125373,20490,7
200734,SPRED2,chr2,R,65307434,65432637,93944852,125203,131250576,20491,8
200765,TIGD1,chr2,R,232547969,232550590,93947473,2621,131253197,20492,0
200772,LOC200772,chr2,R,240954616,240967451,93960308,12835,131266032,20493,8
205147,AMER3,chr2,F,130755503,130768134,93972939,12631,131278663,20494,2
205251,LINC00116,chr2,R,110211528,110222940,93984351,11412,131290075,20495,7
205327,C2orf69,chr2,F,199911255,199928273,94001369,17018,131307093,20496,1
220988,HNRNPA3,chr2,F,177212313,177223959,94013015,11646,131318739,20497,10
245711,SPDYA,chr2,F,28810833,28850610,94052792,39777,131358516,20498,7
245973,ATP6V1C2,chr2,F,10720973,10785110,94116929,64137,131422653,20499,17
246243,RNASEH1,chr2,R,3531812,3558371,94143488,26559,131449212,20500,12
253558,LCLAT1,chr2,F,30447225,30644225,94340488,197000,131646212,20501,8
253635,GPATCH11,chr2,F,37084450,37099244,94355282,14794,131661006,20502,8
253782,CERS6,chr2,F,168456248,168775134,94674168,318886,131979892,20503,11
254042,METAP1D,chr2,F,171999896,172082430,94756702,82534,132062426,20504,12
254128,NIFK-AS1,chr2,F,121649653,121728560,94835609,78907,132141333,20505,3
254773,LYG2,chr2,R,99198502,99256732,94893839,58230,132199563,20506,7
255101,CCDC108,chr2,R,219002845,219041551,94932545,38706,132238269,20507,34
257407,C2orf72,chr2,F,231037565,231049714,94944694,12149,132250418,20508,2
284948,SH2D6,chr2,F,85418731,85437029,94962992,18298,132268716,20509,25
284950,LOC284950,chr2,F,85815129,85826788,94974651,11659,132280375,20510,2
284958,NT5DC4,chr2,F,112720809,112742879,94996721,22070,132302445,20511,17
284992,CCDC150,chr2,F,196639631,196732806,95089896,93175,132395620,20512,32
284996,RNF149,chr2,R,101271218,101308716,95127394,37498,132433118,20513,10
284998,LINC01114,chr2,R,104746636,104757719,95138477,11083,132444201,20514,3
285000,LOC285000,chr2,R,105593096,105610559,95155940,17463,132461664,20515,3
285016,FAM150B,chr2,R,279560,288880,95165260,9320,132470984,20516,6
285025,CCDC141,chr2,R,178829756,179050118,95385622,220362,132691346,20517,25
285033,STARD7-AS1,chr2,F,96208415,96242623,95419830,34208,132725554,20518,3
285043,LOC285043,chr2,F,30346645,30350158,95423343,3513,132729067,20519,1
285045,LINC00486,chr2,F,32825442,32937203,95535104,111761,132840828,20520,9
285051,C2orf61,chr2,R,47086990,47155378,95603492,68388,132909216,20521,6
285074,LOC285074,chr2,R,87030674,87076413,95649231,45739,132954955,20522,10
285084,LINC01305,chr2,F,174326026,174330643,95653848,4617,132959572,20523,2
285093,RTP5,chr2,F,241868318,241873823,95659353,5505,132965077,20524,3
285095,LOC285095,chr2,R,241893987,241903279,95668645,9292,132974369,20525,4
285097,LOC285097,chr2,F,241996696,242006013,95677962,9317,132983686,20526,0
285103,MED15P9,chr2,F,130129622,130139413,95687753,9791,132993477,20527,5
285116,AHCTF1P1,chr2,R,161499066,161507902,95696589,8836,133002313,20528,0
285126,DNAJC5G,chr2,F,27275420,27281430,95702599,6010,133008323,20529,6
285141,ERICH2,chr2,F,170770540,170798971,95731030,28431,133036754,20530,13
285148,IAH1,chr2,F,9474531,9517208,95773707,42677,133079431,20531,14
285150,FLJ33534,chr2,R,11099850,11132176,95806033,32326,133111757,20532,8
285154,CYP1B1-AS1,chr2,F,38131104,38181855,95856784,50751,133162508,20533,2
285172,FAM126B,chr2,R,200973717,201071671,95954738,97954,133260462,20534,17
285175,UNC80,chr2,F,209771992,209999300,96182046,227308,133487770,20535,65
285180,RUFY4,chr2,F,218034933,218090625,96237738,55692,133543462,20536,13
285189,PLGLA,chr2,F,106382113,106391395,96247020,9282,133552744,20537,3
285190,RGPD4,chr2,F,107826931,107892544,96312633,65613,133618357,20538,29
285191,LOC285191,chr2,F,240685941,240689527,96316219,3586,133621943,20539,4
285193,DUSP28,chr2,F,240560053,240564014,96320180,3961,133625904,20540,2
286749,STON1-GTF2A1L,chr2,F,48529924,48776517,96566773,246593,133872497,20541,12
339742,FAM201B,chr2,F,132352498,132354283,96568558,1785,133874282,20542,0
339745,SPOPL,chr2,F,138501779,138573235,96640014,71456,133945738,20543,11
339751,MLK7-AS1,chr2,R,173197711,173282036,96724339,84325,134030063,20544,7
339761,CYP27C1,chr2,R,127183831,127226356,96766864,42525,134072588,20545,13
339766,MROH2A,chr2,F,233775661,233833423,96824626,57762,134130350,20546,44
339768,ESPNL,chr2,F,238100309,238133287,96857604,32978,134163328,20547,10
339778,C2orf70,chr2,F,26562555,26579529,96874578,16974,134180302,20548,8
339779,PRR30,chr2,R,27136846,27139464,96877196,2618,134182920,20549,2
339788,LINC00298,chr2,R,7922424,7976814,96931586,54390,134237310,20550,2
339789,LINC00299,chr2,R,8007770,8328419,97252235,320649,134557959,20551,8
339803,LOC339803,chr2,R,61141591,61144975,97255619,3384,134561343,20552,1
339804,C2orf74,chr2,F,61145090,61164830,97275359,19740,134581083,20553,4
339807,LOC339807,chr2,F,64607311,64616482,97284530,9171,134590254,20554,3
339822,LINC01115,chr2,R,779839,868426,97373117,88587,134678841,20555,3
343930,MSGN1,chr2,F,17816518,17817100,97373699,582,134679423,20556,0
343990,KIAA1211L,chr2,R,98793845,98936221,97516075,142376,134821799,20557,13
344018,FIGLA,chr2,R,70777309,70790643,97529409,13334,134835133,20558,4
344022,NOTO,chr2,F,73202257,73211212,97538364,8955,134844088,20559,2
344148,NCKAP5,chr2,R,132671787,133674923,98541500,1003136,135847224,20560,29
344167,FOXI3,chr2,R,88448206,88452535,98545829,4329,135851553,20561,1
344191,EVX2,chr2,R,176076020,176085797,98555606,9777,135861330,20562,4
344387,CDKL4,chr2,R,39174936,39246810,98627480,71874,135933204,20563,11
344405,PRORSD1P,chr2,F,55282318,55284472,98629634,2154,135935358,20564,0
344454,AOX2P,chr2,F,200695722,200794223,98728135,98501,136033859,20565,30
344558,SH3RF3,chr2,F,109129497,109504636,99103274,375139,136408998,20566,13
344561,GPR148,chr2,F,130728155,130730544,99105663,2389,136411387,20567,1
347694,ECEL1P2,chr2,R,232385749,232387044,99106958,1295,136412682,20568,0
347730,LRRTM1,chr2,R,80288279,80304593,99123272,16314,136428996,20569,1
348654,GEN1,chr2,F,17753626,17787104,99156750,33478,136462474,20570,15
348738,C2orf48,chr2,F,10141381,10211730,99227099,70349,136532823,20571,3
348751,FTCDNL1,chr2,R,199760535,199851173,99317737,90638,136623461,20572,3
348761,SPATA3-AS1,chr2,R,230984367,230996032,99329402,11665,136635126,20573,5
375189,PFN4,chr2,R,24114808,24123477,99338071,8669,136643795,20574,5
375190,FAM228B,chr2,F,24076873,24169638,99430836,92765,136736560,20575,13
375196,LOC375196,chr2,R,38959286,38960344,99431894,1058,136737618,20576,0
375248,ANKRD36,chr2,F,97113185,97264521,99583230,151336,136888954,20577,79
375260,WASH2P,chr2,F,113583652,113599037,99598615,15385,136904339,20578,10
375287,RBM43,chr2,R,151248213,151261901,99612303,13688,136918027,20579,4
375295,LINC01116,chr2,R,176629580,176637574,99620297,7994,136926021,20580,2
375298,CERKL,chr2,R,181536671,181657107,99740733,120436,137046457,20581,13
375307,CATIP,chr2,F,218356831,218368110,99752012,11279,137057736,20582,9
375316,RBM44,chr2,F,237798049,237842808,99796771,44759,137102495,20583,18
375318,AQP12A,chr2,F,240691844,240698483,99803410,6639,137109134,20584,3
376940,ZC3H6,chr2,F,112275558,112340063,99867915,64505,137173639,20585,11
377007,KLHL30,chr2,F,238138721,238152906,99882100,14185,137187824,20586,7
386597,RNF144A-AS1,chr2,R,6912275,6918682,99888507,6407,137194231,20587,4
388931,MFSD2B,chr2,F,24010082,24025874,99904299,15792,137210023,20588,13
388939,C2orf71,chr2,R,29061372,29074838,99917765,13466,137223489,20589,2
388942,LOC388942,chr2,F,41877554,41894046,99934257,16492,137239981,20590,2
388946,TMEM247,chr2,F,46479496,46484579,99939340,5083,137245064,20591,2
388948,LINC01118,chr2,F,46816667,46822660,99945333,5993,137251057,20592,3
388951,TSPYL6,chr2,R,54253177,54256272,99948428,3095,137254152,20593,0
388960,C2orf78,chr2,F,73784188,73817148,99981388,32960,137287112,20594,3
388962,BOLA3,chr2,R,74135400,74147912,99993900,12512,137299624,20595,3
388963,C2orf81,chr2,R,74414175,74417717,99997442,3542,137303166,20596,3
388965,FUNDC2P2,chr2,F,84290681,84292200,99998961,1519,137304685,20597,0
388969,C2orf68,chr2,R,85605252,85612056,100005765,6804,137311489,20598,3
389015,SLC9A4,chr2,F,102473281,102533974,100066458,60693,137372182,20599,11
389023,DPP10-AS1,chr2,R,115144047,115161343,100083754,17296,137389478,20600,2
389033,LOC389033,chr2,R,129922861,129934317,100095210,11456,137400934,20601,2
389043,LINC01120,chr2,F,131402900,131408228,100100538,5328,137406262,20602,2
389058,SP5,chr2,F,170714737,170717988,100103789,3251,137409513,20603,1
389072,PLEKHM3,chr2,R,207821287,208040372,100322874,219085,137628598,20604,13
389073,C2orf80,chr2,R,208165346,208190258,100347786,24912,137653510,20605,9
389075,RESP18,chr2,R,219327408,219336785,100357163,9377,137662887,20606,8
389084,C2orf82,chr2,F,232869118,232878695,100366740,9577,137672464,20607,4
389090,OR6B2,chr2,R,240028964,240033858,100371634,4894,137677358,20608,1
391356,PTRHD1,chr2,R,24790266,24793382,100374750,3116,137680474,20609,1
391365,SULT6B1,chr2,R,37167819,37188547,100395478,20728,137701202,20610,6
391475,DYTN,chr2,R,206651620,206718396,100462254,66776,137767978,20611,11
400940,LOC400940,chr2,F,5981977,5988232,100468509,6255,137774233,20612,2
400941,LINC00487,chr2,R,6729167,6770311,100509653,41144,137815377,20613,5
400945,LINC01376,chr2,R,18984657,19036011,100561007,51354,137866731,20614,5
400946,LINC00954,chr2,F,19868853,19885047,100577201,16194,137882925,20615,9
400950,C2orf91,chr2,R,41935367,41953803,100595637,18436,137901361,20616,3
400952,LINC01121,chr2,R,45174340,45254941,100676238,80601,137981962,20617,5
400954,EML6,chr2,F,54723669,54972908,100925477,249239,138231201,20618,47
400955,LINC01122,chr2,F,58520752,59063766,101468491,543014,138774215,20619,13
400957,LINC01185,chr2,R,60847759,60881314,101502046,33555,138807770,20620,2
400958,LOC400958,chr2,R,64901839,64932447,101532654,30608,138838378,20621,2
400960,PCBP1-AS1,chr2,R,69962262,70087015,101657407,124753,138963131,20622,10
400961,PAIP2B,chr2,R,71182737,71227114,101701784,44377,139007508,20623,5
400966,RGPD1,chr2,F,86913572,87013976,101802188,100404,139107912,20624,30
400986,ANKRD36C,chr2,R,95827618,95992320,101966890,164702,139272614,20625,90
400997,LOC400997,chr2,R,111098340,111115588,101984138,17248,139289862,20626,3
400999,FLJ42351,chr2,R,112641829,112644180,101986489,2351,139292213,20627,4
401010,LOC401010,chr2,R,131442160,131444894,101989223,2734,139294947,20628,0
401014,TEX41,chr2,F,144667966,145076729,102397986,408763,139703710,20629,4
401022,HAGLR,chr2,R,176173188,176188958,102413756,15770,139719480,20630,6
401024,FSIP2,chr2,F,185738627,185833290,102508419,94663,139814143,20631,22
401027,C2orf66,chr2,R,196804414,196810276,102514281,5862,139820005,20632,2
401036,ASB18,chr2,R,236194871,236264345,102583755,69474,139889479,20633,5
401039,FLJ43879,chr2,R,238919301,238926269,102590723,6968,139896447,20634,9
401040,LOC401040,chr2,F,239578395,239586088,102598416,7693,139904140,20635,1
402096,LOC402096,chr2,F,106369737,106372422,102601101,2685,139906825,20636,2
402117,VWC2L,chr2,F,214411126,214579037,102769012,167911,140074736,20637,3
403150,FLJ31356,chr2,R,28384408,28394672,102779276,10264,140085000,20638,1
406903,MIR10B,chr2,F,176150302,176150412,102779386,110,140085110,20639,0
406915,MIR128-1,chr2,F,135665396,135665478,102779468,82,140085192,20640,0
406941,MIR149,chr2,F,240456000,240456089,102779557,89,140085281,20641,0
406944,MIR153-1,chr2,R,219294110,219294200,102779647,90,140085371,20642,0
406998,MIR216A,chr2,R,55988949,55989059,102779757,110,140085481,20643,0
406999,MIR217,chr2,R,55982966,55983076,102779867,110,140085591,20644,0
407017,MIR26B,chr2,F,218402645,218402722,102779944,77,140085668,20645,0
408029,C2orf27B,chr2,R,131794960,131801661,102786645,6701,140092369,20646,2
414061,DNAJB3,chr2,R,233742749,233744015,102787911,1266,140093635,20647,0
431705,ASTL,chr2,R,96122816,96143077,102808172,20261,140113896,20648,8
440854,CAPN14,chr2,R,31173055,31233971,102869088,60916,140174812,20649,25
440864,LOC440864,chr2,F,47695880,47709696,102882904,13816,140188628,20650,2
440867,LOC440867,chr2,F,65436701,65459007,102905210,22306,140210934,20651,2
440888,ACTR3BP2,chr2,F,91941132,91942470,102906548,1338,140212272,20652,0
440894,LINC01123,chr2,F,109986979,109995281,102914850,8302,140220574,20653,3
440895,LOC440895,chr2,F,109947689,109968574,102935735,20885,140241459,20654,17
440900,LINC01191,chr2,F,113979568,114007310,102963477,27742,140269201,20655,1
440905,FAR2P1,chr2,R,130025997,130051131,102988611,25134,140294335,20656,11
440910,LOC440910,chr2,F,131279289,131299819,103009141,20530,140314865,20657,5
440915,POTEKP,chr2,F,131592092,131609401,103026450,17309,140332174,20658,6
440925,LINC01124,chr2,R,170712438,170714567,103028579,2129,140334303,20659,0
440926,H3F3AP4,chr2,F,174719799,174720858,103029638,1059,140335362,20660,0
440934,LOC440934,chr2,F,222314142,222321722,103037218,7580,140342942,20661,1
442028,LOC442028,chr2,R,94868684,94947342,103115876,78658,140421600,20662,9
442038,SULT1C3,chr2,F,108239973,108265608,103141511,25635,140447235,20663,9
445582,POTEE,chr2,F,131211133,131265448,103195826,54315,140501550,20664,15
493753,COA5,chr2,R,98599322,98608518,103205022,9196,140510746,20665,2
493911,PHOSPHO2,chr2,F,169694453,169701708,103212277,7255,140518001,20666,4
494143,CHAC2,chr2,F,53767791,53775150,103219636,7359,140525360,20667,2
494324,MIR375,chr2,R,219001644,219001708,103219700,64,140525424,20668,0
494513,DFNB59,chr2,F,178450591,178461390,103230499,10799,140536223,20669,8
541471,MIR4435-1HG,chr2,R,111367001,111495115,103358613,128114,140664337,20670,2
554201,CCDC148-AS1,chr2,F,158166649,158236169,103428133,69520,140733857,20671,4
554226,ANKRD30BL,chr2,R,132147590,132257969,103538512,110379,140844236,20672,7
554251,FBXO48,chr2,R,68462365,68467316,103543463,4951,140849187,20673,3
619569,SNORA41,chr2,F,206162227,206162359,103543595,132,140849319,20674,0
642273,FAM110C,chr2,R,38813,47115,103551897,8302,140857621,20675,3
643072,LOC643072,chr2,F,159615293,159618042,103554646,2749,140860370,20676,1
643387,LOC643387,chr2,F,238231685,238234345,103557306,2660,140863030,20677,0
643905,PRR21,chr2,R,240041812,240042982,103558476,1170,140864200,20678,0
644093,HCG2040054,chr2,F,47527536,47529164,103560104,1628,140865828,20679,2
644838,LOC644838,chr2,R,67123356,67215319,103652067,91963,140957791,20680,7
644903,LOC644903,chr2,R,108505161,108534219,103681125,29058,140986849,20681,2
645367,GGT8P,chr2,F,91775341,91782127,103687911,6786,140993635,20682,1
645784,ANKRD36BP2,chr2,F,88765901,88806596,103728606,40695,141034330,20683,16
645949,LOC645949,chr2,R,21687433,21710652,103751825,23219,141057549,20684,2
646324,LINC00607,chr2,R,215611562,215843536,103983799,231974,141289523,20685,9
646736,LOC646736,chr2,F,226142793,226180062,104021068,37269,141326792,20686,6
646743,LOC646743,chr2,R,130536569,130549915,104034414,13346,141340138,20687,2
646802,CYP4F62P,chr2,R,130435661,130441681,104040434,6020,141346158,20688,4
646915,ZNF806,chr2,F,132307143,132318747,104052038,11604,141357762,20689,3
646960,PRSS56,chr2,F,232520462,232525716,104057292,5254,141363016,20690,12
647012,YY1P2,chr2,F,138897323,138899174,104059143,1851,141364867,20691,0
653140,FAM228A,chr2,F,24175042,24191698,104075799,16656,141381523,20692,5
653192,TRIM43B,chr2,R,95476966,95484731,104083564,7765,141389288,20693,7
653269,POTEI,chr2,R,130462244,130509355,104130675,47111,141436399,20694,14
653275,CFC1B,chr2,F,130521093,130527992,104137574,6899,141443298,20695,5
653437,AQP12B,chr2,R,240676415,240685768,104146927,9353,141452651,20696,5
653489,RGPD3,chr2,R,106391359,106468345,104223913,76986,141529637,20697,27
653602,LOC653602,chr2,F,14635090,14650819,104239642,15729,141545366,20698,1
653781,POTEJ,chr2,F,130611412,130658448,104286678,47036,141592402,20699,14
653784,MZT2A,chr2,R,131469723,131492719,104309674,22996,141615398,20700,6
654321,SNORA75,chr2,R,231455799,231455936,104309811,137,141615535,20701,0
654342,LOC654342,chr2,R,91636682,91659949,104333078,23267,141638802,20702,3
654412,FAM138B,chr2,F,113577381,113578852,104334549,1471,141640273,20703,2
654433,PAX8-AS1,chr2,F,113235526,113267023,104366046,31497,141671770,20704,8
654841,LOC654841,chr2,R,227221051,227325164,104470159,104113,141775883,20705,13
677772,SCARNA6,chr2,F,233288675,233288941,104470425,266,141776149,20706,0
677775,SCARNA5,chr2,F,233275725,233276003,104470703,278,141776427,20707,0
692058,SNORD11,chr2,F,202293050,202293134,104470787,84,141776511,20708,0
692110,SNORD70,chr2,F,202276430,202276518,104470875,88,141776599,20709,0
692205,SNORD89,chr2,R,101272935,101273049,104470989,114,141776713,20710,0
692209,SNORD92,chr2,F,28913661,28913750,104471078,89,141776802,20711,0
692225,SNORD94,chr2,F,86135869,86136006,104471215,137,141776939,20712,0
693143,MIR558,chr2,F,32532152,32532246,104471309,94,141777033,20713,0
693144,MIR559,chr2,F,47377674,47377770,104471405,96,141777129,20714,0
693146,MIR561,chr2,F,188297491,188297588,104471502,97,141777226,20715,0
693147,MIR562,chr2,F,232172652,232172747,104471597,95,141777321,20716,0
727851,RGPD8,chr2,R,112368368,112433645,104536874,65277,141842598,20717,24
727944,LOC727944,chr2,R,490770,492887,104538991,2117,141844715,20718,1
727982,LINC01249,chr2,R,4628217,4656222,104566996,28005,141872720,20719,4
728066,FAM133DP,chr2,R,157378486,157380509,104569019,2023,141874743,20720,0
728294,D2HGDH,chr2,F,241734578,241768816,104603257,34238,141908981,20721,18
728323,LOC728323,chr2,F,242088632,242160503,104675128,71871,141980852,20722,9
728378,POTEF,chr2,R,130073478,130129222,104730872,55744,142036596,20723,16
728537,LINC01125,chr2,F,97669742,97703066,104764196,33324,142069920,20724,9
728597,DCDC2C,chr2,F,3703591,3847411,104908016,143820,142213740,20725,18
728730,LOC728730,chr2,F,39437415,39601344,105071945,163929,142377669,20726,5
728763,LOC728763,chr2,F,240906358,240993307,105158894,86949,142464618,20727,31
728773,PABPC1P2,chr2,F,146587056,146590990,105162828,3934,142468552,20728,0
728819,LOC728819,chr2,R,43675152,43676322,105163998,1170,142469722,20729,0
729121,RGPD4-AS1,chr2,R,107823063,107826769,105167704,3706,142473428,20730,2
729164,LOC729164,chr2,R,109343759,109345032,105168977,1273,142474701,20731,0
729171,ANKRD20A8P,chr2,R,94760927,94857075,105265125,96148,142570849,20732,23
729224,LOC729224,chr2,R,202113617,202117070,105268578,3453,142574302,20733,1
729234,FAHD2CP,chr2,F,96010550,96023136,105281164,12586,142586888,20734,3
729254,LOC729254,chr2,F,191792839,191820249,105308574,27410,142614298,20735,5
729348,LOC729348,chr2,F,66383305,66392450,105317719,9145,142623443,20736,2
729468,LOC729468,chr2,F,113541190,113570962,105347491,29772,142653215,20737,6
729475,RAD51AP2,chr2,R,17510583,17520580,105357488,9997,142663212,20738,5
729540,RGPD6,chr2,R,110513801,110610888,105454575,97087,142760299,20739,30
729582,DIRC3,chr2,R,217284022,217756593,105927146,472571,143232870,20740,12
729723,DNAJC27-AS1,chr2,F,24972111,25039694,105994729,67583,143300453,20741,2
729770,LOC729770,chr2,F,221572505,221575974,105998198,3469,143303922,20742,0
729857,RGPD2,chr2,R,87757197,87985814,106226815,228617,143532539,20743,28
729967,MORN2,chr2,F,38875961,38882709,106233563,6748,143539287,20744,4
729968,LOC729968,chr2,R,227616990,227618655,106235228,1665,143540952,20745,1
730100,LOC730100,chr2,F,51032600,52407917,107610545,1375317,144916269,20746,10
730198,MEIS1-AS3,chr2,R,66423341,66433470,107620674,10129,144926398,20747,3
730268,LOC730268,chr2,F,87700444,87747727,107667957,47283,144973681,20748,16
730811,MYT1L-AS1,chr2,F,2319231,2327108,107675834,7877,144981558,20749,1
731220,RFX8,chr2,R,101397343,101475096,107753587,77753,145059311,20750,15
100113392,SNORD11B,chr2,F,202291316,202291428,107753699,112,145059423,20751,0
100124535,SNORA36C,chr2,R,69520043,69520171,107753827,128,145059551,20752,0
100124537,SNORA70B,chr2,R,61417243,61417377,107753961,134,145059685,20753,0
100126319,MIR216B,chr2,R,56000713,56000795,107754043,82,145059767,20754,0
100126350,MIR933,chr2,R,175167632,175167709,107754120,77,145059844,20755,0
100128590,SLC8A1-AS1,chr2,F,39917633,40255209,108091696,337576,145397420,20756,4
100128731,OST4,chr2,R,27070471,27071699,108092924,1228,145398648,20757,2
100128905,LOC100128905,chr2,F,174024720,174027158,108095362,2438,145401086,20758,0
100129029,LOC100129029,chr2,R,158678655,158735002,108151709,56347,145457433,20759,3
100129175,LOC100129175,chr2,F,219002214,219015722,108165217,13508,145470941,20760,2
100129278,TDRD15,chr2,F,21106651,21147393,108205959,40742,145511683,20761,5
100129434,LOC100129434,chr2,R,56173533,56185770,108218196,12237,145523920,20762,2
100129455,LOC100129455,chr2,R,176124295,176129631,108223532,5336,145529256,20763,0
100129724,LOC100129724,chr2,R,26979571,27014739,108258700,35168,145564424,20764,9
100129726,LINC01126,chr2,F,43227210,43228855,108260345,1645,145566069,20765,0
100129961,CCNT2-AS1,chr2,R,134866632,134918606,108312319,51974,145618043,20766,4
100129995,LINC01460,chr2,R,27707502,27716550,108321367,9048,145627091,20767,2
100130256,LOC100130256,chr2,R,170619391,170683059,108385035,63668,145690759,20768,10
100130449,PP14571,chr2,R,240449418,240456700,108392317,7282,145698041,20769,1
100130451,LOC100130451,chr2,R,213276552,213284205,108399970,7653,145705694,20770,2
100130452,LOC100130452,chr2,R,196700633,196713012,108412349,12379,145718073,20771,3
100130502,LOC100130502,chr2,R,44921079,44923566,108414836,2487,145720560,20772,0
100130691,LOC100130691,chr2,R,177283507,177392691,108524020,109184,145829744,20773,8
100131211,TMEM194B,chr2,R,190454091,190543625,108613554,89534,145919278,20774,13
100131320,RAB6C-AS1,chr2,R,129966591,129980472,108627435,13881,145933159,20775,5
100131390,SP9,chr2,F,174334959,174346005,108638481,11046,145944205,20776,3
100132215,LOC100132215,chr2,R,63043921,63048521,108643081,4600,145948805,20777,4
100132708,CYP4F30P,chr2,F,130680049,130685863,108648895,5814,145954619,20778,4
100133920,LOC100133920,chr2,R,94575975,94587183,108660103,11208,145965827,20779,3
100133985,LOC100133985,chr2,R,70124035,70125316,108661384,1281,145967108,20780,1
100134259,LINC01119,chr2,F,46827863,46859006,108692527,31143,145998251,20781,2
100144595,LOC100144595,chr2,R,154435852,154457438,108714113,21586,146019837,20782,4
100151683,RNU4ATAC,chr2,F,121530879,121531009,108714243,130,146019967,20783,0
100169989,DBIL5P2,chr2,R,63117850,63119542,108715935,1692,146021659,20784,0
100170221,SNAR-H,chr2,R,77954906,77955026,108716055,120,146021779,20785,0
100189021,TRA-CGC3-1,chr2,F,156400768,156400840,108716127,72,146021851,20786,0
100189022,TRY-GTA2-1,chr2,F,27050781,27050870,108716216,89,146021940,20787,1
100189208,TRG-GCC2-5,chr2,R,156401146,156401217,108716287,71,146022011,20788,0
100189231,TRG-CCC2-2,chr2,R,70248990,70249061,108716358,71,146022082,20789,0
100189253,TRY-ATA1-1,chr2,F,218245825,218245918,108716451,93,146022175,20790,1
100189265,TRI-TAT2-1,chr2,F,42810535,42810628,108716544,93,146022268,20791,1
100189418,TRE-TTC1-2,chr2,R,130337127,130337199,108716616,72,146022340,20792,0
100189589,DCTN1-AS1,chr2,F,74385717,74393881,108724780,8164,146030504,20793,3
100216479,FAR2P2,chr2,R,130416749,130428546,108736577,11797,146042301,20794,5
100271715,ARHGEF33,chr2,F,38919362,38975449,108792664,56087,146098388,20795,15
100271832,LOC100271832,chr2,F,32927126,32946136,108811674,19010,146117398,20796,3
100271835,LIMS3-LOC440895,chr2,F,109898431,109968574,108881817,70143,146187541,20797,17
100286922,LOC100286922,chr2,R,233742960,233743993,108882850,1033,146188574,20798,0
100286979,ANAPC1P1,chr2,F,86861824,86895042,108916068,33218,146221792,20799,14
100287010,LOC100287010,chr2,R,104378849,104408332,108945551,29483,146251275,20800,2
100287216,SH3RF3-AS1,chr2,R,109127326,109130119,108948344,2793,146254068,20801,0
100287387,LOC100287387,chr2,R,238844545,238847679,108951478,3134,146257202,20802,1
100288570,LOC100288570,chr2,R,110402916,110423816,108972378,20900,146278102,20803,3
100288695,LIMS3L,chr2,R,110445882,110473075,108999571,27193,146305295,20804,9
100288893,LOC100288893,chr2,F,3481675,3485094,109002990,3419,146308714,20805,0
100288911,LOC100288911,chr2,R,36354748,36355570,109003812,822,146309536,20806,1
100302126,MIR1471,chr2,R,231892241,231892298,109003869,57,146309593,20807,0
100302128,MIR1302-3,chr2,R,113582958,113583096,109004007,138,146309731,20808,0
100302130,MIR1302-4,chr2,R,207269274,207269424,109004157,150,146309881,20809,0
100302142,MIR1246,chr2,R,176600979,176601052,109004230,73,146309954,20810,0
100302172,MIR1258,chr2,R,179860835,179860908,109004303,73,146310027,20811,0
100302219,MIR1245A,chr2,F,188978091,188978161,109004373,70,146310097,20812,0
100302246,MIR1301,chr2,R,25328639,25328721,109004455,82,146310179,20813,0
100302268,MIR1285-2,chr2,R,70252917,70253005,109004543,88,146310267,20814,0
100302285,MIR1244-1,chr2,F,231713313,231713398,109004628,85,146310352,20815,0
100302650,BRE-AS1,chr2,R,27889455,27891114,109006287,1659,146312011,20816,0
100302652,GPR75-ASB3,chr2,R,53670292,53860033,109196028,189741,146501752,20817,9
100302743,SNORA80B,chr2,R,10446713,10446849,109196164,136,146501888,20818,0
100303491,ZEB2-AS1,chr2,F,144519613,144520899,109197450,1286,146503174,20819,3
100313771,MIR548F2,chr2,R,212426262,212426360,109197548,98,146503272,20820,0
100313824,MIR663B,chr2,R,132256965,132257080,109197663,115,146503387,20821,0
100329109,GCSHP3,chr2,R,206115572,206116572,109198663,1000,146504387,20822,0
100337591,SNORA70F,chr2,R,164687642,164687777,109198798,135,146504522,20823,0
100379249,BOK-AS1,chr2,R,241544383,241559143,109213558,14760,146519282,20824,1
100422824,MIR3128,chr2,R,177255944,177256010,109213624,66,146519348,20825,0
100422862,MIR548S,chr2,F,11767443,11767525,109213706,82,146519430,20826,0
100422863,MIR4265,chr2,R,109141489,109141588,109213805,99,146519529,20827,0
100422888,MIR4264,chr2,R,79649293,79649359,109213871,66,146519595,20828,0
100422908,MIR3129,chr2,R,189133035,189133111,109213947,76,146519671,20829,0
100422928,MIR3127,chr2,F,96798277,96798353,109214023,76,146519747,20830,0
100422929,MIR4261,chr2,R,10192613,10192671,109214081,58,146519805,20831,0
100422942,MIR3133,chr2,F,241477904,241477982,109214159,78,146519883,20832,0
100422957,MIR3131,chr2,R,219058687,219058750,109214222,63,146519946,20833,0
100422959,MIR4268,chr2,R,219906501,219906565,109214286,64,146520010,20834,0
100422965,MIR4263,chr2,F,27996366,27996449,109214369,83,146520093,20835,0
100422986,MIR3125,chr2,F,12737366,12737444,109214447,78,146520171,20836,0
100422993,MIR3130-1,chr2,R,206783233,206783308,109214522,75,146520246,20837,0
100422994,MIR4267,chr2,R,110069960,110070042,109214604,82,146520328,20838,0
100422996,MIR4262,chr2,R,11836932,11836986,109214658,54,146520382,20839,0
100423002,MIR3130-2,chr2,F,206783233,206783308,109214733,75,146520457,20840,0
100423027,MIR4266,chr2,R,109313570,109313625,109214788,55,146520512,20841,0
100423030,MIR3126,chr2,F,69103681,69103755,109214862,74,146520586,20842,0
100423036,MIR2355,chr2,R,207109986,207110073,109214949,87,146520673,20843,0
100423039,MIR3132,chr2,R,219549072,219549147,109215024,75,146520748,20844,0
100423043,MIR4269,chr2,F,239305461,239305545,109215108,84,146520832,20845,0
100499171,LINC00276,chr2,R,14228873,14400958,109387193,172085,146692917,20846,3
100499194,LOC100499194,chr2,R,113977668,113979984,109389509,2316,146695233,20847,0
100500837,MIR3606,chr2,F,188995629,188995692,109389572,63,146695296,20848,0
100500850,MIR3682,chr2,R,53849121,53849205,109389656,84,146695380,20849,0
100500878,MIR3679,chr2,F,134127124,134127192,109389724,68,146695448,20850,0
100500884,MIR3681,chr2,F,12199129,12199201,109389796,72,146695520,20851,0
100505498,LOC100505498,chr2,F,145023073,145182645,109549368,159572,146855092,20852,2
100505624,GTF3C2-AS1,chr2,F,27335541,27337803,109551630,2262,146857354,20853,3
100505716,LOC100505716,chr2,R,28307690,28310459,109554399,2769,146860123,20854,2
100505736,LOC100505736,chr2,R,28148554,28206961,109612806,58407,146918530,20855,2
100505774,LOC100505774,chr2,R,28709049,28751731,109655488,42682,146961212,20856,12
100505876,CEBPZOS,chr2,F,37196491,37204743,109663740,8252,146969464,20857,5
100505964,LINC01304,chr2,R,3957654,3974032,109680118,16378,146985842,20858,2
100505984,LOC100505984,chr2,R,160257718,160271895,109694295,14177,147000019,20859,1
100506036,LOC100506036,chr2,R,96812238,96814072,109696129,1834,147001853,20860,1
100506047,LOC100506047,chr2,R,43069832,43158220,109784517,88388,147090241,20861,9
100506054,RNASEH1-AS1,chr2,F,3558385,3561750,109787882,3365,147093606,20862,2
100506076,LOC100506076,chr2,F,97278716,97291878,109801044,13162,147106768,20863,4
100506108,SIX3-AS1,chr2,R,44940153,44941878,109802769,1725,147108493,20864,2
100506123,LOC100506123,chr2,R,97416164,97424027,109810632,7863,147116356,20865,3
100506124,LOC100506124,chr2,R,165857474,165871941,109825099,14467,147130823,20866,3
100506134,TTC21B-AS1,chr2,F,165933856,165948321,109839564,14465,147145288,20867,4
100506142,LOC100506142,chr2,R,46568255,46580238,109851547,11983,147157271,20868,1
100506235,LOC100506235,chr2,F,47906595,47908167,109853119,1572,147158843,20869,1
100506274,LOC100506274,chr2,F,7421260,7450254,109882113,28994,147187837,20870,5
100506286,LOC100506286,chr2,F,101151582,101155444,109885975,3862,147191699,20871,1
100506299,ID2-AS1,chr2,R,8670983,8681863,109896855,10880,147202579,20872,4
100506317,LOC100506317,chr2,R,9204573,9206506,109898788,1933,147204512,20873,1
100506328,LINC01127,chr2,F,101983464,101985545,109900869,2081,147206593,20874,3
100506405,LOC100506405,chr2,F,11681459,11683323,109902733,1864,147208457,20875,1
100506421,LINC01158,chr2,R,104805424,104851476,109948785,46052,147254509,20876,3
100506457,LOC100506457,chr2,F,12007115,12578348,110520018,571233,147825742,20877,8
100506473,LOC100506473,chr2,R,105334033,105337278,110523263,3245,147828987,20878,1
100506474,LOC100506474,chr2,R,12966781,13007013,110563495,40232,147869219,20879,5
100506563,LOC100506563,chr2,R,109758798,109760383,110565080,1585,147870804,20880,1
100506749,AGAP1-IT1,chr2,F,235504627,235507566,110568019,2939,147873743,20881,1
100506783,HOXD-AS2,chr2,R,176134840,176137098,110570277,2258,147876001,20882,2
100506797,LOC100506797,chr2,R,118182921,118186448,110573804,3527,147879528,20883,2
100506866,TTN-AS1,chr2,F,178522826,178620217,110671195,97391,147976919,20884,21
100506922,LOC100506922,chr2,F,127378127,127389411,110682479,11284,147988203,20885,4
100507006,LOC100507006,chr2,F,64228400,64252531,110706610,24131,148012334,20886,4
100507073,LOC100507073,chr2,F,66574029,66695588,110828169,121559,148133893,20887,5
100507140,LOC100507140,chr2,R,200712304,200735177,110851042,22873,148156766,20888,2
100507171,BOLA3-AS1,chr2,F,74147980,74152389,110855451,4409,148161175,20889,1
100507201,LOC100507201,chr2,R,81461358,81466946,110861039,5588,148166763,20890,2
100507334,LOC100507334,chr2,F,110245637,110266559,110881961,20922,148187685,20891,3
100507443,LOC100507443,chr2,F,208119128,208156762,110919595,37634,148225319,20892,2
100507460,LOC100507460,chr2,F,131682484,131699863,110936974,17379,148242698,20893,5
100507475,IDH1-AS1,chr2,F,208255232,208256194,110937936,962,148243660,20894,1
100507554,LOC100507554,chr2,R,216483896,216499263,110953303,15367,148259027,20895,4
100507562,LOC100507562,chr2,F,21396454,21602884,111159733,206430,148465457,20896,6
100507600,LOC100507600,chr2,F,135820190,135823087,111162630,2897,148468354,20897,1
100509620,LOC100509620,chr2,F,94587233,94619833,111195230,32600,148500954,20898,12
100526664,LY75-CD302,chr2,R,159768627,159904756,111331359,136129,148637083,20899,38
100526767,RNF103-CHMP3,chr2,R,86503429,86721122,111549052,217693,148854776,20900,7
100526794,NT5C1B-RDH14,chr2,R,18554722,18589580,111583910,34858,148889634,20901,9
100526832,PHOSPHO2-KLHL23,chr2,F,169694453,169751886,111641343,57433,148947067,20902,3
100529241,HSPE1-MOB4,chr2,F,197499996,197553699,111695046,53703,149000770,20903,9
100532735,INO80B-WBP1,chr2,F,74455022,74460891,111700915,5869,149006639,20904,3
100533179,UBE2F-SCLY,chr2,F,237966944,238099413,111833384,132469,149139108,20905,18
100616123,MIR4436B1,chr2,R,110086432,110086523,111833475,91,149139199,20906,0
100616136,MIR4430,chr2,F,33418515,33418564,111833524,49,149139248,20907,0
100616157,MIR4772,chr2,F,102432288,102432366,111833602,78,149139326,20908,0
100616159,MIR4779,chr2,R,86193025,86193108,111833685,83,149139409,20909,0
100616165,MIR4771-2,chr2,R,111771060,111771134,111833759,74,149139483,20910,0
100616187,MIR4783,chr2,R,127423536,127423618,111833841,82,149139565,20911,0
100616207,MIR4439,chr2,R,225010460,225010540,111833921,80,149139645,20912,0
100616208,MIR4782,chr2,R,113721289,113721368,111834000,79,149139724,20913,0
100616213,MIR4437,chr2,R,181305592,181305652,111834060,60,149139784,20914,0
100616219,MIR4765,chr2,F,32635254,32635331,111834137,77,149139861,20915,0
100616265,MIR4433A,chr2,F,64340758,64340839,111834218,81,149139942,20916,0
100616267,MIR4776-1,chr2,F,212926256,212926336,111834298,80,149140022,20917,0
100616305,MIR548AE1,chr2,F,184378974,184379044,111834368,70,149140092,20918,0
100616307,MIR4757,chr2,F,19348428,19348505,111834445,77,149140169,20919,0
100616317,MIR4777,chr2,F,231362707,231362793,111834531,86,149140255,20920,0
100616324,MIR1245B,chr2,R,188978092,188978161,111834600,69,149140324,20921,0
100616341,MIR4435-2,chr2,R,111321012,111321086,111834674,74,149140398,20922,0
100616356,MIR4774,chr2,F,168582942,168583018,111834750,76,149140474,20923,0
100616360,MIR2467,chr2,R,239351723,239351804,111834831,81,149140555,20924,0
100616361,MIR4775,chr2,F,207754806,207754881,111834906,75,149140630,20925,0
100616364,MIR4785,chr2,R,160407809,160407882,111834979,73,149140703,20926,0
100616370,MIR4771-1,chr2,F,87194785,87194859,111835053,74,149140777,20927,0
100616375,MIR4438,chr2,F,213758066,213758159,111835146,93,149140870,20928,0
100616378,MIR4784,chr2,R,131491159,131491236,111835223,77,149140947,20929,0
100616392,MIR4773-1,chr2,F,151368333,151368411,111835301,78,149141025,20930,0
100616394,MIR4444-1,chr2,F,177212725,177212799,111835375,74,149141099,20931,0
100616397,MIR4440,chr2,R,239068816,239068914,111835473,98,149141197,20932,0
100616399,MIR4436A,chr2,F,88812369,88812454,111835558,85,149141282,20933,0
100616417,MIR4786,chr2,R,239943014,239943094,111835638,80,149141362,20934,0
100616418,MIR4773-2,chr2,R,151368333,151368411,111835716,78,149141440,20935,0
100616419,MIR4434,chr2,F,64525512,64525565,111835769,53,149141493,20936,0
100616431,MIR4431,chr2,R,52702521,52702615,111835863,94,149141587,20937,0
100616447,MIR4780,chr2,R,88082518,88082599,111835944,81,149141668,20938,0
100616464,MIR4778,chr2,R,66358248,66358328,111836024,80,149141748,20939,0
100616469,MIR4429,chr2,R,11540604,11540677,111836097,73,149141821,20940,0
100616472,MIR4776-2,chr2,R,212926256,212926336,111836177,80,149141901,20941,0
100616473,MIR4432,chr2,R,60387361,60387445,111836261,84,149141985,20942,0
100616475,MIR548AD,chr2,F,35471404,35471486,111836343,82,149142067,20943,0
100616493,MIR4441,chr2,R,239085826,239085926,111836443,100,149142167,20944,0
100616499,MIR4435-1,chr2,F,87629754,87629834,111836523,80,149142247,20945,0
100630918,LOC100630918,chr2,R,85537466,85538886,111837943,1420,149143667,20946,0
100652824,KIAA2012,chr2,F,202073252,202205195,111969886,131943,149275610,20947,23
100846995,MIR5000,chr2,F,75090811,75090914,111969989,103,149275713,20948,0
100847007,MIR5696,chr2,F,101309449,101309534,111970074,85,149275798,20949,0
100847033,MIR4436B2,chr2,F,110284852,110284943,111970165,91,149275889,20950,0
100847037,MIR5001,chr2,R,232550473,232550573,111970265,100,149275989,20951,0
100847053,MIR5702,chr2,R,226658709,226658793,111970349,84,149276073,20952,0
100847069,MIR5590,chr2,F,134857819,134857873,111970403,54,149276127,20953,0
100847081,MIR5703,chr2,F,227472131,227472187,111970459,56,149276183,20954,0
100847087,MIR5192,chr2,F,62205825,62205917,111970551,92,149276275,20955,0
100861402,CERS6-AS1,chr2,R,168771950,168786429,111985030,14479,149290754,20956,3
100873740,RNU6-31P,chr2,F,200830008,200830116,111985138,108,149290862,20957,0
100873998,MEIS1-AS2,chr2,R,66439086,66440330,111986382,1244,149292106,20958,1
100874011,XIRP2-AS1,chr2,R,167122808,167140955,112004529,18147,149310253,20959,1
100874031,AGBL5-AS1,chr2,R,27049682,27050264,112005111,582,149310835,20960,1
100874048,DGUOK-AS1,chr2,R,73957966,73981439,112028584,23473,149334308,20961,1
100874055,LINC00570,chr2,F,11393980,11403077,112037681,9097,149343405,20962,2
100874111,STEAP3-AS1,chr2,R,119244421,119249071,112042331,4650,149348055,20963,1
100874273,TGFA-IT1,chr2,R,70467384,70481640,112056587,14256,149362311,20964,2
100874291,ALMS1-IT1,chr2,F,73457102,73459482,112058967,2380,149364691,20965,1
100874343,HS1BP3-IT1,chr2,R,20590774,20592548,112060741,1774,149366465,20966,1
100885780,VWC2L-IT1,chr2,F,214510181,214536890,112087450,26709,149393174,20967,3
100996478,LOC100996478,chr2,R,85064109,85067535,112090876,3426,149396600,20968,1
100996506,LOC100996506,chr2,F,85314215,85316844,112093505,2629,149399229,20969,1
100996549,LOC100996549,chr2,R,9758589,9778575,112113491,19986,149419215,20970,2
100996579,LOC100996579,chr2,F,161244738,161249050,112117803,4312,149423527,20971,2
100996637,LOC100996637,chr2,F,494738,496631,112119696,1893,149425420,20972,1
100996693,LOC100996693,chr2,F,219494299,219498287,112123684,3988,149429408,20973,4
100996770,LOC100996770,chr2,F,65687655,65692177,112128206,4522,149433930,20974,1
100996902,LOC100996902,chr2,F,38431185,38433573,112130594,2388,149436318,20975,1
101060017,LOC101060017,chr2,F,90359287,90362907,112134214,3620,149439938,20976,6
101060019,LOC101060019,chr2,F,66904435,66971466,112201245,67031,149506969,20977,4
101060091,LOC101060091,chr2,R,113831182,113890992,112261055,59810,149566779,20978,4
101060385,LOC101060385,chr2,R,900215,905451,112266291,5236,149572015,20979,3
101060391,LOC101060391,chr2,R,949633,954998,112271656,5365,149577380,20980,3
101409258,OSGEPL1-AS1,chr2,F,189762779,189765556,112274433,2777,149580157,20981,1
101410544,RMDN2-AS1,chr2,R,37950333,38036341,112360441,86008,149666165,20982,3
101669764,GPR1-AS,chr2,F,206203375,206266243,112423309,62868,149729033,20983,5
101669767,SCHLAP1,chr2,F,180692103,180916939,112648145,224836,149953869,20984,6
101752400,CAPN10-AS1,chr2,R,240582749,240586316,112651712,3567,149957436,20985,0
101805491,LOC101805491,chr2,F,46429189,46441833,112664356,12644,149970080,20986,3
101926913,LOC101926913,chr2,R,170700367,170770766,112734755,70399,150040479,20987,5
101926952,LOC101926952,chr2,R,14991291,14998208,112741672,6917,150047396,20988,2
101926959,LOC101926959,chr2,F,95665650,95668727,112744749,3077,150050473,20989,1
101926966,LOC101926966,chr2,F,15690781,15718961,112772929,28180,150078653,20990,5
101926969,LOC101926969,chr2,F,91571574,91580863,112782218,9289,150087942,20991,2
101926974,LOC101926974,chr2,F,46246436,46291290,112827072,44854,150132796,20992,4
101926982,LOC101926982,chr2,R,9649307,9665708,112843473,16401,150149197,20993,2
101927027,LOC101927027,chr2,F,178413658,178440243,112870058,26585,150175782,20994,4
101927043,LOC101927043,chr2,R,47192404,47345074,113022728,152670,150328452,20995,6
101927050,LOC101927050,chr2,R,89625442,89637953,113035239,12511,150340963,20996,5
101927053,LOC101927053,chr2,F,96919105,96925837,113041971,6732,150347695,20997,2
101927055,LOC101927055,chr2,F,178776925,178779963,113045009,3038,150350733,20998,1
101927070,LOC101927070,chr2,R,98761062,98771898,113055845,10836,150361569,20999,3
101927073,LOC101927073,chr2,F,179655870,179679990,113079965,24120,150385689,21000,8
101927089,LOC101927089,chr2,F,50620906,50632732,113091791,11826,150397515,21001,3
101927142,LOC101927142,chr2,R,100972647,100977161,113096305,4514,150402029,21002,2
101927147,LOC101927147,chr2,R,239879392,239913187,113130100,33795,150435824,21003,5
101927156,LOC101927156,chr2,F,181123836,181399553,113405817,275717,150711541,21004,4
101927165,LOC101927165,chr2,R,56074653,56090382,113421546,15729,150727270,21005,1
101927187,LOC101927187,chr2,F,241687764,241694219,113428001,6455,150733725,21006,2
101927196,LOC101927196,chr2,R,185719873,185740477,113448605,20604,150754329,21007,5
101927213,LOC101927213,chr2,F,56523058,56595913,113521460,72855,150827184,21008,4
101927217,LINC01473,chr2,R,186033530,186086317,113574247,52787,150879971,21009,5
101927235,LOC101927235,chr2,F,57701360,57713180,113586067,11820,150891791,21010,2
101927252,LOC101927252,chr2,R,189338593,189441118,113688592,102525,150994316,21011,5
101927260,LOC101927260,chr2,R,111221748,111248237,113715081,26489,151020805,21012,3
101927262,LOC101927262,chr2,F,286351,294727,113723457,8376,151029181,21013,5
101927283,LOC101927283,chr2,F,111264446,111279486,113738497,15040,151044221,21014,5
101927285,LOC101927285,chr2,F,59217707,59279400,113800190,61693,151105914,21015,2
101927289,LINC01237,chr2,F,241881362,242078722,113997550,197360,151303274,21016,3
101927330,LOC101927330,chr2,R,112583052,112585698,114000196,2646,151305920,21017,2
101927331,LOC101927331,chr2,R,104412151,104414079,114002124,1928,151307848,21018,1
101927360,LINC01103,chr2,R,104488455,104510509,114024178,22054,151329902,21019,5
101927362,LOC101927362,chr2,F,545798,546667,114025047,869,151330771,21020,1
101927366,LOC101927366,chr2,F,192046375,192057724,114036396,11349,151342120,21021,4
101927383,LOC101927383,chr2,F,104703590,104705913,114038719,2323,151344443,21022,1
101927400,LOC101927400,chr2,F,113325090,113427915,114141544,102825,151447268,21023,8
101927402,LOC101927402,chr2,R,64522188,64524611,114143967,2423,151449691,21024,0
101927406,LOC101927406,chr2,F,194344268,194419631,114219330,75363,151525054,21025,5
101927424,LOC101927424,chr2,F,113512450,113515482,114222362,3032,151528086,21026,2
101927431,LOC101927431,chr2,F,194730594,194761435,114253203,30841,151558927,21027,3
101927438,LOC101927438,chr2,R,64846129,64863631,114270705,17502,151576429,21028,4
101927454,LOC101927454,chr2,F,196171538,196172849,114272016,1311,151577740,21029,1
101927482,LOC101927482,chr2,F,196260023,196264204,114276197,4181,151581921,21030,2
101927492,LOC101927492,chr2,R,105097051,105102944,114282090,5893,151587814,21031,3
101927493,LOC101927493,chr2,F,1824236,1834256,114292110,10020,151597834,21032,2
101927509,LOC101927509,chr2,F,241267601,241277002,114301511,9401,151607235,21033,6
101927533,LOC101927533,chr2,F,65897583,65899512,114303440,1929,151609164,21034,1
101927534,LOC101927534,chr2,R,2870557,2871231,114304114,674,151609838,21035,1
101927547,ANKRD44-IT1,chr2,R,197250857,197302519,114355776,51662,151661500,21036,5
101927554,LINC01250,chr2,R,2895047,3126026,114586755,230979,151892479,21037,6
101927577,LOC101927577,chr2,R,66697029,66703227,114592953,6198,151898677,21038,2
101927591,DPP10-AS3,chr2,R,114828431,114833548,114598070,5117,151903794,21039,1
101927596,LOC101927596,chr2,F,197197933,197199273,114599410,1340,151905134,21040,1
101927619,LOC101927619,chr2,R,198299362,198375097,114675145,75735,151980869,21041,2
101927641,LOC101927641,chr2,F,199608067,199659132,114726210,51065,152031934,21042,6
101927661,LOC101927661,chr2,F,67213407,67244574,114757377,31167,152063101,21043,3
101927687,LOC101927687,chr2,R,199867453,199911171,114801095,43718,152106819,21044,11
101927701,LOC101927701,chr2,R,67796053,67825562,114830604,29509,152136328,21045,2
101927709,LOC101927709,chr2,R,118599782,118602966,114833788,3184,152139512,21046,2
101927723,LOC101927723,chr2,R,68361213,68370505,114843080,9292,152148804,21047,1
101927741,LOC101927741,chr2,R,200394902,200477636,114925814,82734,152231538,21048,7
101927750,ATP6V1B1-AS1,chr2,R,70942012,70948611,114932413,6599,152238137,21049,2
101927764,LOC101927764,chr2,R,119710867,119760452,114981998,49585,152287722,21050,5
101927795,LOC101927795,chr2,R,200780494,200812170,115013674,31676,152319398,21051,3
101927801,LOC101927801,chr2,F,121790443,121809945,115033176,19502,152338900,21052,5
101927834,LOC101927834,chr2,R,127628424,127630771,115035523,2347,152341247,21053,2
101927840,LOC101927840,chr2,R,203932316,203940810,115044017,8494,152349741,21054,3
101927861,LINC01293,chr2,F,74939388,74942670,115047299,3282,152353023,21055,1
101927865,LOC101927865,chr2,R,207186689,207254316,115114926,67627,152420650,21056,3
101927881,LOC101927881,chr2,F,128864599,128868727,115119054,4128,152424778,21057,2
101927884,LOC101927884,chr2,F,75524067,75542706,115137693,18639,152443417,21058,2
101927896,LOC101927896,chr2,R,234793203,234888684,115233174,95481,152538898,21059,10
101927907,LOC101927907,chr2,F,76985964,77009788,115256998,23824,152562722,21060,3
101927924,LOC101927924,chr2,F,129923176,129946703,115280525,23527,152586249,21061,3
101927926,LOC101927926,chr2,F,77915933,77918009,115282601,2076,152588325,21062,2
101927948,LOC101927948,chr2,F,78088729,78127806,115321678,39077,152627402,21063,5
101927958,LOC101927958,chr2,F,238235930,238237206,115322954,1276,152628678,21064,1
101927960,LOC101927960,chr2,F,208542841,208854414,115634527,311573,152940251,21065,21
101927967,LOC101927967,chr2,R,77743695,78290731,116181563,547036,153487287,21066,3
101927987,LOC101927987,chr2,R,79493715,79500844,116188692,7129,153494416,21067,4
101927994,LINC01087,chr2,F,131637024,131649615,116201283,12591,153507007,21068,1
101928020,LOC101928020,chr2,F,210029921,210064356,116235718,34435,153541442,21069,4
101928031,LOC101928031,chr2,F,83522813,83523482,116236387,669,153542111,21070,1
101928067,LOC101928067,chr2,R,131983345,131994971,116248013,11626,153553737,21071,2
101928084,LOC101928084,chr2,R,214084845,214102978,116266146,18133,153571870,21072,8
101928103,LOC101928103,chr2,F,214810228,214963605,116419523,153377,153725247,21073,3
101928111,LOC101928111,chr2,F,239401719,239402361,116420165,642,153725889,21074,1
101928113,ST3GAL5-AS1,chr2,F,85889279,85892252,116423138,2973,153728862,21075,2
101928149,LOC101928149,chr2,F,17514390,17514849,116423597,459,153729321,21076,1
101928152,LOC101928152,chr2,R,87470095,87486429,116439931,16334,153745655,21077,3
101928156,LOC101928156,chr2,F,216519181,216529579,116450329,10398,153756053,21078,2
101928161,LOC101928161,chr2,F,133266194,133284758,116468893,18564,153774617,21079,4
101928173,LOC101928173,chr2,R,87439522,87465886,116495257,26364,153800981,21080,1
101928180,LOC101928180,chr2,F,216533703,216579185,116540739,45482,153846463,21081,3
101928185,LOC101928185,chr2,F,132912427,132931704,116560016,19277,153865740,21082,2
101928196,LOC101928196,chr2,R,19398652,19468911,116630275,70259,153935999,21083,4
101928214,LOC101928214,chr2,R,87659370,87686729,116657634,27359,153963358,21084,9
101928222,LOC101928222,chr2,F,19990203,20004806,116672237,14603,153977961,21085,2
101928232,LINC01280,chr2,R,216589992,216606938,116689183,16946,153994907,21086,3
101928243,DARS-AS1,chr2,F,135985175,136007542,116711550,22367,154017274,21087,4
101928250,LOC101928250,chr2,F,216712379,216810997,116810168,98618,154115892,21088,6
101928271,LOC101928271,chr2,F,20859770,20861661,116812059,1891,154117783,21089,1
101928273,LOC101928273,chr2,R,137878753,137927932,116861238,49179,154166962,21090,2
101928278,LOC101928278,chr2,F,216819339,217250031,117291930,430692,154597654,21091,13
101928327,LOC101928327,chr2,F,216870771,216871639,117292798,868,154598522,21092,1
101928347,LOC101928347,chr2,R,88137205,88170560,117326153,33355,154631877,21093,3
101928361,LOC101928361,chr2,F,143602749,143608759,117332163,6010,154637887,21094,2
101928371,LOC101928371,chr2,F,88538719,88575610,117369054,36891,154674778,21095,2
101928386,LOC101928386,chr2,F,143937066,143964156,117396144,27090,154701868,21096,2
101928403,LOC101928403,chr2,F,88627865,88631825,117400104,3960,154705828,21097,1
101928455,LINC01412,chr2,F,144521867,144579434,117457671,57567,154763395,21098,2
101928487,LOC101928487,chr2,R,218216102,218217117,117458686,1015,154764410,21099,1
101928513,CATIP-AS1,chr2,R,218366664,218367902,117459924,1238,154765648,21100,2
101928526,LOC101928526,chr2,F,148855085,148859502,117464341,4417,154770065,21101,1
101928537,LINC01494,chr2,R,218900813,218930637,117494165,29824,154799889,21102,4
101928553,LOC101928553,chr2,R,148876021,148927123,117545267,51102,154850991,21103,10
101928639,LOC101928639,chr2,F,219851638,219872916,117566545,21278,154872269,21104,2
101928765,LOC101928765,chr2,R,228475163,228744681,117836063,269518,155141787,21105,6
101928816,LOC101928816,chr2,R,230443106,230521299,117914256,78193,155219980,21106,4
101928881,LOC101928881,chr2,F,233012623,233015885,117917518,3262,155223242,21107,1
101929230,LOC101929230,chr2,R,21607482,21649563,117959599,42081,155265323,21108,11
101929231,LOC101929231,chr2,F,149587357,149848234,118220476,260877,155526200,21109,2
101929251,LOC101929251,chr2,R,23018974,23199104,118400606,180130,155706330,21110,9
101929260,LOC101929260,chr2,R,150552531,150572221,118420296,19690,155726020,21111,5
101929272,LOC101929272,chr2,F,25420729,25441645,118441212,20916,155746936,21112,5
101929282,LOC101929282,chr2,F,150628896,150635357,118447673,6461,155753397,21113,4
101929319,LOC101929319,chr2,R,151337825,151379371,118489219,41546,155794943,21114,2
101929356,LOC101929356,chr2,R,151776346,151792045,118504918,15699,155810642,21115,5
101929378,LOC101929378,chr2,R,156020534,156254931,118739315,234397,156045039,21116,3
101929386,LOC101929386,chr2,F,29319190,29352202,118772327,33012,156078051,21117,13
101929390,LINC01247,chr2,R,6366009,6375422,118781740,9413,156087464,21118,2
101929418,LOC101929418,chr2,R,29926231,30146654,119002163,220423,156307887,21119,18
101929452,LOC101929452,chr2,R,7062726,7077880,119017317,15154,156323041,21120,2
101929461,LOC101929461,chr2,F,159392375,159404632,119029574,12257,156335298,21121,3
101929510,LOC101929510,chr2,F,7661863,7675004,119042715,13141,156348439,21122,6
101929512,LOC101929512,chr2,R,161223257,161254643,119074101,31386,156379825,21123,3
101929521,LOC101929521,chr2,R,36561410,36575291,119087982,13881,156393706,21124,3
101929531,LOC101929531,chr2,F,7723729,7730724,119094977,6995,156400701,21125,1
101929532,LOC101929532,chr2,F,162114440,162172739,119153276,58299,156459000,21126,3
101929542,LOC101929542,chr2,F,37324878,37326797,119155195,1919,156460919,21127,1
101929551,LOC101929551,chr2,R,7886766,7899655,119168084,12889,156473808,21128,5
101929559,LINC00211,chr2,R,37826246,37875863,119217701,49617,156523425,21129,4
101929567,LOC101929567,chr2,R,8559832,8583792,119241661,23960,156547385,21130,5
101929570,LOC101929570,chr2,F,162768935,162797972,119270698,29037,156576422,21131,4
101929596,LOC101929596,chr2,R,38458636,38515740,119327802,57104,156633526,21132,4
101929615,LOC101929615,chr2,R,164653382,164667896,119342316,14514,156648040,21133,1
101929633,LOC101929633,chr2,F,164840748,164849396,119350964,8648,156656688,21134,1
101929643,LOC101929643,chr2,F,9565640,9575508,119360832,9868,156666556,21135,3
101929667,LOC101929667,chr2,F,40510763,40545583,119395652,34820,156701376,21136,6
101929680,LOC101929680,chr2,F,166081530,166301784,119615906,220254,156921630,21137,11
101929691,LOC101929691,chr2,R,10288459,10302449,119629896,13990,156935620,21138,2
101929700,LOC101929700,chr2,F,40746552,40823415,119706759,76863,157012483,21139,7
101929715,LOC101929715,chr2,F,10449727,10455552,119712584,5825,157018308,21140,4
101929723,LOC101929723,chr2,R,41931598,41933723,119714709,2125,157020433,21141,3
101929733,LOC101929733,chr2,F,10878266,10885118,119721561,6852,157027285,21142,1
101929752,LOC101929752,chr2,R,11719839,11723554,119725276,3715,157031000,21143,3
101929753,LOC101929753,chr2,R,170340516,170350943,119735703,10427,157041427,21144,3
101929763,LOC101929763,chr2,R,43171748,43197822,119761777,26074,157067501,21145,6
101929861,LOC101929861,chr2,R,7867403,7884666,119779040,17263,157084764,21146,4
101929882,LOC101929882,chr2,R,10034215,10043441,119788266,9226,157093990,21147,5
101929908,LOC101929908,chr2,F,117921188,117935488,119802566,14300,157108290,21148,2
101929926,LOC101929926,chr2,F,126898877,126902097,119805786,3220,157111510,21149,8
101929963,LOC101929963,chr2,R,176753399,176763093,119815480,9694,157121204,21150,3
101929976,LOC101929976,chr2,R,182671944,182714608,119858144,42664,157163868,21151,4
101930137,LOC101930137,chr2,R,241482074,241483457,119859527,1383,157165251,21152,1
101930523,LOC101930523,chr2,F,104890352,104901853,119871028,11501,157176752,21153,3
102465255,MIR6512,chr2,R,177313805,177313882,119871105,77,157176829,21154,0
102465256,MIR6513,chr2,R,218280124,218280188,119871169,64,157176893,21155,0
102465485,MIR6809,chr2,R,217900512,217900628,119871285,116,157177009,21156,0
102465486,MIR6811,chr2,F,237510930,237510988,119871343,58,157177067,21157,0
102465535,MIR6888,chr2,F,159186834,159186901,119871410,67,157177134,21158,0
102465692,MIR7157,chr2,R,140586625,140586685,119871470,60,157177194,21159,0
102465693,MIR7158,chr2,F,5974661,5974732,119871541,71,157177265,21160,0
102465802,MIR7704,chr2,F,176188842,176188901,119871600,59,157177324,21161,0
102465833,MIR4433B,chr2,R,64340746,64340848,119871702,102,157177426,21162,0
102465835,MIR7845,chr2,F,207166399,207166498,119871801,99,157177525,21163,0
102465854,MIR548BA,chr2,F,49059602,49059658,119871857,56,157177581,21164,0
102465877,MIR8080,chr2,R,79866494,79866583,119871946,89,157177670,21165,0
102466197,MIR6810,chr2,F,218341910,218341980,119872016,70,157177740,21166,0
102466235,MIR7515,chr2,F,6650372,6650439,119872083,67,157177807,21167,0
102466516,MIR6071,chr2,R,85783599,85783677,119872161,78,157177885,21168,0
102682016,LINC01159,chr2,R,104865496,104872595,119879260,7099,157184984,21169,2
102723362,LOC102723362,chr2,F,22536478,22538288,119881070,1810,157186794,21170,2
102723389,LOC102723389,chr2,R,23206066,23208507,119883511,2441,157189235,21171,3
102723401,LOC102723401,chr2,R,23616498,23618144,119885157,1646,157190881,21172,1
102723413,LOC102723413,chr2,F,118044565,118058126,119898718,13561,157204442,21173,5
102723421,LOC102723421,chr2,R,218622884,218636563,119912397,13679,157218121,21174,3
102723530,LOC102723530,chr2,R,28448519,28449989,119913867,1470,157219591,21175,1
102723594,LOC102723594,chr2,R,30293034,30300485,119921318,7451,157227042,21176,2
102723658,LOC102723658,chr2,R,132029048,132038252,119930522,9204,157236246,21177,4
102723718,LOC102723718,chr2,F,134491390,134497246,119936378,5856,157242102,21178,3
102723730,LOC102723730,chr2,F,1548524,1556488,119944342,7964,157250066,21179,2
102723739,LOC102723739,chr2,R,38184359,38239635,119999618,55276,157305342,21180,4
102723818,LINC01248,chr2,R,5634140,5691118,120056596,56978,157362320,21181,4
102723824,LOC102723824,chr2,R,42142434,42170231,120084393,27797,157390117,21182,3
102723825,LOC102723825,chr2,R,240384283,240391219,120091329,6936,157397053,21183,4
102723854,LOC102723854,chr2,R,43027852,43039543,120103020,11691,157408744,21184,5
102723904,LOC102723904,chr2,R,44161183,44168467,120110304,7284,157416028,21185,2
102723909,LOC102723909,chr2,R,9102704,9110351,120117951,7647,157423675,21186,4
102723927,LOC102723927,chr2,F,241970682,241977276,120124545,6594,157430269,21187,5
102724008,LOC102724008,chr2,F,48253472,48286444,120157517,32972,157463241,21188,5
102724058,LOC102724058,chr2,F,165957417,166036400,120236500,78983,157542224,21189,3
102724063,LOC102724063,chr2,F,54417488,54433863,120252875,16375,157558599,21190,2
102724072,LOC102724072,chr2,F,54433944,54447396,120266327,13452,157572051,21191,4
102724081,LOC102724081,chr2,R,168422622,168460221,120303926,37599,157609650,21192,6
102724142,LOC102724142,chr2,R,60394849,60402128,120311205,7279,157616929,21193,2
102724194,LOC102724194,chr2,R,174329339,174334716,120316582,5377,157622306,21194,3
102724224,LINC01117,chr2,F,176637753,176655958,120334787,18205,157640511,21195,3
102724233,LOC102724233,chr2,F,65030481,65052504,120356810,22023,157662534,21196,5
102724258,LOC102724258,chr2,R,65432009,65434846,120359647,2837,157665371,21197,2
102724288,LOC102724288,chr2,R,182051959,182056212,120363900,4253,157669624,21198,4
102724321,LOC102724321,chr2,R,66921509,66922490,120364881,981,157670605,21199,2
102724332,LOC102724332,chr2,R,90190206,90195883,120370558,5677,157676282,21200,2
102724340,LOC102724340,chr2,F,184190269,184334893,120515182,144624,157820906,21201,5
102724373,LOC102724373,chr2,F,67564317,67598767,120549632,34450,157855356,21202,8
102724389,LOC102724389,chr2,F,68247217,68346020,120648435,98803,157954159,21203,4
102724482,LOC102724482,chr2,R,74750189,74778780,120677026,28591,157982750,21204,2
102724497,LOC102724497,chr2,F,74715208,74754846,120716664,39638,158022388,21205,2
102724515,LINC01291,chr2,F,74909130,74938418,120745952,29288,158051676,21206,4
102724542,LOC102724542,chr2,F,81481749,81850643,121114846,368894,158420570,21207,9
102724579,LOC102724579,chr2,F,85213609,85218191,121119428,4582,158425152,21208,2
102724642,LOC102724642,chr2,F,87125202,87171388,121165614,46186,158471338,21209,19
102724689,LOC102724689,chr2,R,87344929,87348776,121169461,3847,158475185,21210,1
102724691,LOC102724691,chr2,R,104936240,105038496,121271717,102256,158577441,21211,2
102724714,LOC102724714,chr2,F,207662383,207678855,121288189,16472,158593913,21212,4
102724744,LOC102724744,chr2,F,106701689,106781111,121367611,79422,158673335,21213,4
102724762,LOC102724762,chr2,F,107903962,107904243,121367892,281,158673616,21214,1
102724774,LOC102724774,chr2,R,108048497,108232868,121552263,184371,158857987,21215,11
102724805,LOC102724805,chr2,R,88634295,88691476,121609444,57181,158915168,21216,4
102724819,LOC102724819,chr2,R,109260658,109272527,121621313,11869,158927037,21217,2
102724820,LANCL1-AS1,chr2,F,210324711,210470333,121766935,145622,159072659,21218,5
102724848,LOC102724848,chr2,R,109859493,109877007,121784449,17514,159090173,21219,2
102724849,LOC102724849,chr2,F,215453706,215463871,121794614,10165,159100338,21220,3
102724861,LOC102724861,chr2,F,215615343,215690922,121870193,75579,159175917,21221,6
102724875,LOC102724875,chr2,F,110494501,110512013,121887705,17512,159193429,21222,2
102724898,LOC102724898,chr2,F,18560968,18563908,121890645,2940,159196369,21223,2
102724948,LOC102724948,chr2,R,20524721,20540137,121906061,15416,159211785,21224,4
102724955,LOC102724955,chr2,F,112674320,112681167,121912908,6847,159218632,21225,5
102724965,LOC102724965,chr2,R,45648732,45650986,121915162,2254,159220886,21226,1
102725079,LOC102725079,chr2,F,212795319,212817419,121937262,22100,159242986,21227,3
102725082,LOC102725082,chr2,R,212926385,212996462,122007339,70077,159313063,21228,7
102725159,LOC102725159,chr2,R,43843791,43844520,122008068,729,159313792,21229,1
102800310,HAGLROS,chr2,F,176178165,176179009,122008912,844,159314636,21230,1
102800314,MIR7515HG,chr2,R,6649106,6650519,122010325,1413,159316049,21231,1
102800315,LINC01246,chr2,R,6626108,6634706,122018923,8598,159324647,21232,3
102800447,LOC102800447,chr2,F,67086445,67289244,122221722,202799,159527446,21233,4
103344932,PGM5P4-AS1,chr2,R,113528646,113542690,122235766,14044,159541490,21234,4
103504730,MIR9500,chr2,F,218823089,218823154,122235831,65,159541555,21235,0
103504737,MIR8485,chr2,R,50696171,50696262,122235922,91,159541646,21236,0
103689911,CATIP-AS2,chr2,R,218326240,218357966,122267648,31726,159573372,21237,3
103752554,MYCNUT,chr2,F,15920398,15936018,122283268,15620,159588992,21238,2
103752586,BIRC6-AS2,chr2,R,32557519,32574818,122300567,17299,159606291,21239,1
104326052,NRIR,chr2,R,6828553,6840464,122312478,11911,159618202,21240,3
104326057,GACAT1,chr2,F,107754111,107822129,122380496,68018,159686220,21241,5
104326193,DLX2-AS1,chr2,F,172103005,172109982,122387473,6977,159693197,21242,4
104355141,LINC01143,chr2,F,70887870,70889984,122389587,2114,159695311,21243,3
104355152,LINC01090,chr2,R,188035595,188287691,122641683,252096,159947407,21244,2
104355287,LINC01317,chr2,F,33706885,34297746,123232544,590861,160538268,21245,6
104355288,LINC01320,chr2,F,34677556,34722563,123277551,45007,160583275,21246,2
104355290,MIR217HG,chr2,R,55963405,56047326,123361472,83921,160667196,21247,2
104797537,GACAT3,chr2,F,16050426,16085689,123396735,35263,160702459,21248,3
105369142,LOC105369142,chr2,R,113873516,113889943,123413162,16427,160718886,21249,4
105369143,LOC105369143,chr2,R,176673223,176680305,123420244,7082,160725968,21250,2
105369164,LOC105369164,chr2,R,24790747,24793118,123422615,2371,160728339,21251,2
105369165,LOC105369165,chr2,R,52722714,52961460,123661361,238746,160967085,21252,5
105369166,LOC105369166,chr2,F,65476315,65628425,123813471,152110,161119195,21253,3
105369167,LOC105369167,chr2,F,65725675,65788889,123876685,63214,161182409,21254,7
105369168,LOC105369168,chr2,F,65921948,66192020,124146757,270072,161452481,21255,14
105369169,LOC105369169,chr2,R,74407552,74414171,124153376,6619,161459100,21256,3
105369221,LOC105369221,chr2,R,119723201,119728800,124158975,5599,161464699,21257,1
105369287,LOC105369287,chr2,R,238152888,238158749,124164836,5861,161470560,21258,1
105373319,LOC105373319,chr2,R,194492,209541,124179885,15049,161485609,21259,1
105373324,LOC105373324,chr2,R,162723,190544,124207706,27821,161513430,21260,3
105373346,LOC105373346,chr2,R,305120,314395,124216981,9275,161522705,21261,6
105373350,LOC105373350,chr2,F,316254,336807,124237534,20553,161543258,21262,4
105373351,LOC105373351,chr2,F,367534,387147,124257147,19613,161562871,21263,2
105373352,LOC105373352,chr2,F,557812,561982,124261317,4170,161567041,21264,2
105373353,LOC105373353,chr2,F,635636,646098,124271779,10462,161577503,21265,1
105373354,LOC105373354,chr2,F,677386,686799,124281192,9413,161586916,21266,3
105373358,LOC105373358,chr2,R,697223,715523,124299492,18300,161605216,21267,3
105373359,LOC105373359,chr2,R,1309201,1314449,124304740,5248,161610464,21268,4
105373360,LOC105373360,chr2,R,1251792,1262948,124315896,11156,161621620,21269,2
105373362,LOC105373362,chr2,F,1414508,1417633,124319021,3125,161624745,21270,1
105373363,LOC105373363,chr2,R,1543549,1556582,124332054,13033,161637778,21271,1
105373364,LOC105373364,chr2,F,1558526,1564260,124337788,5734,161643512,21272,2
105373365,LOC105373365,chr2,F,1750736,1753954,124341006,3218,161646730,21273,1
105373371,LOC105373371,chr2,F,1801805,1803582,124342783,1777,161648507,21274,1
105373380,LOC105373380,chr2,F,1798740,1811738,124355781,12998,161661505,21275,5
105373389,LOC105373389,chr2,F,2484407,2495203,124366577,10796,161672301,21276,2
105373390,LOC105373390,chr2,R,2831395,2839440,124374622,8045,161680346,21277,4
105373391,LOC105373391,chr2,R,3128060,3129950,124376512,1890,161682236,21278,2
105373393,LOC105373393,chr2,R,3697340,3703500,124382672,6160,161688396,21279,4
105373394,LOC105373394,chr2,F,3974160,3975170,124383682,1010,161689406,21280,2
105373395,LOC105373395,chr2,F,4020895,4025307,124388094,4412,161693818,21281,3
105373396,LOC105373396,chr2,R,4323241,4330011,124394864,6770,161700588,21282,2
105373397,LOC105373397,chr2,F,4096388,4140262,124438738,43874,161744462,21283,7
105373398,LOC105373398,chr2,F,5273717,5295080,124460101,21363,161765825,21284,3
105373399,LOC105373399,chr2,R,5401307,5409084,124467878,7777,161773602,21285,4
105373400,LOC105373400,chr2,R,5811126,5812618,124469370,1492,161775094,21286,2
105373401,LOC105373401,chr2,R,6291564,6313142,124490948,21578,161796672,21287,4
105373402,LOC105373402,chr2,R,6398176,6421122,124513894,22946,161819618,21288,2
105373403,LOC105373403,chr2,F,6428678,6431854,124517070,3176,161822794,21289,2
105373404,LOC105373404,chr2,R,6790928,6796822,124522964,5894,161828688,21290,2
105373405,LOC105373405,chr2,R,7314116,7332485,124541333,18369,161847057,21291,3
105373406,LOC105373406,chr2,F,7382668,7387037,124545702,4369,161851426,21292,4
105373407,LOC105373407,chr2,F,7476747,7478651,124547606,1904,161853330,21293,2
105373408,LOC105373408,chr2,R,7797097,7863440,124613949,66343,161919673,21294,3
105373409,LOC105373409,chr2,F,7881306,7892182,124624825,10876,161930549,21295,2
105373410,LOC105373410,chr2,R,8357373,8362275,124629727,4902,161935451,21296,3
105373411,LOC105373411,chr2,R,8598895,8622855,124653687,23960,161959411,21297,2
105373412,LOC105373412,chr2,F,8679241,8681930,124656376,2689,161962100,21298,3
105373413,LOC105373413,chr2,F,9004076,9046176,124698476,42100,162004200,21299,4
105373414,LOC105373414,chr2,F,9103857,9109859,124704478,6002,162010202,21300,1
105373415,LOC105373415,chr2,R,9115765,9127143,124715856,11378,162021580,21301,3
105373416,LOC105373416,chr2,F,9110422,9117032,124722466,6610,162028190,21302,4
105373417,LOC105373417,chr2,R,9135019,9145910,124733357,10891,162039081,21303,4
105373418,LOC105373418,chr2,F,9638736,9641402,124736023,2666,162041747,21304,2
105373419,LOC105373419,chr2,F,9660377,9661283,124736929,906,162042653,21305,1
105373420,LOC105373420,chr2,F,9752889,9757498,124741538,4609,162047262,21306,2
105373421,LOC105373421,chr2,R,9805309,9807483,124743712,2174,162049436,21307,2
105373422,LOC105373422,chr2,R,9939096,9950829,124755445,11733,162061169,21308,2
105373423,LOC105373423,chr2,F,10030592,10040346,124765199,9754,162070923,21309,1
105373424,LOC105373424,chr2,R,10198595,10202060,124768664,3465,162074388,21310,2
105373425,LOC105373425,chr2,R,10406376,10412513,124774801,6137,162080525,21311,2
105373426,LOC105373426,chr2,R,10534484,10548676,124788993,14192,162094717,21312,5
105373427,LOC105373427,chr2,R,10709199,10715339,124795133,6140,162100857,21313,2
105373428,LOC105373428,chr2,R,10768708,10772525,124798950,3817,162104674,21314,2
105373429,LOC105373429,chr2,F,11406206,11426386,124819130,20180,162124854,21315,5
105373430,LOC105373430,chr2,F,11832218,11866277,124853189,34059,162158913,21316,4
105373431,LOC105373431,chr2,R,12445239,12463279,124871229,18040,162176953,21317,2
105373432,LOC105373432,chr2,R,12189642,12192849,124874436,3207,162180160,21318,3
105373433,LOC105373433,chr2,R,12104598,12108303,124878141,3705,162183865,21319,2
105373435,LOC105373435,chr2,F,13110188,13128540,124896493,18352,162202217,21320,2
105373436,LOC105373436,chr2,F,13277936,13331663,124950220,53727,162255944,21321,3
105373437,LOC105373437,chr2,F,13357300,13403233,124996153,45933,162301877,21322,3
105373438,LOC105373438,chr2,F,13609061,13758396,125145488,149335,162451212,21323,3
105373439,LOC105373439,chr2,R,14778928,15137440,125504000,358512,162809724,21324,4
105373440,LOC105373440,chr2,F,15561425,15573831,125516406,12406,162822130,21325,4
105373441,LOC105373441,chr2,F,15781175,15786575,125521806,5400,162827530,21326,4
105373442,LOC105373442,chr2,R,5696236,5700950,125526520,4714,162832244,21327,2
105373443,LOC105373443,chr2,R,16201589,16204940,125529871,3351,162835595,21328,2
105373444,LOC105373444,chr2,R,16454994,16478580,125553457,23586,162859181,21329,3
105373445,LOC105373445,chr2,F,16529378,16547574,125571653,18196,162877377,21330,2
105373446,LOC105373446,chr2,F,16738037,16743667,125577283,5630,162883007,21331,2
105373447,LOC105373447,chr2,F,17376560,17399920,125600643,23360,162906367,21332,3
105373448,LOC105373448,chr2,R,17433585,17441992,125609050,8407,162914774,21333,2
105373449,LOC105373449,chr2,R,17762475,17801314,125647889,38839,162953613,21334,5
105373450,LOC105373450,chr2,R,17847699,17849474,125649664,1775,162955388,21335,2
105373451,LOC105373451,chr2,R,18280366,18311575,125680873,31209,162986597,21336,3
105373452,LOC105373452,chr2,F,18361589,18385968,125705252,24379,163010976,21337,3
105373453,LOC105373453,chr2,R,18492235,18502923,125715940,10688,163021664,21338,2
105373454,LOC105373454,chr2,F,18442419,18514629,125788150,72210,163093874,21339,2
105373455,LOC105373455,chr2,R,19040671,19066012,125813491,25341,163119215,21340,2
105373456,LOC105373456,chr2,F,18563941,19089337,126338887,525396,163644611,21341,6
105373457,LOC105373457,chr2,F,19096586,19100476,126342777,3890,163648501,21342,2
105373458,LOC105373458,chr2,R,19431395,19436404,126347786,5009,163653510,21343,2
105373459,LOC105373459,chr2,R,19590263,19605464,126362987,15201,163668711,21344,3
105373460,LOC105373460,chr2,F,19475575,19520010,126407422,44435,163713146,21345,5
105373461,LOC105373461,chr2,F,19711682,19717471,126413211,5789,163718935,21346,1
105373462,LOC105373462,chr2,F,19901890,19903112,126414433,1222,163720157,21347,1
105373463,LOC105373463,chr2,F,20052137,20126029,126488325,73892,163794049,21348,9
105373464,LOC105373464,chr2,R,20182375,20186047,126491997,3672,163797721,21349,1
105373465,LOC105373465,chr2,R,20405083,20424964,126511878,19881,163817602,21350,3
105373479,LOC105373479,chr2,R,689813,692453,126514518,2640,163820242,21351,1
105373480,LOC105373480,chr2,F,731289,779111,126562340,47822,163868064,21352,8
105373481,LOC105373481,chr2,F,905594,916572,126573318,10978,163879042,21353,1
105373482,LOC105373482,chr2,F,1443512,1445676,126575482,2164,163881206,21354,2
105373483,LOC105373483,chr2,F,7720339,7723681,126578824,3342,163884548,21355,2
105373484,LOC105373484,chr2,F,13000447,13213628,126792005,213181,164097729,21356,2
105373485,LOC105373485,chr2,R,13519496,13533126,126805635,13630,164111359,21357,1
105373486,LOC105373486,chr2,R,94651638,94668792,126822789,17154,164128513,21358,2
105373487,LOC105373487,chr2,F,94947783,94959950,126834956,12167,164140680,21359,2
105373488,LOC105373488,chr2,F,95074831,95076293,126836418,1462,164142142,21360,2
105373489,LOC105373489,chr2,F,95207502,95222682,126851598,15180,164157322,21361,4
105373490,LOC105373490,chr2,R,95637089,95641984,126856493,4895,164162217,21362,1
105373491,LOC105373491,chr2,R,95711718,95718523,126863298,6805,164169022,21363,1
105373492,LOC105373492,chr2,R,95786365,95789577,126866510,3212,164172234,21364,1
105373493,LOC105373493,chr2,F,96035327,96038215,126869398,2888,164175122,21365,1
105373494,LOC105373494,chr2,R,96049530,96057639,126877507,8109,164183231,21366,4
105373495,LOC105373495,chr2,R,96307262,96321893,126892138,14631,164197862,21367,1
105373496,LOC105373496,chr2,R,96527939,96532304,126896503,4365,164202227,21368,2
105373497,LOC105373497,chr2,R,97037447,97059182,126918238,21735,164223962,21369,2
105373498,LOC105373498,chr2,F,97438097,97439092,126919233,995,164224957,21370,1
105373499,LOC105373499,chr2,R,97607119,97612902,126925016,5783,164230740,21371,3
105373500,LOC105373500,chr2,F,97997642,98001796,126929170,4154,164234894,21372,1
105373501,LOC105373501,chr2,R,98045460,98052372,126936082,6912,164241806,21373,2
105373502,LOC105373502,chr2,R,98331062,98333595,126938615,2533,164244339,21374,2
105373503,LOC105373503,chr2,F,98698431,98708207,126948391,9776,164254115,21375,2
105373504,LOC105373504,chr2,F,99697611,99701828,126952608,4217,164258332,21376,3
105373505,LOC105373505,chr2,R,99679173,99686597,126960032,7424,164265756,21377,3
105373506,LOC105373506,chr2,R,100476032,100494205,126978205,18173,164283929,21378,4
105373507,LOC105373507,chr2,F,100603728,100609353,126983830,5625,164289554,21379,2
105373508,LOC105373508,chr2,F,100739946,100747314,126991198,7368,164296922,21380,2
105373510,LOC105373510,chr2,F,101023410,101024307,126992095,897,164297819,21381,1
105373511,LOC105373511,chr2,R,101260815,101266670,126997950,5855,164303674,21382,1
105373512,LOC105373512,chr2,F,101308780,101312792,127001962,4012,164307686,21383,2
105373513,LOC105373513,chr2,F,101325592,101371755,127048125,46163,164353849,21384,2
105373514,LOC105373514,chr2,R,101551587,101567902,127064440,16315,164370164,21385,4
105373515,LOC105373515,chr2,F,102063805,102065330,127065965,1525,164371689,21386,2
105373516,LOC105373516,chr2,R,102179733,102182108,127068340,2375,164374064,21387,1
105373517,LOC105373517,chr2,R,102519987,102522382,127070735,2395,164376459,21388,2
105373518,LOC105373518,chr2,R,102873282,102895751,127093204,22469,164398928,21389,6
105373519,LOC105373519,chr2,R,102967407,102984520,127110317,17113,164416041,21390,3
105373520,LOC105373520,chr2,R,103812110,103820168,127118375,8058,164424099,21391,4
105373521,LOC105373521,chr2,R,104093617,104111966,127136724,18349,164442448,21392,2
105373522,LOC105373522,chr2,R,104144116,104148317,127140925,4201,164446649,21393,2
105373523,LOC105373523,chr2,R,104115005,104158335,127184255,43330,164489979,21394,6
105373524,LOC105373524,chr2,R,104580820,104581930,127185365,1110,164491089,21395,1
105373525,LOC105373525,chr2,F,104583151,104585357,127187571,2206,164493295,21396,1
105373526,LOC105373526,chr2,F,104659336,104667649,127195884,8313,164501608,21397,6
105373527,LOC105373527,chr2,F,105103353,105106155,127198686,2802,164504410,21398,5
105373528,LOC105373528,chr2,R,105194217,105197397,127201866,3180,164507590,21399,2
105373529,LOC105373529,chr2,R,105450326,105454691,127206231,4365,164511955,21400,2
105373530,LOC105373530,chr2,R,105928192,105937732,127215771,9540,164521495,21401,2
105373531,LOC105373531,chr2,F,105943179,105971483,127244075,28304,164549799,21402,3
105373532,LOC105373532,chr2,F,106083051,106093568,127254592,10517,164560316,21403,1
105373533,LOC105373533,chr2,F,106376451,106378247,127256388,1796,164562112,21404,2
105373534,LOC105373534,chr2,F,106468417,106470142,127258113,1725,164563837,21405,1
105373535,LOC105373535,chr2,R,107028962,107032908,127262059,3946,164567783,21406,2
105373536,LOC105373536,chr2,R,107260699,107365873,127367233,105174,164672957,21407,5
105373537,LOC105373537,chr2,F,107529377,107555805,127393661,26428,164699385,21408,2
105373538,LOC105373538,chr2,R,107382471,107542816,127554006,160345,164859730,21409,9
105373539,LOC105373539,chr2,R,107638477,107651650,127567179,13173,164872903,21410,6
105373540,LOC105373540,chr2,R,107888298,107895228,127574109,6930,164879833,21411,1
105373541,LOC105373541,chr2,R,108594691,108613386,127592804,18695,164898528,21412,2
105373542,LOC105373542,chr2,F,108882110,108885485,127596179,3375,164901903,21413,1
105373543,LOC105373543,chr2,R,109065022,109069925,127601082,4903,164906806,21414,3
105373544,LOC105373544,chr2,R,109045834,109061999,127617247,16165,164922971,21415,3
105373545,LOC105373545,chr2,F,109694485,109701282,127624044,6797,164929768,21416,2
105373546,LOC105373546,chr2,R,109733088,109764662,127655618,31574,164961342,21417,1
105373547,LOC105373547,chr2,R,109918859,109922848,127659607,3989,164965331,21418,3
105373548,LOC105373548,chr2,R,110035838,110039614,127663383,3776,164969107,21419,3
105373549,LOC105373549,chr2,R,110039634,110041438,127665187,1804,164970911,21420,2
105373550,LOC105373550,chr2,R,110341769,110351400,127674818,9631,164980542,21421,1
105373551,LOC105373551,chr2,F,110316887,110347069,127705000,30182,165010724,21422,22
105373552,LOC105373552,chr2,F,110448571,110452647,127709076,4076,165014800,21423,3
105373553,LOC105373553,chr2,F,110611117,110612096,127710055,979,165015779,21424,1
105373554,LOC105373554,chr2,F,110678187,110692786,127724654,14599,165030378,21425,2
105373555,LOC105373555,chr2,R,110730383,110732444,127726715,2061,165032439,21426,2
105373556,LOC105373556,chr2,R,111006200,111050212,127770727,44012,165076451,21427,2
105373557,LOC105373557,chr2,F,111484327,111510994,127797394,26667,165103118,21428,2
105373558,LOC105373558,chr2,F,111279789,111291564,127809169,11775,165114893,21429,3
105373559,LOC105373559,chr2,F,111607743,111612541,127813967,4798,165119691,21430,1
105373560,LOC105373560,chr2,R,112061079,112064122,127817010,3043,165122734,21431,1
105373561,LOC105373561,chr2,F,112286641,112288965,127819334,2324,165125058,21432,1
105373562,LOC105373562,chr2,R,112541655,112542293,127819972,638,165125696,21433,1
105373563,LOC105373563,chr2,R,112889624,112908546,127838894,18922,165144618,21434,4
105373564,LOC105373564,chr2,R,113209948,113213332,127842278,3384,165148002,21435,1
105373565,LOC105373565,chr2,F,113213364,113214540,127843454,1176,165149178,21436,1
105373566,LOC105373566,chr2,R,113353529,113360000,127849925,6471,165155649,21437,2
105373567,LOC105373567,chr2,R,113314500,113325321,127860746,10821,165166470,21438,2
105373568,LOC105373568,chr2,R,113457223,113502749,127906272,45526,165211996,21439,2
105373569,LOC105373569,chr2,R,113643187,113645824,127908909,2637,165214633,21440,1
105373570,LOC105373570,chr2,R,113803962,113818948,127923895,14986,165229619,21441,3
105373571,LOC105373571,chr2,F,113963215,113970753,127931433,7538,165237157,21442,2
105373572,LOC105373572,chr2,R,115738896,115756822,127949359,17926,165255083,21443,2
105373573,LOC105373573,chr2,R,115537712,115539107,127950754,1395,165256478,21444,1
105373574,LOC105373574,chr2,R,115112254,115115265,127953765,3011,165259489,21445,2
105373575,LOC105373575,chr2,R,115075160,115099027,127977632,23867,165283356,21446,5
105373576,LOC105373576,chr2,F,116294576,116388224,128071280,93648,165377004,21447,3
105373577,LOC105373577,chr2,R,117701113,117704474,128074641,3361,165380365,21448,2
105373578,LOC105373578,chr2,R,118187837,118224425,128111229,36588,165416953,21449,5
105373579,LOC105373579,chr2,R,118459849,118493394,128144774,33545,165450498,21450,2
105373580,LOC105373580,chr2,R,118949304,118953065,128148535,3761,165454259,21451,1
105373581,LOC105373581,chr2,R,119265587,119271421,128154369,5834,165460093,21452,2
105373582,LOC105373582,chr2,R,120167959,120173745,128160155,5786,165465879,21453,2
105373583,LOC105373583,chr2,R,120235701,120246141,128170595,10440,165476319,21454,2
105373584,LOC105373584,chr2,R,120317385,120319159,128172369,1774,165478093,21455,2
105373585,LOC105373585,chr2,R,120543558,120553374,128182185,9816,165487909,21456,2
105373586,LOC105373586,chr2,F,120596296,120604040,128189929,7744,165495653,21457,1
105373587,LOC105373587,chr2,F,121049462,121057784,128198251,8322,165503975,21458,5
105373588,LOC105373588,chr2,R,121138061,121140709,128200899,2648,165506623,21459,1
105373589,LOC105373589,chr2,R,121562037,121574097,128212959,12060,165518683,21460,1
105373590,LOC105373590,chr2,R,121775392,121790364,128227931,14972,165533655,21461,3
105373591,LOC105373591,chr2,F,122233396,122243224,128237759,9828,165543483,21462,5
105373592,LOC105373592,chr2,F,121902310,122432879,128768328,530569,166074052,21463,14
105373593,LOC105373593,chr2,R,122491373,122505123,128782078,13750,166087802,21464,3
105373594,LOC105373594,chr2,R,122800092,122808893,128790879,8801,166096603,21465,4
105373595,LOC105373595,chr2,F,122874890,122886858,128802847,11968,166108571,21466,6
105373596,LOC105373596,chr2,R,122987902,122999839,128814784,11937,166120508,21467,2
105373597,LOC105373597,chr2,F,125710918,125793559,128897425,82641,166203149,21468,3
105373598,LOC105373598,chr2,R,125706790,125811356,129001991,104566,166307715,21469,5
105373599,LOC105373599,chr2,F,125822157,125832794,129012628,10637,166318352,21470,2
105373600,LOC105373600,chr2,R,126109778,126118017,129020867,8239,166326591,21471,4
105373601,LOC105373601,chr2,F,126443976,126461948,129038839,17972,166344563,21472,3
105373602,LOC105373602,chr2,R,126535788,126640247,129143298,104459,166449022,21473,4
105373603,LOC105373603,chr2,R,126893082,126898796,129149012,5714,166454736,21474,2
105373604,LOC105373604,chr2,F,127023809,127035755,129160958,11946,166466682,21475,3
105373605,LOC105373605,chr2,F,127107498,127136514,129189974,29016,166495698,21476,4
105373606,LOC105373606,chr2,F,127337788,127375404,129227590,37616,166533314,21477,3
105373607,LOC105373607,chr2,F,127467024,127489810,129250376,22786,166556100,21478,2
105373608,LOC105373608,chr2,R,127426233,127470996,129295139,44763,166600863,21479,6
105373609,LOC105373609,chr2,R,127560044,127571395,129306490,11351,166612214,21480,2
105373610,LOC105373610,chr2,R,128375518,128379070,129310042,3552,166615766,21481,2
105373611,LOC105373611,chr2,F,128404938,128644230,129549334,239292,166855058,21482,2
105373612,LOC105373612,chr2,F,129243285,129289156,129595205,45871,166900929,21483,5
105373613,LOC105373613,chr2,F,129402518,129462087,129654774,59569,166960498,21484,2
105373614,LOC105373614,chr2,R,129546811,129591308,129699271,44497,167004995,21485,5
105373615,LOC105373615,chr2,R,129862280,129877563,129714554,15283,167020278,21486,5
105373616,LOC105373616,chr2,F,129877898,129883679,129720335,5781,167026059,21487,2
105373617,LOC105373617,chr2,F,130107683,130110357,129723009,2674,167028733,21488,1
105373618,LOC105373618,chr2,F,130391652,130393729,129725086,2077,167030810,21489,1
105373619,LOC105373619,chr2,R,131382329,131394225,129736982,11896,167042706,21490,5
105373620,LOC105373620,chr2,R,131228564,131245710,129754128,17146,167059852,21491,2
105373621,LOC105373621,chr2,F,132335050,132338397,129757475,3347,167063199,21492,3
105373622,LOC105373622,chr2,F,132268618,132276904,129765761,8286,167071485,21493,3
105373623,LOC105373623,chr2,F,132656416,132666990,129776335,10574,167082059,21494,3
105373624,LOC105373624,chr2,F,132943686,132952620,129785269,8934,167090993,21495,2
105373625,LOC105373625,chr2,F,132673311,132675855,129787813,2544,167093537,21496,1
105373626,LOC105373626,chr2,R,133927334,133952961,129813440,25627,167119164,21497,1
105373627,LOC105373627,chr2,R,133952985,133993284,129853739,40299,167159463,21498,5
105373628,LOC105373628,chr2,R,134018704,134031272,129866307,12568,167172031,21499,3
105373629,LOC105373629,chr2,F,134718274,134722526,129870559,4252,167176283,21500,1
105373630,LOC105373630,chr2,R,134503142,134507488,129874905,4346,167180629,21501,2
105373631,LOC105373631,chr2,F,135225837,135238968,129888036,13131,167193760,21502,3
105373632,LOC105373632,chr2,F,136088440,136114702,129914298,26262,167220022,21503,1
105373633,LOC105373633,chr2,R,136544830,136575840,129945308,31010,167251032,21504,2
105373634,LOC105373634,chr2,R,137493465,137507560,129959403,14095,167265127,21505,6
105373635,LOC105373635,chr2,F,138101883,138105905,129963425,4022,167269149,21506,2
105373636,LOC105373636,chr2,R,138046742,138060251,129976934,13509,167282658,21507,3
105373637,LOC105373637,chr2,R,138492203,138500791,129985522,8588,167291246,21508,1
105373638,LOC105373638,chr2,R,138596360,138601765,129990927,5405,167296651,21509,2
105373639,LOC105373639,chr2,R,138910054,138917218,129998091,7164,167303815,21510,2
105373640,LOC105373640,chr2,F,138917224,138975280,130056147,58056,167361871,21511,2
105373641,LOC105373641,chr2,F,139259919,139264152,130060380,4233,167366104,21512,2
105373642,LOC105373642,chr2,F,139234685,139359561,130185256,124876,167490980,21513,5
105373643,LOC105373643,chr2,F,139362262,139379146,130202140,16884,167507864,21514,5
105373644,LOC105373644,chr2,R,139384817,139388334,130205657,3517,167511381,21515,2
105373645,LOC105373645,chr2,F,139411296,139474824,130269185,63528,167574909,21516,2
105373646,LOC105373646,chr2,F,139991108,140002659,130280736,11551,167586460,21517,2
105373647,LOC105373647,chr2,R,140079958,140117665,130318443,37707,167624167,21518,5
105373648,LOC105373648,chr2,F,141846828,141855907,130327522,9079,167633246,21519,4
105373649,LOC105373649,chr2,F,141459800,141475120,130342842,15320,167648566,21520,5
105373650,LOC105373650,chr2,F,140712157,140738920,130369605,26763,167675329,21521,3
105373651,LOC105373651,chr2,F,142299009,142341746,130412342,42737,167718066,21522,6
105373652,LOC105373652,chr2,R,142862571,142871212,130420983,8641,167726707,21523,4
105373653,LOC105373653,chr2,R,143737982,143776114,130459115,38132,167764839,21524,6
105373654,LOC105373654,chr2,R,143628242,143719630,130550503,91388,167856227,21525,6
105373655,LOC105373655,chr2,F,143217360,143224173,130557316,6813,167863040,21526,1
105373656,LOC105373656,chr2,R,144523540,144524580,130558356,1040,167864080,21527,2
105373657,LOC105373657,chr2,F,144485907,144504067,130576516,18160,167882240,21528,3
105373659,LOC105373659,chr2,F,144450971,144485659,130611204,34688,167916928,21529,3
105373660,LOC105373660,chr2,F,144440542,144450689,130621351,10147,167927075,21530,2
105373661,LOC105373661,chr2,F,145188107,145263207,130696451,75100,168002175,21531,2
105373662,LOC105373662,chr2,R,144877863,144882011,130700599,4148,168006323,21532,2
105373663,LOC105373663,chr2,F,144806055,144810119,130704663,4064,168010387,21533,2
105373664,LOC105373664,chr2,R,145600920,145631847,130735590,30927,168041314,21534,7
105373665,LOC105373665,chr2,R,145856244,145869832,130749178,13588,168054902,21535,6
105373666,LOC105373666,chr2,F,145872225,145881611,130758564,9386,168064288,21536,2
105373667,LOC105373667,chr2,R,146203714,146413225,130968075,209511,168273799,21537,3
105373668,LOC105373668,chr2,F,146856680,146878427,130989822,21747,168295546,21538,5
105373669,LOC105373669,chr2,F,146837769,146856686,131008739,18917,168314463,21539,5
105373670,LOC105373670,chr2,R,147088082,147390670,131311327,302588,168617051,21540,2
105373671,LOC105373671,chr2,R,147858937,147903047,131355437,44110,168661161,21541,4
105373672,LOC105373672,chr2,R,148111314,148118379,131362502,7065,168668226,21542,2
105373673,LOC105373673,chr2,R,148021850,148040045,131380697,18195,168686421,21543,2
105373674,LOC105373674,chr2,F,147983184,147993777,131391290,10593,168697014,21544,4
105373675,LOC105373675,chr2,F,148520105,148525052,131396237,4947,168701961,21545,4
105373676,LOC105373676,chr2,F,148951084,148955218,131400371,4134,168706095,21546,2
105373677,LOC105373677,chr2,R,149174737,149184798,131410432,10061,168716156,21547,3
105373678,LOC105373678,chr2,R,149170627,149174748,131414553,4121,168720277,21548,1
105373679,LOC105373679,chr2,F,149287751,149290184,131416986,2433,168722710,21549,2
105373680,LOC105373680,chr2,R,149745650,149749703,131421039,4053,168726763,21550,1
105373681,LOC105373681,chr2,F,149588277,149596428,131429190,8151,168734914,21551,3
105373682,LOC105373682,chr2,R,150150632,150166366,131444924,15734,168750648,21552,1
105373683,LOC105373683,chr2,R,150234657,150257007,131467274,22350,168772998,21553,2
105373684,LOC105373684,chr2,F,150169490,150353345,131651129,183855,168956853,21554,2
105373685,LOC105373685,chr2,F,150426603,150428905,131653431,2302,168959155,21555,2
105373686,LOC105373686,chr2,R,151043835,151050581,131660177,6746,168965901,21556,3
105373687,LOC105373687,chr2,R,151298347,151303452,131665282,5105,168971006,21557,1
105373688,LOC105373688,chr2,R,152178859,152180718,131667141,1859,168972865,21558,1
105373689,LOC105373689,chr2,F,152175870,152190687,131681958,14817,168987682,21559,3
105373690,LOC105373690,chr2,R,152634932,152646102,131693128,11170,168998852,21560,2
105373691,LOC105373691,chr2,F,152958935,153028286,131762479,69351,169068203,21561,4
105373692,LOC105373692,chr2,R,154469633,154471577,131764423,1944,169070147,21562,1
105373693,LOC105373693,chr2,F,154486462,154509447,131787408,22985,169093132,21563,2
105373694,LOC105373694,chr2,R,154471595,154488929,131804742,17334,169110466,21564,2
105373695,LOC105373695,chr2,R,154935461,154945130,131814411,9669,169120135,21565,1
105373696,LOC105373696,chr2,R,154950223,155054274,131918462,104051,169224186,21566,7
105373697,LOC105373697,chr2,R,155075484,155225935,132068913,150451,169374637,21567,2
105373698,LOC105373698,chr2,F,155263626,155281981,132087268,18355,169392992,21568,3
105373699,LOC105373699,chr2,F,155363584,155417986,132141670,54402,169447394,21569,3
105373700,LOC105373700,chr2,F,155473245,155489338,132157763,16093,169463487,21570,2
105373701,LOC105373701,chr2,R,155759645,155814139,132212257,54494,169517981,21571,2
105373702,LOC105373702,chr2,R,155838363,155840975,132214869,2612,169520593,21572,2
105373703,LOC105373703,chr2,R,155866974,155913995,132261890,47021,169567614,21573,4
105373704,LOC105373704,chr2,R,156160949,156318728,132419669,157779,169725393,21574,3
105373705,LOC105373705,chr2,R,155979692,155981040,132421017,1348,169726741,21575,2
105373706,LOC105373706,chr2,F,156407649,156433598,132446966,25949,169752690,21576,3
105373707,LOC105373707,chr2,F,156610723,156613737,132449980,3014,169755704,21577,1
105373708,LOC105373708,chr2,F,156666599,156694613,132477994,28014,169783718,21578,2
105373709,LOC105373709,chr2,F,157031460,157049719,132496253,18259,169801977,21579,4
105373710,LOC105373710,chr2,R,156968413,157056592,132584432,88179,169890156,21580,3
105373711,LOC105373711,chr2,R,157392921,157404877,132596388,11956,169902112,21581,1
105373712,LOC105373712,chr2,R,157464940,157491080,132622528,26140,169928252,21582,4
105373713,LOC105373713,chr2,R,157725715,157728415,132625228,2700,169930952,21583,1
105373714,LOC105373714,chr2,F,157876565,157918379,132667042,41814,169972766,21584,1
105373715,LOC105373715,chr2,F,158577398,158589945,132679589,12547,169985313,21585,2
105373716,LOC105373716,chr2,F,159234308,159241064,132686345,6756,169992069,21586,2
105373717,LOC105373717,chr2,F,160035059,160141970,132793256,106911,170098980,21587,3
105373718,LOC105373718,chr2,R,160555162,160648509,132886603,93347,170192327,21588,2
105373719,LOC105373719,chr2,R,161067775,161160272,132979100,92497,170284824,21589,4
105373720,LOC105373720,chr2,R,161469582,161489464,132998982,19882,170304706,21590,1
105373721,LOC105373721,chr2,R,161902103,161913163,133010042,11060,170315766,21591,2
105373722,LOC105373722,chr2,R,161883344,161902093,133028791,18749,170334515,21592,2
105373723,LOC105373723,chr2,F,162073484,162077941,133033248,4457,170338972,21593,3
105373724,LOC105373724,chr2,F,162246131,162250062,133037179,3931,170342903,21594,2
105373725,LOC105373725,chr2,F,162839634,162854772,133052317,15138,170358041,21595,2
105373726,LOC105373726,chr2,F,162490350,162495479,133057446,5129,170363170,21596,2
105373727,LOC105373727,chr2,F,163259327,163329379,133127498,70052,170433222,21597,4
105373728,LOC105373728,chr2,F,163450805,163456673,133133366,5868,170439090,21598,2
105373729,LOC105373729,chr2,R,165624079,165640659,133149946,16580,170455670,21599,2
105373730,LOC105373730,chr2,R,165821976,165848186,133176156,26210,170481880,21600,5
105373731,LOC105373731,chr2,F,166485071,166547759,133238844,62688,170544568,21601,5
105373732,LOC105373732,chr2,F,168211338,168213423,133240929,2085,170546653,21602,1
105373733,LOC105373733,chr2,R,168341188,168344168,133243909,2980,170549633,21603,2
105373734,LOC105373734,chr2,R,168344313,168421771,133321367,77458,170627091,21604,7
105373735,LOC105373735,chr2,R,170242360,170249706,133328713,7346,170634437,21605,2
105373736,LOC105373736,chr2,F,170968876,170973258,133333095,4382,170638819,21606,2
105373737,LOC105373737,chr2,R,171244625,171301140,133389610,56515,170695334,21607,7
105373738,LOC105373738,chr2,F,171771783,171793618,133411445,21835,170717169,21608,2
105373739,LOC105373739,chr2,R,171903125,171916801,133425121,13676,170730845,21609,2
105373740,LOC105373740,chr2,R,171916948,171922316,133430489,5368,170736213,21610,2
105373741,LOC105373741,chr2,F,172137372,172153485,133446602,16113,170752326,21611,2
105373742,LOC105373742,chr2,R,172324054,172330554,133453102,6500,170758826,21612,4
105373743,LOC105373743,chr2,R,173291825,173296884,133458161,5059,170763885,21613,3
105373744,LOC105373744,chr2,R,173435474,173446779,133469466,11305,170775190,21614,4
105373745,LOC105373745,chr2,R,173813385,173816126,133472207,2741,170777931,21615,1
105373746,LOC105373746,chr2,R,174060752,174062516,133473971,1764,170779695,21616,2
105373747,LOC105373747,chr2,R,174210409,174213844,133477406,3435,170783130,21617,2
105373748,LOC105373748,chr2,F,174487304,174489311,133479413,2007,170785137,21618,2
105373749,LOC105373749,chr2,F,174649247,174657611,133487777,8364,170793501,21619,2
105373750,LOC105373750,chr2,R,174772903,174782066,133496940,9163,170802664,21620,2
105373751,LOC105373751,chr2,F,175166466,175226558,133557032,60092,170862756,21621,2
105373752,LOC105373752,chr2,F,175454605,175471257,133573684,16652,170879408,21622,2
105373753,LOC105373753,chr2,R,176164163,176168203,133577724,4040,170883448,21623,1
105373754,LOC105373754,chr2,R,176611436,176616503,133582791,5067,170888515,21624,1
105373755,LOC105373755,chr2,F,176495529,176589896,133677158,94367,170982882,21625,3
105373756,LOC105373756,chr2,F,176849009,176862400,133690549,13391,170996273,21626,6
105373757,LOC105373757,chr2,R,176830838,176859854,133719565,29016,171025289,21627,8
105373758,LOC105373758,chr2,F,176892117,176966102,133793550,73985,171099274,21628,6
105373759,LOC105373759,chr2,R,177211393,177226835,133808992,15442,171114716,21629,3
105373760,LOC105373760,chr2,R,177064318,177164600,133909274,100282,171214998,21630,7
105373761,LOC105373761,chr2,R,177032669,177035022,133911627,2353,171217351,21631,1
105373762,LOC105373762,chr2,R,177471906,177476741,133916462,4835,171222186,21632,2
105373763,LOC105373763,chr2,F,177836949,177840285,133919798,3336,171225522,21633,2
105373764,LOC105373764,chr2,F,177702403,177728138,133945533,25735,171251257,21634,3
105373765,LOC105373765,chr2,R,178924630,178927625,133948528,2995,171254252,21635,2
105373766,LOC105373766,chr2,F,178827302,178922667,134043893,95365,171349617,21636,5
105373767,LOC105373767,chr2,R,180116043,180125194,134053044,9151,171358768,21637,3
105373768,LOC105373768,chr2,F,180222896,180224210,134054358,1314,171360082,21638,2
105373769,LOC105373769,chr2,R,180406865,180432380,134079873,25515,171385597,21639,3
105373770,LOC105373770,chr2,R,180566858,180571819,134084834,4961,171390558,21640,3
105373771,LOC105373771,chr2,R,180719966,180724583,134089451,4617,171395175,21641,2
105373772,LOC105373772,chr2,R,180961078,180980199,134108572,19121,171414296,21642,2
105373773,LOC105373773,chr2,R,182643257,182644844,134110159,1587,171415883,21643,2
105373774,LOC105373774,chr2,F,183211205,183215400,134114354,4195,171420078,21644,1
105373775,LOC105373775,chr2,R,184049139,184051402,134116617,2263,171422341,21645,2
105373776,LOC105373776,chr2,R,184278486,184395388,134233519,116902,171539243,21646,7
105373777,LOC105373777,chr2,R,184140726,184204282,134297075,63556,171602799,21647,4
105373778,LOC105373778,chr2,F,184431246,184436490,134302319,5244,171608043,21648,2
105373779,LOC105373779,chr2,F,184461928,184467187,134307578,5259,171613302,21649,4
105373780,LOC105373780,chr2,R,184593626,184598985,134312937,5359,171618661,21650,3
105373781,LOC105373781,chr2,F,185166734,185220392,134366595,53658,171672319,21651,4
105373782,LOC105373782,chr2,R,185011650,185167113,134522058,155463,171827782,21652,5
105373783,LOC105373783,chr2,F,185483052,185509615,134548621,26563,171854345,21653,4
105373784,LOC105373784,chr2,F,186132082,186161648,134578187,29566,171883911,21654,2
105373785,LOC105373785,chr2,R,186421057,186456754,134613884,35697,171919608,21655,2
105373786,LOC105373786,chr2,F,187461501,187549450,134701833,87949,172007557,21656,6
105373787,LOC105373787,chr2,R,187144437,187149713,134707109,5276,172012833,21657,2
105373788,LOC105373788,chr2,F,187803652,187806590,134710047,2938,172015771,21658,2
105373789,LOC105373789,chr2,R,188596509,188600686,134714224,4177,172019948,21659,2
105373790,LOC105373790,chr2,F,188666707,188751299,134798816,84592,172104540,21660,3
105373791,LOC105373791,chr2,R,188966457,188984799,134817158,18342,172122882,21661,2
105373792,LOC105373792,chr2,R,189296073,189298666,134819751,2593,172125475,21662,2
105373793,LOC105373793,chr2,R,189673119,189674826,134821458,1707,172127182,21663,1
105373794,LOC105373794,chr2,R,190129377,190141478,134833559,12101,172139283,21664,5
105373795,LOC105373795,chr2,R,189884557,189921080,134870082,36523,172175806,21665,1
105373796,LOC105373796,chr2,R,189852770,189879498,134896810,26728,172202534,21666,4
105373797,LOC105373797,chr2,F,189823417,189824528,134897921,1111,172203645,21667,1
105373798,LOC105373798,chr2,F,190281194,190282710,134899437,1516,172205161,21668,1
105373799,LOC105373799,chr2,R,190219975,190244880,134924342,24905,172230066,21669,2
105373800,LOC105373800,chr2,R,190342270,190343960,134926032,1690,172231756,21670,1
105373801,LOC105373801,chr2,R,190625329,190649638,134950341,24309,172256065,21671,6
105373802,LOC105373802,chr2,R,190438858,190446113,134957596,7255,172263320,21672,2
105373803,LOC105373803,chr2,R,191320639,191322584,134959541,1945,172265265,21673,2
105373804,LOC105373804,chr2,F,191177888,191207578,134989231,29690,172294955,21674,3
105373805,LOC105373805,chr2,F,191030971,191032314,134990574,1343,172296298,21675,1
105373806,LOC105373806,chr2,F,191020573,191030969,135000970,10396,172306694,21676,2
105373807,LOC105373807,chr2,F,191615025,191637497,135023442,22472,172329166,21677,2
105373808,LOC105373808,chr2,R,191661082,191677906,135040266,16824,172345990,21678,2
105373809,LOC105373809,chr2,F,191646543,191675766,135069489,29223,172375213,21679,2
105373810,LOC105373810,chr2,F,191714480,191720598,135075607,6118,172381331,21680,1
105373811,LOC105373811,chr2,R,191736164,191745498,135084941,9334,172390665,21681,3
105373812,LOC105373812,chr2,F,191779244,191792523,135098220,13279,172403944,21682,2
105373813,LOC105373813,chr2,F,191922930,192046161,135221451,123231,172527175,21683,8
105373814,LOC105373814,chr2,F,192323297,192372952,135271106,49655,172576830,21684,2
105373815,LOC105373815,chr2,R,193949680,193972977,135294403,23297,172600127,21685,3
105373816,LOC105373816,chr2,R,194379600,194386835,135301638,7235,172607362,21686,3
105373817,LOC105373817,chr2,F,195365826,195371228,135307040,5402,172612764,21687,2
105373818,LOC105373818,chr2,R,195569630,195574469,135311879,4839,172617603,21688,2
105373819,LOC105373819,chr2,F,195795936,195801312,135317255,5376,172622979,21689,1
105373820,LOC105373820,chr2,R,196155264,196156431,135318422,1167,172624146,21690,1
105373821,LOC105373821,chr2,F,196457254,196475692,135336860,18438,172642584,21691,4
105373822,LOC105373822,chr2,F,196428252,196437190,135345798,8938,172651522,21692,2
105373823,LOC105373823,chr2,R,196638319,196639539,135347018,1220,172652742,21693,1
105373824,LOC105373824,chr2,F,197311044,197318938,135354912,7894,172660636,21694,3
105373825,LOC105373825,chr2,R,197247107,197249055,135356860,1948,172662584,21695,1
105373826,LOC105373826,chr2,R,197215836,197216865,135357889,1029,172663613,21696,1
105373827,LOC105373827,chr2,F,197818596,197820913,135360206,2317,172665930,21697,1
105373828,LOC105373828,chr2,R,197798212,197810235,135372229,12023,172677953,21698,5
105373829,LOC105373829,chr2,F,198160280,198165781,135377730,5501,172683454,21699,2
105373830,LOC105373830,chr2,F,198562229,198572584,135388085,10355,172693809,21700,2
105373831,LOC105373831,chr2,R,198493307,198772330,135667108,279023,172972832,21701,4
105373832,LOC105373832,chr2,R,199812115,199817697,135672690,5582,172978414,21702,1
105373833,LOC105373833,chr2,R,200086796,200090376,135676270,3580,172981994,21703,2
105373834,LOC105373834,chr2,R,199970637,200174746,135880379,204109,173186103,21704,2
105373835,LOC105373835,chr2,F,200963489,201016352,135933242,52863,173238966,21705,3
105373836,LOC105373836,chr2,R,201105762,201115417,135942897,9655,173248621,21706,2
105373837,LOC105373837,chr2,R,201359682,201364217,135947432,4535,173253156,21707,2
105373838,LOC105373838,chr2,F,201511728,201547908,135983612,36180,173289336,21708,3
105373839,LOC105373839,chr2,F,201754647,201757293,135986258,2646,173291982,21709,1
105373840,LOC105373840,chr2,F,201781051,201782110,135987317,1059,173293041,21710,1
105373841,LOC105373841,chr2,R,202055389,202057408,135989336,2019,173295060,21711,2
105373842,LOC105373842,chr2,R,202178659,202193756,136004433,15097,173310157,21712,2
105373843,LOC105373843,chr2,R,202075409,202149600,136078624,74191,173384348,21713,5
105373844,LOC105373844,chr2,F,203847448,203865146,136096322,17698,173402046,21714,2
105373845,LOC105373845,chr2,F,204473811,204475910,136098421,2099,173404145,21715,3
105373846,LOC105373846,chr2,F,204661812,204663666,136100275,1854,173405999,21716,2
105373847,LOC105373847,chr2,R,205798675,205843342,136144942,44667,173450666,21717,5
105373848,LOC105373848,chr2,R,206094917,206106004,136156029,11087,173461753,21718,2
105373849,LOC105373849,chr2,F,206084252,206086860,136158637,2608,173464361,21719,2
105373850,LOC105373850,chr2,F,206840961,206869493,136187169,28532,173492893,21720,4
105373851,LOC105373851,chr2,F,207334515,207351877,136204531,17362,173510255,21721,3
105373852,LOC105373852,chr2,F,207260431,207271064,136215164,10633,173520888,21722,2
105373853,LOC105373853,chr2,F,207238185,207248433,136225412,10248,173531136,21723,2
105373854,LOC105373854,chr2,F,208064716,208077198,136237894,12482,173543618,21724,3
105373855,LOC105373855,chr2,R,208400917,208406646,136243623,5729,173549347,21725,2
105373856,LOC105373856,chr2,R,208778471,208793803,136258955,15332,173564679,21726,3
105373857,LOC105373857,chr2,R,208757109,208768944,136270790,11835,173576514,21727,2
105373858,LOC105373858,chr2,R,209236048,209280638,136315380,44590,173621104,21728,2
105373859,LOC105373859,chr2,F,210105419,210107520,136317481,2101,173623205,21729,1
105373860,LOC105373860,chr2,R,212706805,212709454,136320130,2649,173625854,21730,1
105373861,LOC105373861,chr2,F,212733154,212750599,136337575,17445,173643299,21731,2
105373862,LOC105373862,chr2,R,212870611,212903415,136370379,32804,173676103,21732,2
105373863,LOC105373863,chr2,R,213155803,213167704,136382280,11901,173688004,21733,3
105373864,LOC105373864,chr2,F,213167786,213174270,136388764,6484,173694488,21734,2
105373865,LOC105373865,chr2,F,214491074,214500502,136398192,9428,173703916,21735,2
105373866,LOC105373866,chr2,R,214336953,214472229,136533468,135276,173839192,21736,2
105373867,LOC105373867,chr2,F,215356854,215364872,136541486,8018,173847210,21737,3
105373868,LOC105373868,chr2,F,215436487,215437119,136542118,632,173847842,21738,1
105373869,LOC105373869,chr2,F,215717968,215720946,136545096,2978,173850820,21739,1
105373870,LOC105373870,chr2,F,215897171,215912688,136560613,15517,173866337,21740,3
105373871,LOC105373871,chr2,R,216558247,216576856,136579222,18609,173884946,21741,4
105373872,LOC105373872,chr2,R,217203344,217220857,136596735,17513,173902459,21742,3
105373873,LOC105373873,chr2,R,217060567,217066968,136603136,6401,173908860,21743,2
105373874,LOC105373874,chr2,F,217035118,217039287,136607305,4169,173913029,21744,2
105373875,LOC105373875,chr2,R,216887925,216889525,136608905,1600,173914629,21745,2
105373876,LOC105373876,chr2,R,216866331,216867813,136610387,1482,173916111,21746,1
105373877,LOC105373877,chr2,F,217259389,217319557,136670555,60168,173976279,21747,12
105373878,LOC105373878,chr2,F,217978762,217993768,136685561,15006,173991285,21748,4
105373879,LOC105373879,chr2,F,217957313,217970141,136698389,12828,174004113,21749,4
105373880,LOC105373880,chr2,F,218316583,218318603,136700409,2020,174006133,21750,1
105373881,LOC105373881,chr2,R,218306388,218322038,136716059,15650,174021783,21751,7
105373882,LOC105373882,chr2,R,218894009,218897041,136719091,3032,174024815,21752,2
105373883,LOC105373883,chr2,R,219362505,219368390,136724976,5885,174030700,21753,1
105373884,LOC105373884,chr2,F,219388353,219403626,136740249,15273,174045973,21754,4
105373885,LOC105373885,chr2,R,219481731,219517047,136775565,35316,174081289,21755,1
105373886,LOC105373886,chr2,F,219730125,219737928,136783368,7803,174089092,21756,1
105373887,LOC105373887,chr2,F,219738825,219745176,136789719,6351,174095443,21757,2
105373888,LOC105373888,chr2,F,219791731,219794499,136792487,2768,174098211,21758,4
105373889,LOC105373889,chr2,R,219903501,219904931,136793917,1430,174099641,21759,2
105373890,LOC105373890,chr2,F,219904936,219940772,136829753,35836,174135477,21760,2
105373891,LOC105373891,chr2,F,219960659,220035183,136904277,74524,174210001,21761,5
105373892,LOC105373892,chr2,F,220067467,220073310,136910120,5843,174215844,21762,3
105373893,LOC105373893,chr2,F,220105802,220451110,137255428,345308,174561152,21763,4
105373894,LOC105373894,chr2,R,220510649,220515136,137259915,4487,174565639,21764,3
105373895,LOC105373895,chr2,F,220568461,220634124,137325578,65663,174631302,21765,3
105373896,LOC105373896,chr2,F,220740284,220798343,137383637,58059,174689361,21766,7
105373897,LOC105373897,chr2,R,221587410,221610365,137406592,22955,174712316,21767,2
105373898,LOC105373898,chr2,R,221655794,221670487,137421285,14693,174727009,21768,2
105373899,LOC105373899,chr2,F,221637528,221738686,137522443,101158,174828167,21769,9
105373900,LOC105373900,chr2,R,221906473,221960848,137576818,54375,174882542,21770,2
105373901,LOC105373901,chr2,F,222221399,222259470,137614889,38071,174920613,21771,3
105373902,LOC105373902,chr2,F,222644911,222650900,137620878,5989,174926602,21772,2
105373903,LOC105373903,chr2,F,222760824,222777844,137637898,17020,174943622,21773,3
105373904,LOC105373904,chr2,R,222917338,222921272,137641832,3934,174947556,21774,2
105373905,LOC105373905,chr2,R,223102613,223112389,137651608,9776,174957332,21775,2
105373906,LOC105373906,chr2,R,223203055,223212133,137660686,9078,174966410,21776,2
105373907,LOC105373907,chr2,F,223489112,223506153,137677727,17041,174983451,21777,3
105373908,LOC105373908,chr2,F,224199293,224204044,137682478,4751,174988202,21778,3
105373909,LOC105373909,chr2,F,224603810,224664957,137743625,61147,175049349,21779,2
105373910,LOC105373910,chr2,F,224678660,224717757,137782722,39097,175088446,21780,2
105373911,LOC105373911,chr2,R,224739007,224742296,137786011,3289,175091735,21781,2
105373912,LOC105373912,chr2,F,224936466,224941418,137790963,4952,175096687,21782,4
105373913,LOC105373913,chr2,R,226284255,226285872,137792580,1617,175098304,21783,2
105373914,LOC105373914,chr2,R,225680560,225748583,137860603,68023,175166327,21784,3
105373915,LOC105373915,chr2,R,226454781,226466774,137872596,11993,175178320,21785,2
105373916,LOC105373916,chr2,F,226799904,226812425,137885117,12521,175190841,21786,3
105373917,LOC105373917,chr2,F,227172054,227176410,137889473,4356,175195197,21787,2
105373918,LOC105373918,chr2,F,227962601,228042985,137969857,80384,175275581,21788,4
105373919,LOC105373919,chr2,F,228716687,228737394,137990564,20707,175296288,21789,3
105373920,LOC105373920,chr2,F,228689336,228716684,138017912,27348,175323636,21790,3
105373921,LOC105373921,chr2,F,228580072,228595870,138033710,15798,175339434,21791,2
105373922,LOC105373922,chr2,R,229249194,229258703,138043219,9509,175348943,21792,1
105373923,LOC105373923,chr2,R,229610190,229612542,138045571,2352,175351295,21793,1
105373924,LOC105373924,chr2,R,229956259,229958999,138048311,2740,175354035,21794,2
105373925,LOC105373925,chr2,R,230385336,230401049,138064024,15713,175369748,21795,6
105373926,LOC105373926,chr2,F,231401612,231408342,138070754,6730,175376478,21796,1
105373927,LOC105373927,chr2,F,231412452,231426537,138084839,14085,175390563,21797,2
105373928,LOC105373928,chr2,F,231611781,231613585,138086643,1804,175392367,21798,1
105373929,LOC105373929,chr2,R,232595381,232610764,138102026,15383,175407750,21799,1
105373930,LOC105373930,chr2,F,233357821,233360222,138104427,2401,175410151,21800,2
105373932,LOC105373932,chr2,F,234200536,234215305,138119196,14769,175424920,21801,3
105373933,LOC105373933,chr2,R,234285402,234301820,138135614,16418,175441338,21802,4
105373934,LOC105373934,chr2,R,234446071,234454606,138144149,8535,175449873,21803,2
105373935,LOC105373935,chr2,F,234438327,234463212,138169034,24885,175474758,21804,2
105373936,LOC105373936,chr2,R,234596553,234632705,138205186,36152,175510910,21805,3
105373937,LOC105373937,chr2,F,234900826,234915106,138219466,14280,175525190,21806,3
105373938,LOC105373938,chr2,F,234932600,234951586,138238452,18986,175544176,21807,5
105373939,LOC105373939,chr2,R,234976939,234978778,138240291,1839,175546015,21808,2
105373940,LOC105373940,chr2,F,235270616,235274228,138243903,3612,175549627,21809,2
105373941,LOC105373941,chr2,R,235379049,235381061,138245915,2012,175551639,21810,2
105373942,LOC105373942,chr2,R,235746384,235790474,138290005,44090,175595729,21811,5
105373943,LOC105373943,chr2,R,235675981,235685021,138299045,9040,175604769,21812,2
105373944,LOC105373944,chr2,R,236161365,236164208,138301888,2843,175607612,21813,2
105373945,LOC105373945,chr2,F,236337817,236356131,138320202,18314,175625926,21814,3
105373946,LOC105373946,chr2,R,236603141,236604117,138321178,976,175626902,21815,2
105373947,LOC105373947,chr2,F,236604265,236609360,138326273,5095,175631997,21816,2
105373948,LOC105373948,chr2,R,236731522,236743517,138338268,11995,175643992,21817,5
105373949,LOC105373949,chr2,F,236774138,236780767,138344897,6629,175650621,21818,3
105373950,LOC105373950,chr2,F,237062648,237066802,138349051,4154,175654775,21819,1
105373951,LOC105373951,chr2,R,236953635,236980061,138375477,26426,175681201,21820,3
105373952,LOC105373952,chr2,F,237145832,237152822,138382467,6990,175688191,21821,3
105373953,LOC105373953,chr2,F,237213737,237257644,138426374,43907,175732098,21822,7
105373954,LOC105373954,chr2,R,237290279,237297921,138434016,7642,175739740,21823,3
105373955,LOC105373955,chr2,R,237421419,237434822,138447419,13403,175753143,21824,5
105373956,LOC105373956,chr2,R,237536038,237548656,138460037,12618,175765761,21825,1
105373957,LOC105373957,chr2,R,237485699,237487338,138461676,1639,175767400,21826,2
105373958,LOC105373958,chr2,F,237592955,237595972,138464693,3017,175770417,21827,1
105373959,LOC105373959,chr2,R,237676757,237691882,138479818,15125,175785542,21828,4
105373960,LOC105373960,chr2,R,237922332,237934197,138491683,11865,175797407,21829,2
105373961,LOC105373961,chr2,R,238298475,238300271,138493479,1796,175799203,21830,2
105373962,LOC105373962,chr2,F,238720323,238744084,138517240,23761,175822964,21831,2
105373963,LOC105373963,chr2,R,238707847,238722612,138532005,14765,175837729,21832,4
105373964,LOC105373964,chr2,R,238692526,238697520,138536999,4994,175842723,21833,2
105373965,LOC105373965,chr2,F,239299120,239303601,138541480,4481,175847204,21834,1
105373966,LOC105373966,chr2,F,239656420,239662405,138547465,5985,175853189,21835,2
105373967,LOC105373967,chr2,F,239728452,239731002,138550015,2550,175855739,21836,1
105373968,LOC105373968,chr2,R,240252143,240256455,138554327,4312,175860051,21837,1
105373969,LOC105373969,chr2,R,240857206,240870637,138567758,13431,175873482,21838,3
105373970,LOC105373970,chr2,R,241007451,241033724,138594031,26273,175899755,21839,5
105373971,LOC105373971,chr2,R,241167274,241188369,138615126,21095,175920850,21840,2
105373972,LOC105373972,chr2,F,241108800,241111925,138618251,3125,175923975,21841,1
105373973,LOC105373973,chr2,R,241360877,241372559,138629933,11682,175935657,21842,4
105373974,LOC105373974,chr2,R,241546657,241549970,138633246,3313,175938970,21843,2
105373975,LOC105373975,chr2,R,241574994,241577204,138635456,2210,175941180,21844,1
105373976,LOC105373976,chr2,F,241769783,241772524,138638197,2741,175943921,21845,1
105373977,LOC105373977,chr2,F,241852951,241856276,138641522,3325,175947246,21846,1
105373978,LOC105373978,chr2,R,241879040,241881306,138643788,2266,175949512,21847,2
105373979,LOC105373979,chr2,R,242047625,242084592,138680755,36967,175986479,21848,6
105373980,LOC105373980,chr2,R,242037223,242042233,138685765,5010,175991489,21849,2
105373981,LOC105373981,chr2,R,242143860,242155858,138697763,11998,176003487,21850,1
105373982,LOC105373982,chr2,F,96869181,96870390,138698972,1209,176004696,21851,1
105373983,LOC105373983,chr2,F,97091740,97100360,138707592,8620,176013316,21852,3
105373984,LOC105373984,chr2,F,105142925,105145520,138710187,2595,176015911,21853,2
105373985,LOC105373985,chr2,R,110022299,110029293,138717181,6994,176022905,21854,7
105373986,LOC105373986,chr2,R,110041482,110055097,138730796,13615,176036520,21855,9
105373987,LOC105373987,chr2,F,111700613,111722334,138752517,21721,176058241,21856,9
105373988,LOC105373988,chr2,R,118077310,118088892,138764099,11582,176069823,21857,2
105373989,LOC105373989,chr2,F,120328665,120346060,138781494,17395,176087218,21858,2
105373990,LOC105373990,chr2,F,121610401,121649344,138820437,38943,176126161,21859,3
105373991,LOC105373991,chr2,F,236553698,236569257,138835996,15559,176141720,21860,4
105374316,LOC105374316,chr2,F,21070939,21100195,138865252,29256,176170976,21861,3
105374317,LOC105374317,chr2,F,21265965,21285701,138884988,19736,176190712,21862,2
105374318,LOC105374318,chr2,F,21317681,21321008,138888315,3327,176194039,21863,1
105374319,LOC105374319,chr2,F,21845474,21913178,138956019,67704,176261743,21864,2
105374320,LOC105374320,chr2,F,21951655,21980652,138985016,28997,176290740,21865,4
105374321,LOC105374321,chr2,R,22192842,22228925,139021099,36083,176326823,21866,2
105374322,LOC105374322,chr2,R,22390133,22544763,139175729,154630,176481453,21867,6
105374323,LOC105374323,chr2,R,23357526,23381923,139200126,24397,176505850,21868,4
105374324,LOC105374324,chr2,F,23811282,23828566,139217410,17284,176523134,21869,2
105374325,LOC105374325,chr2,R,23501924,23524344,139239830,22420,176545554,21870,1
105374326,LOC105374326,chr2,R,23441549,23467457,139265738,25908,176571462,21871,2
105374328,LOC105374328,chr2,R,24165999,24174833,139274572,8834,176580296,21872,5
105374329,LOC105374329,chr2,F,24404027,24412395,139282940,8368,176588664,21873,3
105374330,LOC105374330,chr2,F,24766163,24767963,139284740,1800,176590464,21874,1
105374331,LOC105374331,chr2,R,25685018,25690713,139290435,5695,176596159,21875,2
105374332,LOC105374332,chr2,R,25724082,25725529,139291882,1447,176597606,21876,2
105374333,LOC105374333,chr2,F,26046328,26093870,139339424,47542,176645148,21877,3
105374334,LOC105374334,chr2,F,26298655,26310607,139351376,11952,176657100,21878,4
105374337,LOC105374337,chr2,R,26950440,26965072,139366008,14632,176671732,21879,2
105374363,LOC105374363,chr2,F,27356738,27367501,139376771,10763,176682495,21880,2
105374369,LOC105374369,chr2,F,27942454,27943504,139377821,1050,176683545,21881,1
105374378,LOC105374378,chr2,F,27716067,27761921,139423675,45854,176729399,21882,9
105374381,LOC105374381,chr2,F,28348957,28350574,139425292,1617,176731016,21883,2
105374382,LOC105374382,chr2,F,28358010,28365746,139433028,7736,176738752,21884,3
105374383,LOC105374383,chr2,F,28377354,28387129,139442803,9775,176748527,21885,2
105374384,LOC105374384,chr2,R,28678454,28683308,139447657,4854,176753381,21886,2
105374385,LOC105374385,chr2,F,29063826,29088122,139471953,24296,176777677,21887,2
105374386,LOC105374386,chr2,R,29088775,29097607,139480785,8832,176786509,21888,2
105374389,LOC105374389,chr2,R,29474735,29475449,139481499,714,176787223,21889,1
105374405,LOC105374405,chr2,F,30164208,30207730,139525021,43522,176830745,21890,3
105374414,LOC105374414,chr2,R,30177190,30191224,139539055,14034,176844779,21891,3
105374435,LOC105374435,chr2,F,30823451,30835366,139550970,11915,176856694,21892,3
105374446,LOC105374446,chr2,R,30861068,30879094,139568996,18026,176874720,21893,2
105374448,LOC105374448,chr2,R,30898689,30899514,139569821,825,176875545,21894,1
105374449,LOC105374449,chr2,R,31773852,31803056,139599025,29204,176904749,21895,4
105374450,LOC105374450,chr2,R,31855214,31865811,139609622,10597,176915346,21896,1
105374451,LOC105374451,chr2,R,31956452,31968268,139621438,11816,176927162,21897,2
105374452,LOC105374452,chr2,R,32625001,32626671,139623108,1670,176928832,21898,2
105374453,LOC105374453,chr2,R,32885987,32903087,139640208,17100,176945932,21899,2
105374454,LOC105374454,chr2,R,33555044,33557450,139642614,2406,176948338,21900,1
105374455,LOC105374455,chr2,F,33600612,33656498,139698500,55886,177004224,21901,8
105374456,LOC105374456,chr2,R,34047950,34067084,139717634,19134,177023358,21902,2
105374457,LOC105374457,chr2,R,34306287,34343658,139755005,37371,177060729,21903,5
105374458,LOC105374458,chr2,R,34702782,34736518,139788741,33736,177094465,21904,4
105374459,LOC105374459,chr2,R,34598069,34618578,139809250,20509,177114974,21905,6
105374460,LOC105374460,chr2,R,34943765,34990735,139856220,46970,177161944,21906,2
105374461,LOC105374461,chr2,R,34998266,35068525,139926479,70259,177232203,21907,3
105374462,LOC105374462,chr2,F,36365956,36378814,139939337,12858,177245061,21908,1
105374463,LOC105374463,chr2,F,37211090,37216193,139944440,5103,177250164,21909,3
105374464,LOC105374464,chr2,F,37455123,37613081,140102398,157958,177408122,21910,9
105374465,LOC105374465,chr2,R,37719543,37737598,140120453,18055,177426177,21911,2
105374466,LOC105374466,chr2,R,38112990,38121988,140129451,8998,177435175,21912,2
105374467,LOC105374467,chr2,R,38269092,38272203,140132562,3111,177438286,21913,2
105374468,LOC105374468,chr2,F,38408941,38411923,140135544,2982,177441268,21914,2
105374469,LOC105374469,chr2,R,38694894,38733550,140174200,38656,177479924,21915,2
105374470,LOC105374470,chr2,F,38836369,38850121,140187952,13752,177493676,21916,2
105374471,LOC105374471,chr2,R,38935828,38953511,140205635,17683,177511359,21917,4
105374472,LOC105374472,chr2,F,40592102,40602796,140216329,10694,177522053,21918,2
105374473,LOC105374473,chr2,R,40617528,40620321,140219122,2793,177524846,21919,2
105374475,LOC105374475,chr2,R,40633255,40639622,140225489,6367,177531213,21920,2
105374491,LOC105374491,chr2,F,40717275,40732352,140240566,15077,177546290,21921,3
105374497,LOC105374497,chr2,R,40686109,40970267,140524724,284158,177830448,21922,4
105374506,LOC105374506,chr2,R,41418927,41760081,140865878,341154,178171602,21923,4
105374517,LOC105374517,chr2,R,41983355,41987312,140869835,3957,178175559,21924,3
105374531,LOC105374531,chr2,R,42083473,42097793,140884155,14320,178189879,21925,1
105374537,LOC105374537,chr2,R,42413740,42425087,140895502,11347,178201226,21926,2
105374543,LOC105374543,chr2,R,42335558,42346725,140906669,11167,178212393,21927,2
105374555,LOC105374555,chr2,R,42582315,42623401,140947755,41086,178253479,21928,6
105374567,LOC105374567,chr2,F,42808518,42971692,141110929,163174,178416653,21929,7
105374568,LOC105374568,chr2,R,42920434,42922943,141113438,2509,178419162,21930,2
105374569,LOC105374569,chr2,R,42972721,43022358,141163075,49637,178468799,21931,5
105374570,LOC105374570,chr2,F,43127569,43132357,141167863,4788,178473587,21932,3
105374571,LOC105374571,chr2,F,43774156,43774992,141168699,836,178474423,21933,1
105374572,LOC105374572,chr2,F,44490729,44493731,141171701,3002,178477425,21934,2
105374573,LOC105374573,chr2,F,44816971,44822357,141177087,5386,178482811,21935,2
105374574,LOC105374574,chr2,F,45002563,45004868,141179392,2305,178485116,21936,2
105374575,LOC105374575,chr2,R,45304937,45311582,141186037,6645,178491761,21937,2
105374576,LOC105374576,chr2,F,45207539,45209655,141188153,2116,178493877,21938,2
105374577,LOC105374577,chr2,F,45323516,45338630,141203267,15114,178508991,21939,4
105374578,LOC105374578,chr2,F,45963409,45965365,141205223,1956,178510947,21940,1
105374579,LOC105374579,chr2,F,45786144,45788599,141207678,2455,178513402,21941,3
105374580,LOC105374580,chr2,R,45674700,45675476,141208454,776,178514178,21942,1
105374581,LOC105374581,chr2,R,46251662,46256777,141213569,5115,178519293,21943,2
105374582,LOC105374582,chr2,R,46392285,46394232,141215516,1947,178521240,21944,2
105374583,LOC105374583,chr2,R,46291677,46338138,141261977,46461,178567701,21945,2
105374584,LOC105374584,chr2,F,46636407,46655968,141281538,19561,178587262,21946,3
105374585,LOC105374585,chr2,F,46675846,46682929,141288621,7083,178594345,21947,2
105374586,LOC105374586,chr2,F,46863533,46875320,141300408,11787,178606132,21948,1
105374587,LOC105374587,chr2,F,46777784,46781473,141304097,3689,178609821,21949,1
105374588,LOC105374588,chr2,F,47218129,47221349,141307317,3220,178613041,21950,1
105374589,LOC105374589,chr2,F,47755587,47760444,141312174,4857,178617898,21951,4
105374590,LOC105374590,chr2,F,47914337,47915783,141313620,1446,178619344,21952,2
105374591,LOC105374591,chr2,R,47924437,48004929,141394112,80492,178699836,21953,4
105374592,LOC105374592,chr2,F,47926498,47937881,141405495,11383,178711219,21954,2
105374593,LOC105374593,chr2,R,48108947,48314501,141611049,205554,178916773,21955,4
105374594,LOC105374594,chr2,F,48799304,48815072,141626817,15768,178932541,21956,4
105374595,LOC105374595,chr2,F,49307721,49413132,141732228,105411,179037952,21957,3
105374596,LOC105374596,chr2,F,52370605,52389837,141751460,19232,179057184,21958,2
105374597,LOC105374597,chr2,R,51976709,51984284,141759035,7575,179064759,21959,3
105374598,LOC105374598,chr2,R,52691302,52698089,141765822,6787,179071546,21960,2
105374599,LOC105374599,chr2,F,52713263,52717040,141769599,3777,179075323,21961,2
105374600,LOC105374600,chr2,R,53579790,53603408,141793217,23618,179098941,21962,3
105374601,LOC105374601,chr2,R,53604279,53606080,141795018,1801,179100742,21963,2
105374603,LOC105374603,chr2,R,53818164,53838667,141815521,20503,179121245,21964,2
105374610,LOC105374610,chr2,R,54269192,54278557,141824886,9365,179130610,21965,2
105374611,LOC105374611,chr2,F,54146526,54149618,141827978,3092,179133702,21966,2
105374615,LOC105374615,chr2,F,54106302,54108991,141830667,2689,179136391,21967,1
105374632,LOC105374632,chr2,R,54581658,54584999,141834008,3341,179139732,21968,2
105374640,LOC105374640,chr2,R,54515825,54558211,141876394,42386,179182118,21969,7
105374653,LOC105374653,chr2,F,54674381,54684908,141886921,10527,179192645,21970,2
105374662,LOC105374662,chr2,F,55080229,55086883,141893575,6654,179199299,21971,2
105374667,LOC105374667,chr2,R,54747102,54750515,141896988,3413,179202712,21972,2
105374674,LOC105374674,chr2,R,55142271,55170440,141925157,28169,179230881,21973,4
105374679,LOC105374679,chr2,F,55824157,55874935,141975935,50778,179281659,21974,2
105374690,LOC105374690,chr2,F,55945823,56177552,142207664,231729,179513388,21975,8
105374697,LOC105374697,chr2,F,57720806,57726143,142213001,5337,179518725,21976,2
105374726,LOC105374726,chr2,R,57916337,58047296,142343960,130959,179649684,21977,8
105374744,LOC105374744,chr2,F,58276111,58296797,142364646,20686,179670370,21978,4
105374754,LOC105374754,chr2,R,59238393,59388349,142514602,149956,179820326,21979,7
105374755,LOC105374755,chr2,F,60264917,60269545,142519230,4628,179824954,21980,1
105374756,LOC105374756,chr2,R,60334398,60353073,142537905,18675,179843629,21981,6
105374757,LOC105374757,chr2,F,60470080,60472959,142540784,2879,179846508,21982,2
105374758,LOC105374758,chr2,R,61151432,61162483,142551835,11051,179857559,21983,1
105374759,LOC105374759,chr2,R,61129404,61140184,142562615,10780,179868339,21984,2
105374760,LOC105374760,chr2,F,61793508,61798714,142567821,5206,179873545,21985,1
105374761,LOC105374761,chr2,F,62264242,62275531,142579110,11289,179884834,21986,2
105374762,LOC105374762,chr2,R,62535871,62538475,142581714,2604,179887438,21987,2
105374763,LOC105374763,chr2,R,62540905,62662834,142703643,121929,180009367,21988,15
105374764,LOC105374764,chr2,F,62665818,62673770,142711595,7952,180017319,21989,2
105374765,LOC105374765,chr2,R,63881419,63884684,142714860,3265,180020584,21990,1
105374766,LOC105374766,chr2,F,63859208,63868699,142724351,9491,180030075,21991,2
105374767,LOC105374767,chr2,F,63975788,63992698,142741261,16910,180046985,21992,2
105374768,LOC105374768,chr2,R,64302868,64341706,142780099,38838,180085823,21993,2
105374769,LOC105374769,chr2,R,64330483,64332803,142782419,2320,180088143,21994,2
105374770,LOC105374770,chr2,R,64438585,64445588,142789422,7003,180095146,21995,2
105374771,LOC105374771,chr2,R,64395431,64437171,142831162,41740,180136886,21996,7
105374772,LOC105374772,chr2,R,64581256,64607175,142857081,25919,180162805,21997,3
105374773,LOC105374773,chr2,R,64537399,64557556,142877238,20157,180182962,21998,2
105374774,LOC105374774,chr2,F,64484673,64501651,142894216,16978,180199940,21999,2
105374775,LOC105374775,chr2,F,64644434,64647690,142897472,3256,180203196,22000,1
105374776,LOC105374776,chr2,F,64788892,64797081,142905661,8189,180211385,22001,4
105374777,LOC105374777,chr2,R,64761383,64768186,142912464,6803,180218188,22002,4
105374778,LOC105374778,chr2,R,65044711,65056197,142923950,11486,180229674,22003,3
105374779,LOC105374779,chr2,R,65070700,65082529,142935779,11829,180241503,22004,1
105374780,LOC105374780,chr2,R,65442461,65456524,142949842,14063,180255566,22005,4
105374781,LOC105374781,chr2,R,65487254,65519262,142981850,32008,180287574,22006,3
105374782,LOC105374782,chr2,R,66227792,66236237,142990295,8445,180296019,22007,2
105374783,LOC105374783,chr2,F,66336463,66360141,143013973,23678,180319697,22008,2
105374784,LOC105374784,chr2,R,66441475,66448980,143021478,7505,180327202,22009,2
105374785,LOC105374785,chr2,R,66965144,67015104,143071438,49960,180377162,22010,2
105374786,LOC105374786,chr2,R,67553909,67564516,143082045,10607,180387769,22011,5
105374787,LOC105374787,chr2,F,67549147,67551853,143084751,2706,180390475,22012,2
105374788,LOC105374788,chr2,R,67522672,67543548,143105627,20876,180411351,22013,2
105374789,LOC105374789,chr2,R,68088913,68111556,143128270,22643,180433994,22014,2
105374790,LOC105374790,chr2,R,68750612,68763013,143140671,12401,180446395,22015,2
105374791,LOC105374791,chr2,R,68831187,68837207,143146691,6020,180452415,22016,2
105374792,LOC105374792,chr2,R,68875540,68882029,143153180,6489,180458904,22017,3
105374793,LOC105374793,chr2,F,70418958,70441467,143175689,22509,180481413,22018,2
105374794,LOC105374794,chr2,F,70673290,70680753,143183152,7463,180488876,22019,2
105374795,LOC105374795,chr2,R,70973539,70984116,143193729,10577,180499453,22020,2
105374796,LOC105374796,chr2,F,71000445,71002934,143196218,2489,180501942,22021,1
105374797,LOC105374797,chr2,R,71258261,71276445,143214402,18184,180520126,22022,2
105374798,LOC105374798,chr2,R,72010399,72033799,143237802,23400,180543526,22023,2
105374799,LOC105374799,chr2,F,72172113,72176272,143241961,4159,180547685,22024,1
105374800,LOC105374800,chr2,R,73053328,73055511,143244144,2183,180549868,22025,1
105374801,LOC105374801,chr2,F,73113110,73113833,143244867,723,180550591,22026,1
105374802,LOC105374802,chr2,R,73305945,73307875,143246797,1930,180552521,22027,1
105374803,LOC105374803,chr2,F,73307969,73316078,143254906,8109,180560630,22028,1
105374804,LOC105374804,chr2,R,73352366,73385681,143288221,33315,180593945,22029,3
105374805,LOC105374805,chr2,R,73613838,73626560,143300943,12722,180606667,22030,2
105374806,LOC105374806,chr2,R,73844798,73858028,143314173,13230,180619897,22031,2
105374807,LOC105374807,chr2,R,73820774,73830838,143324237,10064,180629961,22032,3
105374808,LOC105374808,chr2,F,74701695,74708947,143331489,7252,180637213,22033,2
105374809,LOC105374809,chr2,R,74928261,74932595,143335823,4334,180641547,22034,1
105374810,LOC105374810,chr2,F,75345229,75348373,143338967,3144,180644691,22035,4
105374811,LOC105374811,chr2,F,75146352,75279139,143471754,132787,180777478,22036,4
105374812,LOC105374812,chr2,F,75153942,75189220,143507032,35278,180812756,22037,1
105374813,LOC105374813,chr2,F,75710959,75752096,143548169,41137,180853893,22038,2
105374814,LOC105374814,chr2,F,76506880,76589939,143631228,83059,180936952,22039,3
105374815,LOC105374815,chr2,F,76854859,76859183,143635552,4324,180941276,22040,2
105374816,LOC105374816,chr2,R,77987875,77999030,143646707,11155,180952431,22041,2
105374817,LOC105374817,chr2,R,77924541,77955034,143677200,30493,180982924,22042,9
105374818,LOC105374818,chr2,R,78409493,78542064,143809771,132571,181115495,22043,2
105374819,LOC105374819,chr2,R,78558149,78570361,143821983,12212,181127707,22044,3
105374820,LOC105374820,chr2,F,78542134,78566088,143845937,23954,181151661,22045,3
105374821,LOC105374821,chr2,F,78786133,78791332,143851136,5199,181156860,22046,2
105374822,LOC105374822,chr2,R,78900474,78931140,143881802,30666,181187526,22047,4
105374823,LOC105374823,chr2,R,79269924,79292856,143904734,22932,181210458,22048,6
105374824,LOC105374824,chr2,R,80343395,80364019,143925358,20624,181231082,22049,2
105374825,LOC105374825,chr2,R,80028005,80035348,143932701,7343,181238425,22050,3
105374826,LOC105374826,chr2,F,79762193,79778096,143948604,15903,181254328,22051,2
105374827,LOC105374827,chr2,R,80912463,80955011,143991152,42548,181296876,22052,3
105374828,LOC105374828,chr2,R,81708831,81709753,143992074,922,181297798,22053,1
105374829,LOC105374829,chr2,F,81868768,81895284,144018590,26516,181324314,22054,5
105374830,LOC105374830,chr2,F,82408594,82424499,144034495,15905,181340219,22055,2
105374831,LOC105374831,chr2,F,82825992,82832960,144041463,6968,181347187,22056,2
105374832,LOC105374832,chr2,R,82882459,82937536,144096540,55077,181402264,22057,2
105374833,LOC105374833,chr2,R,83256588,83293509,144133461,36921,181439185,22058,2
105374834,LOC105374834,chr2,F,83518673,83541904,144156692,23231,181462416,22059,4
105374836,LOC105374836,chr2,R,84901642,84907108,144162158,5466,181467882,22060,1
105374837,LOC105374837,chr2,F,84888974,84902938,144176122,13964,181481846,22061,2
105374838,LOC105374838,chr2,F,84926030,84964294,144214386,38264,181520110,22062,3
105374839,LOC105374839,chr2,F,85242034,85253179,144225531,11145,181531255,22063,3
105374840,LOC105374840,chr2,R,85389023,85390209,144226717,1186,181532441,22064,1
105374841,LOC105374841,chr2,F,85413991,85416576,144229302,2585,181535026,22065,2
105374842,LOC105374842,chr2,F,85681346,85683560,144231516,2214,181537240,22066,2
105374843,LOC105374843,chr2,R,85982593,85998113,144247036,15520,181552760,22067,2
105374844,LOC105374844,chr2,R,86409954,86440973,144278055,31019,181583779,22068,2
105374845,LOC105374845,chr2,F,86562067,86620173,144336161,58106,181641885,22069,1
105374846,LOC105374846,chr2,F,86795301,86822306,144363166,27005,181668890,22070,3
105374847,LOC105374847,chr2,R,87249071,87253878,144367973,4807,181673697,22071,1
105374848,LOC105374848,chr2,R,87319418,87323434,144371989,4016,181677713,22072,1
105374851,LOC105374851,chr2,F,87990653,87991283,144372619,630,181678343,22073,1
105374852,LOC105374852,chr2,F,88016790,88021354,144377183,4564,181682907,22074,3
105374853,LOC105374853,chr2,R,88714477,88723820,144386526,9343,181692250,22075,2
105374854,LOC105374854,chr2,F,88813828,88829980,144402678,16152,181708402,22076,4
105374855,LOC105374855,chr2,R,88810390,88825340,144417628,14950,181723352,22077,2
105374856,LOC105374856,chr2,R,88853975,88855610,144419263,1635,181724987,22078,1
105374857,LOC105374857,chr2,F,89100402,89101843,144420704,1441,181726428,22079,2
105374858,LOC105374858,chr2,F,89034561,89039896,144426039,5335,181731763,22080,5
105374859,LOC105374859,chr2,F,88966813,88989684,144448910,22871,181754634,22081,4
105374860,LOC105374860,chr2,F,38075386,38095569,144469093,20183,181774817,22082,1
105374861,LOC105374861,chr2,R,39148211,39150198,144471080,1987,181776804,22083,2
105374862,LOC105374862,chr2,F,89843624,89850844,144478300,7220,181784024,22084,2
105374863,LOC105374863,chr2,R,90126274,90133710,144485736,7436,181791460,22085,2
105374866,LOC105374866,chr2,F,90245394,90250362,144490704,4968,181796428,22086,2
105374867,LOC105374867,chr2,R,91561594,91571328,144500438,9734,181806162,22087,2
105374868,LOC105374868,chr2,F,91769213,91774850,144506075,5637,181811799,22088,2
105377625,LOC105377625,chr2,F,22198762,22199227,144506540,465,181812264,22089,1
105377626,LOC105377626,chr2,R,24832079,24834476,144508937,2397,181814661,22090,1
105377627,LOC105377627,chr2,R,51332724,51342650,144518863,9926,181824587,22091,2
105377628,LOC105377628,chr2,R,57782224,57785883,144522522,3659,181828246,22092,2
105377629,LOC105377629,chr2,R,57706582,57711600,144527540,5018,181833264,22093,2
105377630,LOC105377630,chr2,R,57694906,57705174,144537808,10268,181843532,22094,4
105377631,LOC105377631,chr2,R,57536145,57551728,144553391,15583,181859115,22095,2
105377632,LOC105377632,chr2,R,57289875,57886242,145149758,596367,182455482,22096,7
105377633,LOC105377633,chr2,F,61471392,61471845,145150211,453,182455935,22097,1
105377634,LOC105377634,chr2,R,64488747,64506810,145168274,18063,182473998,22098,3
105377635,LOC105377635,chr2,F,87349151,87353057,145172180,3906,182477904,22099,2
105377636,LOC105377636,chr2,F,88897956,88905372,145179596,7416,182485320,22100,2
105377637,LOC105377637,chr2,F,23382826,23402338,145199108,19512,182504832,22101,7
105377638,LOC105377638,chr2,F,87406252,87411116,145203972,4864,182509696,22102,4
105377639,LOC105377639,chr2,F,87411883,87422883,145214972,11000,182520696,22103,5
105378957,LOC105378957,chr2,R,91498318,91506909,145223563,8591,182529287,22104,3
105378958,LOC105378958,chr2,R,91507531,91513275,145229307,5744,182535031,22105,5
105379432,LOC105379432,chr2,R,89647371,89649440,145231376,2069,182537100,22106,1
105379433,LOC105379433,chr2,F,89661729,89683251,145252898,21522,182558622,22107,4
100,ADA,chr20,R,44619521,44652233,32712,32712,182591334,22108,12
146,ADRA1D,chr20,R,4220630,4249012,61094,28382,182619716,22109,1
182,JAG1,chr20,R,10637683,10674046,97457,36363,182656079,22110,25
191,AHCY,chr20,R,34234839,34311976,174594,77137,182733216,22111,15
434,ASIP,chr20,F,34186492,34269344,257446,82852,182816068,22112,7
514,ATP5E,chr20,R,59028677,59032367,261136,3690,182819758,22113,2
551,AVP,chr20,R,3082554,3093521,272103,10967,182830725,22114,3
598,BCL2L1,chr20,R,31664451,31723964,331616,59513,182890238,22115,7
631,BFSP1,chr20,R,17493904,17569220,406932,75316,182965554,22116,13
650,BMP2,chr20,F,6767693,6780263,419502,12570,182978124,22117,2
655,BMP7,chr20,R,57168752,57266651,517401,97899,183076023,22118,6
671,BPI,chr20,F,38304149,38337505,550757,33356,183109379,22119,15
955,ENTPD6,chr20,F,25195669,25226724,581812,31055,183140434,22120,16
958,CD40,chr20,F,46118249,46129745,593308,11496,183151930,22121,8
994,CDC25B,chr20,F,3786771,3806121,612658,19350,183171280,22122,17
1002,CDH4,chr20,F,61252425,61940617,1300850,688192,183859472,22123,17
1051,CEBPB,chr20,F,50190582,50192690,1302958,2108,183861580,22124,0
1059,CENPB,chr20,R,3783850,3786690,1305798,2840,183864420,22125,0
1114,CHGB,chr20,F,5911327,5925361,1319832,14034,183878454,22126,4
1137,CHRNA4,chr20,R,63343309,63361396,1337919,18087,183896541,22127,6
1299,COL9A3,chr20,F,62817061,62841159,1362017,24098,183920639,22128,33
1434,CSE1L,chr20,F,49046245,49096960,1412732,50715,183971354,22129,24
1457,CSNK2A1,chr20,R,472968,543838,1483602,70870,184042224,22130,15
1469,CST1,chr20,R,23747552,23750937,1486987,3385,184045609,22131,2
1470,CST2,chr20,R,23823766,23826675,1489896,2909,184048518,22132,2
1471,CST3,chr20,R,23627896,23638048,1500048,10152,184058670,22133,3
1472,CST4,chr20,R,23685639,23689025,1503434,3386,184062056,22134,2
1473,CST5,chr20,R,23875934,23879743,1507243,3809,184065865,22135,2
1477,CSTF1,chr20,F,56392370,56404526,1519399,12156,184078021,22136,5
1522,CTSZ,chr20,R,58995186,59007254,1531467,12068,184090089,22137,5
1591,CYP24A1,chr20,R,54153448,54173985,1552004,20537,184110626,22138,11
1789,DNMT3B,chr20,F,32762384,32809356,1598976,46972,184157598,22139,23
1869,E2F1,chr20,R,33675485,33686404,1609895,10919,184168517,22140,6
1908,EDN3,chr20,F,59300423,59325992,1635464,25569,184194086,22141,5
1917,EEF1A2,chr20,R,63488011,63499315,1646768,11304,184205390,22142,7
2036,EPB41L1,chr20,F,36064890,36232799,1814677,167909,184373299,22143,36
2139,EYA2,chr20,F,46894623,47188844,2108898,294221,184667520,22144,16
2280,FKBP1A,chr20,R,1368976,1393172,2133094,24196,184691716,22145,9
2307,FOXS1,chr20,R,31844299,31845617,2134412,1318,184693034,22146,0
2686,GGT7,chr20,R,34844719,34872858,2162551,28139,184721173,22147,17
2691,GHRH,chr20,R,37251064,37261878,2173365,10814,184731987,22148,7
2778,GNAS,chr20,F,58839739,58911195,2244821,71456,184803443,22149,15
2797,GNRH2,chr20,F,3039060,3045860,2251621,6800,184810243,22150,4
2832,NPBWR2,chr20,R,64105829,64106831,2252623,1002,184811245,22151,0
2937,GSS,chr20,R,34928432,34955992,2280183,27560,184838805,22152,14
3055,HCK,chr20,F,32052187,32101856,2329852,49669,184888474,22153,14
3170,FOXA2,chr20,R,22581003,22585463,2334312,4460,184892934,22154,4
3172,HNF4A,chr20,F,44355800,44432845,2411357,77045,184969979,22155,12
3397,ID1,chr20,F,31605282,31606515,2412590,1233,184971212,22156,0
3420,IDH3B,chr20,R,2658393,2664219,2418416,5826,184977038,22157,12
3642,INSM1,chr20,F,20368120,20370949,2421245,2829,184979867,22158,0
3692,EIF6,chr20,R,35278905,35284816,2427156,5911,184985778,22159,5
3704,ITPA,chr20,F,3208867,3227449,2445738,18582,185004360,22160,11
3745,KCNB1,chr20,R,49363876,49484042,2565904,120166,185124526,22161,3
3755,KCNG1,chr20,R,51003655,51023176,2585425,19521,185144047,22162,4
3785,KCNQ2,chr20,R,63400207,63472640,2657858,72433,185216480,22163,20
3787,KCNS1,chr20,R,45092071,45101112,2666899,9041,185225521,22164,4
3911,LAMA5,chr20,R,62309059,62367320,2725160,58261,185283782,22165,80
3929,LBP,chr20,F,38346410,38377011,2755761,30601,185314383,22166,14
4159,MC3R,chr20,F,56248731,56249815,2756845,1084,185315467,22167,0
4318,MMP9,chr20,F,46008907,46016561,2764499,7654,185323121,22168,12
4605,MYBL2,chr20,F,43667018,43716496,2813977,49478,185372599,22169,13
4661,MYT1,chr20,F,64164473,64242253,2891757,77780,185450379,22170,22
4773,NFATC2,chr20,R,51386956,51562858,3067659,175902,185626281,22171,12
4821,NKX2-2,chr20,R,21499259,21514026,3082426,14767,185641048,22172,4
4826,NNAT,chr20,F,37521204,37523690,3084912,2486,185643534,22173,2
4923,NTSR1,chr20,F,62708782,62762771,3138901,53989,185697523,22174,3
4987,OPRL1,chr20,F,64080117,64100643,3159427,20526,185718049,22175,6
5020,OXT,chr20,F,3068870,3072517,3163074,3647,185721696,22176,3
5075,PAX1,chr20,F,21705658,21718486,3175902,12828,185734524,22177,4
5105,PCK1,chr20,F,57561080,57566461,3181283,5381,185739905,22178,9
5111,PCNA,chr20,R,5114952,5126622,3192953,11670,185751575,22179,6
5126,PCSK2,chr20,F,17226106,17484578,3451425,258472,186010047,22180,12
5173,PDYN,chr20,R,1978755,1994285,3466955,15530,186025577,22181,8
5203,PFDN4,chr20,F,54207962,54219953,3478946,11991,186037568,22182,3
5266,PI3,chr20,F,45174898,45176544,3480592,1646,186039214,22183,2
5326,PLAGL2,chr20,R,32192503,32207743,3495832,15240,186054454,22184,5
5332,PLCB4,chr20,F,9068709,9480816,3907939,412107,186466561,22185,42
5335,PLCG1,chr20,F,41137518,41175721,3946142,38203,186504764,22186,30
5360,PLTP,chr20,R,45898619,45912364,3959887,13745,186518509,22187,16
5476,CTSA,chr20,F,45890951,45898820,3967756,7869,186526378,22188,14
5509,PPP1R3D,chr20,R,59936831,59940297,3971222,3466,186529844,22189,0
5621,PRNP,chr20,F,4686150,4701588,3986660,15438,186545282,22190,1
5688,PSMA7,chr20,R,62136726,62143458,3993392,6732,186552014,22191,6
5740,PTGIS,chr20,R,49503873,49568170,4057689,64297,186616311,22192,9
5753,PTK6,chr20,R,63528412,63537370,4066647,8958,186625269,22193,7
5770,PTPN1,chr20,F,50510320,50584762,4141089,74442,186699711,22194,9
5786,PTPRA,chr20,F,2864194,3038669,4315564,174475,186874186,22195,29
5834,PYGB,chr20,F,25248069,25298012,4365507,49943,186924129,22196,19
5933,RBL1,chr20,R,36996348,37096000,4465159,99652,187023781,22197,23
6185,RPN2,chr20,F,37179050,37241623,4527732,62573,187086354,22198,18
6227,RPS21,chr20,F,62387064,62388520,4529188,1456,187087810,22199,5
6238,RRBP1,chr20,R,17613677,17682283,4597794,68606,187156416,22200,25
6385,SDC4,chr20,R,45325284,45348424,4620934,23140,187179556,22201,4
6406,SEMG1,chr20,F,45206996,45209773,4623711,2777,187182333,22202,2
6407,SEMG2,chr20,F,45221368,45224458,4626801,3090,187185423,22203,2
6431,SRSF6,chr20,F,43457863,43463605,4632543,5742,187191165,22204,5
6590,SLPI,chr20,R,45252238,45254564,4634869,2326,187193491,22205,3
6614,SIGLEC1,chr20,R,3686969,3712617,4660517,25648,187219139,22206,22
6615,SNAI1,chr20,F,49982975,49988886,4666428,5911,187225050,22207,2
6616,SNAP25,chr20,F,10218828,10307420,4755020,88592,187313642,22208,9
6628,SNRPB,chr20,R,2461634,2470853,4764239,9219,187322861,22209,6
6629,SNRPB2,chr20,F,16729963,16741772,4776048,11809,187334670,22210,6
6640,SNTA1,chr20,R,33407956,33443892,4811984,35936,187370606,22211,7
6666,SOX12,chr20,F,325570,330228,4816642,4658,187375264,22212,0
6676,SPAG4,chr20,F,35615852,35621045,4821835,5193,187380457,22213,13
6714,SRC,chr20,F,37344684,37405432,4882583,60748,187441205,22214,15
6725,SRMS,chr20,R,63539923,63547504,4890164,7581,187448786,22215,7
6754,SSTR4,chr20,F,23035419,23036677,4891422,1258,187450044,22216,0
6780,STAU1,chr20,R,49113338,49188370,4966454,75032,187525076,22217,17
6789,STK4,chr20,F,44966478,45079975,5079951,113497,187638573,22218,16
6790,AURKA,chr20,R,56369388,56392295,5102858,22907,187661480,22219,10
6874,TAF4,chr20,R,61974797,62065810,5193871,91013,187752493,22220,14
6919,TCEA2,chr20,F,64042349,64072347,5223869,29998,187782491,22221,13
6939,TCF15,chr20,R,603992,610266,5230143,6274,187788765,22222,1
7022,TFAP2C,chr20,F,56629301,56639283,5240125,9982,187798747,22223,6
7052,TGM2,chr20,R,38128460,38166509,5278174,38049,187836796,22224,13
7053,TGM3,chr20,F,2295966,2341079,5323287,45113,187881909,22225,12
7056,THBD,chr20,R,23045632,23049664,5327319,4032,187885941,22226,0
7125,TNNC2,chr20,R,45823213,45833323,5337429,10110,187896051,22227,6
7150,TOP1,chr20,F,41028821,41124487,5433095,95666,187991717,22228,22
7165,TPD52L2,chr20,F,63865227,63891545,5459413,26318,188018035,22229,9
7335,UBE2V1,chr20,R,50081123,50115959,5494249,34836,188052871,22230,9
7529,YWHAB,chr20,F,44885598,44908532,5517183,22934,188075805,22231,6
7686,MKRN7P,chr20,R,46463659,46465292,5518816,1633,188077438,22232,0
7692,ZNF133,chr20,F,18288282,18316996,5547530,28714,188106152,22233,8
7764,ZNF217,chr20,R,53567064,53608969,5589435,41905,188148057,22234,9
8195,MKKS,chr20,R,10404779,10434239,5618895,29460,188177517,22235,6
8200,GDF5,chr20,R,35433346,35441387,5626936,8041,188185558,22236,3
8202,NCOA3,chr20,F,47501856,47656877,5781957,155021,188340579,22237,22
8455,ATRN,chr20,F,3471017,3651122,5962062,180105,188520684,22238,31
8480,RAE1,chr20,F,57351088,57378463,5989437,27375,188548059,22239,14
8530,CST7,chr20,F,24949229,24959928,6000136,10699,188558758,22240,3
8537,BCAS1,chr20,R,53943539,54070765,6127362,127226,188685984,22241,13
8675,STX16,chr20,F,58651252,58679526,6155636,28274,188714258,22242,8
8760,CDS2,chr20,F,5126760,5197887,6226763,71127,188785385,22243,13
8771,TNFRSF6B,chr20,F,63696650,63698698,6228811,2048,188787433,22244,2
8785,MATN4,chr20,R,45293445,45308566,6243932,15121,188802554,22245,9
8813,DPM1,chr20,R,50934854,50958561,6267639,23707,188826261,22246,9
8839,WISP2,chr20,F,44714992,44727812,6280459,12820,188839081,22247,4
8894,EIF2S2,chr20,R,34088308,34112279,6304430,23971,188863052,22248,8
8904,CPNE1,chr20,R,35626030,35664956,6343356,38926,188901978,22249,18
9054,NFS1,chr20,R,35668687,35699365,6374034,30678,188932656,22250,13
9139,CBFA2T2,chr20,F,33490121,33650031,6533944,159910,189092566,22251,18
9217,VAPB,chr20,F,58389118,58451101,6595927,61983,189154549,22252,5
9334,B4GALT5,chr20,R,49632944,49713884,6676867,80940,189235489,22253,10
9371,KIF3B,chr20,F,32277650,32335011,6734228,57361,189292850,22254,8
9491,PSMF1,chr20,F,1113262,1168378,6789344,55116,189347966,22255,7
9584,RBM39,chr20,R,35703608,35742336,6828072,38728,189386694,22256,17
9675,TTI1,chr20,R,37983006,38033468,6878534,50462,189437156,22257,10
9751,SNPH,chr20,F,1266296,1309327,6921565,43031,189480187,22258,7
9762,LZTS3,chr20,R,3162616,3173592,6932541,10976,189491163,22259,6
9770,RASSF2,chr20,R,4780022,4823645,6976164,43623,189534786,22260,14
9777,TM9SF4,chr20,F,32109505,32167258,7033917,57753,189592539,22261,17
9825,SPATA2,chr20,R,49903390,49915543,7046070,12153,189604692,22262,5
9837,GINS1,chr20,F,25407443,25448555,7087182,41112,189645804,22263,10
9885,OSBPL2,chr20,F,62238484,62296213,7144911,57729,189703533,22264,18
9935,MAFB,chr20,R,40685847,40689240,7148304,3393,189706926,22265,0
9962,SLC23A2,chr20,R,4852355,5010293,7306242,157938,189864864,22266,19
10005,ACOT8,chr20,R,45841720,45857409,7321931,15689,189880553,22267,6
10047,CST8,chr20,F,23491075,23507128,7337984,16053,189896606,22268,6
10079,ATP9A,chr20,R,51596774,51768411,7509621,171637,190068243,22269,28
10110,SGK2,chr20,F,43558994,43585633,7536260,26639,190094882,22270,13
10137,RBM12,chr20,R,35648924,35664956,7552292,16032,190110914,22271,18
10139,ARFRP1,chr20,R,63698641,63708013,7561664,9372,190120286,22272,6
10287,RGS19,chr20,R,64073180,64080003,7568487,6823,190127109,22273,8
10326,SIRPB1,chr20,R,1564382,1626497,7630602,62115,190189224,22274,15
10388,SYCP2,chr20,R,59863556,59933681,7700727,70125,190259349,22275,47
10398,MYL9,chr20,F,36541483,36549823,7709067,8340,190267689,22276,3
10406,WFDC2,chr20,F,45448647,45481532,7741952,32885,190300574,22277,6
10483,SEC23B,chr20,F,18507543,18561415,7795824,53872,190354446,22278,19
10528,NOP56,chr20,F,2652531,2658393,7801686,5862,190360308,22279,11
10544,PROCR,chr20,F,35171936,35215989,7845739,44053,190404361,22280,4
10564,ARFGEF2,chr20,F,48921720,49036693,7960712,114973,190519334,22281,38
10616,RBCK1,chr20,F,408064,430966,7983614,22902,190542236,22282,13
10621,POLR3F,chr20,F,18467388,18484648,8000874,17260,190559496,22283,9
10732,TCFL5,chr20,R,62841013,62861763,8021624,20750,190580246,22284,7
10741,RBBP9,chr20,R,18486539,18497255,8032340,10716,190590962,22285,4
10816,SPINT3,chr20,R,45512460,45515624,8035504,3164,190594126,22286,1
10893,MMP24,chr20,F,35226735,35277663,8086432,50928,190645054,22287,8
10904,BLCAP,chr20,R,37517416,37527931,8096947,10515,190655569,22288,4
10953,TOMM34,chr20,R,44942129,44960473,8115291,18344,190673913,22289,8
10955,SERINC3,chr20,R,44496222,44522085,8141154,25863,190699776,22290,10
11034,DSTN,chr20,F,17569172,17608242,8180224,39070,190738846,22291,5
11047,ADRM1,chr20,F,62302055,62308862,8187031,6807,190745653,22292,9
11054,OGFR,chr20,F,62804824,62814000,8196207,9176,190754829,22293,6
11065,UBE2C,chr20,F,45812575,45816957,8200589,4382,190759211,22294,7
11083,DIDO1,chr20,R,62877733,62937952,8260808,60219,190819430,22295,18
11122,PTPRT,chr20,R,42072751,43189917,9377974,1117166,191936596,22296,34
11142,PKIG,chr20,F,44531780,44619037,9465231,87257,192023853,22297,6
11190,CEP250,chr20,F,35455138,35517531,9527624,62393,192086246,22298,36
11237,RNF24,chr20,R,3929917,4015569,9613276,85652,192171898,22299,8
11255,HRH3,chr20,R,62214765,62220278,9618789,5513,192177411,22300,2
11264,PXMP4,chr20,R,33702743,33720330,9636376,17587,192194998,22301,3
11317,RBPJL,chr20,F,45306823,45319677,9649230,12854,192207852,22302,12
22803,XRN2,chr20,F,21303303,21389825,9735752,86522,192294374,22303,30
22839,DLGAP4,chr20,F,36306322,36528637,9958067,222315,192516689,22304,16
22888,UBOX5,chr20,R,3107572,3159910,10010405,52338,192569027,22305,4
22903,BTBD3,chr20,F,11890722,11926595,10046278,35873,192604900,22306,5
22913,RALY,chr20,F,33993651,34083185,10135812,89534,192694434,22307,11
22918,CD93,chr20,R,23079355,23086340,10142797,6985,192701419,22308,1
22919,MAPRE1,chr20,F,32819779,32850405,10173423,30626,192732045,22309,6
22974,TPX2,chr20,F,31733818,31801802,10241407,67984,192800029,22310,18
22981,NINL,chr20,R,25452696,25585531,10374242,132835,192932864,22311,31
23051,ZHX3,chr20,R,41178448,41317618,10513412,139170,193072034,22312,16
23054,NCOA6,chr20,R,34714773,34825630,10624269,110857,193182891,22313,20
23236,PLCB1,chr20,F,8132253,8884900,11376916,752647,193935538,22314,35
23315,SLC9A8,chr20,F,49812712,49892242,11456446,79530,194015068,22315,19
23394,ADNP,chr20,R,50888917,50930990,11498519,42073,194057141,22316,7
23509,POFUT1,chr20,F,32207821,32238664,11529362,30843,194087984,22317,8
23613,ZMYND8,chr20,R,47209213,47356889,11677038,147676,194235660,22318,31
23626,SPO11,chr20,F,57329758,57343993,11691273,14235,194249895,22319,13
23627,PRND,chr20,F,4721853,4728462,11697882,6609,194256504,22320,1
23767,FLRT3,chr20,R,14323992,14337667,11711557,13675,194270179,22321,3
24141,LAMP5,chr20,F,9514317,9530524,11727764,16207,194286386,22322,5
24148,PRPF6,chr20,F,63981068,64033100,11779796,52032,194338418,22323,20
25876,SPEF1,chr20,R,3777503,3781466,11783759,3963,194342381,22324,6
25939,SAMHD1,chr20,R,36891823,36951843,11843779,60020,194402401,22325,16
25943,C20orf194,chr20,R,3249301,3407662,12002140,158361,194560762,22326,38
25980,AAR2,chr20,F,36236416,36256941,12022665,20525,194581287,22327,4
26013,L3MBTL1,chr20,F,43507679,43541895,12056881,34216,194615503,22328,21
26039,SS18L1,chr20,F,62143719,62182510,12095672,38791,194654294,22329,14
26051,PPP1R16B,chr20,F,38805704,38923024,12212992,117320,194771614,22330,11
26074,CFAP61,chr20,F,20052513,20360714,12521193,308201,195079815,22331,31
26090,ABHD12,chr20,R,25294742,25390982,12617433,96240,195176055,22332,16
26133,TRPC4AP,chr20,R,35002403,35092837,12707867,90434,195266489,22333,21
26152,ZNF337,chr20,R,25673194,25696904,12731577,23710,195290199,22334,6
26164,MTG2,chr20,F,62183024,62203568,12752121,20544,195310743,22335,9
26205,GMEB2,chr20,R,63587601,63627028,12791548,39427,195350170,22336,10
26765,SNORD12C,chr20,F,49278944,49279023,12791627,79,195350249,22337,0
26767,RNU105B,chr20,F,8831184,8831393,12791836,209,195350458,22338,0
26776,SNORA71B,chr20,R,38425194,38425330,12791972,136,195350594,22339,0
26777,SNORA71A,chr20,R,38427305,38427443,12792110,138,195350732,22340,0
26792,SNORD57,chr20,F,2656938,2657010,12792182,72,195350804,22341,0
26793,SNORD56,chr20,F,2656623,2656694,12792253,71,195350875,22342,0
27111,SDCBP2,chr20,R,1309908,1329235,12811580,19327,195370202,22343,9
27131,SNX5,chr20,R,17941595,17968991,12838976,27396,195397598,22344,12
27296,TP53TG5,chr20,R,45373879,45407838,12872935,33959,195431557,22345,9
27304,MOCS3,chr20,F,50958813,50961863,12875985,3050,195434607,22346,0
28231,SLCO4A1,chr20,F,62642444,62685830,12919371,43386,195477993,22347,14
28954,REM1,chr20,F,31475287,31484905,12928989,9618,195487611,22348,4
29058,TMEM230,chr20,R,5099837,5113087,12942239,13250,195500861,22349,5
29075,LINC00652,chr20,R,18787970,18794584,12948853,6614,195507475,22350,3
29107,NXT1,chr20,F,23350735,23354771,12952889,4036,195511511,22351,2
30813,VSX1,chr20,R,25070884,25082379,12964384,11495,195523006,22352,6
50861,STMN3,chr20,R,63639704,63653610,12978290,13906,195536912,22353,5
51006,SLC35C2,chr20,R,46349527,46364458,12993221,14931,195551843,22354,11
51012,SLMO2,chr20,R,59033144,59042846,13002923,9702,195561545,22355,7
51098,IFT52,chr20,F,43590612,43647227,13059538,56615,195618160,22356,15
51126,NAA20,chr20,F,20017289,20033629,13075878,16340,195634500,22357,6
51230,PHF20,chr20,F,35772000,35950377,13254255,178377,195812877,22358,20
51282,SCAND1,chr20,R,35953616,35955359,13255998,1743,195814620,22359,2
51297,BPIFA1,chr20,F,33235995,33243309,13263312,7314,195821934,22360,8
51340,CRNKL1,chr20,R,20034360,20056046,13284998,21686,195843620,22361,14
51378,ANGPT4,chr20,R,871242,916375,13330131,45133,195888753,22362,13
51497,NELFCD,chr20,F,58981207,58995134,13344058,13927,195902680,22363,14
51507,RTFDC1,chr20,F,56468584,56518886,13394360,50302,195952982,22364,10
51526,OSER1,chr20,R,44195938,44210906,13409328,14968,195967950,22365,6
51575,ESF1,chr20,R,13714321,13784933,13479940,70612,196038562,22366,13
51604,PIGT,chr20,F,45416066,45426245,13490119,10179,196048741,22367,11
51605,TRMT6,chr20,R,5937832,5950558,13502845,12726,196061467,22368,10
51614,ERGIC3,chr20,F,35542028,35557634,13518451,15606,196077073,22369,13
51654,CDK5RAP1,chr20,R,33358838,33401902,13561515,43064,196120137,22370,14
51750,RTEL1,chr20,F,63657809,63696253,13599959,38444,196158581,22371,34
54345,SOX18,chr20,R,64047725,64049626,13601860,1901,196160482,22372,1
54363,HAO1,chr20,R,7882983,7940446,13659323,57463,196217945,22373,7
54453,RIN2,chr20,F,19757609,20002459,13904173,244850,196462795,22374,21
54498,SMOX,chr20,F,4148778,4187747,13943142,38969,196501764,22375,8
54675,CRLS1,chr20,F,6006092,6040072,13977122,33980,196535744,22376,10
54915,YTHDF1,chr20,R,63195428,63216186,13997880,20758,196556502,22377,4
54923,LIME1,chr20,F,63736625,63739107,14000362,2482,196558984,22378,5
54963,UCKL1,chr20,R,63939828,63959435,14019969,19607,196578591,22379,14
54976,C20orf27,chr20,R,3753498,3768388,14034859,14890,196593481,22380,6
54994,GID8,chr20,F,62938088,62948475,14045246,10387,196603868,22381,4
55184,DZANK1,chr20,R,18383366,18467185,14129065,83819,196687687,22382,25
55245,UQCC1,chr20,R,35302565,35412142,14238642,109577,196797264,22383,11
55251,PCMTD2,chr20,F,64255694,64276226,14259174,20532,196817796,22384,5
55257,MRGBP,chr20,F,62796452,62800593,14263315,4141,196821937,22385,4
55304,SPTLC3,chr20,F,13008978,13170944,14425281,161966,196983903,22386,14
55317,AP5S1,chr20,F,3820523,3825307,14430065,4784,196988687,22387,2
55321,TMEM74B,chr20,R,1180560,1188128,14437633,7568,196996255,22388,4
55370,PPP4R1L,chr20,R,58232776,58309439,14514296,76663,197072918,22389,16
55423,SIRPG,chr20,R,1629151,1686516,14571661,57365,197130283,22390,7
55544,RBM38,chr20,F,57391397,57409333,14589597,17936,197148219,22391,5
55612,FERMT1,chr20,R,6074844,6123544,14638297,48700,197196919,22392,14
55614,KIF16B,chr20,R,16272096,16573434,14939635,301338,197498257,22393,27
55617,TASP1,chr20,R,13389388,13638936,15189183,249548,197747805,22394,19
55653,BCAS4,chr20,F,50794893,50877854,15272144,82961,197830766,22395,7
55661,DDX27,chr20,F,49219294,49244077,15296927,24783,197855549,22396,21
55713,ZNF334,chr20,R,46481907,46513581,15328601,31674,197887223,22397,11
55734,ZFP64,chr20,R,52084010,52191985,15436576,107975,197995198,22398,13
55738,ARFGAP1,chr20,F,63272784,63289793,15453585,17009,198012207,22399,15
55741,EDEM2,chr20,R,35115356,35147358,15485587,32002,198044209,22400,9
55816,DOK5,chr20,F,54475471,54651171,15661287,175700,198219909,22401,10
55857,KIZ,chr20,F,21125982,21246622,15781927,120640,198340549,22402,13
55861,DBNDD2,chr20,F,45405992,45410610,15786545,4618,198345167,22403,3
55902,ACSS2,chr20,F,34874941,34927966,15839570,53025,198398192,22404,21
55905,RNF114,chr20,F,49936376,49953885,15857079,17509,198415701,22405,5
55959,SULF2,chr20,R,47657405,47786629,15986303,129224,198544925,22406,23
55968,NSFL1C,chr20,R,1442161,1467720,16011862,25559,198570484,22407,12
55969,C20orf24,chr20,F,36605733,36612557,16018686,6824,198577308,22408,4
56255,TMX4,chr20,R,7977352,8019829,16061163,42477,198619785,22409,7
56259,CTNNBL1,chr20,F,37693954,37872129,16239338,178175,198797960,22410,17
56261,GPCPD1,chr20,R,5544433,5611026,16305931,66593,198864553,22411,22
56265,CPXM1,chr20,R,2794068,2800646,16312509,6578,198871131,22412,13
56731,SLC2A4RG,chr20,F,63739857,63744050,16316702,4193,198875324,22413,7
56914,OTOR,chr20,F,16748352,16752164,16320514,3812,198879136,22414,3
56937,PMEPA1,chr20,R,57648391,57711536,16383659,63145,198942281,22415,6
57091,CASS4,chr20,F,56411547,56459340,16431452,47793,198990074,22416,6
57119,EPPIN,chr20,R,45540625,45547426,16438253,6801,198996875,22417,4
57136,APMAP,chr20,R,24962924,24992974,16468303,30050,199026925,22418,8
57144,PAK7,chr20,R,9537388,9839039,16769954,301651,199328576,22419,13
57148,RALGAPB,chr20,F,38472805,38578861,16876010,106056,199434632,22420,30
57158,JPH2,chr20,R,44111696,44187578,16951892,75882,199510514,22421,8
57167,SALL4,chr20,R,51784008,51913245,17081129,129237,199639751,22422,9
57169,ZNFX1,chr20,R,49245896,49278244,17113477,32348,199672099,22423,13
57186,RALGAPA2,chr20,R,20389557,20712638,17436558,323081,199995180,22424,44
57325,CSRP2BP,chr20,F,18142223,18188387,17482722,46164,200041344,22425,9
57403,RAB22A,chr20,F,58309714,58367507,17540515,57793,200099137,22426,6
57419,SLC24A3,chr20,F,19212645,19722897,18050767,510252,200609389,22427,16
57446,NDRG3,chr20,R,36651765,36746138,18145140,94373,200703762,22428,18
57468,SLC12A5,chr20,F,46021689,46060150,18183601,38461,200742223,22429,26
57473,ZNF512B,chr20,R,63956703,63969870,18196768,13167,200755390,22430,20
57506,MAVS,chr20,F,3846798,3876123,18226093,29325,200784715,22431,6
57580,PREX1,chr20,R,48624248,48827883,18429728,203635,200988350,22432,40
57593,EBF4,chr20,F,2692877,2760108,18496959,67231,201055581,22433,17
57642,COL20A1,chr20,F,63293168,63334847,18538638,41679,201097260,22434,37
57644,MYH7B,chr20,F,34955834,35002437,18585241,46603,201143863,22435,48
57727,NCOA5,chr20,R,46060984,46089952,18614209,28968,201172831,22436,7
57761,TRIB3,chr20,F,380628,397559,18631140,16931,201189762,22437,5
58476,TP53INP2,chr20,F,34704310,34713439,18640269,9129,201198891,22438,5
58490,RPRD1B,chr20,F,38033486,38092364,18699147,58878,201257769,22439,10
58495,OVOL2,chr20,R,18024151,18059188,18734184,35037,201292806,22440,4
60436,TGIF2,chr20,F,36573472,36593952,18754664,20480,201313286,22441,3
60437,CDH26,chr20,F,59955830,60034338,18833172,78508,201391794,22442,22
60493,FASTKD5,chr20,R,3146518,3159886,18846540,13368,201405162,22443,1
60598,KCNK15,chr20,F,44745846,44752313,18853007,6467,201411629,22444,1
60625,DHX35,chr20,F,38962337,39039723,18930393,77386,201489015,22445,24
63905,MANBAL,chr20,F,37289647,37317260,18958006,27613,201516628,22446,3
63908,NAPB,chr20,R,23374518,23421519,19005007,47001,201563629,22447,10
63910,SLC17A9,chr20,F,62952646,62969585,19021946,16939,201580568,22448,13
63916,ELMO2,chr20,R,46366048,46407051,19062949,41003,201621571,22449,21
63925,ZNF335,chr20,R,45948652,45972194,19086491,23542,201645113,22450,27
63926,ANKEF1,chr20,F,10034998,10056764,19108257,21766,201666879,22451,11
63930,LOC63930,chr20,F,63009382,63085071,19183946,75689,201742568,22452,4
63935,PCIF1,chr20,F,45934673,45948023,19197296,13350,201755918,22453,17
63939,FAM217B,chr20,F,59933763,59948680,19212213,14917,201770835,22454,6
63941,NECAB3,chr20,R,33657086,33674458,19229585,17372,201788207,22455,15
64096,GFRA4,chr20,R,3659291,3663399,19233693,4108,201792315,22456,4
64405,CDH22,chr20,R,46173732,46308829,19368790,135097,201927412,22457,14
64412,GZF1,chr20,F,23361638,23373046,19380198,11408,201938820,22458,8
64601,VPS16,chr20,F,2840696,2866732,19406234,26036,201964856,22459,23
64773,PCED1A,chr20,R,2835313,2841243,19412164,5930,201970786,22460,8
64849,SLC13A3,chr20,R,46557822,46684485,19538827,126663,202097449,22461,14
64900,LPIN3,chr20,F,41340779,41360585,19558633,19806,202117255,22462,21
64949,MRPS26,chr20,F,3046028,3048250,19560855,2222,202119477,22463,3
65992,DDRGK1,chr20,R,3190365,3204649,19575139,14284,202133761,22464,8
78997,GDAP1L1,chr20,F,44247098,44280917,19608958,33819,202167580,22465,6
79015,LINC01260,chr20,R,44656450,44671739,19624247,15289,202182869,22466,4
79025,C20orf195,chr20,F,63553019,63556708,19627936,3689,202186558,22467,5
79133,NDUFAF5,chr20,F,13785025,13818421,19661332,33396,202219954,22468,15
79144,PPDPF,chr20,F,63520077,63522171,19663426,2094,202222048,22469,3
79160,LOC79160,chr20,F,58634771,58635738,19664393,967,202223015,22470,0
79175,ZNF343,chr20,R,2480070,2524522,19708845,44452,202267467,22471,9
79183,TTPAL,chr20,F,44475882,44494603,19727566,18721,202286188,22472,7
79444,BIRC7,chr20,F,63235882,63240507,19732191,4625,202290813,22473,6
79716,NPEPL1,chr20,F,58689130,58715844,19758905,26714,202317527,22474,22
79913,ACTR5,chr20,F,38748257,38772446,19783094,24189,202341716,22475,10
79953,SYNDIG1,chr20,F,24469198,24666617,19980513,197419,202539135,22476,12
79980,DSN1,chr20,R,36751790,36773827,20002550,22037,202561172,22477,10
80023,NRSN2,chr20,F,346725,354868,20010693,8143,202569315,22478,6
80025,PANK2,chr20,F,3888838,3923891,20045746,35053,202604368,22479,12
80307,FER1L4,chr20,R,35558736,35607562,20094572,48826,202653194,22480,42
80331,DNAJC5,chr20,F,63895101,63936031,20135502,40930,202694124,22481,8
80332,ADAM33,chr20,R,3667972,3682131,20149661,14159,202708283,22482,20
80336,PABPC1L,chr20,F,44910057,44958801,20198405,48744,202757027,22483,17
80341,BPIFB2,chr20,F,33007577,33023709,20214537,16132,202773159,22484,15
80343,SEL1L2,chr20,R,13849187,13995333,20360683,146146,202919305,22485,24
81027,TUBB1,chr20,F,59019253,59026654,20368084,7401,202926706,22486,3
81030,ZBP1,chr20,R,57603845,57620576,20384815,16731,202943437,22487,11
81031,SLC2A10,chr20,F,46708346,46736347,20412816,28001,202971438,22488,7
81502,HM13,chr20,F,31514409,31569567,20467974,55158,203026596,22489,12
81572,PDRG1,chr20,R,31944954,31968710,20491730,23756,203050352,22490,5
81610,FAM83D,chr20,F,38925077,38953060,20519713,27983,203078335,22491,4
81623,DEFB126,chr20,F,142552,145751,20522912,3199,203081534,22492,1
81928,CABLES2,chr20,R,62388629,62407283,20541566,18654,203100188,22493,9
83541,FAM110A,chr20,F,833696,846279,20554149,12583,203112771,22494,6
83658,DYNLRB1,chr20,F,34516354,34540958,20578753,24604,203137375,22495,6
83737,ITCH,chr20,F,34363234,34511393,20726912,148159,203285534,22496,27
83959,SLC4A11,chr20,R,3227416,3241482,20740978,14066,203299600,22497,23
84174,SLA2,chr20,R,36612518,36646216,20774676,33698,203333298,22498,8
84181,CHD6,chr20,R,41402100,41618494,20991070,216394,203549692,22499,40
84515,MCM8,chr20,F,5950651,5995206,21035625,44555,203594247,22500,20
84532,ACSS1,chr20,R,25006229,25058182,21087578,51953,203646200,22501,14
84557,MAP1LC3A,chr20,F,34546829,34560345,21101094,13516,203659716,22502,6
84612,PARD6B,chr20,F,50731543,50753741,21123292,22198,203681914,22503,2
84619,ZGPAT,chr20,F,63707441,63736142,21151993,28701,203710615,22504,7
84701,COX4I2,chr20,F,31637878,31645009,21159124,7131,203717746,22505,6
84905,ZNF341,chr20,F,33731759,33792269,21219634,60510,203778256,22506,14
84969,TOX2,chr20,F,43914851,44069616,21374399,154765,203933021,22507,11
85364,ZCCHC3,chr20,F,297562,300321,21377158,2759,203935780,22508,0
85366,MYLK2,chr20,F,31819311,31834697,21392544,15386,203951166,22509,13
85441,HELZ2,chr20,R,63558085,63574239,21408698,16154,203967320,22510,20
85449,KIAA1755,chr20,R,38210504,38260772,21458966,50268,204017588,22511,13
85508,SCRT2,chr20,R,661595,676179,21473550,14584,204032172,22512,1
90187,EMILIN3,chr20,R,41359965,41366858,21480443,6893,204039065,22513,3
90196,SYS1,chr20,F,45361936,45376802,21495309,14866,204053931,22514,5
90199,WFDC8,chr20,R,45551151,45579350,21523508,28199,204082130,22515,6
90203,SNX21,chr20,F,45833621,45843275,21533162,9654,204091784,22516,6
90204,ZSWIM1,chr20,F,45880941,45885266,21537487,4325,204096109,22517,2
92086,GGTLC1,chr20,R,23985052,23988779,21541214,3727,204099836,22518,7
92667,MGME1,chr20,F,17968852,17991122,21563484,22270,204122106,22519,6
92675,DTD1,chr20,F,18587911,18763917,21739490,176006,204298112,22520,7
92747,BPIFB1,chr20,F,33283134,33309878,21766234,26744,204324856,22521,15
112858,TP53RK,chr20,R,46684364,46689637,21771507,5273,204330129,22522,1
113278,SLC52A3,chr20,R,760079,775985,21787413,15906,204346035,22523,5
116092,DNTTIP1,chr20,F,45791936,45811427,21806904,19491,204365526,22524,12
116151,FAM210B,chr20,F,56358926,56368663,21816641,9737,204375263,22525,2
116154,PHACTR3,chr20,F,59577508,59847711,22086844,270203,204645466,22526,17
116835,HSPA12B,chr20,F,3732669,3753111,22107286,20442,204665908,22527,14
117285,DEFB118,chr20,F,31368617,31373923,22112592,5306,204671214,22528,1
117532,TMC2,chr20,F,2536606,2641869,22217855,105263,204776477,22529,20
128408,BHLHE23,chr20,R,63005978,63007035,22218912,1057,204777534,22530,0
128414,NKAIN4,chr20,R,63240783,63254540,22232669,13757,204791291,22531,7
128434,VSTM2L,chr20,F,37903096,37945350,22274923,42254,204833545,22532,3
128439,SNHG11,chr20,F,38446653,38450921,22279191,4268,204837813,22533,4
128486,FITM2,chr20,R,44306556,44311249,22283884,4693,204842506,22534,1
128488,WFDC12,chr20,R,45123425,45124465,22284924,1040,204843546,22535,2
128497,SPATA25,chr20,R,45886485,45888653,22287092,2168,204845714,22536,2
128506,OCSTAMP,chr20,R,46541030,46550574,22296636,9544,204855258,22537,2
128553,TSHZ2,chr20,F,52972308,53495330,22819658,523022,205378280,22538,3
128602,C20orf85,chr20,F,58150926,58161130,22829862,10204,205388484,22539,3
128611,ZNF831,chr20,F,59123427,59259113,22965548,135686,205524170,22540,11
128637,TBC1D20,chr20,R,435476,462553,22992625,27077,205551247,22541,7
128646,SIRPD,chr20,R,1534222,1559006,23017409,24784,205576031,22542,6
128653,C20orf141,chr20,F,2814986,2815830,23018253,844,205576875,22543,1
128674,PROKR2,chr20,R,5299873,5317547,23035927,17674,205594549,22544,2
128710,SLX4IP,chr20,F,10434546,10638546,23239927,204000,205798549,22545,12
128817,CSTL1,chr20,F,23439638,23461091,23261380,21453,205820002,22546,8
128821,CST9L,chr20,R,23564731,23568749,23265398,4018,205824020,22547,2
128822,CST9,chr20,R,23602409,23605973,23268962,3564,205827584,22548,1
128826,MIR1-1HG,chr20,F,62550452,62570764,23289274,20312,205847896,22549,3
128853,DUSP15,chr20,R,31861066,31870676,23298884,9610,205857506,22550,8
128854,TSPY26P,chr20,R,32189145,32190360,23300099,1215,205858721,22551,0
128859,BPIFB6,chr20,F,33030976,33044047,23313170,13071,205871792,22552,15
128861,BPIFA3,chr20,F,33217309,33227806,23323667,10497,205882289,22553,6
128864,C20orf144,chr20,F,33662285,33663915,23325297,1630,205883919,22554,1
128866,CHMP4B,chr20,F,33811303,33854367,23368361,43064,205926983,22555,4
128869,PIGU,chr20,R,34560541,34677285,23485105,116744,206043727,22556,12
128872,HMGB3P1,chr20,R,34833574,34834462,23485993,888,206044615,22557,0
128876,FAM83C,chr20,R,35285730,35292422,23492685,6692,206051307,22558,3
140628,GATA5,chr20,R,62463496,62475970,23505159,12474,206063781,22559,7
140678,MLLT10P1,chr20,R,30402907,30403462,23505714,555,206064336,22560,0
140679,SLC32A1,chr20,F,38724461,38729372,23510625,4911,206069247,22561,1
140680,C20orf96,chr20,R,270862,290778,23530541,19916,206089163,22562,9
140683,BPIFA2,chr20,F,33161835,33181417,23550123,19582,206108745,22563,9
140685,ZBTB46,chr20,R,63743667,63832344,23638800,88677,206197422,22564,14
140686,WFDC3,chr20,R,45774207,45791908,23656501,17701,206215123,22565,8
140687,GCNT7,chr20,R,56491491,56525925,23690935,34434,206249557,22566,6
140688,NOL4L,chr20,R,32443058,32585073,23832950,142015,206391572,22567,18
140689,CBLN4,chr20,R,55997356,56005474,23841068,8118,206399690,22568,3
140690,CTCFL,chr20,R,57495964,57525652,23870756,29688,206429378,22569,14
140699,MROH8,chr20,R,37101225,37179588,23949119,78363,206507741,22570,23
140700,SAMD10,chr20,R,63974112,63980986,23955993,6874,206514615,22571,6
140701,ABHD16B,chr20,F,63861212,63862988,23957769,1776,206516391,22572,0
140706,CCM2L,chr20,F,32010378,32032182,23979573,21804,206538195,22573,11
140710,SOGA1,chr20,R,36777441,36863684,24065816,86243,206624438,22574,16
140711,TLDC2,chr20,F,36876120,36894235,24083931,18115,206642553,22575,7
140730,RIMS4,chr20,R,44751803,44810338,24142466,58535,206701088,22576,5
140731,ANKRD60,chr20,R,58216125,58228653,24154994,12528,206713616,22577,4
140732,SUN5,chr20,R,32983772,33004449,24175671,20677,206734293,22578,14
140733,MACROD2,chr20,F,13995499,16053197,26233369,2057698,208791991,22579,19
140809,SRXN1,chr20,R,646614,653370,26240125,6756,208798747,22580,1
140823,ROMO1,chr20,F,35699309,35700980,26241796,1671,208800418,22581,2
140825,NEURL2,chr20,R,45888471,45891287,26244612,2816,208803234,22582,1
140828,LINC00261,chr20,R,22560552,22578642,26262702,18090,208821324,22583,3
140831,ZSWIM3,chr20,F,45857580,45879131,26284253,21551,208842875,22584,2
140832,WFDC10A,chr20,F,45629745,45631192,26285700,1447,208844322,22585,1
140834,C20orf62,chr20,R,44461762,44465344,26289282,3582,208847904,22586,1
140836,BANF2,chr20,F,17693674,17735872,26331480,42198,208890102,22587,5
140838,NANP,chr20,R,25612934,25624012,26342558,11078,208901180,22588,1
140846,FAM83C-AS1,chr20,F,35285250,35285772,26343080,522,208901702,22589,1
140848,MACROD2-IT1,chr20,F,14554383,14628908,26417605,74525,208976227,22590,4
140849,LINC00266-1,chr20,F,64290384,64303354,26430575,12970,208989197,22591,2
140850,DEFB127,chr20,F,157469,159163,26432269,1694,208990891,22592,1
140856,SCP2D1,chr20,F,18813725,18814392,26432936,667,208991558,22593,0
140862,ISM1,chr20,F,13221770,13300650,26511816,78880,209070438,22594,5
140870,WFDC6,chr20,R,45534196,45539495,26517115,5299,209075737,22595,2
140873,C20orf173,chr20,R,35520740,35529652,26526027,8912,209084649,22596,12
140875,LINC00028,chr20,F,31485777,31487574,26527824,1797,209086446,22597,3
140876,FAM65C,chr20,R,50586107,50692004,26633721,105897,209192343,22598,30
140880,CST11,chr20,R,23450403,23452845,26636163,2442,209194785,22599,2
140881,DEFB129,chr20,F,227257,229886,26638792,2629,209197414,22600,1
140885,SIRPA,chr20,F,1894116,1939896,26684572,45780,209243194,22601,11
140893,RBBP8NL,chr20,R,62410236,62427680,26702016,17444,209260638,22602,13
140894,CNBD2,chr20,F,35954561,36030700,26778155,76139,209336777,22603,16
140901,STK35,chr20,F,2099798,2148555,26826912,48757,209385534,22604,3
140902,R3HDML,chr20,F,44337157,44350792,26840547,13635,209399169,22605,4
149684,LOC149684,chr20,F,38260174,38288947,26869320,28773,209427942,22606,1
149685,ADIG,chr20,F,38581194,38588463,26876589,7269,209435211,22607,2
149699,GTSF1L,chr20,R,43726160,43727012,26877441,852,209436063,22608,0
149708,WFDC5,chr20,R,45109451,45116321,26884311,6870,209442933,22609,4
149773,APCDD1L-AS1,chr20,F,58515378,58619892,26988825,104514,209547447,22610,6
149775,GNAS-AS1,chr20,R,58818917,58850903,27020811,31986,209579433,22611,4
149830,PRNT,chr20,R,4731281,4740668,27030198,9387,209588820,22612,1
149837,LINC00654,chr20,R,5498571,5504596,27036223,6025,209594845,22613,1
149840,C20orf196,chr20,F,5750334,5864407,27150296,114073,209708918,22614,8
149934,NCOR1P1,chr20,R,26103415,26114041,27160922,10626,209719544,22615,1
149950,LOC149950,chr20,F,32587478,32608893,27182337,21415,209740959,22616,2
149951,COMMD7,chr20,R,32702690,32744008,27223655,41318,209782277,22617,8
149954,BPIFB4,chr20,F,33081511,33111751,27253895,30240,209812517,22618,15
149986,LSM14B,chr20,F,62122458,62135378,27266815,12920,209825437,22619,13
164237,WFDC13,chr20,F,45702015,45708817,27273617,6802,209832239,22620,3
164284,APCDD1L,chr20,R,58452468,58515393,27336542,62925,209895164,22621,5
164312,LRRN4,chr20,R,6039744,6054080,27350878,14336,209909500,22622,4
164380,CST13P,chr20,F,23519145,23542018,27373751,22873,209932373,22623,3
164395,TTLL9,chr20,F,31870701,31944959,27448009,74258,210006631,22624,23
170487,ACTL10,chr20,F,33666497,33668525,27450037,2028,210008659,22625,0
171023,ASXL1,chr20,F,32358343,32439319,27531013,80976,210089635,22626,18
198437,LKAAEAR1,chr20,R,64083375,64085144,27532782,1769,210091404,22627,3
200232,FAM209A,chr20,F,56524728,56526152,27534206,1424,210092828,22628,1
200261,LINC00656,chr20,R,23125067,23132636,27541775,7569,210100397,22629,3
245929,DEFB115,chr20,F,31257663,31259632,27543744,1969,210102366,22630,1
245930,DEFB116,chr20,R,31303211,31308585,27549118,5374,210107740,22631,1
245932,DEFB119,chr20,R,31377162,31390649,27562605,13487,210121227,22632,4
245934,DEFB121,chr20,R,31404844,31419068,27576829,14224,210135451,22633,7
245935,DEFB122,chr20,R,31421438,31429180,27584571,7742,210143193,22634,2
245936,DEFB123,chr20,F,31440518,31450257,27594310,9739,210152932,22635,1
245937,DEFB124,chr20,R,31465505,31473013,27601818,7508,210160440,22636,1
245938,DEFB125,chr20,F,87671,96573,27610720,8902,210169342,22637,1
245939,DEFB128,chr20,R,187852,189681,27612549,1829,210171171,22638,1
253868,C20orf166-AS1,chr20,R,62543069,62551561,27621041,8492,210179663,22639,6
259239,WFDC11,chr20,R,45648562,45670239,27642718,21677,210201340,22640,4
259240,WFDC9,chr20,R,45607938,45631268,27666048,23330,210224670,22641,4
280664,WFDC10B,chr20,R,45684650,45705019,27686417,20369,210245039,22642,3
284739,LINC00176,chr20,F,64034343,64039962,27692036,5619,210250658,22643,3
284749,LINC00494,chr20,F,48359910,48370638,27702764,10728,210261386,22644,4
284751,LINC01270,chr20,F,50292719,50314919,27724964,22200,210283586,22645,4
284756,C20orf197,chr20,F,60055924,60072953,27741993,17029,210300615,22646,4
284757,MIR646HG,chr20,F,60138491,60322256,27925758,183765,210484380,22647,4
284759,SIRPB2,chr20,R,1470687,1491587,27946658,20900,210505280,22648,8
284788,LOC284788,chr20,R,22400332,22420643,27966969,20311,210525591,22649,3
284798,LOC284798,chr20,R,25140797,25148790,27974962,7993,210533584,22650,3
284800,FAM182A,chr20,F,26054613,26086917,28007266,32304,210565888,22651,4
284801,MIR663AHG,chr20,R,26187018,26209233,28029481,22215,210588103,22652,4
284802,FRG1B,chr20,F,30377202,30399331,28051610,22129,210610232,22653,7
284805,C20orf203,chr20,R,32631624,32651981,28071967,20357,210630589,22654,4
317716,BPIFA4P,chr20,F,33193604,33210462,28088825,16858,210647447,22655,8
339568,LOC339568,chr20,R,39213780,39224748,28099793,10968,210658415,22656,3
339593,LOC339593,chr20,R,11266658,11273383,28106518,6725,210665140,22657,1
343578,ARHGAP40,chr20,F,38601933,38650652,28155237,48719,210713859,22658,14
343637,RSPO4,chr20,R,958451,1002284,28199070,43833,210757692,22659,7
343641,TGM6,chr20,F,2380907,2432753,28250916,51846,210809538,22660,12
343702,XKR7,chr20,F,31968001,31998453,28281368,30452,210839990,22661,2
359710,BPIFB3,chr20,F,33055330,33073637,28299675,18307,210858297,22662,14
387521,TMEM189,chr20,R,50123736,50153798,28329737,30062,210888359,22663,7
387522,TMEM189-UBE2V1,chr20,R,50081123,50153798,28402412,72675,210961034,22664,7
388780,LOC388780,chr20,F,2206467,2258031,28453976,51564,211012598,22665,4
388789,LINC00493,chr20,F,18567428,18569560,28456108,2132,211014730,22666,1
388795,EFCAB8,chr20,F,32860994,32961845,28556959,100851,211115581,22667,26
388796,SNHG17,chr20,R,38420591,38435375,28571743,14784,211130365,22668,7
388799,FAM209B,chr20,F,56526194,56536521,28582070,10327,211140692,22669,4
391253,SPINT4,chr20,F,45722348,45725696,28585418,3348,211144040,22670,2
391257,SUMO1P1,chr20,R,53874497,53875709,28586630,1212,211145252,22671,0
400830,DEFB132,chr20,F,257735,261096,28589991,3361,211148613,22672,1
400831,C20orf202,chr20,F,1203453,1208274,28594812,4821,211153434,22673,1
400839,FLJ33581,chr20,F,24199766,24224588,28619634,24822,211178256,22674,3
406896,MIR103A2,chr20,F,3917493,3917571,28619712,78,211178334,22675,0
406904,MIR1-1,chr20,F,62554305,62554376,28619783,71,211178405,22676,0
406909,MIR124-3,chr20,F,63178499,63178586,28619870,87,211178492,22677,0
406923,MIR133A2,chr20,F,62564911,62565013,28619972,102,211178594,22678,0
407022,MIR296,chr20,R,58817614,58817694,28620052,80,211178674,22679,0
440757,LINC00851,chr20,F,18379048,18381484,28622488,2436,211181110,22680,1
441951,ZFAS1,chr20,F,49278177,49289260,28633571,11083,211192193,22681,4
574501,MIR499A,chr20,F,34990375,34990497,28633693,122,211192315,22682,0
613266,LOC613266,chr20,R,15892332,15985882,28727243,93550,211285865,22683,2
642636,RAD21L1,chr20,F,1226042,1261279,28762480,35237,211321102,22684,17
643406,LOC643406,chr20,F,5471195,5477134,28768419,5939,211327041,22685,1
644524,NKX2-4,chr20,R,21395366,21397409,28770462,2043,211329084,22686,1
647476,FRG2EP,chr20,R,29414074,29416961,28773349,2887,211331971,22687,3
647979,LINC00657,chr20,R,36045617,36050960,28778692,5343,211337314,22688,0
677821,SNORA71E,chr20,F,38448082,38448218,28778828,136,211337450,22689,0
677831,SNORA51,chr20,F,2655066,2655198,28778960,132,211337582,22690,0
677837,SNORA60,chr20,F,38449368,38449504,28779096,136,211337718,22691,0
677839,SNORA71C,chr20,R,38429666,38429804,28779234,138,211337856,22692,0
677840,SNORA71D,chr20,R,38433861,38433999,28779372,138,211337994,22693,0
692057,SNORD12,chr20,F,49280682,49280772,28779462,90,211338084,22694,0
692086,SNORD17,chr20,R,17962709,17962946,28779699,237,211338321,22695,0
692201,SNORD86,chr20,F,2656096,2656182,28779785,86,211338407,22696,0
692213,SNORD110,chr20,F,2654211,2654286,28779860,75,211338482,22697,0
693229,MIR644A,chr20,F,34466324,34466418,28779954,94,211338576,22698,0
693230,MIR645,chr20,F,50585785,50585879,28780048,94,211338670,22699,0
693231,MIR646,chr20,F,60308473,60308567,28780142,94,211338764,22700,0
693232,MIR647,chr20,R,63942630,63942726,28780238,96,211338860,22701,0
724033,MIR663A,chr20,R,26208185,26208278,28780331,93,211338953,22702,0
727993,LOC727993,chr20,F,1947245,2007517,28840603,60272,211399225,22703,3
728228,LINC01433,chr20,F,4193089,4195953,28843467,2864,211402089,22704,2
728283,LOC728283,chr20,F,5315581,5317717,28845603,2136,211404225,22705,0
728434,C20orf187,chr20,F,10862084,11029529,29013048,167445,211571670,22706,18
728450,LINC00687,chr20,R,11809986,11870715,29073777,60729,211632399,22707,1
728805,LOC728805,chr20,R,53168642,53180017,29085152,11375,211643774,22708,1
728882,FAM182B,chr20,R,25763465,25801291,29122978,37826,211681600,22709,6
729296,LOC729296,chr20,F,60087685,60101387,29136680,13702,211695302,22710,4
767557,SYS1-DBNDD2,chr20,F,45363168,45410610,29184122,47442,211742744,22711,3
768096,HAR1A,chr20,F,63101291,63104385,29187216,3094,211745838,22712,1
768097,HAR1B,chr20,R,63095492,63102319,29194043,6827,211752665,22713,1
100101490,MCTS2P,chr20,F,31547381,31548220,29194882,839,211753504,22714,0
100113378,SNORD119,chr20,R,2462951,2463047,29194978,96,211753600,22715,0
100113386,UCKL1-AS1,chr20,F,63953383,63956985,29198580,3602,211757202,22716,1
100113393,SNORD12B,chr20,F,49280312,49280415,29198683,103,211757305,22717,0
100126296,MIR298,chr20,R,58818225,58818313,29198771,88,211757393,22718,0
100126329,MIR941-1,chr20,F,63919448,63919520,29198843,72,211757465,22719,0
100126330,MIR941-4,chr20,F,63919755,63919827,29198915,72,211757537,22720,0
100126339,MIR941-2,chr20,F,63919504,63919576,29198987,72,211757609,22721,0
100126352,MIR941-3,chr20,F,63919560,63919632,29199059,72,211757681,22722,0
100127888,SLCO4A1-AS1,chr20,R,62663026,62666621,29202654,3595,211761276,22723,3
100128496,C20orf78,chr20,R,18809350,18830203,29223507,20853,211782129,22724,2
100128988,LOC100128988,chr20,F,40980036,41024521,29267992,44485,211826614,22725,4
100128998,C20orf181,chr20,R,63832608,63848312,29283696,15704,211842318,22726,2
100129869,LOC100129869,chr20,R,57958680,57959615,29284631,935,211843253,22727,0
100130152,LOC100130152,chr20,R,63392886,63398343,29290088,5457,211848710,22728,3
100130264,LOC100130264,chr20,R,19242301,19284596,29332383,42295,211891005,22729,7
100130587,LOC100130587,chr20,F,63359987,63371177,29343573,11190,211902195,22730,4
100130934,ZNF663P,chr20,R,46456492,46457643,29344724,1151,211903346,22731,0
100131208,SNAP25-AS1,chr20,R,10023811,10219506,29540419,195695,212099041,22732,4
100131496,LOC100131496,chr20,F,47318501,47320754,29542672,2253,212101294,22733,0
100132911,DPH3P1,chr20,F,62844565,62846191,29544298,1626,212102920,22734,0
100134015,UBOX5-AS1,chr20,F,3106910,3150867,29588255,43957,212146877,22735,6
100134868,LOC100134868,chr20,F,26009798,26021795,29600252,11997,212158874,22736,4
100144596,LINC00029,chr20,R,63034216,63037028,29603064,2812,212161686,22737,3
100144597,LINC01056,chr20,F,63038010,63053863,29618917,15853,212177539,22738,5
100192386,FLJ16779,chr20,F,63253977,63261615,29626555,7638,212185177,22739,0
100270679,LINC01432,chr20,F,22054089,22074654,29647120,20565,212205742,22740,3
100270804,LOC100270804,chr20,F,18794048,18796065,29649137,2017,212207759,22741,0
100287792,LOC100287792,chr20,F,37676909,37683234,29655462,6325,212214084,22742,3
100288797,TMEM239,chr20,F,2815873,2818062,29657651,2189,212216273,22743,1
100289097,LOC100289097,chr20,R,28557089,28602838,29703400,45749,212262022,22744,15
100289473,LOC100289473,chr20,R,1773364,1779746,29709782,6382,212268404,22745,3
100291105,LOC100291105,chr20,R,57383725,57392492,29718549,8767,212277171,22746,1
100302125,MIR1289-1,chr20,R,35453953,35454097,29718693,144,212277315,22747,0
100302137,MIR1914,chr20,R,63941464,63941544,29718773,80,212277395,22748,0
100302138,MIR1292,chr20,F,2652776,2652842,29718839,66,212277461,22749,0
100302146,MIR1302-5,chr20,R,50614635,50614785,29718989,150,212277611,22750,0
100302168,MIR1257,chr20,R,61953545,61953662,29719106,117,212277728,22751,0
100302183,MIR1825,chr20,F,32237794,32237847,29719159,53,212277781,22752,0
100302282,MIR103B2,chr20,R,3917501,3917563,29719221,62,212277843,22753,0
100302739,PCNA-AS1,chr20,F,5119585,5119969,29719605,384,212278227,22754,0
100303755,PET117,chr20,F,18137854,18143169,29724920,5315,212283542,22755,1
100379174,MACROD2-AS1,chr20,R,14884252,14929518,29770186,45266,212328808,22756,3
100422838,MIR3195,chr20,F,62064801,62064885,29770270,84,212328892,22757,0
100422875,MIR3192,chr20,F,18470614,18470691,29770347,77,212328969,22758,0
100422883,MIR4325,chr20,R,57321501,57321591,29770437,90,212329059,22759,0
100422889,MIR3194,chr20,R,51452904,51452977,29770510,73,212329132,22760,0
100422904,MIR3193,chr20,F,31607185,31607240,29770565,55,212329187,22761,0
100422945,MIR4326,chr20,F,63286807,63286866,29770624,59,212329246,22762,0
100423014,MIR3196,chr20,F,63238778,63238842,29770688,64,212329310,22763,0
100462983,MTRNR2L3,chr20,R,57358439,57359822,29772071,1383,212330693,22764,0
100500813,MIR3646,chr20,F,44408119,44408203,29772155,84,212330777,22765,0
100500814,MIR3616,chr20,F,47166966,47167058,29772247,92,212330869,22766,0
100500897,MIR3617,chr20,R,45705101,45705180,29772326,79,212330948,22767,0
100505515,LOC100505515,chr20,F,12950339,12951627,29773614,1288,212332236,22768,1
100505536,ISM1-AS1,chr20,R,13237419,13239687,29775882,2268,212334504,22769,2
100505663,LINC01370,chr20,F,40004460,40008529,29779951,4069,212338573,22770,2
100505664,LOC100505664,chr20,F,23159610,23190307,29810648,30697,212369270,22771,7
100505683,LINC01431,chr20,R,23356593,23358127,29812182,1534,212370804,22772,2
100505771,LOC100505771,chr20,F,63627242,63628757,29813697,1515,212372319,22773,1
100505783,OSER1-AS1,chr20,F,44210959,44226027,29828765,15068,212387387,22774,3
100505826,STK4-AS1,chr20,R,44963793,44966458,29831430,2665,212390052,22775,2
100506115,LINC01272,chr20,F,50267482,50279795,29843743,12313,212402365,22776,3
100506175,LOC100506175,chr20,F,50645470,50660291,29858564,14821,212417186,22777,2
100506384,LOC100506384,chr20,R,59626463,59628289,29860390,1826,212419012,22778,1
100506470,LOC100506470,chr20,F,61079063,61080179,29861506,1116,212420128,22779,1
100507459,NRSN2-AS1,chr20,R,319686,325252,29867072,5566,212425694,22780,2
100507495,SDCBP2-AS1,chr20,F,1325342,1378735,29920465,53393,212479087,22781,3
100507629,LINC00658,chr20,R,5431956,5445748,29934257,13792,212492879,22782,4
100526773,EPPIN-WFDC6,chr20,R,45536279,45547426,29945404,11147,212504026,22783,4
100527943,TGIF2-C20orf24,chr20,F,36574553,36612557,29983408,38004,212542030,22784,4
100528031,FKBP1A-SDCBP2,chr20,R,1309908,1393172,30066672,83264,212625294,22785,9
100533107,RTEL1-TNFRSF6B,chr20,F,63657809,63698698,30107561,40889,212666183,22786,2
100533975,SLMO2-ATP5E,chr20,R,59028677,59042846,30121730,14169,212680352,22787,7
100534593,STX16-NPEPL1,chr20,F,58651252,58715844,30186322,64592,212744944,22788,22
100616134,MIR499B,chr20,R,34990399,34990472,30186395,73,212745017,22789,0
100616190,MIR548O2,chr20,F,38516562,38516632,30186465,70,212745087,22790,0
100616225,MIR4756,chr20,R,54068407,54068485,30186543,78,212745165,22791,0
100616340,MIR4758,chr20,R,62332486,62332557,30186614,71,212745236,22792,0
100616353,MIR4532,chr20,F,57895393,57895444,30186665,51,212745287,22793,0
100616362,MIR4533,chr20,F,60478110,60478181,30186736,71,212745358,22794,0
100616434,MIR4755,chr20,F,34049118,34049190,30186808,72,212745430,22795,0
100616440,MIR548AG2,chr20,F,60564561,60564625,30186872,64,212745494,22796,0
100652730,LINC00659,chr20,R,62774120,62776856,30189608,2736,212748230,22797,2
100861522,LINC00489,chr20,R,37619297,37623119,30193430,3822,212752052,22798,2
100874042,HM13-AS1,chr20,R,31567706,31573263,30198987,5557,212757609,22799,2
100887755,TRERNA1,chr20,R,50040706,50041629,30199910,923,212758532,22800,1
101060004,LINC01523,chr20,F,47983225,47984313,30200998,1088,212759620,22801,1
101409261,OGFR-AS1,chr20,R,62800626,62805587,30205959,4961,212764581,22802,2
101410538,MMP24-AS1,chr20,R,35276332,35278157,30207784,1825,212766406,22803,1
101926888,RALY-AS1,chr20,R,33992487,33994367,30209664,1880,212768286,22804,2
101926889,LOC101926889,chr20,R,25184671,25196892,30221885,12221,212780507,22805,5
101926935,LOC101926935,chr20,R,25844666,25854021,30231240,9355,212789862,22806,2
101926955,LOC101926955,chr20,F,25955811,25969288,30244717,13477,212803339,22807,3
101926987,DLGAP4-AS1,chr20,R,36507701,36573275,30310291,65574,212868913,22808,4
101927098,LOC101927098,chr20,R,40694035,40717316,30333572,23281,212892194,22809,5
101927117,PLCG1-AS1,chr20,R,41097993,41138000,30373579,40007,212932201,22810,6
101927138,LOC101927138,chr20,F,42968743,42971492,30376328,2749,212934950,22811,1
101927159,LOC101927159,chr20,F,42685482,42688562,30379408,3080,212938030,22812,3
101927182,LOC101927182,chr20,F,42090233,42091012,30380187,779,212938809,22813,2
101927200,LOC101927200,chr20,F,43727394,43826432,30479225,99038,213037847,22814,7
101927219,HNF4A-AS1,chr20,R,44377742,44395706,30497189,17964,213055811,22815,3
101927242,LINC01430,chr20,R,44448776,44450557,30498970,1781,213057592,22816,2
101927355,LOC101927355,chr20,R,46900385,46901915,30500500,1530,213059122,22817,1
101927377,LOC101927377,chr20,F,47352560,47354633,30502573,2073,213061195,22818,1
101927457,LINC01522,chr20,R,47980092,47990117,30512598,10025,213071220,22819,2
101927486,LOC101927486,chr20,F,49568123,49571934,30516409,3811,213075031,22820,1
101927512,LOC101927512,chr20,R,50162768,50166247,30519888,3479,213078510,22821,2
101927541,LINC01273,chr20,F,50172569,50176671,30523990,4102,213082612,22822,2
101927559,CEBPB-AS1,chr20,R,50184602,50192069,30531457,7467,213090079,22823,6
101927586,LINC01271,chr20,R,50310710,50321342,30542089,10632,213100711,22824,2
101927631,ADNP-AS1,chr20,F,50930983,50945134,30556240,14151,213114862,22825,3
101927678,LINC01429,chr20,R,51831796,51862913,30587357,31117,213145979,22826,2
101927700,LINC01524,chr20,F,52620837,52650426,30616946,29589,213175568,22827,2
101927770,LOC101927770,chr20,F,53552769,53575308,30639485,22539,213198107,22828,5
101927796,LINC01441,chr20,R,55420335,55427197,30646347,6862,213204969,22829,2
101927932,LOC101927932,chr20,R,58863755,58888810,30671402,25055,213230024,22830,4
101928026,LOC101928026,chr20,F,60470712,60482972,30683662,12260,213242284,22831,3
101928048,LOC101928048,chr20,R,60469608,60472976,30687030,3368,213245652,22832,1
101928158,LAMA5-AS1,chr20,F,62353009,62356480,30690501,3471,213249123,22833,2
101928465,LOC101928465,chr20,R,62648960,62656352,30697893,7392,213256515,22834,1
101928604,ZBTB46-AS1,chr20,F,63808075,63823015,30712833,14940,213271455,22835,2
101929010,SIRPG-AS1,chr20,F,1633507,1648473,30727799,14966,213286421,22836,2
101929098,LOC101929098,chr20,R,3068759,3072278,30731318,3519,213289940,22837,2
101929125,LOC101929125,chr20,F,3808493,3812434,30735259,3941,213293881,22838,3
101929207,LOC101929207,chr20,R,5507874,5510002,30737387,2128,213296009,22839,2
101929225,MCM8-AS1,chr20,R,5990794,6005821,30752414,15027,213311036,22840,4
101929244,CASC20,chr20,F,6426731,6528459,30854142,101728,213412764,22841,3
101929265,LINC01428,chr20,R,7146466,7254202,30961878,107736,213520500,22842,7
101929288,LOC101929288,chr20,R,7302088,7307507,30967297,5419,213525919,22843,1
101929312,LOC101929312,chr20,F,7347432,7368501,30988366,21069,213546988,22844,2
101929329,LAMP5-AS1,chr20,R,9505179,9514998,30998185,9819,213556807,22845,4
101929348,LOC101929348,chr20,F,9619723,9626898,31005360,7175,213563982,22846,2
101929371,LOC101929371,chr20,F,9986332,10007116,31026144,20784,213584766,22847,1
101929395,LOC101929395,chr20,F,10753089,10754027,31027082,938,213585704,22848,1
101929413,LOC101929413,chr20,R,10875332,10909272,31061022,33940,213619644,22849,6
101929486,LOC101929486,chr20,R,12865203,12952519,31148338,87316,213706960,22850,11
101929526,LOC101929526,chr20,R,18674394,18698708,31172652,24314,213731274,22851,3
101929547,LOC101929547,chr20,R,19208993,19210497,31174156,1504,213732778,22852,1
101929575,LOC101929575,chr20,R,20254829,20267873,31187200,13044,213745822,22853,3
101929591,KIZ-AS1,chr20,R,21194403,21218289,31211086,23886,213769708,22854,7
101929608,LOC101929608,chr20,R,21610786,21703585,31303885,92799,213862507,22855,4
101929625,LOC101929625,chr20,F,21570023,21615722,31349584,45699,213908206,22856,3
101929663,LINC01427,chr20,R,22280227,22282801,31352158,2574,213910780,22857,3
101929685,LINC01384,chr20,R,22587521,22607517,31372154,19996,213930776,22858,2
101929698,LOC101929698,chr20,F,32509958,32520285,31382481,10327,213941103,22859,2
101929707,LOC101929707,chr20,R,22995689,23030820,31417612,35131,213976234,22860,10
101929746,ZNF341-AS1,chr20,R,33787372,33811099,31441339,23727,213999961,22861,3
101929863,LOC101929863,chr20,R,45137458,45139104,31442985,1646,214001607,22862,2
101929866,LOC101929866,chr20,F,45179753,45191664,31454896,11911,214013518,22863,5
101929937,LOC101929937,chr20,R,346265,347981,31456612,1716,214015234,22864,2
102465487,MIR6812,chr20,F,45425509,45425573,31456676,64,214015298,22865,0
102465524,MIR6869,chr20,R,1392899,1392961,31456738,62,214015360,22866,0
102465525,MIR6870,chr20,R,10649635,10649695,31456798,60,214015420,22867,0
102465865,MIR8062,chr20,F,7371607,7371692,31456883,85,214015505,22868,0
102466741,MIR6813,chr20,R,64076954,64077010,31456939,56,214015561,22869,0
102466912,MIR6871,chr20,F,41169022,41169078,31456995,56,214015617,22870,0
102606466,LOC102606466,chr20,R,12934876,12936963,31459082,2087,214017704,22871,1
102723316,LOC102723316,chr20,F,29080250,29100567,31479399,20317,214038021,22872,6
102723390,LOC102723390,chr20,R,29457392,29496909,31518916,39517,214077538,22873,13
102723442,LOC102723442,chr20,R,47384738,47412256,31546434,27518,214105056,22874,3
102723483,CSE1L-AS1,chr20,R,49040462,49046056,31552028,5594,214110650,22875,2
102723552,LOC102723552,chr20,R,30681104,30723938,31594862,42834,214153484,22876,14
102723578,LINC01440,chr20,F,55423042,55426791,31598611,3749,214157233,22877,2
102723590,BMP7-AS1,chr20,F,57213695,57215866,31600782,2171,214159404,22878,3
102723636,LOC102723636,chr20,F,30537620,30546376,31609538,8756,214168160,22879,2
102723788,LOC102723788,chr20,R,63370752,63378135,31616921,7383,214175543,22880,3
102723814,LOC102723814,chr20,R,63517261,63519417,31619077,2156,214177699,22881,1
102724529,LOC102724529,chr20,R,1413624,1424572,31630025,10948,214188647,22882,4
102724734,LOC102724734,chr20,F,19047398,19050391,31633018,2993,214191640,22883,3
102724826,ZNF337-AS1,chr20,F,25624044,25678074,31687048,54030,214245670,22884,9
102724950,LOC102724950,chr20,R,39655322,39661014,31692740,5692,214251362,22885,4
102724968,LOC102724968,chr20,R,40573976,40619185,31737949,45209,214296571,22886,4
102725201,LOC102725201,chr20,R,35476373,35491205,31752781,14832,214311403,22887,3
103504732,MIR941-5,chr20,F,63919867,63919939,31752853,72,214311475,22888,0
105369158,LOC105369158,chr20,R,58289904,58305718,31768667,15814,214327289,22889,2
105369209,LOC105369209,chr20,F,62227875,62235050,31775842,7175,214334464,22890,2
105369219,LOC105369219,chr20,R,1692912,1727566,31810496,34654,214369118,22891,7
105372491,LOC105372491,chr20,F,660778,692740,31842458,31962,214401080,22892,2
105372492,LOC105372492,chr20,F,913547,938162,31867073,24615,214425695,22893,2
105372493,LOC105372493,chr20,R,1027719,1118497,31957851,90778,214516473,22894,4
105372494,LOC105372494,chr20,R,1016846,1025695,31966700,8849,214525322,22895,5
105372495,LOC105372495,chr20,F,1175045,1179952,31971607,4907,214530229,22896,1
105372496,LOC105372496,chr20,F,1185660,1191878,31977825,6218,214536447,22897,2
105372497,LOC105372497,chr20,R,1405145,1411146,31983826,6001,214542448,22898,2
105372498,LOC105372498,chr20,R,1515293,1521871,31990404,6578,214549026,22899,2
105372499,LOC105372499,chr20,F,1512514,1540023,32017913,27509,214576535,22900,3
105372502,LOC105372502,chr20,F,2194049,2201397,32025261,7348,214583883,22901,2
105372503,LOC105372503,chr20,R,2296077,2301491,32030675,5414,214589297,22902,2
105372504,LOC105372504,chr20,R,2534527,2543543,32039691,9016,214598313,22903,2
105372505,LOC105372505,chr20,R,2613358,2644140,32070473,30782,214629095,22904,4
105372506,LOC105372506,chr20,R,2703711,2709578,32076340,5867,214634962,22905,1
105372507,LOC105372507,chr20,R,2667712,2692614,32101242,24902,214659864,22906,4
105372508,LOC105372508,chr20,R,3417035,3430842,32115049,13807,214673671,22907,2
105372509,LOC105372509,chr20,F,3408016,3420788,32127821,12772,214686443,22908,2
105372510,LOC105372510,chr20,R,4564340,4572084,32135565,7744,214694187,22909,2
105372511,LOC105372511,chr20,R,4777722,4779349,32137192,1627,214695814,22910,1
105372512,LOC105372512,chr20,R,5059228,5069347,32147311,10119,214705933,22911,3
105372513,LOC105372513,chr20,R,5480785,5489424,32155950,8639,214714572,22912,3
105372514,LOC105372514,chr20,R,5703631,5708551,32160870,4920,214719492,22913,2
105372515,LOC105372515,chr20,R,5831327,5833217,32162760,1890,214721382,22914,2
105372516,LOC105372516,chr20,R,6730790,6736277,32168247,5487,214726869,22915,3
105372517,LOC105372517,chr20,R,6765589,6767484,32170142,1895,214728764,22916,2
105372518,LOC105372518,chr20,F,7698352,7724996,32196786,26644,214755408,22917,5
105372519,LOC105372519,chr20,R,7848221,7879444,32228009,31223,214786631,22918,2
105372520,LOC105372520,chr20,F,8018551,8028623,32238081,10072,214796703,22919,6
105372521,LOC105372521,chr20,R,8624468,8657173,32270786,32705,214829408,22920,5
105372522,LOC105372522,chr20,F,8962198,8968281,32276869,6083,214835491,22921,1
105372523,LOC105372523,chr20,F,9563014,9616108,32329963,53094,214888585,22922,4
105372524,LOC105372524,chr20,F,10172430,10200528,32358061,28098,214916683,22923,5
105372525,LOC105372525,chr20,F,10843775,10852803,32367089,9028,214925711,22924,3
105372526,LOC105372526,chr20,R,10659559,10663956,32371486,4397,214930108,22925,1
105372527,LOC105372527,chr20,F,11157484,11158782,32372784,1298,214931406,22926,2
105372528,LOC105372528,chr20,R,11171602,11178453,32379635,6851,214938257,22927,2
105372529,LOC105372529,chr20,R,11309807,11427287,32497115,117480,215055737,22928,2
105372530,LOC105372530,chr20,R,11713040,11728808,32512883,15768,215071505,22929,3
105372531,LOC105372531,chr20,R,11952878,11958943,32518948,6065,215077570,22930,2
105372532,LOC105372532,chr20,R,12651075,12673203,32541076,22128,215099698,22931,5
105372533,LOC105372533,chr20,F,12649844,12692468,32583700,42624,215142322,22932,2
105372534,LOC105372534,chr20,R,12374135,12393694,32603259,19559,215161881,22933,2
105372535,LOC105372535,chr20,F,12935947,12940821,32608133,4874,215166755,22934,4
105372536,LOC105372536,chr20,R,13104759,13125077,32628451,20318,215187073,22935,1
105372537,LOC105372537,chr20,F,13321161,13325145,32632435,3984,215191057,22936,1
105372538,LOC105372538,chr20,R,13261419,13325070,32696086,63651,215254708,22937,3
105372539,LOC105372539,chr20,F,13239079,13245243,32702250,6164,215260872,22938,3
105372540,LOC105372540,chr20,R,13787358,13791782,32706674,4424,215265296,22939,2
105372541,LOC105372541,chr20,R,16589896,16605499,32722277,15603,215280899,22940,11
105372542,LOC105372542,chr20,F,16610525,16640181,32751933,29656,215310555,22941,3
105372543,LOC105372543,chr20,R,16965437,16968001,32754497,2564,215313119,22942,2
105372544,LOC105372544,chr20,F,17122177,17196938,32829258,74761,215387880,22943,4
105372545,LOC105372545,chr20,R,17216770,17218180,32830668,1410,215389290,22944,2
105372546,LOC105372546,chr20,R,17264081,17327491,32894078,63410,215452700,22945,5
105372547,LOC105372547,chr20,R,17697615,17699583,32896046,1968,215454668,22946,1
105372548,LOC105372548,chr20,F,17872635,17883258,32906669,10623,215465291,22947,3
105372549,LOC105372549,chr20,R,17912578,17925217,32919308,12639,215477930,22948,1
105372550,LOC105372550,chr20,R,18312987,18359309,32965630,46322,215524252,22949,7
105372551,LOC105372551,chr20,R,18270623,18271104,32966111,481,215524733,22950,1
105372552,LOC105372552,chr20,R,18579500,18587830,32974441,8330,215533063,22951,2
105372553,LOC105372553,chr20,F,20022506,20025611,32977546,3105,215536168,22952,1
105372554,LOC105372554,chr20,F,20232045,20232873,32978374,828,215536996,22953,1
105372555,LOC105372555,chr20,F,20729259,20749637,32998752,20378,215557374,22954,4
105372556,LOC105372556,chr20,R,21087615,21106341,33017478,18726,215576100,22955,4
105372557,LOC105372557,chr20,R,21145661,21162880,33034697,17219,215593319,22956,1
105372558,LOC105372558,chr20,F,21397336,21441456,33078817,44120,215637439,22957,9
105372560,LOC105372560,chr20,F,22217053,22223265,33085029,6212,215643651,22958,2
105372561,LOC105372561,chr20,R,22260494,22275074,33099609,14580,215658231,22959,4
105372562,LOC105372562,chr20,R,22449440,22467245,33117414,17805,215676036,22960,4
105372563,LOC105372563,chr20,R,22468026,22471553,33120941,3527,215679563,22961,2
105372564,LOC105372564,chr20,R,22510142,22524166,33134965,14024,215693587,22962,3
105372565,LOC105372565,chr20,F,22596075,22618421,33157311,22346,215715933,22963,2
105372566,LOC105372566,chr20,R,22667514,22686694,33176491,19180,215735113,22964,4
105372567,LOC105372567,chr20,F,22772812,22774034,33177713,1222,215736335,22965,2
105372568,LOC105372568,chr20,F,22805756,22824384,33196341,18628,215754963,22966,2
105372569,LOC105372569,chr20,F,23030888,23039219,33204672,8331,215763294,22967,2
105372570,LOC105372570,chr20,R,23346626,23348876,33206922,2250,215765544,22968,1
105372571,LOC105372571,chr20,R,23320999,23335863,33221786,14864,215780408,22969,3
105372572,LOC105372572,chr20,R,23309455,23351410,33263741,41955,215822363,22970,2
105372573,LOC105372573,chr20,F,23667148,23674842,33271435,7694,215830057,22971,3
105372574,LOC105372574,chr20,F,23722546,23729631,33278520,7085,215837142,22972,2
105372575,LOC105372575,chr20,F,23810658,23821189,33289051,10531,215847673,22973,2
105372576,LOC105372576,chr20,R,24092277,24112234,33309008,19957,215867630,22974,2
105372577,LOC105372577,chr20,R,24309216,24318114,33317906,8898,215876528,22975,3
105372578,LOC105372578,chr20,F,24929216,24932985,33321675,3769,215880297,22976,2
105372579,LOC105372579,chr20,R,25229227,25237008,33329456,7781,215888078,22977,3
105372580,LOC105372580,chr20,R,25238998,25247970,33338428,8972,215897050,22978,2
105372581,LOC105372581,chr20,R,25394252,25408643,33352819,14391,215911441,22979,2
105372582,LOC105372582,chr20,F,25751190,25768644,33370273,17454,215928895,22980,2
105372583,LOC105372583,chr20,R,25738900,25750488,33381861,11588,215940483,22981,2
105372585,LOC105372585,chr20,R,24468225,24475800,33389436,7575,215948058,22982,4
105372586,LOC105372586,chr20,R,30292607,30297883,33394712,5276,215953334,22983,3
105372587,LOC105372587,chr20,R,30350381,30362209,33406540,11828,215965162,22984,2
105372588,LOC105372588,chr20,R,31604690,31605190,33407040,500,215965662,22985,1
105372589,LOC105372589,chr20,F,31677433,31716844,33446451,39411,216005073,22986,5
105372590,LOC105372590,chr20,R,32362608,32393526,33477369,30918,216035991,22987,2
105372591,LOC105372591,chr20,F,32561039,32574387,33490717,13348,216049339,22988,2
105372592,LOC105372592,chr20,F,32536592,32541950,33496075,5358,216054697,22989,2
105372593,LOC105372593,chr20,R,33242535,33257496,33511036,14961,216069658,22990,2
105372594,LOC105372594,chr20,F,33298755,33299853,33512134,1098,216070756,22991,1
105372595,LOC105372595,chr20,F,33590177,33596981,33518938,6804,216077560,22992,2
105372596,LOC105372596,chr20,R,34014736,34017502,33521704,2766,216080326,22993,1
105372597,LOC105372597,chr20,R,34002856,34003619,33522467,763,216081089,22994,1
105372598,LOC105372598,chr20,R,33989479,33992292,33525280,2813,216083902,22995,1
105372599,LOC105372599,chr20,R,34703646,34704182,33525816,536,216084438,22996,1
105372601,LOC105372601,chr20,R,34991406,34993743,33528153,2337,216086775,22997,2
105372602,LOC105372602,chr20,R,36213336,36236461,33551278,23125,216109900,22998,2
105372603,LOC105372603,chr20,R,36174994,36197852,33574136,22858,216132758,22999,2
105372604,LOC105372604,chr20,R,36147280,36149901,33576757,2621,216135379,23000,1
105372605,LOC105372605,chr20,F,37281183,37289076,33584650,7893,216143272,23001,2
105372606,LOC105372606,chr20,R,37337439,37344570,33591781,7131,216150403,23002,1
105372608,LOC105372608,chr20,F,37571117,37583924,33604588,12807,216163210,23003,3
105372609,LOC105372609,chr20,R,37686041,37691276,33609823,5235,216168445,23004,4
105372610,LOC105372610,chr20,F,37751145,37757532,33616210,6387,216174832,23005,2
105372611,LOC105372611,chr20,F,38109438,38112432,33619204,2994,216177826,23006,2
105372612,LOC105372612,chr20,R,38288599,38317559,33648164,28960,216206786,23007,3
105372613,LOC105372613,chr20,R,39785313,39788283,33651134,2970,216209756,23008,2
105372614,LOC105372614,chr20,F,39757262,39813637,33707509,56375,216266131,23009,5
105372615,LOC105372615,chr20,F,40022594,40044813,33729728,22219,216288350,23010,4
105372616,LOC105372616,chr20,F,40116425,40121077,33734380,4652,216293002,23011,3
105372617,LOC105372617,chr20,R,40298751,40301661,33737290,2910,216295912,23012,2
105372618,LOC105372618,chr20,R,40458150,40466842,33745982,8692,216304604,23013,2
105372619,LOC105372619,chr20,R,40531463,40543923,33758442,12460,216317064,23014,2
105372620,LOC105372620,chr20,R,40677231,40678675,33759886,1444,216318508,23015,1
105372621,LOC105372621,chr20,R,40995613,41005881,33770154,10268,216328776,23016,1
105372622,LOC105372622,chr20,R,42014561,42024246,33779839,9685,216338461,23017,4
105372623,LOC105372623,chr20,F,42949324,42955794,33786309,6470,216344931,23018,2
105372624,LOC105372624,chr20,F,42630823,42648771,33804257,17948,216362879,23019,6
105372625,LOC105372625,chr20,R,43820924,43824807,33808140,3883,216366762,23020,2
105372626,LOC105372626,chr20,F,43894695,43895292,33808737,597,216367359,23021,1
105372628,LOC105372628,chr20,R,44211498,44220256,33817495,8758,216376117,23022,2
105372629,LOC105372629,chr20,R,44347766,44355780,33825509,8014,216384131,23023,6
105372630,LOC105372630,chr20,F,45230840,45290352,33885021,59512,216443643,23024,7
105372631,LOC105372631,chr20,F,45427317,45446730,33904434,19413,216463056,23025,4
105372632,LOC105372632,chr20,F,46022983,46023581,33905032,598,216463654,23026,1
105372633,LOC105372633,chr20,F,46406767,46444971,33943236,38204,216501858,23027,3
105372634,LOC105372634,chr20,F,46387699,46393520,33949057,5821,216507679,23028,2
105372635,LOC105372635,chr20,F,47651282,47652327,33950102,1045,216508724,23029,1
105372636,LOC105372636,chr20,R,47840983,47843284,33952403,2301,216511025,23030,3
105372637,LOC105372637,chr20,F,47950809,47961287,33962881,10478,216521503,23031,6
105372638,LOC105372638,chr20,F,48054522,48057838,33966197,3316,216524819,23032,1
105372639,LOC105372639,chr20,F,48024794,48067686,34009089,42892,216567711,23033,4
105372640,LOC105372640,chr20,F,48119690,48126814,34016213,7124,216574835,23034,1
105372641,LOC105372641,chr20,F,48192337,48202756,34026632,10419,216585254,23035,5
105372642,LOC105372642,chr20,R,48216270,48231631,34041993,15361,216600615,23036,2
105372643,LOC105372643,chr20,F,48394161,48399443,34047275,5282,216605897,23037,2
105372644,LOC105372644,chr20,F,48409271,48410716,34048720,1445,216607342,23038,1
105372645,LOC105372645,chr20,F,48471319,48477559,34054960,6240,216613582,23039,1
105372646,LOC105372646,chr20,R,48526379,48563403,34091984,37024,216650606,23040,4
105372648,LOC105372648,chr20,R,48835601,48888173,34144556,52572,216703178,23041,2
105372649,LOC105372649,chr20,F,49331412,49340733,34153877,9321,216712499,23042,2
105372650,LOC105372650,chr20,F,49517320,49520374,34156931,3054,216715553,23043,1
105372651,LOC105372651,chr20,F,49594584,49602528,34164875,7944,216723497,23044,2
105372652,LOC105372652,chr20,R,49764898,49775396,34175373,10498,216733995,23045,4
105372653,LOC105372653,chr20,F,49915821,49928854,34188406,13033,216747028,23046,2
105372654,LOC105372654,chr20,R,50029090,50030477,34189793,1387,216748415,23047,2
105372655,LOC105372655,chr20,R,50053030,50057196,34193959,4166,216752581,23048,3
105372656,LOC105372656,chr20,F,50252722,50264246,34205483,11524,216764105,23049,2
105372657,LOC105372657,chr20,F,50350697,50368831,34223617,18134,216782239,23050,2
105372658,LOC105372658,chr20,F,50378608,50397021,34242030,18413,216800652,23051,2
105372659,LOC105372659,chr20,F,50667519,50674627,34249138,7108,216807760,23052,4
105372660,LOC105372660,chr20,R,50871176,50874367,34252329,3191,216810951,23053,2
105372661,LOC105372661,chr20,F,51117389,51142931,34277871,25542,216836493,23054,4
105372662,LOC105372662,chr20,R,51117875,51122709,34282705,4834,216841327,23055,2
105372663,LOC105372663,chr20,F,51366363,51396988,34313330,30625,216871952,23056,2
105372664,LOC105372664,chr20,F,52080870,52096481,34328941,15611,216887563,23057,1
105372665,LOC105372665,chr20,R,52609796,52619168,34338313,9372,216896935,23058,4
105372666,LOC105372666,chr20,F,52540822,52693843,34491334,153021,217049956,23059,11
105372667,LOC105372667,chr20,R,52469240,52471666,34493760,2426,217052382,23060,2
105372668,LOC105372668,chr20,R,52840945,52895423,34548238,54478,217106860,23061,4
105372669,LOC105372669,chr20,R,53434173,53461505,34575570,27332,217134192,23062,4
105372670,LOC105372670,chr20,R,53399261,53401377,34577686,2116,217136308,23063,1
105372671,LOC105372671,chr20,R,53514110,53525280,34588856,11170,217147478,23064,3
105372672,LOC105372672,chr20,F,53608353,53634615,34615118,26262,217173740,23065,2
105372673,LOC105372673,chr20,R,53744988,53751251,34621381,6263,217180003,23066,2
105372674,LOC105372674,chr20,F,53845513,53852486,34628354,6973,217186976,23067,4
105372675,LOC105372675,chr20,F,54178397,54189802,34639759,11405,217198381,23068,2
105372676,LOC105372676,chr20,R,55577626,55745007,34807140,167381,217365762,23069,6
105372677,LOC105372677,chr20,F,55803899,55829685,34832926,25786,217391548,23070,2
105372678,LOC105372678,chr20,F,55839010,55858371,34852287,19361,217410909,23071,4
105372679,LOC105372679,chr20,F,56036766,56040487,34856008,3721,217414630,23072,1
105372680,LOC105372680,chr20,R,56142471,56169754,34883291,27283,217441913,23073,3
105372681,LOC105372681,chr20,F,56497537,56499022,34884776,1485,217443398,23074,1
105372682,LOC105372682,chr20,F,56558910,56596608,34922474,37698,217481096,23075,5
105372683,LOC105372683,chr20,F,56975133,56985778,34933119,10645,217491741,23076,3
105372684,LOC105372684,chr20,R,57048748,57051527,34935898,2779,217494520,23077,2
105372685,LOC105372685,chr20,R,57117188,57135984,34954694,18796,217513316,23078,5
105372686,LOC105372686,chr20,R,57158788,57162383,34958289,3595,217516911,23079,1
105372687,LOC105372687,chr20,R,57274074,57350728,35034943,76654,217593565,23080,12
105372688,LOC105372688,chr20,F,57460473,57463525,35037995,3052,217596617,23081,2
105372689,LOC105372689,chr20,F,57546264,57548897,35040628,2633,217599250,23082,1
105372690,LOC105372690,chr20,F,57580578,57582585,35042635,2007,217601257,23083,2
105372691,LOC105372691,chr20,F,57710537,57712775,35044873,2238,217603495,23084,1
105372692,LOC105372692,chr20,F,57720480,57726370,35050763,5890,217609385,23085,5
105372693,LOC105372693,chr20,R,57985846,57996859,35061776,11013,217620398,23086,5
105372694,LOC105372694,chr20,R,58164069,58179679,35077386,15610,217636008,23087,2
105372695,LOC105372695,chr20,F,58773391,58774811,35078806,1420,217637428,23088,1
105372696,LOC105372696,chr20,F,59470082,59471988,35080712,1906,217639334,23089,1
105372697,LOC105372697,chr20,R,60332373,60335793,35084132,3420,217642754,23090,1
105372698,LOC105372698,chr20,F,60257757,60261182,35087557,3425,217646179,23091,2
105372699,LOC105372699,chr20,F,60748289,60777746,35117014,29457,217675636,23092,10
105372700,LOC105372700,chr20,F,60804744,60808967,35121237,4223,217679859,23093,3
105372701,LOC105372701,chr20,F,61179147,61185077,35127167,5930,217685789,23094,2
105372703,LOC105372703,chr20,R,61433089,61437453,35131531,4364,217690153,23095,4
105372704,LOC105372704,chr20,R,62000727,62002317,35133121,1590,217691743,23096,1
105372705,LOC105372705,chr20,F,62066199,62068533,35135455,2334,217694077,23097,1
105372706,LOC105372706,chr20,R,62101142,62124048,35158361,22906,217716983,23098,4
105372707,LOC105372707,chr20,R,62305431,62308014,35160944,2583,217719566,23099,1
105372708,LOC105372708,chr20,R,62373816,62378978,35166106,5162,217724728,23100,1
105372709,LOC105372709,chr20,R,62402230,62406314,35170190,4084,217728812,23101,1
105372710,LOC105372710,chr20,F,62427791,62449546,35191945,21755,217750567,23102,7
105372711,LOC105372711,chr20,F,62481284,62490856,35201517,9572,217760139,23103,2
105372712,LOC105372712,chr20,R,62601376,62603809,35203950,2433,217762572,23104,1
105372713,LOC105372713,chr20,F,62589664,62598358,35212644,8694,217771266,23105,1
105372714,LOC105372714,chr20,F,33140336,33163020,35235328,22684,217793950,23106,6
105372715,LOC105372715,chr20,F,49608934,49633617,35260011,24683,217818633,23107,6
105372716,LOC105372716,chr20,R,62783217,62794298,35271092,11081,217829714,23108,4
105372717,LOC105372717,chr20,F,62861425,62878190,35287857,16765,217846479,23109,3
105372718,LOC105372718,chr20,R,63025481,63028012,35290388,2531,217849010,23110,2
105372719,LOC105372719,chr20,F,63116221,63122754,35296921,6533,217855543,23111,2
105372720,LOC105372720,chr20,F,63447023,63450897,35300795,3874,217859417,23112,4
105372721,LOC105372721,chr20,F,63435345,63436091,35301541,746,217860163,23113,1
105372722,LOC105372722,chr20,F,63419678,63424047,35305910,4369,217864532,23114,2
105372724,LOC105372724,chr20,F,63409538,63413375,35309747,3837,217868369,23115,2
105372725,LOC105372725,chr20,F,63502057,63505726,35313416,3669,217872038,23116,2
105372726,LOC105372726,chr20,F,63653151,63655003,35315268,1852,217873890,23117,1
105372727,LOC105372727,chr20,R,64139444,64143682,35319506,4238,217878128,23118,3
105376973,LOC105376973,chr20,R,37499706,37517257,35337057,17551,217895679,23119,1
105376977,LOC105376977,chr20,F,46204442,46212987,35345602,8545,217904224,23120,2
105376979,LOC105376979,chr20,F,47831870,47834983,35348715,3113,217907337,23121,1
105376980,LOC105376980,chr20,R,47894361,47899523,35353877,5162,217912499,23122,1
105376985,LOC105376985,chr20,F,52660164,52667932,35361645,7768,217920267,23123,5
105376986,LOC105376986,chr20,F,52210622,52357555,35508578,146933,218067200,23124,5
105376989,LOC105376989,chr20,F,56101773,56103602,35510407,1829,218069029,23125,1
105376992,LOC105376992,chr20,F,58003849,58004580,35511138,731,218069760,23126,1
105376995,LOC105376995,chr20,F,62534031,62536728,35513835,2697,218072457,23127,3
105376996,LOC105376996,chr20,R,63117065,63130287,35527057,13222,218085679,23128,3
105377058,LOC105377058,chr20,R,18945738,18946078,35527397,340,218086019,23129,1
105377060,LOC105377060,chr20,F,22744669,22746973,35529701,2304,218088323,23130,4
105379476,LOC105379476,chr20,R,29401774,29408058,35535985,6284,218094607,23131,3
105379477,LOC105379477,chr20,F,29454922,29476568,35557631,21646,218116253,23132,2
105379478,LOC105379478,chr20,F,29548673,29559760,35568718,11087,218127340,23133,2
105379481,LOC105379481,chr20,F,30514051,30531183,35585850,17132,218144472,23134,2
105379483,LOC105379483,chr20,R,30610097,30613167,35588920,3070,218147542,23135,1
104,ADARB1,chr21,F,45074577,45226563,151986,151986,218299528,23136,18
326,AIRE,chr21,F,44285837,44298219,164368,12382,218311910,23137,13
351,APP,chr21,R,25880549,26171128,454947,290579,218602489,23138,19
522,ATP5J,chr21,R,25724479,25735654,466122,11175,218613664,23139,4
539,ATP5O,chr21,R,33903452,33915854,478524,12402,218626066,23140,6
571,BACH1,chr21,F,29298794,29361896,541626,63102,218689168,23141,10
754,PTTG1IP,chr21,R,44849584,44873903,565945,24319,218713487,23142,5
755,C21orf2,chr21,R,44328943,44339402,576404,10459,218723946,23143,8
757,TMEM50B,chr21,R,33432485,33480009,623928,47524,218771470,23144,9
861,RUNX1,chr21,R,34787800,35049310,885438,261510,219032980,23145,11
873,CBR1,chr21,F,36069923,36073177,888692,3254,219036234,23146,2
874,CBR3,chr21,F,36134899,36146562,900355,11663,219047897,23147,3
875,CBS,chr21,R,43053190,43076868,924033,23678,219071575,23148,23
1291,COL6A1,chr21,F,45981748,46005049,947334,23301,219094876,23149,34
1292,COL6A2,chr21,F,46097605,46132849,982578,35244,219130120,23150,30
1409,CRYAA,chr21,F,43169007,43172810,986381,3803,219133923,23151,3
1476,CSTB,chr21,R,43773664,43776375,989092,2711,219136634,23152,2
1525,CXADR,chr21,F,17512905,17633323,1109510,120418,219257052,23153,9
1826,DSCAM,chr21,R,40010998,40847113,1945625,836115,220093167,23154,32
1827,RCAN1,chr21,R,34516441,34615142,2044326,98701,220191868,23155,8
1859,DYRK1A,chr21,F,37365789,37515376,2193913,149587,220341455,23156,17
2078,ERG,chr21,R,38367260,38661833,2488486,294573,220636028,23157,17
2114,ETS2,chr21,F,38805306,38824955,2508135,19649,220655677,23158,11
2551,GABPA,chr21,F,25734946,25772460,2545649,37514,220693191,23159,11
2618,GART,chr21,R,33503930,33542917,2584636,38987,220732178,23160,22
2897,GRIK1,chr21,R,29536932,29939964,2987668,403032,221135210,23161,18
3141,HLCS,chr21,R,36750887,36990246,3227027,239359,221374569,23162,19
3150,HMGN1,chr21,R,39342314,39349121,3233834,6807,221381376,23163,8
3275,PRMT2,chr21,F,46635152,46665685,3264367,30533,221411909,23164,11
3454,IFNAR1,chr21,F,33324442,33359823,3299748,35381,221447290,23165,12
3455,IFNAR2,chr21,F,33229894,33264513,3334367,34619,221481909,23166,9
3460,IFNGR2,chr21,F,33402895,33437521,3368993,34626,221516535,23167,8
3588,IL10RB,chr21,F,33266359,33297234,3399868,30875,221547410,23168,6
3689,ITGB2,chr21,R,44885948,44928873,3442793,42925,221590335,23169,16
3753,KCNE1,chr21,R,34418714,34512275,3536354,93561,221683896,23170,8
3763,KCNJ6,chr21,R,37617481,37919731,3838604,302250,221986146,23171,5
3772,KCNJ15,chr21,F,38229914,38303126,3911816,73212,222059358,23172,9
4047,LSS,chr21,R,46188445,46228824,3952195,40379,222099737,23173,23
4599,MX1,chr21,F,41420328,41459214,3991081,38886,222138623,23174,21
4600,MX2,chr21,F,41361985,41408943,4038039,46958,222185581,23175,16
4685,NCAM2,chr21,F,20998314,21540630,4580355,542316,222727897,23176,25
4731,NDUFV3,chr21,F,42893267,42909670,4596758,16403,222744300,23177,4
5116,PCNT,chr21,F,46324099,46445769,4718428,121670,222865970,23178,49
5121,PCP4,chr21,F,39867420,39929397,4780405,61977,222927947,23179,2
5152,PDE9A,chr21,F,42653751,42775520,4902174,121769,223049716,23180,24
5211,PFKL,chr21,F,44300033,44327381,4929522,27348,223077064,23181,26
5316,PKNOX1,chr21,F,42974509,43033931,4988944,59422,223136486,23182,10
5651,TMPRSS15,chr21,R,18269106,18403806,5123644,134700,223271186,23183,26
5822,PWP2,chr21,F,44107289,44131181,5147536,23892,223295078,23184,21
6285,S100B,chr21,R,46598617,46605122,5154041,6505,223301583,23185,2
6450,SH3BGR,chr21,F,39445855,39515506,5223692,69651,223371234,23186,9
6453,ITSN1,chr21,F,33642399,33889305,5470598,246906,223618140,23187,43
6493,SIM2,chr21,F,36699132,36750219,5521685,51087,223669227,23188,12
6526,SLC5A3,chr21,F,34073522,34106262,5554425,32740,223701967,23189,1
6573,SLC19A1,chr21,R,45502516,45563126,5615035,60610,223762577,23190,17
6612,SUMO3,chr21,R,44805616,44818129,5627548,12513,223775090,23191,3
6647,SOD1,chr21,F,31659621,31668931,5636858,9310,223784400,23192,4
6651,SON,chr21,F,33543037,33577514,5671335,34477,223818877,23193,14
6782,HSPA13,chr21,R,14371114,14383188,5683409,12074,223830951,23194,4
7031,TFF1,chr21,R,42362281,42366535,5687663,4254,223835205,23195,2
7032,TFF2,chr21,R,42346356,42351099,5692406,4743,223839948,23196,3
7033,TFF3,chr21,R,42311666,42315596,5696336,3930,223843878,23197,2
7074,TIAM1,chr21,R,31118417,31559977,6137896,441560,224285438,23198,32
7109,TRAPPC10,chr21,F,44012324,44106552,6232124,94228,224379666,23199,27
7113,TMPRSS2,chr21,R,41464550,41508158,6275732,43608,224423274,23200,16
7179,TPTE,chr21,F,10521513,10606270,6360489,84757,224508031,23201,23
7226,TRPM2,chr21,F,44350125,44443081,6453445,92956,224600987,23202,35
7267,TTC3,chr21,F,37073253,37203107,6583299,129854,224730841,23203,49
7307,U2AF1,chr21,R,43092955,43107578,6597922,14623,224745464,23204,8
7327,UBE2G2,chr21,R,44768579,44801836,6631179,33257,224778721,23205,6
7485,WRB,chr21,F,39379675,39397889,6649393,18214,224796935,23206,6
8204,NRIP1,chr21,R,14961234,15065903,6754062,104669,224901604,23207,8
8208,CHAF1B,chr21,F,36377056,36416827,6793833,39771,224941375,23208,17
8209,C21orf33,chr21,F,44133611,44145723,6805945,12112,224953487,23209,8
8566,PDXK,chr21,F,43719096,43762307,6849156,43211,224996698,23210,17
8568,RRP1,chr21,F,43789534,43804102,6863724,14568,225011266,23211,14
8624,PSMG1,chr21,R,39175445,39183514,6871793,8069,225019335,23212,6
8867,SYNJ1,chr21,R,32628758,32728040,6971075,99282,225118617,23213,33
8888,MCM3AP,chr21,R,46235124,46286559,7022510,51435,225170052,23214,29
9073,CLDN8,chr21,R,30214005,30216151,7024656,2146,225172198,23215,0
9510,ADAMTS1,chr21,R,26836286,26845409,7033779,9123,225181321,23216,8
9619,ABCG1,chr21,F,42199688,42304387,7138478,104699,225286020,23217,19
9875,URB1,chr21,R,32311018,32393003,7220463,81985,225368005,23218,38
9946,CRYZL1,chr21,R,33589340,33641854,7272977,52514,225420519,23219,12
9980,DOPEY2,chr21,F,36156782,36294274,7410469,137492,225558011,23220,38
9992,KCNE2,chr21,F,34364023,34371141,7417587,7118,225565129,23221,1
10069,RWDD2B,chr21,R,29004777,29019371,7432181,14594,225579723,23222,5
10215,OLIG2,chr21,F,33025907,33029196,7435470,3289,225583012,23223,1
10281,DSCR4,chr21,R,38006552,38121360,7550278,114808,225697820,23224,4
10311,DSCR3,chr21,R,37223424,37268124,7594978,44700,225742520,23225,9
10317,B3GALT5,chr21,F,39612939,39662889,7644928,49950,225792470,23226,4
10600,USP16,chr21,F,29024616,29054488,7674800,29872,225822342,23227,18
10694,CCT8,chr21,R,29056321,29073797,7692276,17476,225839818,23228,15
10785,WDR4,chr21,R,42843079,42879589,7728786,36510,225876328,23229,12
10841,FTCD,chr21,R,46136150,46155856,7748492,19706,225896034,23230,15
10950,BTG3,chr21,R,17593649,17612950,7767793,19301,225915335,23231,7
11077,HSF2BP,chr21,R,43529185,43659499,7898107,130314,226045649,23232,9
11096,ADAMTS5,chr21,R,26917911,26967120,7947316,49209,226094858,23233,7
23076,RRP1B,chr21,F,43659550,43696079,7983845,36529,226131387,23234,15
23181,DIP2A,chr21,F,46458941,46584263,8109167,125322,226256709,23235,43
23275,POFUT2,chr21,R,45263927,45287899,8133139,23972,226280681,23236,13
23308,ICOSLG,chr21,R,44216970,44241447,8157616,24477,226305158,23237,9
23515,MORC3,chr21,F,36320188,36376646,8214074,56458,226361616,23238,19
23562,CLDN14,chr21,R,36460620,36580085,8333539,119465,226481081,23239,8
25825,BACE2,chr21,F,41167800,41282534,8448273,114734,226595815,23240,8
25966,C2CD2,chr21,R,41885109,41953957,8517121,68848,226664663,23241,16
26046,LTN1,chr21,R,28928143,28992956,8581934,64813,226729476,23242,29
26285,CLDN17,chr21,R,30165922,30166653,8582665,731,226730207,23243,0
29104,N6AMT1,chr21,R,28872190,28885373,8595848,13183,226743390,23244,6
29761,USP25,chr21,F,15729946,15880072,8745974,150126,226893516,23245,28
29947,DNMT3L,chr21,R,44246338,44267138,8766774,20800,226914316,23246,12
29980,DONSON,chr21,R,33577550,33588708,8777932,11158,226925474,23247,9
30811,HUNK,chr21,F,31873314,32004064,8908682,130750,227056224,23248,10
49854,ZBTB21,chr21,R,41986830,42010387,8932239,23557,227079781,23249,5
51227,PIGP,chr21,R,37065363,37073158,8940034,7795,227087576,23250,6
53347,UBASH3A,chr21,F,42403861,42447688,8983861,43827,227131403,23251,16
53820,RIPPLY3,chr21,F,37006155,37019659,8997365,13504,227144907,23252,4
54014,BRWD1,chr21,R,39184175,39313819,9127009,129644,227274551,23253,42
54020,SLC37A1,chr21,F,42499631,42581440,9208818,81809,227356360,23254,23
54033,RBM11,chr21,F,14216105,14228372,9221085,12267,227368627,23255,4
54039,PCBP3,chr21,F,45849960,45942454,9313579,92494,227461121,23256,13
54055,CYP4F29P,chr21,R,13843132,13848364,9318811,5232,227466353,23257,5
54058,C21orf58,chr21,R,46300429,46323899,9342281,23470,227489823,23258,12
54059,YBEY,chr21,F,46286309,46313225,9369197,26916,227516739,23259,8
54064,LINC00160,chr21,R,34723806,34737182,9382573,13376,227530115,23260,5
54065,SMIM11,chr21,F,34375449,34389154,9396278,13705,227543820,23261,3
54067,C21orf62-AS1,chr21,F,32772099,32797707,9421886,25608,227569428,23262,3
54069,MIS18A,chr21,R,32268218,32279065,9432733,10847,227580275,23263,4
54072,LINC00158,chr21,R,25385819,25431701,9478615,45882,227626157,23264,4
54075,CHODL-AS1,chr21,R,17835671,17885608,9528552,49937,227676094,23265,2
54082,TSPEAR-AS1,chr21,F,44506043,44516575,9539084,10532,227686626,23266,6
54084,TSPEAR,chr21,R,44497891,44711580,9752773,213689,227900315,23267,12
54088,LINC00113,chr21,F,27722378,27751233,9781628,28855,227929170,23268,3
54089,LINC00112,chr21,F,41716435,41717582,9782775,1147,227930317,23269,2
54090,LINC00111,chr21,F,41679301,41697336,9800810,18035,227948352,23270,2
54093,SETD4,chr21,R,36034540,36060818,9827088,26278,227974630,23271,13
54097,FAM3B,chr21,F,41304222,41357727,9880593,53505,228028135,23272,10
54101,RIPK4,chr21,R,41739368,41767089,9908314,27721,228055856,23273,7
54102,CLIC6,chr21,F,34669291,34718227,9957250,48936,228104792,23274,6
54143,LINC00308,chr21,F,22098616,22116528,9975162,17912,228122704,23275,5
54148,MRPL39,chr21,R,25585655,25607846,9997353,22191,228144895,23276,11
54149,C21orf91,chr21,R,17788966,17819386,10027773,30420,228175315,23277,4
54943,DNAJC28,chr21,R,33488054,33491747,10031466,3693,228179008,23278,2
56245,C21orf62,chr21,R,32790672,32814181,10054975,23509,228202517,23279,3
56246,MRAP,chr21,F,32291812,32314784,10077947,22972,228225489,23280,5
56683,C21orf59,chr21,R,32601673,32612608,10088882,10935,228236424,23281,6
56894,AGPAT3,chr21,F,43865159,43987594,10211317,122435,228358859,23282,17
56911,MAP3K7CL,chr21,F,29077470,29175889,10309736,98419,228457278,23283,13
57466,SCAF4,chr21,R,31670999,31732118,10370855,61119,228518397,23284,19
58494,JAM2,chr21,F,25639281,25717562,10449136,78281,228596678,23285,11
59271,EVA1C,chr21,F,32411691,32515400,10552845,103709,228700387,23286,9
63977,PRDM15,chr21,R,41798224,41879482,10634103,81258,228781645,23287,37
64092,SAMSN1,chr21,R,14485227,14583402,10732278,98175,228879820,23288,13
64699,TMPRSS3,chr21,R,42371886,42396846,10757238,24960,228904780,23289,12
64968,MRPS6,chr21,F,34073522,34143034,10826750,69512,228974292,23290,2
80215,RUNX1-IT1,chr21,R,35037924,35039426,10828252,1502,228975794,23291,0
80781,COL18A1,chr21,F,45405136,45513720,10936836,108584,229084378,23292,42
81543,LRRC3,chr21,F,44455485,44458856,10940207,3371,229087749,23293,1
84221,SPATC1L,chr21,R,46161147,46185149,10964209,24002,229111751,23294,5
84536,LINC01547,chr21,R,44933283,44939913,10970839,6630,229118381,23295,4
84677,DSCR8,chr21,F,38121450,38156511,11005900,35061,229153442,23296,3
84996,URB1-AS1,chr21,F,32393132,32393960,11006728,828,229154270,23297,0
85319,BAGE2,chr21,F,10413531,10491615,11084812,78084,229232354,23298,9
85395,FAM207A,chr21,F,44939997,44976976,11121791,36979,229269333,23299,6
89765,RSPH1,chr21,R,42472485,42496354,11145660,23869,229293202,23300,8
89766,UMODL1,chr21,F,42031462,42142996,11257194,111534,229404736,23301,31
94104,PAXBP1,chr21,R,32733898,32771858,11295154,37960,229442696,23302,19
114036,LINC00310,chr21,F,34180676,34189919,11304397,9243,229451939,23303,2
114038,LINC00313,chr21,R,43462093,43478223,11320527,16130,229468069,23304,3
114041,B3GALT5-AS1,chr21,R,39597146,39612822,11336203,15676,229483745,23305,3
114043,TSPEAR-AS2,chr21,F,44517214,44518977,11337966,1763,229485508,23306,2
114044,MCM3AP-AS1,chr21,F,46229230,46251701,11360437,22471,229507979,23307,4
114614,MIR155HG,chr21,F,25562144,25575168,11373461,13024,229521003,23308,2
116159,CYYR1,chr21,R,26466208,26573284,11480537,107076,229628079,23309,5
116448,OLIG1,chr21,F,33070143,33072422,11482816,2279,229630358,23310,0
118421,LINC00161,chr21,F,28539317,28540355,11483854,1038,229631396,23311,1
140258,KRTAP13-1,chr21,F,30396073,30396822,11484603,749,229632145,23312,0
140290,TCP10L,chr21,R,32574840,32585535,11495298,10695,229642840,23313,4
140578,CHODL,chr21,F,17819594,18267373,11943077,447779,230090619,23314,11
149992,ANKRD30BP2,chr21,F,13038165,13118251,12023163,80086,230170705,23315,11
149998,LIPI,chr21,R,14108462,14211040,12125741,102578,230273283,23316,11
150000,ABCC13,chr21,F,14273798,14301386,12153329,27588,230300871,23317,6
150051,LOC150051,chr21,F,31559240,31560487,12154576,1247,230302118,23318,1
150082,LCA5L,chr21,R,39405843,39445793,12194526,39950,230342068,23319,13
150084,IGSF5,chr21,F,39725837,39802096,12270785,76259,230418327,23320,10
150094,SIK1,chr21,R,43414508,43427126,12283403,12618,230430945,23321,13
150135,LINC00479,chr21,R,41711519,41715775,12287659,4256,230435201,23322,5
150142,ZNF295-AS1,chr21,F,42009193,42024920,12303386,15727,230450928,23323,3
150147,UMODL1-AS1,chr21,R,42102133,42108534,12309787,6401,230457329,23324,1
191585,PLAC4,chr21,R,41175230,41185239,12319796,10009,230467338,23325,0
193629,LINC00189,chr21,F,29193493,29288205,12414508,94712,230562050,23326,1
246312,C21orf91-OT1,chr21,R,17777403,17792509,12429614,15106,230577156,23327,3
246705,LINC00314,chr21,F,28013362,28023209,12439461,9847,230587003,23328,1
254950,KRTAP15-1,chr21,F,30440327,30440780,12439914,453,230587456,23329,0
257203,DSCR9,chr21,F,37208502,37221736,12453148,13234,230600690,23330,2
259234,DSCR10,chr21,F,38206155,38208644,12455637,2489,230603179,23331,2
266917,D21S2088E,chr21,R,23361103,23384835,12479369,23732,230626911,23332,4
266919,LINC00307,chr21,R,30209150,30211783,12482002,2633,230629544,23333,2
282566,LINC00515,chr21,R,25582774,25583224,12482452,450,230629994,23334,0
284825,LOC284825,chr21,F,28048413,28137609,12571648,89196,230719190,23335,6
284827,KRTAP13-4,chr21,F,30430275,30430758,12572131,483,230719673,23336,0
284835,LINC00323,chr21,R,41141499,41148064,12578696,6565,230726238,23337,1
284836,LINC00319,chr21,F,43450023,43453893,12582566,3870,230730108,23338,2
284837,AATBC,chr21,R,43805757,43812567,12589376,6810,230736918,23339,1
317754,POTED,chr21,F,13610060,13641585,12620901,31525,230768443,23340,11
337878,KRTAP7-1,chr21,R,30829038,30829732,12621595,694,230769137,23341,0
337879,KRTAP8-1,chr21,R,30812696,30813252,12622151,556,230769693,23342,0
337880,KRTAP11-1,chr21,R,30880643,30881555,12623063,912,230770605,23343,0
337882,KRTAP19-1,chr21,R,30480044,30480317,12623336,273,230770878,23344,0
337959,KRTAP13-2,chr21,R,30371390,30372239,12624185,849,230771727,23345,0
337960,KRTAP13-3,chr21,R,30425392,30425912,12624705,520,230772247,23346,0
337963,KRTAP23-1,chr21,R,30348398,30348606,12624913,208,230772455,23347,0
337966,KRTAP6-1,chr21,R,30613685,30613904,12625132,219,230772674,23348,0
337967,KRTAP6-2,chr21,R,30598685,30598874,12625321,189,230772863,23349,0
337968,KRTAP6-3,chr21,F,30592439,30593055,12625937,616,230773479,23350,0
337969,KRTAP19-2,chr21,R,30487189,30487348,12626096,159,230773638,23351,0
337970,KRTAP19-3,chr21,R,30491463,30491957,12626590,494,230774132,23352,0
337971,KRTAP19-4,chr21,R,30496855,30497110,12626845,255,230774387,23353,0
337972,KRTAP19-5,chr21,R,30501871,30502090,12627064,219,230774606,23354,0
337973,KRTAP19-6,chr21,R,30541534,30541864,12627394,330,230774936,23355,0
337974,KRTAP19-7,chr21,R,30561097,30561289,12627586,192,230775128,23356,0
337975,KRTAP20-1,chr21,F,30616454,30616625,12627757,171,230775299,23357,0
337976,KRTAP20-2,chr21,F,30635263,30635461,12627955,198,230775497,23358,0
337977,KRTAP21-1,chr21,R,30755138,30755378,12628195,240,230775737,23359,0
337978,KRTAP21-2,chr21,R,30746950,30747202,12628447,252,230775989,23360,0
337979,KRTAP22-1,chr21,F,30601120,30601267,12628594,147,230776136,23361,0
337985,KRTAP20-3,chr21,F,30642863,30643136,12628867,273,230776409,23362,0
339622,LOC339622,chr21,F,24840549,25057746,12846064,217197,230993606,23363,3
353323,KRTAP12-2,chr21,R,44666188,44666927,12846803,739,230994345,23364,0
353332,KRTAP12-1,chr21,R,44681575,44682163,12847391,588,230994933,23365,0
353333,KRTAP10-10,chr21,F,44637355,44638455,12848491,1100,230996033,23366,0
378825,LINC00162,chr21,R,44999207,45004727,12854011,5520,231001553,23367,1
378828,LINC00317,chr21,R,21723292,21737319,12868038,14027,231015580,23368,2
378832,COL18A1-AS1,chr21,R,45419715,45425070,12873393,5355,231020935,23369,2
386672,KRTAP10-4,chr21,F,44573728,44575371,12875036,1643,231022578,23370,0
386674,KRTAP10-6,chr21,R,44591267,44592505,12876274,1238,231023816,23371,0
386675,KRTAP10-7,chr21,F,44600596,44602174,12877852,1578,231025394,23372,0
386676,KRTAP10-9,chr21,F,44627122,44628378,12879108,1256,231026650,23373,0
386677,KRTAP10-1,chr21,R,44539184,44540195,12880119,1011,231027661,23374,0
386678,KRTAP10-11,chr21,F,44646413,44647650,12881356,1237,231028898,23375,0
386679,KRTAP10-2,chr21,R,44550356,44551505,12882505,1149,231030047,23376,0
386680,KRTAP10-5,chr21,R,44579454,44580604,12883655,1150,231031197,23377,0
386681,KRTAP10-8,chr21,F,44612078,44612954,12884531,876,231032073,23378,0
386682,KRTAP10-3,chr21,R,44558022,44558760,12885269,738,231032811,23379,0
386683,KRTAP12-3,chr21,F,44657931,44658341,12885679,410,231033221,23380,0
386684,KRTAP12-4,chr21,R,44654212,44654659,12886126,447,231033668,23381,0
386685,KRTAP10-12,chr21,F,44697171,44698044,12886999,873,231034541,23382,0
387486,LINC00320,chr21,R,20742589,20803108,12947518,60519,231095060,23383,8
388813,LOC388813,chr21,R,14591391,14643107,12999234,51716,231146776,23384,6
388815,MIR99AHG,chr21,F,16070521,16609775,13538488,539254,231686030,23385,9
388818,KRTAP26-1,chr21,R,30319130,30320289,13539647,1159,231687189,23386,0
388830,LINC00316,chr21,R,45338589,45341990,13543048,3401,231690590,23387,1
391267,ANKRD20A11P,chr21,R,13943768,13980444,13579724,36676,231727266,23388,5
400863,LOC400863,chr21,F,33947933,33965164,13596955,17231,231744497,23389,2
400866,LINC00114,chr21,R,38738954,38773477,13631478,34523,231779020,23390,8
400867,LOC400867,chr21,R,38877290,38938429,13692617,61139,231840159,23391,3
400870,LOC400870,chr21,F,43363323,43363963,13693257,640,231840799,23392,0
406885,MIRLET7C,chr21,F,16539827,16539911,13693341,84,231840883,23393,0
406912,MIR125B2,chr21,F,16590236,16590325,13693430,89,231840972,23394,0
406947,MIR155,chr21,F,25573979,25574044,13693495,65,231841037,23395,0
407055,MIR99A,chr21,F,16539088,16539169,13693576,81,231841118,23396,0
441058,MGC39584,chr21,R,9781847,9821061,13732790,39214,231880332,23397,5
441956,LOC441956,chr21,R,13679218,13681132,13734704,1914,231882246,23398,0
642852,LOC642852,chr21,F,45288051,45297354,13744007,9303,231891549,23399,2
642976,GRIK1-AS1,chr21,F,29748174,29764006,13759839,15832,231907381,23400,4
643803,KRTAP24-1,chr21,R,30281308,30282958,13761489,1650,231909031,23401,0
643812,KRTAP27-1,chr21,R,30337012,30337694,13762171,682,231909713,23402,0
677846,SNORA80A,chr21,R,32377186,32377322,13762307,136,231909849,23403,0
727699,LINC00163,chr21,R,44989863,44994086,13766530,4223,231914072,23404,1
728039,SSR4P1,chr21,R,45070954,45073211,13768787,2257,231916329,23405,0
728299,KRTAP19-8,chr21,R,31038158,31038476,13769105,318,231916647,23406,0
728409,LINC01548,chr21,R,33165469,33170236,13773872,4767,231921414,23407,3
768219,MIR802,chr21,F,35720714,35720808,13773966,94,231921508,23408,0
100126693,LINC00322,chr21,R,43322208,43332039,13783797,9831,231931339,23409,2
100129027,LOC100129027,chr21,R,45827840,45836419,13792376,8579,231939918,23410,2
100131902,KRTAP25-1,chr21,R,30289144,30289514,13792746,370,231940288,23411,0
100132288,TEKT4P2,chr21,R,9068355,9129761,13854152,61406,232001694,23412,4
100133286,LOC100133286,chr21,R,36069641,36126640,13911151,56999,232058693,23413,3
100151643,KRTAP20-4,chr21,F,30620626,30620850,13911375,224,232058917,23414,0
100189284,TRG-GCC1-5,chr21,R,17454788,17454859,13911446,71,232058988,23415,0
100288287,KRTAP22-2,chr21,R,30590104,30590397,13911739,293,232059281,23416,0
100288323,KRTAP21-3,chr21,R,30718524,30718777,13911992,253,232059534,23417,0
100288432,IL10RB-AS1,chr21,R,33265631,33266260,13912621,629,232060163,23418,1
100379661,GRIK1-AS2,chr21,F,29596039,29630747,13947329,34708,232094871,23419,2
100422891,MIR4327,chr21,R,30375293,30375378,13947414,85,232094956,23420,0
100422920,MIR548X,chr21,R,18686089,18686164,13947489,75,232095031,23421,0
100423008,MIR3118-1,chr21,R,13644774,13644850,13947565,76,232095107,23422,0
100423018,MIR3156-3,chr21,R,13406383,13406460,13947642,77,232095184,23423,0
100423023,MIR3197,chr21,F,41167556,41167629,13947715,73,232095257,23424,0
100500815,MIR3687-1,chr21,F,8208843,8208904,13947776,61,232095318,23425,0
100500862,MIR3648-1,chr21,F,8208472,8208652,13947956,180,232095498,23426,0
100505727,LOC100505727,chr21,F,44485006,44493034,13955984,8028,232103526,23427,1
100505746,ITGB2-AS1,chr21,F,44921034,44929680,13964630,8646,232112172,23428,4
100505929,LINC01549,chr21,F,17438889,17449185,13974926,10296,232122468,23429,3
100506215,PAXBP1-AS1,chr21,F,32728113,32743122,13989935,15009,232137477,23430,4
100506334,LINC00649,chr21,F,33931211,33971186,14029910,39975,232177452,23431,2
100506385,LINC01426,chr21,F,34745824,34784886,14068972,39062,232216514,23432,3
100506403,LOC100506403,chr21,R,35372506,35580764,14277230,208258,232424772,23433,2
100506428,CBR3-AS1,chr21,R,36131766,36156308,14301772,24542,232449314,23434,4
100506492,DSCAM-AS1,chr21,F,40383082,40385358,14304048,2276,232451590,23435,2
100551499,LINC00159,chr21,R,32080480,32086295,14309863,5815,232457405,23436,1
100616148,MIR4760,chr21,R,40212351,40212431,14309943,80,232457485,23437,0
100616243,MIR4759,chr21,F,26953960,26954043,14310026,83,232457568,23438,0
100847013,MIR5692B,chr21,R,42950927,42951014,14310113,87,232457655,23439,0
100861510,LRRC3-AS1,chr21,R,44450985,44455284,14314412,4299,232461954,23440,3
100862692,DIP2A-IT1,chr21,F,46462470,46469306,14321248,6836,232468790,23441,3
100874006,TTC3-AS1,chr21,R,37187611,37194628,14328265,7017,232475807,23442,1
100874093,BRWD1-AS1,chr21,F,39315706,39323218,14335777,7512,232483319,23443,2
100874190,SAMSN1-AS1,chr21,F,14582201,14598303,14351879,16102,232499421,23444,4
100874236,COL18A1-AS2,chr21,R,45407385,45410065,14354559,2680,232502101,23445,3
100874322,BACH1-IT2,chr21,F,29372500,29373980,14356039,1480,232503581,23446,1
100874326,DSCAM-IT1,chr21,R,40618506,40630767,14368300,12261,232515842,23447,3
100996571,CYYR1-AS1,chr21,F,26405942,26569263,14531621,163321,232679163,23448,4
100996609,LINC01436,chr21,F,36005319,36008295,14534597,2976,232682139,23449,1
101927345,LOC101927345,chr21,R,9357430,9377128,14554295,19698,232701837,23450,7
101927615,LOC101927615,chr21,F,9045566,9064076,14572805,18510,232720347,23451,5
101927745,LOC101927745,chr21,R,15368446,15444674,14649033,76228,232796575,23452,13
101927797,LOC101927797,chr21,R,18561264,18759812,14847581,198548,232995123,23453,3
101927821,LINC01425,chr21,F,21746984,21797415,14898012,50431,233045554,23454,4
101927843,LOC101927843,chr21,R,22009157,22098459,14987314,89302,233134856,23455,5
101927869,LOC101927869,chr21,R,24304549,24321377,15004142,16828,233151684,23456,3
101927973,LOC101927973,chr21,R,28116093,28228667,15116716,112574,233264258,23457,5
101928107,LOC101928107,chr21,R,33111703,33123700,15128713,11997,233276255,23458,2
101928126,LOC101928126,chr21,F,33975185,33978885,15132413,3700,233279955,23459,1
101928147,C21orf140,chr21,R,34400111,34401072,15133374,961,233280916,23460,0
101928182,LOC101928182,chr21,F,34419637,34425353,15139090,5716,233286632,23461,1
101928212,LOC101928212,chr21,R,42571424,42573810,15141476,2386,233289018,23462,1
101928233,LOC101928233,chr21,R,42599497,42615095,15157074,15598,233304616,23463,2
101928255,LOC101928255,chr21,R,42648293,42653442,15162223,5149,233309765,23464,2
101928269,LOC101928269,chr21,R,35954659,36004667,15212231,50008,233359773,23465,5
101928284,LOC101928284,chr21,R,42733593,42742422,15221060,8829,233368602,23466,1
101928311,LOC101928311,chr21,R,42777812,42780091,15223339,2279,233370881,23467,1
101928368,LOC101928368,chr21,F,37751554,37761121,15232906,9567,233380448,23468,3
101928369,LOC101928369,chr21,F,43107720,43144669,15269855,36949,233417397,23469,5
101928398,LOC101928398,chr21,F,38857538,38858862,15271179,1324,233418721,23470,2
101928399,LOC101928399,chr21,R,43358054,43362688,15275813,4634,233423355,23471,1
101928435,LOC101928435,chr21,R,38974428,38977774,15279159,3346,233426701,23472,2
101928576,LOC101928576,chr21,F,5101664,5103184,15280679,1520,233428221,23473,2
101928607,TRPM2-AS,chr21,R,44414589,44425563,15291653,10974,233439195,23474,2
101928689,LINC01424,chr21,F,44802240,44804717,15294130,2477,233441672,23475,1
101928745,LOC101928745,chr21,R,45403805,45405442,15295767,1637,233443309,23476,2
101928796,LOC101928796,chr21,F,45972969,45974953,15297751,1984,233445293,23477,1
101930094,LOC101930094,chr21,F,42496451,42497443,15298743,992,233446285,23478,2
101930100,LOC101930100,chr21,F,9325036,9367242,15340949,42206,233488491,23479,5
101930249,LOC101930249,chr21,F,42363413,42365104,15342640,1691,233490182,23480,1
101930746,LINC00945,chr21,F,33057828,33065079,15349891,7251,233497433,23481,4
102464825,MIR6070,chr21,R,43609886,43609989,15349994,103,233497536,23482,0
102465248,MIR6501,chr21,F,33550661,33550728,15350061,67,233497603,23483,0
102465433,MIR6724-1,chr21,F,8205314,8205406,15350153,92,233497695,23484,0
102465488,MIR6814,chr21,R,41746771,41746841,15350223,70,233497765,23485,0
102465489,MIR6815,chr21,F,45478265,45478326,15350284,61,233497826,23486,0
102466252,MIR8069-1,chr21,F,6859170,6859256,15350370,86,233497912,23487,0
102466967,MIR6130,chr21,F,23079283,23079392,15350479,109,233498021,23488,0
102466972,MIR6508,chr21,F,39447009,39447069,15350539,60,233498081,23489,0
102723360,LOC102723360,chr21,R,7669396,7692185,15373328,22789,233520870,23490,3
102723380,LOC102723380,chr21,F,43465132,43467509,15375705,2377,233523247,23491,1
102723451,LOC102723451,chr21,R,7769591,7771151,15377265,1560,233524807,23492,0
102723475,LOC102723475,chr21,R,7789188,7829632,15417709,40444,233565251,23493,5
102723489,LINC00205,chr21,R,45290196,45296026,15423539,5830,233571081,23494,1
102723553,LOC102723553,chr21,F,7744418,7772253,15451374,27835,233598916,23495,4
102723570,LOC102723570,chr21,R,8240738,8243081,15453717,2343,233601259,23496,0
102723584,LOC102723584,chr21,R,8423783,8426058,15455992,2275,233603534,23497,0
102723603,LOC102723603,chr21,R,8466829,8470663,15459826,3834,233607368,23498,0
102723996,LOC102723996,chr21,F,5022043,5046692,15484475,24649,233632017,23499,7
102724023,LOC102724023,chr21,R,5116340,5128451,15496586,12111,233644128,23500,8
102724159,LOC102724159,chr21,R,5130870,5154767,15520483,23897,233668025,23501,21
102724184,LOC102724184,chr21,F,5012323,5017158,15525318,4835,233672860,23502,2
102724188,LOC102724188,chr21,F,13546032,13558461,15537747,12429,233685289,23503,3
102724200,LOC102724200,chr21,R,5155498,5165464,15547713,9966,233695255,23504,3
102724219,LOC102724219,chr21,F,5553665,5592004,15586052,38339,233733594,23505,6
102724334,LOC102724334,chr21,R,5972931,5973359,15586480,428,233734022,23506,0
102724354,LOC102724354,chr21,F,6057766,6066898,15595612,9132,233743154,23507,2
102724355,LOC102724355,chr21,R,27173542,27351332,15773402,177790,233920944,23508,6
102724370,LOC102724370,chr21,R,6070757,6073132,15775777,2375,233923319,23509,1
102724385,LOC102724385,chr21,F,6066957,6100022,15808842,33065,233956384,23510,4
102724398,LOC102724398,chr21,R,6084372,6088242,15812712,3870,233960254,23511,1
102724428,LOC102724428,chr21,F,6111134,6123746,15825324,12612,233972866,23512,13
102724441,LOC102724441,chr21,R,6228965,6267304,15863663,38339,234011205,23513,6
102724449,LOC102724449,chr21,R,31655386,31659520,15867797,4134,234015339,23514,2
102724502,LOC102724502,chr21,F,32958887,32960566,15869476,1679,234017018,23515,1
102724560,LOC102724560,chr21,R,6444868,6468507,15893115,23639,234040657,23516,22
102724584,LOC102724584,chr21,F,34836588,34848498,15905025,11910,234052567,23517,2
102724594,LOC102724594,chr21,R,6484622,6499284,15919687,14662,234067229,23518,8
102724636,LOC102724636,chr21,F,6499398,6536357,15956646,36959,234104188,23519,5
102724652,LOC102724652,chr21,F,6560655,6564489,15960480,3834,234108022,23520,3
102724678,LINC01423,chr21,R,38326358,38346076,15980198,19718,234127740,23521,5
102724701,LOC102724701,chr21,R,6630189,6670705,16020714,40516,234168256,23522,9
102724740,LOC102724740,chr21,R,38988388,39019256,16051582,30868,234199124,23523,5
102724757,LOC102724757,chr21,F,39406638,39428408,16073352,21770,234220894,23524,6
102724800,LOC102724800,chr21,F,41767185,41774864,16081031,7679,234228573,23525,3
102724843,LOC102724843,chr21,F,7048887,7087230,16119374,38343,234266916,23526,6
102724951,LOC102724951,chr21,F,7430665,7469008,16157717,38343,234305259,23527,6
102725065,LOC102725065,chr21,F,44208133,44210115,16159699,1982,234307241,23528,1
103091865,BRWD1-IT2,chr21,F,39313906,39314915,16160708,1009,234308250,23529,0
103504727,MIR6724-2,chr21,F,8249504,8249596,16160800,92,234308342,23530,0
103504728,MIR3687-2,chr21,F,8987369,8987430,16160861,61,234308403,23531,0
103504731,MIR3648-2,chr21,F,8986998,8987178,16161041,180,234308583,23532,0
103504733,MIR6724-4,chr21,F,8432529,8432621,16161133,92,234308675,23533,0
103504736,MIR8069-2,chr21,F,13724188,13724274,16161219,86,234308761,23534,0
103504739,MIR6724-3,chr21,F,8388361,8388453,16161311,92,234308853,23535,0
105369159,LOC105369159,chr21,F,16041291,16640637,16760657,599346,234908199,23536,6
105369290,LOC105369290,chr21,F,14477328,14539296,16822625,61968,234970167,23537,2
105369292,LOC105369292,chr21,R,15263420,15283708,16842913,20288,234990455,23538,3
105369294,LOC105369294,chr21,F,40415613,40422226,16849526,6613,234997068,23539,3
105369295,LOC105369295,chr21,F,36061895,36068569,16856200,6674,235003742,23540,3
105369299,LOC105369299,chr21,R,29296164,29298696,16858732,2532,235006274,23541,2
105369300,LOC105369300,chr21,R,14740138,14744489,16863083,4351,235010625,23542,2
105369301,LOC105369301,chr21,F,36430293,36482182,16914972,51889,235062514,23543,5
105369302,LOC105369302,chr21,R,15571197,15627241,16971016,56044,235118558,23544,2
105369304,LOC105369304,chr21,F,14383248,14394031,16981799,10783,235129341,23545,3
105369305,LOC105369305,chr21,F,36811385,36813696,16984110,2311,235131652,23546,1
105369306,LOC105369306,chr21,F,36104433,36109692,16989369,5259,235136911,23547,1
105369307,LOC105369307,chr21,F,15056028,15063803,16997144,7775,235144686,23548,1
105369308,LOC105369308,chr21,R,36632680,36638498,17002962,5818,235150504,23549,1
105372730,LOC105372730,chr21,F,8759112,8805942,17049792,46830,235197334,23550,2
105372731,LOC105372731,chr21,R,9026618,9043096,17066270,16478,235213812,23551,2
105372732,LOC105372732,chr21,F,9757290,9758365,17067345,1075,235214887,23552,1
105372733,LOC105372733,chr21,R,9996066,10119507,17190786,123441,235338328,23553,9
105372734,LOC105372734,chr21,R,9972438,9986333,17204681,13895,235352223,23554,2
105372735,LOC105372735,chr21,F,10500931,10514209,17217959,13278,235365501,23555,2
105372738,LOC105372738,chr21,R,14676698,14678599,17219860,1901,235367402,23556,1
105372739,LOC105372739,chr21,F,15186636,15189854,17223078,3218,235370620,23557,2
105372741,LOC105372741,chr21,R,17743226,17767158,17247010,23932,235394552,23558,2
105372742,LOC105372742,chr21,R,17928944,17931326,17249392,2382,235396934,23559,2
105372743,LOC105372743,chr21,F,17803427,17812311,17258276,8884,235405818,23560,1
105372744,LOC105372744,chr21,F,19649774,19657603,17266105,7829,235413647,23561,2
105372745,LOC105372745,chr21,F,19899945,20022665,17388825,122720,235536367,23562,3
105372746,LOC105372746,chr21,R,19885220,19899790,17403395,14570,235550937,23563,3
105372747,LOC105372747,chr21,F,23408636,23434254,17429013,25618,235576555,23564,4
105372748,LOC105372748,chr21,F,23358429,23371752,17442336,13323,235589878,23565,3
105372749,LOC105372749,chr21,F,23704242,23709301,17447395,5059,235594937,23566,2
105372750,LOC105372750,chr21,F,23812621,23876401,17511175,63780,235658717,23567,4
105372751,LOC105372751,chr21,F,24530663,24547942,17528454,17279,235675996,23568,1
105372752,LOC105372752,chr21,R,25450335,25466499,17544618,16164,235692160,23569,2
105372753,LOC105372753,chr21,R,25496793,25518895,17566720,22102,235714262,23570,5
105372754,LOC105372754,chr21,R,25572130,25579769,17574359,7639,235721901,23571,1
105372755,LOC105372755,chr21,R,25744059,25754784,17585084,10725,235732626,23572,2
105372756,LOC105372756,chr21,F,25862370,25865989,17588703,3619,235736245,23573,3
105372757,LOC105372757,chr21,R,25800175,25806990,17595518,6815,235743060,23574,2
105372758,LOC105372758,chr21,R,26432005,26437483,17600996,5478,235748538,23575,5
105372759,LOC105372759,chr21,F,27204883,27234255,17630368,29372,235777910,23576,3
105372760,LOC105372760,chr21,F,26854879,26953019,17728508,98140,235876050,23577,3
105372761,LOC105372761,chr21,F,27375370,27395627,17748765,20257,235896307,23578,2
105372762,LOC105372762,chr21,R,27419014,27448644,17778395,29630,235925937,23579,2
105372763,LOC105372763,chr21,F,27638580,27674774,17814589,36194,235962131,23580,8
105372764,LOC105372764,chr21,F,28391707,28393335,17816217,1628,235963759,23581,1
105372765,LOC105372765,chr21,R,28922496,28923668,17817389,1172,235964931,23582,1
105372766,LOC105372766,chr21,F,28993095,28994162,17818456,1067,235965998,23583,2
105372767,LOC105372767,chr21,F,29178118,29183572,17823910,5454,235971452,23584,2
105372768,LOC105372768,chr21,F,29561623,29577698,17839985,16075,235987527,23585,2
105372769,LOC105372769,chr21,F,29555308,29559910,17844587,4602,235992129,23586,2
105372770,LOC105372770,chr21,R,29492137,29495926,17848376,3789,235995918,23587,3
105372771,LOC105372771,chr21,F,29413560,29417792,17852608,4232,236000150,23588,2
105372772,LOC105372772,chr21,R,30393249,30475708,17935067,82459,236082609,23589,5
105372773,LOC105372773,chr21,R,30707277,30725702,17953492,18425,236101034,23590,2
105372774,LOC105372774,chr21,F,31030141,31036268,17959619,6127,236107161,23591,2
105372775,LOC105372775,chr21,R,31014383,31019190,17964426,4807,236111968,23592,3
105372776,LOC105372776,chr21,R,30805579,31004816,18163663,199237,236311205,23593,3
105372777,LOC105372777,chr21,F,31255431,31262458,18170690,7027,236318232,23594,1
105372778,LOC105372778,chr21,R,32156295,32247342,18261737,91047,236409279,23595,2
105372779,LOC105372779,chr21,R,32306463,32309154,18264428,2691,236411970,23596,1
105372780,LOC105372780,chr21,F,32543588,32547223,18268063,3635,236415605,23597,2
105372781,LOC105372781,chr21,F,32598793,32601315,18270585,2522,236418127,23598,1
105372782,LOC105372782,chr21,F,32586430,32592239,18276394,5809,236423936,23599,3
105372783,LOC105372783,chr21,R,32953676,32955915,18278633,2239,236426175,23600,1
105372784,LOC105372784,chr21,F,32926855,33019816,18371594,92961,236519136,23601,2
105372785,LOC105372785,chr21,F,33035538,33037078,18373134,1540,236520676,23602,2
105372786,LOC105372786,chr21,R,33077483,33078260,18373911,777,236521453,23603,2
105372787,LOC105372787,chr21,R,33172957,33195517,18396471,22560,236544013,23604,3
105372788,LOC105372788,chr21,R,33967078,33969220,18398613,2142,236546155,23605,2
105372789,LOC105372789,chr21,R,34016902,34019035,18400746,2133,236548288,23606,2
105372790,LOC105372790,chr21,F,33982965,34051939,18469720,68974,236617262,23607,5
105372791,LOC105372791,chr21,R,34353036,34375396,18492080,22360,236639622,23608,4
105372792,LOC105372792,chr21,R,34484015,34486898,18494963,2883,236642505,23609,1
105372793,LOC105372793,chr21,F,34404722,34418061,18508302,13339,236655844,23610,4
105372794,LOC105372794,chr21,R,36107892,36111219,18511629,3327,236659171,23611,1
105372795,LOC105372795,chr21,R,37063039,37064216,18512806,1177,236660348,23612,1
105372796,LOC105372796,chr21,R,37341404,37344292,18515694,2888,236663236,23613,1
105372797,LOC105372797,chr21,R,37478889,37490168,18526973,11279,236674515,23614,2
105372798,LOC105372798,chr21,F,37563972,37570518,18533519,6546,236681061,23615,2
105372799,LOC105372799,chr21,F,37715916,37739035,18556638,23119,236704180,23616,4
105372800,LOC105372800,chr21,R,38248948,38256605,18564295,7657,236711837,23617,2
105372801,LOC105372801,chr21,R,38235676,38260085,18588704,24409,236736246,23618,1
105372802,LOC105372802,chr21,F,38503439,38543341,18628606,39902,236776148,23619,3
105372803,LOC105372803,chr21,F,39011234,39015106,18632478,3872,236780020,23620,1
105372804,LOC105372804,chr21,F,39349997,39378559,18661040,28562,236808582,23621,4
105372805,LOC105372805,chr21,F,39642339,39654265,18672966,11926,236820508,23622,3
105372806,LOC105372806,chr21,R,41164260,41167256,18675962,2996,236823504,23623,2
105372807,LOC105372807,chr21,R,41357304,41368087,18686745,10783,236834287,23624,1
105372808,LOC105372808,chr21,F,41576140,41581627,18692232,5487,236839774,23625,2
105372809,LOC105372809,chr21,R,41552803,41593324,18732753,40521,236880295,23626,5
105372811,LOC105372811,chr21,F,26395032,26413109,18750830,18077,236898372,23627,3
105372812,LOC105372812,chr21,F,41637880,41641787,18754737,3907,236902279,23628,1
105372813,LOC105372813,chr21,F,41668948,41672645,18758434,3697,236905976,23629,3
105372814,LOC105372814,chr21,R,42209427,42222893,18771900,13466,236919442,23630,2
105372815,LOC105372815,chr21,F,42351222,42363359,18784037,12137,236931579,23631,6
105372816,LOC105372816,chr21,R,42663281,42666981,18787737,3700,236935279,23632,3
105372817,LOC105372817,chr21,F,42879666,42887737,18795808,8071,236943350,23633,3
105372818,LOC105372818,chr21,R,42916802,42919021,18798027,2219,236945569,23634,0
105372819,LOC105372819,chr21,R,42947361,42956065,18806731,8704,236954273,23635,2
105372821,LOC105372821,chr21,F,43182043,43184143,18808831,2100,236956373,23636,2
105372822,LOC105372822,chr21,F,43284979,43285295,18809147,316,236956689,23637,1
105372823,LOC105372823,chr21,F,6145978,6149671,18812840,3693,236960382,23638,1
105372824,LOC105372824,chr21,F,43736999,43738097,18813938,1098,236961480,23639,0
105372825,LOC105372825,chr21,R,43778629,43779271,18814580,642,236962122,23640,1
105372826,LOC105372826,chr21,R,43945402,43946514,18815692,1112,236963234,23641,2
105372827,LOC105372827,chr21,R,43899368,43902738,18819062,3370,236966604,23642,2
105372828,LOC105372828,chr21,F,43884322,43889917,18824657,5595,236972199,23643,2
105372829,LOC105372829,chr21,F,43993527,43997486,18828616,3959,236976158,23644,2
105372831,LOC105372831,chr21,F,5067515,5089824,18850925,22309,236998467,23645,5
105372832,LOC105372832,chr21,R,44201797,44208199,18857327,6402,237004869,23646,3
105372833,LOC105372833,chr21,F,44250812,44251521,18858036,709,237005578,23647,1
105372834,LOC105372834,chr21,F,44473511,44477220,18861745,3709,237009287,23648,1
105372835,LOC105372835,chr21,R,45091703,45101260,18871302,9557,237018844,23649,3
105372836,LOC105372836,chr21,R,45055876,45073903,18889329,18027,237036871,23650,4
105372837,LOC105372837,chr21,F,45309458,45311610,18891481,2152,237039023,23651,1
105372838,LOC105372838,chr21,R,45327343,45330632,18894770,3289,237042312,23652,1
105372839,LOC105372839,chr21,F,45347381,45353536,18900925,6155,237048467,23653,1
105372840,LOC105372840,chr21,F,45590786,45597407,18907546,6621,237055088,23654,2
105372841,LOC105372841,chr21,F,45978493,45981570,18910623,3077,237058165,23655,2
105372842,LOC105372842,chr21,F,46036806,46039533,18913350,2727,237060892,23656,2
105372843,LOC105372843,chr21,F,43191603,43195876,18917623,4273,237065165,23657,2
105377134,LOC105377134,chr21,F,14027415,14060261,18950469,32846,237098011,23658,1
105377136,LOC105377136,chr21,F,32880276,32893764,18963957,13488,237111499,23659,3
105377137,LOC105377137,chr21,R,43388598,43392291,18967650,3693,237115192,23660,1
105377138,LOC105377138,chr21,R,44158735,44159922,18968837,1187,237116379,23661,2
105377139,LOC105377139,chr21,R,44172146,44194634,18991325,22488,237138867,23662,4
105378260,LOC105378260,chr21,F,10462906,10500830,19029249,37924,237176791,23663,10
105379484,LOC105379484,chr21,R,5011975,5012684,19029958,709,237177500,23664,1
105379485,LOC105379485,chr21,F,5055739,5061872,19036091,6133,237183633,23665,3
105379486,LOC105379486,chr21,R,5093472,5099713,19042332,6241,237189874,23666,1
105379487,LOC105379487,chr21,R,5499382,5502552,19045502,3170,237193044,23667,2
105379488,LOC105379488,chr21,F,5506971,5509729,19048260,2758,237195802,23668,3
105379489,LOC105379489,chr21,R,5544929,5546787,19050118,1858,237197660,23669,2
105379490,LOC105379490,chr21,F,6001515,6009381,19057984,7866,237205526,23670,1
105379491,LOC105379491,chr21,F,6274185,6276043,19059842,1858,237207384,23671,2
105379492,LOC105379492,chr21,R,6311243,6314001,19062600,2758,237210142,23672,3
105379493,LOC105379493,chr21,F,6318420,6359726,19103906,41306,237251448,23673,9
105379494,LOC105379494,chr21,R,6374074,6376537,19106369,2463,237253911,23674,1
105379495,LOC105379495,chr21,F,6574581,6576681,19108469,2100,237256011,23675,2
105379496,LOC105379496,chr21,F,6675124,6677882,19111227,2758,237258769,23676,3
105379497,LOC105379497,chr21,R,6713082,6714940,19113085,1858,237260627,23677,2
105379498,LOC105379498,chr21,F,6721496,6725231,19116820,3735,237264362,23678,1
105379499,LOC105379499,chr21,R,6986188,6997775,19128407,11587,237275949,23679,4
105379500,LOC105379500,chr21,F,7002194,7004952,19131165,2758,237278707,23680,3
105379501,LOC105379501,chr21,R,7040151,7042009,19133023,1858,237280565,23681,2
105379502,LOC105379502,chr21,F,7383972,7386730,19135781,2758,237283323,23682,3
105379503,LOC105379503,chr21,R,7421930,7423788,19137639,1858,237285181,23683,2
105379504,LOC105379504,chr21,F,7777353,7788049,19148335,10696,237295877,23684,2
105379505,LOC105379505,chr21,R,7854002,7856885,19151218,2883,237298760,23685,1
105379506,LOC105379506,chr21,F,8222254,8223462,19152426,1208,237299968,23686,2
105379507,LOC105379507,chr21,F,8449460,8450648,19153614,1188,237301156,23687,2
105379508,LOC105379508,chr21,F,8405253,8406461,19154822,1208,237302364,23688,2
105379511,LOC105379511,chr21,F,9529921,9559264,19184165,29343,237331707,23689,5
105379512,LOC105379512,chr21,F,9634285,9648103,19197983,13818,237345525,23690,2
105379513,LOC105379513,chr21,R,9677283,9678341,19199041,1058,237346583,23691,1
105379514,LOC105379514,chr21,F,9661336,9681385,19219090,20049,237366632,23692,5
49,ACR,chr22,F,50738223,50745299,7076,7076,237373708,23693,4
50,ACO2,chr22,F,41469124,41528989,66941,59865,237433573,23694,17
135,ADORA2A,chr22,F,24423596,24442360,85705,18764,237452337,23695,5
157,ADRBK2,chr22,F,25517855,25729294,297144,211439,237663776,23696,24
158,ADSL,chr22,F,40346499,40387408,338053,40909,237704685,23697,15
162,AP1B1,chr22,R,29327679,29388583,398957,60904,237765589,23698,22
410,ARSA,chr22,R,50622753,50628173,404377,5420,237771009,23699,7
421,ARVCF,chr22,R,19966602,20016802,454577,50200,237821209,23700,25
468,ATF4,chr22,F,39520558,39522686,456705,2128,237823337,23701,1
529,ATP6V1E1,chr22,R,17592135,17628822,493392,36687,237860024,23702,8
613,BCR,chr22,F,23180364,23318037,631065,137673,237997697,23703,22
637,BID,chr22,R,17734139,17774665,671591,40526,238038223,23704,7
638,BIK,chr22,F,43110747,43129712,690556,18965,238057188,23705,4
706,TSPO,chr22,F,43151513,43163242,702285,11729,238068917,23706,4
758,MPPED1,chr22,F,43412013,43507808,798080,95795,238164712,23707,7
1120,CHKB,chr22,R,50578957,50582999,802122,4042,238168754,23708,10
1312,COMT,chr22,F,19941739,19969975,830358,28236,238196990,23709,10
1375,CPT1B,chr22,R,50568860,50578667,840165,9807,238206797,23710,19
1399,CRKL,chr22,F,20917397,20953749,876517,36352,238243149,23711,2
1413,CRYBA4,chr22,F,26607986,26630672,899203,22686,238265835,23712,6
1414,CRYBB1,chr22,R,26599277,26618087,918013,18810,238284645,23713,5
1415,CRYBB2,chr22,F,25211669,25231869,938213,20200,238304845,23714,6
1416,CRYBB2P1,chr22,F,25448086,25461678,951805,13592,238318437,23715,5
1417,CRYBB3,chr22,F,25198685,25207363,960483,8678,238327115,23716,5
1439,CSF2RB,chr22,F,36913574,36940449,987358,26875,238353990,23717,13
1454,CSNK1E,chr22,R,38290690,38318084,1014752,27394,238381384,23718,11
1564,CYP2D7,chr22,R,42140202,42144575,1019125,4373,238385757,23719,8
1565,CYP2D6,chr22,R,42125655,42135378,1028848,9723,238395480,23720,10
1652,DDT,chr22,R,23971364,23979828,1037312,8464,238403944,23721,3
1727,CYB5R3,chr22,R,42617839,42649399,1068872,31560,238435504,23722,10
1890,TYMP,chr22,R,50525751,50530085,1073206,4334,238439838,23723,8
2033,EP300,chr22,F,41092609,41180077,1160674,87468,238527306,23724,30
2130,EWSR1,chr22,F,29268008,29300525,1193191,32517,238559823,23725,18
2192,FBLN1,chr22,F,45502838,45601134,1291487,98296,238658119,23726,19
2547,XRCC6,chr22,F,41621162,41664048,1334373,42886,238701005,23727,12
2678,GGT1,chr22,F,24583749,24629005,1379629,45256,238746261,23728,17
2679,GGT3P,chr22,R,18773688,18791961,1397902,18273,238764534,23729,12
2687,GGT5,chr22,R,24219653,24245142,1423391,25489,238790023,23730,13
2781,GNAZ,chr22,F,23070482,23125034,1477943,54552,238844575,23731,6
2812,GP1BB,chr22,F,19723542,19724774,1479175,1232,238845807,23732,1
2847,MCHR1,chr22,F,40679177,40682814,1482812,3637,238849444,23733,1
2928,GSC2,chr22,R,19148990,19150283,1484105,1293,238850737,23734,2
2953,GSTT2,chr22,F,23980027,23983915,1487993,3888,238854625,23735,4
3005,H1F0,chr22,F,37805106,37807436,1490323,2330,238856955,23736,0
3053,SERPIND1,chr22,F,20774094,20787720,1503949,13626,238870581,23737,4
3162,HMOX1,chr22,F,35381066,35394214,1517097,13148,238883729,23738,4
3543,IGLL1,chr22,R,23573124,23580472,1524445,7348,238891077,23739,2
3560,IL2RB,chr22,R,37125837,37149922,1548530,24085,238915162,23740,9
3761,KCNJ4,chr22,R,38426326,38455199,1577403,28873,238944035,23741,2
3956,LGALS1,chr22,F,37675605,37679802,1581600,4197,238948232,23742,3
3957,LGALS2,chr22,R,37570245,37580017,1591372,9772,238958004,23743,3
3976,LIF,chr22,R,30240446,30257923,1608849,17477,238975481,23744,4
3985,LIMK2,chr22,F,31212263,31280080,1676666,67817,239043298,23745,17
4151,MB,chr22,R,35606763,35623354,1693257,16591,239059889,23746,5
4174,MCM5,chr22,F,35400062,35454889,1748084,54827,239114716,23747,18
4242,MFNG,chr22,R,37469062,37486440,1765462,17378,239132094,23748,7
4248,MGAT3,chr22,F,39447181,39492194,1810475,45013,239177107,23749,12
4282,MIF,chr22,F,23894377,23895222,1811320,845,239177952,23750,2
4320,MMP11,chr22,F,23772848,23784316,1822788,11468,239189420,23751,7
4330,MN1,chr22,R,27748276,27801498,1876010,53222,239242642,23752,1
4357,MPST,chr22,F,37019641,37029822,1886191,10181,239252823,23753,4
4627,MYH9,chr22,R,36281276,36388067,1992982,106791,239359614,23754,42
4668,NAGA,chr22,R,42058333,42070871,2005520,12538,239372152,23755,8
4689,NCF4,chr22,F,36860987,36878017,2022550,17030,239389182,23756,11
4700,NDUFA6,chr22,R,42085525,42090884,2027909,5359,239394541,23757,2
4733,DRG1,chr22,F,31399552,31434186,2062543,34634,239429175,23758,8
4744,NEFH,chr22,F,29480191,29491290,2073642,11099,239440274,23759,3
4771,NF2,chr22,F,29603555,29698600,2168687,95045,239535319,23760,16
4809,NHP2L1,chr22,R,41673932,41689292,2184047,15360,239550679,23761,4
5008,OSM,chr22,R,30262825,30266840,2188062,4015,239554694,23762,3
5155,PDGFB,chr22,R,39223679,39244952,2209335,21273,239575967,23763,7
5297,PI4KA,chr22,R,20707690,20858812,2360457,151122,239727089,23764,56
5372,PMM1,chr22,R,41576885,41589867,2373439,12982,239740071,23765,10
5413,SEPT5,chr22,F,19714463,19723322,2382298,8859,239748930,23766,12
5435,POLR2F,chr22,F,37953662,38041915,2470551,88253,239837183,23767,8
5465,PPARA,chr22,F,46150546,46243756,2563761,93210,239930393,23768,12
5594,MAPK1,chr22,R,21759656,21867680,2671785,108024,240038417,23769,8
5600,MAPK11,chr22,R,50263712,50270393,2678466,6681,240045098,23770,11
5625,PRODH,chr22,R,18912694,18936553,2702325,23859,240068957,23771,15
5816,PVALB,chr22,R,36800700,36819473,2721098,18773,240087730,23772,5
5880,RAC2,chr22,R,37225260,37244299,2740137,19039,240106769,23773,7
5902,RANBP1,chr22,F,20115937,20127357,2751557,11420,240118189,23774,8
5905,RANGAP1,chr22,R,41244776,41302210,2808991,57434,240175623,23775,20
5988,RFPL1,chr22,F,29434529,29442455,2816917,7926,240183549,23776,4
6122,RPL3,chr22,R,39312881,39319665,2823701,6784,240190333,23777,9
6300,MAPK12,chr22,R,50252901,50261759,2832559,8858,240199191,23778,11
6305,SBF1,chr22,R,50444629,50480296,2868226,35667,240234858,23779,46
6523,SLC5A1,chr22,F,32043031,32113029,2938224,69998,240304856,23780,15
6525,SMTN,chr22,F,31064179,31104624,2978669,40445,240345301,23781,26
6527,SLC5A4,chr22,R,32218420,32353008,3113257,134588,240479889,23782,16
6545,SLC7A4,chr22,R,21028717,21032558,3117098,3841,240483730,23783,4
6576,SLC25A1,chr22,R,19175574,19178863,3120387,3289,240487019,23784,8
6598,SMARCB1,chr22,F,23786962,23834518,3167943,47556,240534575,23785,8
6634,SNRPD3,chr22,F,24555649,24574964,3187258,19315,240553890,23786,3
6663,SOX10,chr22,R,37972311,37984532,3199479,12221,240566111,23787,3
6721,SREBF2,chr22,F,41833078,41907308,3273709,74230,240640341,23788,22
6753,SSTR3,chr22,R,37204236,37220447,3289920,16211,240656552,23789,7
6767,ST13,chr22,R,40824534,40857008,3322394,32474,240689026,23790,11
6899,TBX1,chr22,F,19756702,19783593,3349285,26891,240715917,23791,12
6942,TCF20,chr22,R,42160012,42283922,3473195,123910,240839827,23792,8
6948,TCN2,chr22,F,30607082,30627060,3493173,19978,240859805,23793,8
7008,TEF,chr22,F,41367332,41399328,3525169,31996,240891801,23794,4
7078,TIMP3,chr22,F,32800815,32863041,3587395,62226,240954027,23795,4
7122,CLDN5,chr22,R,19523023,19525337,3589709,2314,240956341,23796,0
7152,TOP1P2,chr22,F,24764500,24766021,3591230,1521,240957862,23797,0
7235,TRU-TCA2-1,chr22,F,44150656,44150742,3591316,86,240957948,23798,0
7263,TST,chr22,R,37010858,37020183,3600641,9325,240967273,23799,3
7290,HIRA,chr22,R,19330700,19431696,3701637,100996,241068269,23800,24
7332,UBE2L3,chr22,F,21549446,21624034,3776225,74588,241142857,23801,5
7353,UFD1L,chr22,R,19449940,19479296,3805581,29356,241172213,23802,11
7380,UPK3A,chr22,F,45284986,45295879,3816474,10893,241183106,23803,6
7441,VPREB1,chr22,F,22244779,22245515,3817210,736,241183842,23804,1
7477,WNT7B,chr22,R,45920361,45977128,3873977,56767,241240609,23805,4
7494,XBP1,chr22,R,28794559,28800572,3879990,6013,241246622,23806,4
7533,YWHAH,chr22,F,31944492,31957603,3893101,13111,241259733,23807,1
7621,ZNF70,chr22,R,23741583,23751092,3902610,9509,241269242,23808,1
7625,ZNF74,chr22,F,20394114,20408463,3916959,14349,241283591,23809,5
8214,DGCR6,chr22,F,18906222,18912088,3922825,5866,241289457,23810,5
8216,LZTR1,chr22,F,20982268,20999037,3939594,16769,241306226,23811,20
8218,CLTCL1,chr22,R,19179472,19291725,4051847,112253,241418479,23812,35
8220,DGCR14,chr22,R,19130278,19144726,4066295,14448,241432927,23813,10
8224,SYN3,chr22,R,32508021,33058391,4616665,550370,241983297,23814,20
8318,CDC45,chr22,F,19479384,19520612,4657893,41228,242024525,23815,20
8398,PLA2G6,chr22,R,38111494,38192109,4738508,80615,242105140,23816,27
8459,TPST2,chr22,R,26525747,26590125,4802886,64378,242169518,23817,8
8484,GALR3,chr22,F,37822008,37825865,4806743,3857,242173375,23818,2
8508,NIPSNAP1,chr22,R,29554807,29581337,4833273,26530,242199905,23819,10
8542,APOL1,chr22,F,36253070,36267531,4847734,14461,242214366,23820,7
8563,THOC5,chr22,R,29508166,29553760,4893328,45594,242259960,23821,22
8664,EIF3D,chr22,R,36510849,36529431,4911910,18582,242278542,23822,14
8897,MTMR3,chr22,F,29883164,30030868,5059614,147704,242426246,23823,22
8911,CACNA1I,chr22,F,39557968,39689739,5191385,131771,242558017,23824,37
8940,TOP3B,chr22,R,21957024,21982843,5217204,25819,242583836,23825,18
9127,P2RX6,chr22,F,21014450,21028013,5230767,13563,242597399,23826,10
9145,SYNGR1,chr22,F,39349948,39385588,5266407,35640,242633039,23827,5
9215,LARGE,chr22,R,33273075,33922841,5916173,649766,243282805,23828,20
9342,SNAP29,chr22,F,20859003,20891214,5948384,32211,243315016,23829,4
9402,GRAP2,chr22,F,39893807,39973343,6027920,79536,243394552,23830,9
9463,PICK1,chr22,F,38056419,38075701,6047202,19282,243413834,23831,13
9514,GAL3ST1,chr22,R,30554634,30574588,6067156,19954,243433788,23832,10
9567,GTPBP1,chr22,F,38704556,38738173,6100773,33617,243467405,23833,15
9582,APOBEC3B,chr22,F,38982398,38992779,6111154,10381,243477786,23834,7
9609,RAB36,chr22,F,23145325,23169285,6135114,23960,243501746,23835,14
9620,CELSR1,chr22,R,46360833,46537502,6311783,176669,243678415,23836,37
9647,PPM1F,chr22,R,21919418,21952878,6345243,33460,243711875,23837,7
9681,DEPDC5,chr22,F,31753950,31907034,6498327,153084,243864959,23838,46
9701,PPP6R2,chr22,F,50343316,50445090,6600101,101774,243966733,23839,27
9814,SFI1,chr22,F,31488687,31618551,6729965,129864,244096597,23840,35
9889,ZBED4,chr22,F,49853848,49890078,6766195,36230,244132827,23841,3
9929,JOSD1,chr22,R,38685542,38701418,6782071,15876,244148703,23842,6
9978,RBX1,chr22,F,40951346,40973015,6803740,21669,244170372,23843,4
9993,DGCR2,chr22,R,19036281,19122454,6889913,86173,244256545,23844,9
9997,SCO2,chr22,R,50523567,50526439,6892785,2872,244259417,23845,3
10042,HMGXB4,chr22,F,35241534,35295807,6947058,54273,244313690,23846,13
10043,TOM1,chr22,F,35299274,35347994,6995778,48720,244362410,23847,17
10126,DNAL4,chr22,R,38778507,38794156,7011427,15649,244378059,23848,3
10291,SF3A1,chr22,R,30331987,30356947,7036387,24960,244403019,23849,15
10343,PKDREJ,chr22,R,46255662,46263322,7044047,7660,244410679,23850,0
10369,CACNG2,chr22,R,36560868,36702645,7185824,141777,244552456,23851,3
10454,TAB1,chr22,F,39399753,39437127,7223198,37374,244589830,23852,11
10478,SLC25A17,chr22,R,40769629,40819399,7272968,49770,244639600,23853,11
10521,DDX17,chr22,R,38483437,38506340,7295871,22903,244662503,23854,12
10587,TXNRD2,chr22,R,19875517,19941992,7362346,66475,244728978,23855,18
10633,RASL10A,chr22,R,29312932,29319618,7369032,6686,244735664,23856,5
10634,GAS2L1,chr22,F,29306617,29312789,7375204,6172,244741836,23857,6
10737,RFPL3S,chr22,R,32359905,32371264,7386563,11359,244753195,23858,5
10738,RFPL3,chr22,F,32354884,32361161,7392840,6277,244759472,23859,2
10739,RFPL2,chr22,R,32190434,32207236,7409642,16802,244776274,23860,7
10740,RFPL1S,chr22,R,29437014,29442129,7414757,5115,244781389,23861,0
10762,NUP50,chr22,F,45163844,45188011,7438924,24167,244805556,23862,11
10766,TOB2,chr22,R,41433487,41448230,7453667,14743,244820299,23863,2
11015,KDELR3,chr22,F,38468061,38483447,7469053,15386,244835685,23864,4
11020,IFT27,chr22,R,36758201,36776133,7486985,17932,244853617,23865,7
11078,TRIOBP,chr22,F,37696987,37776556,7566554,79569,244933186,23866,25
11135,CDC42EP1,chr22,F,37559777,37569405,7576182,9628,244942814,23867,5
11144,DMC1,chr22,R,38509153,38570286,7637315,61133,245003947,23868,15
11158,RABL2B,chr22,R,50767491,50783675,7653499,16184,245020131,23869,9
11200,CHEK2,chr22,R,28687742,28741905,7707662,54163,245074294,23870,21
11252,PACSIN2,chr22,R,42869765,43015690,7853587,145925,245220219,23871,15
11274,USP18,chr22,F,18149958,18177397,7881026,27439,245247658,23872,10
22880,MORC2,chr22,R,30925137,30968497,7924386,43360,245291018,23873,26
23112,TNRC6B,chr22,F,40044816,40335808,8215378,290992,245582010,23874,26
23119,HIC2,chr22,F,21417403,21451463,8249438,34060,245616070,23875,5
23151,GRAMD4,chr22,F,46576016,46682758,8356180,106742,245722812,23876,23
23170,TTLL12,chr22,R,43166621,43187131,8376690,20510,245743322,23877,14
23209,MLC1,chr22,R,50059390,50085929,8403229,26539,245769861,23878,12
23264,ZC3H7B,chr22,F,41301502,41360147,8461874,58645,245828506,23879,22
23313,KIAA0930,chr22,R,45192241,45240769,8510402,48528,245877034,23880,11
23331,TTC28,chr22,R,27978013,28679865,9212254,701852,246578886,23881,26
23384,SPECC1L,chr22,F,24270816,24417740,9359178,146924,246725810,23882,18
23464,GCAT,chr22,F,37807899,37817327,9368606,9428,246735238,23883,9
23466,CBX6,chr22,R,38861215,38872334,9379725,11119,246746357,23884,5
23467,NPTXR,chr22,R,38818450,38844012,9405287,25562,246771919,23885,4
23481,PES1,chr22,R,30576624,30607013,9435676,30389,246802308,23886,17
23492,CBX7,chr22,R,39130771,39152662,9457567,21891,246824199,23887,5
23523,CABIN1,chr22,F,24011191,24178628,9625004,167437,246991636,23888,43
23532,PRAME,chr22,R,22547695,22559361,9636670,11666,247003302,23889,5
23539,SLC16A8,chr22,R,38078136,38083163,9641697,5027,247008329,23890,4
23541,SEC14L2,chr22,F,30396940,30425303,9670060,28363,247036692,23891,11
23542,MAPK8IP2,chr22,F,50600684,50611551,9680927,10867,247047559,23892,11
23543,RBFOX2,chr22,R,35738735,36028892,9971084,290157,247337716,23893,20
23544,SEZ6L,chr22,F,26169473,26383597,10185208,214124,247551840,23894,16
23551,RASD2,chr22,F,35540517,35554002,10198693,13485,247565325,23895,5
23598,PATZ1,chr22,R,31325803,31346263,10219153,20460,247585785,23896,5
23616,SH3BP1,chr22,F,37639676,37656043,10235520,16367,247602152,23897,17
23617,TSSK2,chr22,F,19130807,19132623,10237336,1816,247603968,23898,0
23654,PLXNB2,chr22,R,50274978,50307642,10270000,32664,247636632,23899,39
23753,SDF2L1,chr22,F,21642252,21644299,10272047,2047,247638679,23900,2
23759,PPIL2,chr22,F,21665983,21697913,10303977,31930,247670609,23901,20
23760,PITPNB,chr22,R,27851668,27919306,10371615,67638,247738247,23902,11
23761,PISD,chr22,R,31618490,31662564,10415689,44074,247782321,23903,16
23762,OSBP2,chr22,F,30693781,30907824,10629732,214043,247996364,23904,18
23764,MAFF,chr22,F,38201931,38216511,10644312,14580,248010944,23905,3
23765,IL17RA,chr22,F,17084958,17115694,10675048,30736,248041680,23906,12
23774,BRD1,chr22,R,49773277,49827548,10729319,54271,248095951,23907,18
23779,ARHGAP8,chr22,F,44752557,44862784,10839546,110227,248206178,23908,12
23780,APOL2,chr22,R,36226208,36239954,10853292,13746,248219924,23909,9
23782,AP1B1P1,chr22,F,32121976,32133469,10864785,11493,248231417,23910,3
23783,ANKRD62P1-PARP4P3,chr22,R,16653707,16675540,10886618,21833,248253250,23911,8
23784,POTEH,chr22,F,15690025,15721631,10918224,31606,248284856,23912,10
23786,BCL2L13,chr22,F,17628854,17730855,11020225,102001,248386857,23913,10
24144,TFIP11,chr22,R,26491926,26512496,11040795,20570,248407427,23914,15
25770,C22orf31,chr22,R,29058671,29073966,11056090,15295,248422722,23915,5
25771,TBC1D22A,chr22,F,46762616,47203479,11496953,440863,248863585,23916,21
25774,GSTTP1,chr22,R,23998400,24005361,11503914,6961,248870546,23917,3
25775,C22orf24,chr22,R,31925315,31945362,11523961,20047,248890593,23918,5
25776,CBY1,chr22,F,38656652,38673850,11541159,17198,248907791,23919,5
25777,SUN2,chr22,R,38734713,38756019,11562465,21306,248929097,23920,20
25786,DGCR11,chr22,R,19046161,19048375,11564679,2214,248931311,23921,0
25787,DGCR9,chr22,F,19017833,19020248,11567094,2415,248933726,23922,0
25793,FBXO7,chr22,F,32474681,32498831,11591244,24150,248957876,23923,9
25807,RHBDD3,chr22,R,29259854,29268185,11599575,8331,248966207,23924,7
25809,TTLL1,chr22,R,43039515,43089428,11649488,49913,249016120,23925,12
25812,POM121L1P,chr22,R,22631556,22644541,11662473,12985,249029105,23926,9
25813,SAMM50,chr22,F,43955380,43996532,11703625,41152,249070257,23927,14
25814,ATXN10,chr22,F,45671797,45845307,11877135,173510,249243767,23928,11
25817,FAM19A5,chr22,F,48489459,48751935,12139611,262476,249506243,23929,4
25828,TXN2,chr22,R,36467035,36482025,12154601,14990,249521233,23930,4
25829,TMEM184B,chr22,R,38216376,38273034,12211259,56658,249577891,23931,13
25830,SULT4A1,chr22,R,43824506,43862498,12249251,37992,249615883,23932,8
26088,GGA1,chr22,F,37607234,37633564,12275581,26330,249642213,23933,20
26150,RIBC2,chr22,F,45413690,45432422,12294313,18732,249660945,23934,8
26220,DGCR5,chr22,F,18970497,19031242,12355058,60745,249721690,23935,5
26222,DGCR10,chr22,F,19022623,19023550,12355985,927,249722617,23936,0
26226,FBXW4P1,chr22,F,23262766,23265005,12358224,2239,249724856,23937,0
26286,ARFGAP3,chr22,R,42796523,42857402,12419103,60879,249785735,23938,15
26807,SNORD43,chr22,R,39319051,39319113,12419165,62,249785797,23939,0
27037,TRMT2A,chr22,R,20111865,20117295,12424595,5430,249791227,23940,11
27124,INPP5J,chr22,F,31107735,31134697,12451557,26962,249818189,23941,15
27127,SMC1B,chr22,R,45344062,45413629,12521124,69567,249887756,23942,25
27128,CYTH4,chr22,F,37282453,37315348,12554019,32895,249920651,23943,13
27156,RSPH14,chr22,R,23059407,23145230,12639842,85823,250006474,23944,12
27254,CSDC2,chr22,F,41561009,41576666,12655499,15657,250022131,23945,3
27341,RRP7A,chr22,R,42508334,42519823,12666988,11489,250033620,23946,6
27349,MCAT,chr22,R,43132205,43143397,12678180,11192,250044812,23947,3
27350,APOBEC3C,chr22,F,39014259,39018838,12682759,4579,250049391,23948,3
27351,DESI1,chr22,R,41598027,41621061,12705793,23034,250072425,23949,7
27352,SGSM3,chr22,F,40370561,40410289,12745521,39728,250112153,23950,20
27437,HSFY1P1,chr22,F,16827473,16829335,12747383,1862,250114015,23951,1
27439,CECR6,chr22,R,17116298,17121367,12752452,5069,250119084,23952,0
27440,CECR5,chr22,R,17137519,17165287,12780220,27768,250146852,23953,10
27442,CECR3,chr22,R,17256858,17266733,12790095,9875,250156727,23954,2
27443,CECR2,chr22,F,17359948,17558155,12988302,198207,250354934,23955,22
29774,POM121L9P,chr22,F,24251620,24265524,13002206,13904,250368838,23956,6
29775,CARD10,chr22,R,37490361,37519203,13031048,28842,250397680,23957,19
29780,PARVB,chr22,F,43999210,44169233,13201071,170023,250567703,23958,16
29781,NCAPH2,chr22,F,50508214,50524780,13217637,16566,250584269,23959,20
29796,UQCR10,chr22,F,29767368,29770413,13220682,3045,250587314,23960,1
29797,POM121L8P,chr22,F,21282424,21297730,13235988,15306,250602620,23961,6
29799,YPEL1,chr22,R,21697535,21735834,13274287,38299,250640919,23962,4
29801,ZDHHC8,chr22,F,20131840,20148007,13290454,16167,250657086,23963,10
29802,VPREB3,chr22,R,23752742,23754443,13292155,1701,250658787,23964,1
50487,PLA2G3,chr22,R,31134806,31140757,13298106,5951,250664738,23965,7
51233,DRICH1,chr22,R,23580871,23637723,13354958,56852,250721590,23966,17
51386,EIF3L,chr22,F,37848447,37888782,13395293,40335,250761925,23967,12
51493,RTCB,chr22,R,32387574,32412287,13420006,24713,250786638,23968,11
51512,GTSE1,chr22,F,46296013,46333699,13457692,37686,250824324,23969,13
51537,MTFP1,chr22,F,30425622,30429054,13461124,3432,250827756,23970,3
51586,MED15,chr22,F,20507541,20587632,13541215,80091,250907847,23971,23
51733,UPB1,chr22,F,24494466,24528390,13575139,33924,250941771,23972,12
51807,TUBA8,chr22,F,18110686,18131731,13596184,21045,250962816,23973,4
51816,CECR1,chr22,R,17178789,17221854,13639249,43065,251005881,23974,11
53947,A4GALT,chr22,R,42692116,42721301,13668434,29185,251035066,23975,7
54456,MOV10L1,chr22,F,50090005,50161705,13740134,71700,251106766,23976,29
54471,MIEF1,chr22,F,39500099,39518134,13758169,18035,251124801,23977,9
54487,DGCR8,chr22,F,20080231,20111877,13789815,31646,251156447,23978,13
54584,GNB1L,chr22,R,19788410,19854939,13856344,66529,251222976,23979,7
54944,LINC01521,chr22,F,31346758,31351155,13860741,4397,251227373,23980,0
55000,TUG1,chr22,F,30969210,30979395,13870926,10185,251237558,23981,3
55007,FAM118A,chr22,F,45309199,45341955,13903682,32756,251270314,23982,17
55020,TTC38,chr22,F,46267963,46294008,13929727,26045,251296359,23983,17
55267,PRR34,chr22,R,46050458,46054144,13933413,3686,251300045,23984,1
55586,MIOX,chr22,F,50483987,50490321,13939747,6334,251306379,23985,11
55615,PRR5,chr22,F,44668546,44737681,14008882,69135,251375514,23986,10
55670,PEX26,chr22,F,18077919,18091031,14021994,13112,251388626,23987,4
55687,TRMU,chr22,F,46335400,46357340,14043934,21940,251410566,23988,11
55954,ZMAT5,chr22,R,29730955,29767068,14080047,36113,251446679,23989,7
55964,SEPT3,chr22,F,41976926,41998221,14101342,21295,251467974,23990,9
56241,SUSD2,chr22,F,24181475,24189106,14108973,7631,251475605,23991,14
56478,EIF4ENIF1,chr22,R,31436962,31489950,14161961,52988,251528593,23992,23
56666,PANX2,chr22,F,50170730,50180295,14171526,9565,251538158,23993,3
56993,TOMM22,chr22,F,38681948,38684760,14174338,2812,251540970,23994,3
57026,PDXP,chr22,F,37658729,37666932,14182541,8203,251549173,23995,1
57168,ASPHD2,chr22,F,26429313,26445012,14198240,15699,251564872,23996,3
57553,MICAL3,chr22,R,17787648,18024559,14435151,236911,251801783,23997,46
57591,MKL1,chr22,R,40410280,40636719,14661590,226439,252028222,23998,18
60489,APOBEC3G,chr22,F,39077004,39087743,14672329,10739,252038961,23999,7
63929,XPNPEP3,chr22,F,40857080,40932819,14748068,75739,252114700,24000,11
64098,PARVG,chr22,F,44170226,44208469,14786311,38243,252152943,24001,18
64781,CERK,chr22,R,46684409,46738255,14840157,53846,252206789,24002,13
64800,EFCAB6,chr22,R,43528560,43812337,15123934,283777,252490566,24003,39
64976,MRPL40,chr22,F,19432512,19436077,15127499,3565,252494131,24004,3
65078,RTN4R,chr22,R,20241414,20268293,15154378,26879,252521010,24005,1
66035,SLC2A11,chr22,F,23856702,23886112,15183788,29410,252550420,24006,13
79019,CENPM,chr22,R,41927762,41947164,15203190,19402,252569822,24007,8
79087,ALG12,chr22,R,49859146,49918458,15262502,59312,252629134,24008,12
79159,NOL12,chr22,F,37686336,37693478,15269644,7142,252636276,24009,5
79174,CRELD2,chr22,F,49918629,49927540,15278555,8911,252645187,24010,11
79640,C22orf46,chr22,F,41689935,41698136,15286756,8201,252653388,24011,1
79680,C22orf29,chr22,R,19846137,19854848,15295467,8711,252662099,24012,2
79734,KCTD17,chr22,F,37051724,37063390,15307133,11666,252673765,24013,7
79879,CCDC134,chr22,F,41800621,41832164,15338676,31543,252705308,24014,7
79924,ADM2,chr22,F,50481555,50486437,15343558,4882,252710190,24015,1
80020,FOXRED2,chr22,R,36487185,36507101,15363474,19916,252730106,24016,7
80115,BAIAP2L2,chr22,R,38084882,38111304,15389896,26422,252756528,24017,19
80274,SCUBE1,chr22,R,43203222,43343388,15530062,140166,252896694,24018,25
80305,TRABD,chr22,F,50185904,50199598,15543756,13694,252910388,24019,10
80339,PNPLA3,chr22,F,43923738,43947568,15567586,23830,252934218,24020,8
80764,THAP7,chr22,R,20999771,21002115,15569930,2344,252936562,24021,3
80830,APOL6,chr22,F,35648359,35668409,15589980,20050,252956612,24022,3
80831,APOL5,chr22,F,35708423,35730325,15611882,21902,252978514,24023,7
80832,APOL4,chr22,R,36189127,36204833,15627588,15706,252994220,24024,5
80833,APOL3,chr22,R,36140322,36166177,15653443,25855,253020075,24025,8
81061,OR11H1,chr22,F,15528158,15529139,15654424,981,253021056,24026,0
83606,GUCD1,chr22,R,24540422,24555935,15669937,15513,253036569,24027,6
83642,SELO,chr22,F,50200978,50217616,15686575,16638,253053207,24028,8
83733,SLC25A18,chr22,F,17563164,17590890,15714301,27726,253080933,24029,11
83746,L3MBTL2,chr22,F,41205231,41231272,15740342,26041,253106974,24030,16
83874,TBC1D10A,chr22,R,30291989,30326966,15775319,34977,253141951,24031,8
83933,HDAC10,chr22,R,50245182,50251405,15781542,6223,253148174,24032,19
83999,KREMEN1,chr22,F,29073077,29168333,15876798,95256,253243430,24033,11
84133,ZNRF3,chr22,F,28800653,29057488,16133633,256835,253500265,24034,18
84164,ASCC2,chr22,R,29788607,29838304,16183330,49697,253549962,24035,22
84222,TMEM191A,chr22,F,20701113,20704603,16186820,3490,253553452,24036,7
84247,LDOC1L,chr22,R,44492569,44498125,16192376,5556,253559008,24037,1
84271,POLDIP3,chr22,R,42583720,42614962,16223618,31242,253590250,24038,9
84645,C22orf23,chr22,R,37943049,37953669,16234238,10620,253600870,24039,5
84700,MYO18B,chr22,F,25742146,26058788,16550880,316642,253917512,24040,51
84844,PHF5A,chr22,R,41459716,41468704,16559868,8988,253926500,24041,3
84861,KLHL22,chr22,R,20441518,20495883,16614233,54365,253980865,24042,7
85352,KIAA1644,chr22,R,44243664,44331695,16702264,88031,254068896,24043,5
85358,SHANK3,chr22,F,50674641,50733212,16760835,58571,254127467,24044,21
85359,DGCR6L,chr22,R,20314237,20320105,16766703,5868,254133335,24045,4
85371,KIAA1656,chr22,R,30368810,30377905,16775798,9095,254142430,24046,1
85376,RIMBP3,chr22,R,18606123,18611919,16781594,5796,254148226,24047,0
85377,MICALL1,chr22,F,37906147,37942458,16817905,36311,254184537,24048,18
85378,TUBGCP6,chr22,R,50217688,50245024,16845241,27336,254211873,24049,23
85379,KIAA1671,chr22,F,24952701,25197448,17089988,244747,254456620,24050,15
89781,HPS4,chr22,R,26443612,26483863,17130239,40251,254496871,24051,18
91179,SCARF2,chr22,R,20424583,20437859,17143515,13276,254510147,24052,10
91227,GGTLC2,chr22,F,22644619,22647898,17146794,3279,254513426,24053,5
91289,LMF2,chr22,R,50502946,50507840,17151688,4894,254518320,24054,12
91316,GUSBP11,chr22,R,23638486,23717423,17230625,78937,254597257,24055,11
91319,DERL3,chr22,R,23834502,23839213,17235336,4711,254601968,24056,4
91353,IGLL3P,chr22,F,25318256,25320227,17237307,1971,254603939,24057,2
91355,LRP5L,chr22,R,25351417,25381989,17267879,30572,254634511,24058,5
91445,RNF185,chr22,F,31160151,31207019,17314747,46868,254681379,24059,8
91464,ISX,chr22,F,35066135,35087387,17335999,21252,254702631,24060,4
91582,RPS19BP1,chr22,R,39529092,39532855,17339762,3763,254706394,24061,4
91689,SMDT1,chr22,F,42079690,42084284,17344356,4594,254710988,24062,2
91695,RRP7BP,chr22,R,42573243,42582011,17353124,8768,254719756,24063,6
94009,SERHL,chr22,F,42500578,42512560,17365106,11982,254731738,24064,10
96610,BMS1P20,chr22,F,22298097,22322968,17389977,24871,254756609,24065,10
112885,PHF21B,chr22,R,44868431,45009928,17531474,141497,254898106,24066,17
113691,TUBA3FP,chr22,R,21008202,21014287,17537559,6085,254904191,24067,2
113730,KLHDC7B,chr22,F,50548032,50551023,17540550,2991,254907182,24068,0
113791,PIK3IP1,chr22,R,31281592,31292534,17551492,10942,254918124,24069,5
113828,FAM83F,chr22,F,39994948,40030039,17586583,35091,254953215,24070,4
114794,ELFN2,chr22,R,37340643,37427470,17673410,86827,255040042,24071,4
114904,C1QTNF6,chr22,R,37180165,37198301,17691546,18136,255058178,24072,4
115650,TNFRSF13C,chr22,R,41925031,41926817,17693332,1786,255059964,24073,2
116936,RNU86,chr22,R,39316841,39316896,17693387,55,255060019,24074,0
116937,SNORD83A,chr22,R,39315212,39315307,17693482,95,255060114,24075,0
116938,SNORD83B,chr22,R,39313818,39313911,17693575,93,255060207,24076,0
128954,GAB4,chr22,R,16961935,17008278,17739918,46343,255106550,24077,10
128977,C22orf39,chr22,R,19440885,19448232,17747265,7347,255113897,24078,3
128989,TANGO2,chr22,F,20016999,20065926,17796192,48927,255162824,24079,12
129025,ZNF280A,chr22,R,22513735,22520281,17802738,6546,255169370,24080,1
129049,SGSM1,chr22,F,24806220,24926846,17923364,120626,255289996,24081,25
129080,EMID1,chr22,F,29205911,29259597,17977050,53686,255343682,24082,22
129138,ANKRD54,chr22,R,37830853,37848621,17994818,17768,255361450,24083,9
140564,APOBEC3D,chr22,F,39021112,39033251,18006957,12139,255373589,24084,6
140606,SELM,chr22,R,31104776,31107565,18009746,2789,255376378,24085,4
140883,ZNF280B,chr22,R,22484420,22509187,18034513,24767,255401145,24086,5
150160,CCT8L2,chr22,R,16590757,16592810,18036566,2053,255403198,24087,0
150165,XKR3,chr22,R,16783411,16821694,18074849,38283,255441481,24088,3
150185,LINC00895,chr22,R,19566129,19566839,18075559,710,255442191,24089,0
150197,LINC00896,chr22,F,20206331,20208537,18077765,2206,255444397,24090,0
150209,AIFM3,chr22,F,20965129,20981360,18093996,16231,255460628,24091,21
150221,RIMBP3C,chr22,R,21545665,21551461,18099792,5796,255466424,24092,0
150223,YDJC,chr22,R,21628088,21630325,18102029,2237,255468661,24093,3
150244,ZDHHC8P1,chr22,R,23390604,23402612,18114037,12008,255480669,24094,5
150248,C22orf15,chr22,F,23760032,23765863,18119868,5831,255486500,24095,6
150274,HSCB,chr22,F,28742000,28757518,18135386,15518,255502018,24096,5
150275,CCDC117,chr22,F,28772673,28789301,18152014,16628,255518646,24097,5
150280,HORMAD2,chr22,F,30080068,30210882,18282828,130814,255649460,24098,15
150290,DUSP18,chr22,R,30652050,30667890,18298668,15840,255665300,24099,4
150291,MORC2-AS1,chr22,F,30922307,30926654,18303015,4347,255669647,24100,1
150297,C22orf42,chr22,R,32149005,32160432,18314442,11427,255681074,24101,10
150350,ENTHD1,chr22,R,39743043,39893806,18465205,150763,255831837,24102,13
150353,DNAJB7,chr22,R,40859548,40862126,18467783,2578,255834415,24103,0
150356,CHADL,chr22,R,41209868,41241762,18499677,31894,255866309,24104,7
150365,MEI1,chr22,F,41699500,41799456,18599633,99956,255966265,24105,33
150368,FAM109B,chr22,F,42074250,42079438,18604821,5188,255971453,24106,3
150372,NFAM1,chr22,R,42380406,42437083,18661498,56677,256028130,24107,7
150379,PNPLA5,chr22,R,43879677,43892013,18673834,12336,256040466,24108,8
150381,PRR34-AS1,chr22,F,46053845,46058522,18678511,4677,256045143,24109,2
150383,CDPF1,chr22,R,46244012,46250679,18685178,6667,256051810,24110,7
150384,GTSE1-AS1,chr22,R,46295142,46296660,18686696,1518,256053328,24111,0
164592,CCDC116,chr22,F,21632146,21637327,18691877,5181,256058509,24112,4
164633,CABP7,chr22,F,29720089,29731833,18703621,11744,256070253,24113,5
164656,TMPRSS6,chr22,R,37065435,37110635,18748821,45200,256115453,24114,20
164668,APOBEC3H,chr22,F,39097222,39104067,18755666,6845,256122298,24115,5
164684,WBP2NL,chr22,F,41995345,42059574,18819895,64229,256186527,24116,9
164714,TTLL8,chr22,R,50018574,50059132,18860453,40558,256227085,24117,15
171568,POLR3H,chr22,R,41525798,41544606,18879261,18808,256245893,24118,7
200298,LINC00528,chr22,F,17777289,17779481,18881453,2192,256248085,24119,0
200312,RNF215,chr22,R,30378811,30387313,18889955,8502,256256587,24120,8
200315,APOBEC3A,chr22,F,38957521,38963183,18895617,5662,256262249,24121,4
200316,APOBEC3F,chr22,F,39040603,39055972,18910986,15369,256277618,24122,6
253143,PRR14L,chr22,R,31681346,31750173,18979813,68827,256346445,24123,10
253190,SERHL2,chr22,F,42518734,42574382,19035461,55648,256402093,24124,15
254240,BPIFC,chr22,R,32413844,32464469,19086086,50625,256452718,24125,19
255349,TMEM211,chr22,R,24934772,24939347,19090661,4575,256457293,24126,2
266629,SEC14L3,chr22,R,30447958,30472047,19114750,24089,256481382,24127,14
266697,POM121L4P,chr22,F,20689554,20691721,19116917,2167,256483549,24128,0
266747,RGL4,chr22,F,23690860,23699705,19125762,8845,256492394,24129,11
267010,RNU12,chr22,F,42615244,42615393,19125911,149,256492543,24130,0
267020,ATP5L2,chr22,R,42639802,42640601,19126710,799,256493342,24131,0
284865,LOC284865,chr22,R,20198729,20204918,19132899,6189,256499531,24132,3
284889,MIF-AS1,chr22,R,23893709,23898930,19138120,5221,256504752,24133,2
284898,LOC284898,chr22,R,27048143,27060505,19150482,12362,256517114,24134,1
284900,TTC28-AS1,chr22,F,27919375,28002679,19233786,83304,256600418,24135,6
284904,SEC14L4,chr22,R,30488889,30505711,19250608,16822,256617240,24136,12
284912,LOC284912,chr22,R,35626987,35637850,19261471,10863,256628103,24137,7
284930,LOC284930,chr22,F,47631673,47855600,19485398,223927,256852030,24138,8
284933,LOC284933,chr22,R,48538899,48547387,19493886,8488,256860518,24139,4
284942,RPL23AP82,chr22,F,50757085,50799637,19536438,42552,256903070,24140,4
339665,SLC35E4,chr22,F,30635805,30647875,19548508,12070,256915140,24141,1
339666,LOC339666,chr22,F,32376663,32384343,19556188,7680,256922820,24142,2
339669,TEX33,chr22,R,36991118,37007863,19572933,16745,256939565,24143,6
339674,LINC00634,chr22,F,41952186,41958942,19579689,6756,256946321,24144,1
339685,LOC339685,chr22,F,47324622,47366807,19621874,42185,256988506,24145,2
348645,C22orf34,chr22,R,49414523,49657542,19864893,243019,257231525,24146,10
373856,USP41,chr22,R,20363283,20390758,19892368,27475,257259000,24147,9
375133,PI4KAP2,chr22,R,21472997,21517491,19936862,44494,257303494,24148,16
376844,SDC4P,chr22,R,30481289,30481756,19937329,467,257303961,24149,0
386593,CHKB-CPT1B,chr22,R,50568860,50582999,19951468,14139,257318100,24150,10
387590,TPTEP1,chr22,F,16601910,16648830,19998388,46920,257365020,24151,8
388849,LOC388849,chr22,R,20148416,20151259,20001231,2843,257367863,24152,8
388882,LOC388882,chr22,R,23462081,23486980,20026130,24899,257392762,24153,11
388886,LRRC75B,chr22,R,24585622,24593104,20033612,7482,257400244,24154,4
388906,OGFRP1,chr22,F,42269752,42274862,20038722,5110,257405354,24155,1
388910,LINC00207,chr22,F,44569339,44572449,20041832,3110,257408464,24156,4
400891,LRRC74B,chr22,F,21045959,21064168,20060041,18209,257426673,24157,13
400892,BCRP2,chr22,F,21103015,21122286,20079312,19271,257445944,24158,5
400916,CHCHD10,chr22,R,23765833,23767972,20081451,2139,257448083,24159,3
400927,LOC400927,chr22,R,38344664,38398926,20135713,54262,257502345,24160,4
400931,MIRLET7BHG,chr22,F,46085996,46113928,20163645,27932,257530277,24161,5
400932,LINC00898,chr22,R,47621042,47631569,20174172,10527,257540804,24162,5
400935,IL17REL,chr22,R,49994512,50013198,20192858,18686,257559490,24163,15
402055,SRRD,chr22,F,26483883,26491938,20200913,8055,257567545,24164,6
406883,MIRLET7A3,chr22,F,46112748,46112822,20200987,74,257567619,24165,0
406884,MIRLET7B,chr22,F,46113685,46113768,20201070,83,257567702,24166,0
406920,MIR130B,chr22,F,21653303,21653385,20201152,82,257567784,24167,0
406961,MIR185,chr22,F,20033138,20033220,20201234,82,257567866,24168,0
407039,MIR33A,chr22,F,41900943,41901012,20201303,69,257567935,24169,0
414351,LINC00229,chr22,R,44606327,44625419,20220395,19092,257587027,24170,4
414918,DENND6B,chr22,R,50311962,50327089,20235522,15127,257602154,24171,20
415116,PIM3,chr22,F,49960494,49964072,20239100,3578,257605732,24172,5
439931,THAP7-AS1,chr22,F,21001921,21010374,20247553,8453,257614185,24173,2
440799,P2RX6P,chr22,R,21042391,21044249,20249411,1858,257616043,24174,1
440804,RIMBP3B,chr22,F,21383750,21389169,20254830,5419,257621462,24175,0
440822,PIWIL3,chr22,R,24719033,24774720,20310517,55687,257677149,24176,22
440823,MIAT,chr22,F,26657481,26676478,20329514,18997,257696146,24177,4
440829,SHISA8,chr22,R,41909532,41915093,20335075,5561,257701707,24178,3
440836,ODF3B,chr22,R,50530408,50532579,20337246,2171,257703878,24179,5
503637,DUXAP8,chr22,F,15784953,15827434,20379727,42481,257746359,24180,7
550631,CCDC157,chr22,F,30356637,30378383,20401473,21746,257768105,24181,13
553158,PRR5-ARHGAP8,chr22,F,44702197,44862784,20562060,160587,257928692,24182,12
642633,FAM230B,chr22,F,21166902,21192156,20587314,25254,257953946,24183,12
642643,LOC642643,chr22,F,18733734,18750417,20603997,16683,257970629,24184,7
642648,LOC642648,chr22,R,46064650,46071037,20610384,6387,257977016,24185,2
642757,TBC1D22A-AS1,chr22,R,46914091,46916042,20612335,1951,257978967,24186,0
644165,BCRP3,chr22,F,24632914,24653360,20632781,20446,257999413,24187,6
644186,SYCE3,chr22,R,50551111,50562899,20644569,11788,258011201,24188,2
645426,TMEM191C,chr22,F,21467139,21469940,20647370,2801,258014002,24189,6
646023,ADORA2A-AS1,chr22,R,24429209,24494815,20712976,65606,258079608,24190,10
646074,POM121L10P,chr22,R,24645165,24659147,20726958,13982,258093590,24191,5
646851,FAM227A,chr22,R,38578119,38656629,20805468,78510,258172100,24192,20
648691,LL22NC03-63E9.3,chr22,F,22559342,22566599,20812725,7257,258179357,24193,2
649179,PRAMENP,chr22,R,21991098,22044033,20865660,52935,258232292,24194,11
649264,CES5AP1,chr22,R,23359605,23382126,20888181,22521,258254813,24195,6
652968,GATSL3,chr22,R,30285117,30289627,20892691,4510,258259323,24196,8
653203,FAM230A,chr22,F,18493206,18500595,20900080,7389,258266712,24197,7
653689,GSTT2B,chr22,R,23957413,23961234,20903901,3821,258270533,24198,4
693233,MIR648,chr22,R,17980867,17980961,20903995,94,258270627,24199,0
693234,MIR649,chr22,R,21034175,21034272,20904092,97,258270724,24200,0
723778,MIR650,chr22,F,22822775,22822871,20904188,96,258270820,24201,0
724028,MIR658,chr22,R,37844271,37844371,20904288,100,258270920,24202,0
724029,MIR659,chr22,R,37847677,37847774,20904385,97,258271017,24203,0
728229,TMEM191B,chr22,F,18527801,18530794,20907378,2993,258274010,24204,9
728233,PI4KAP1,chr22,R,18533863,18548828,20922343,14965,258288975,24205,14
728441,GGT2,chr22,R,21207971,21239982,20954354,32011,258320986,24206,18
729461,LOC729461,chr22,R,18369331,18391105,20976128,21774,258342760,24207,10
730005,SEC14L6,chr22,R,30524605,30546717,20998240,22112,258364872,24208,14
730668,LOC730668,chr22,F,46006615,46010777,21002402,4162,258369034,24209,0
100037417,DDTL,chr22,F,23966837,23972559,21008124,5722,258374756,24210,3
100113380,SNORD125,chr22,R,29333162,29333258,21008220,96,258374852,24211,0
100126318,MIR301B,chr22,F,21652980,21653058,21008298,78,258374930,24212,0
100128531,LOC100128531,chr22,R,25102416,25112692,21018574,10276,258385206,24213,4
100128818,LPEQ6126,chr22,R,47115068,47118799,21022305,3731,258388937,24214,1
100128946,LINC01310,chr22,F,48866769,48898386,21053922,31617,258420554,24215,6
100130418,CECR7,chr22,F,17036569,17058792,21076145,22223,258442777,24216,3
100130717,CECR5-AS1,chr22,F,17159388,17165445,21082202,6057,258448834,24217,1
100130899,LOC100130899,chr22,F,40032331,40036577,21086448,4246,258453080,24218,0
100132273,NDUFA6-AS1,chr22,F,42090932,42125349,21120865,34417,258487497,24219,4
100144603,CHKB-AS1,chr22,F,50583025,50595281,21133121,12256,258499753,24220,4
100192420,FLJ41941,chr22,F,18029384,18037968,21141705,8584,258508337,24221,1
100271722,LINC00899,chr22,R,46039906,46044868,21146667,4962,258513299,24222,3
100302118,MIR1286,chr22,R,20249133,20249211,21146745,78,258513377,24223,0
100302149,MIR1249,chr22,R,45200953,45201019,21146811,66,258513443,24224,0
100302197,MIR1306,chr22,F,20086057,20086142,21146896,85,258513528,24225,0
100302237,MIR1281,chr22,F,41092512,41092566,21146950,54,258513582,24226,0
100313914,MIR548J,chr22,R,26555211,26555323,21147062,112,258513694,24227,0
100422912,MIR3200,chr22,F,30731556,30731641,21147147,85,258513779,24228,0
100422916,MIR3201,chr22,F,48274363,48274415,21147199,52,258513831,24229,0
100422998,MIR3199-2,chr22,F,27920525,27920611,21147285,86,258513917,24230,0
100423025,MIR3198-1,chr22,R,17764179,17764259,21147365,80,258513997,24231,0
100423034,MIR3199-1,chr22,R,27920524,27920612,21147453,88,258514085,24232,0
100423062,IGLL5,chr22,F,22887779,22895834,21155508,8055,258522140,24233,2
100500826,MIR3909,chr22,F,35335639,35335758,21155627,119,258522259,24234,0
100500828,MIR3619,chr22,F,46091043,46091126,21155710,83,258522342,24235,0
100500833,MIR3653,chr22,R,29333157,29333267,21155820,110,258522452,24236,0
100500860,MIR3618,chr22,F,20085745,20085833,21155908,88,258522540,24237,0
100500882,MIR3667,chr22,R,49543392,49543466,21155982,74,258522614,24238,0
100500901,MIR3928,chr22,R,31160061,31160119,21156040,58,258522672,24239,0
100506195,LARGE-AS1,chr22,F,33724985,33750817,21181872,25832,258548504,24240,9
100506241,LL22NC01-81G9.3,chr22,F,36965247,36968172,21184797,2925,258551429,24241,3
100506271,LOC100506271,chr22,R,37352189,37354839,21187447,2650,258554079,24242,1
100506472,LOC100506472,chr22,F,39432159,39437128,21192416,4969,258559048,24243,3
100506679,LOC100506679,chr22,F,43038584,43052366,21206198,13782,258572830,24244,2
100506714,NUP50-AS1,chr22,R,45133757,45163781,21236222,30024,258602854,24245,3
100506737,LINC01589,chr22,R,45589134,45606015,21253103,16881,258619735,24246,2
100507599,LOC100507599,chr22,F,26512509,26514568,21255162,2059,258621794,24247,1
100507657,LOC100507657,chr22,F,27311742,27318444,21261864,6702,258628496,24248,1
100526833,SEPT5-GP1BB,chr22,F,19717219,19724774,21269419,7555,258636051,24249,1
100616143,MIR4763,chr22,F,46113565,46113657,21269511,92,258636143,24250,0
100616146,MIR4534,chr22,F,37988793,37988853,21269571,60,258636203,24251,0
100616253,MIR4762,chr22,F,45760523,45760598,21269646,75,258636278,24252,0
100616259,MIR378I,chr22,R,41923221,41923297,21269722,76,258636354,24253,0
100616283,MIR4766,chr22,R,40813882,40813958,21269798,76,258636430,24254,0
100616295,MIR4764,chr22,R,33436581,33436669,21269886,88,258636518,24255,0
100616414,MIR4761,chr22,F,19963752,19963834,21269968,82,258636600,24256,0
100616415,MIR4535,chr22,F,48780294,48780353,21270027,59,258636659,24257,0
100652736,LINC01311,chr22,F,19171705,19172832,21271154,1127,258637786,24258,0
100652871,LOC100652871,chr22,F,23935476,23942861,21278539,7385,258645171,24259,3
100652901,LOC100652901,chr22,R,25343581,25345261,21280219,1680,258646851,24260,0
100847006,MIR5571,chr22,F,22886266,22886379,21280332,113,258646964,24261,0
100852406,POTEH-AS1,chr22,R,15700385,15703354,21283301,2969,258649933,24262,1
100873756,RNU6-28P,chr22,R,31479384,31479488,21283405,104,258650037,24263,0
100874123,ZNRF3-AS1,chr22,R,29024998,29031476,21289883,6478,258656515,24264,2
100874197,EFCAB6-AS1,chr22,F,43516253,43536605,21310235,20352,258676867,24265,2
100874530,APOBEC3B-AS1,chr22,R,38991558,38998220,21316897,6662,258683529,24266,4
100996335,LOC100996335,chr22,R,21308503,21325019,21333413,16516,258700045,24267,8
100996342,LOC100996342,chr22,F,17121594,17132104,21343923,10510,258710555,24268,3
100996401,LOC100996401,chr22,F,18527066,18527706,21344563,640,258711195,24269,0
100996404,LOC100996404,chr22,R,25561119,25564893,21348337,3774,258714969,24270,2
100996415,LOC100996415,chr22,R,18178025,18202437,21372749,24412,258739381,24271,12
100996598,LOC100996598,chr22,F,41369081,41370396,21374064,1315,258740696,24272,1
101730217,SPECC1L-ADORA2A,chr22,F,24270816,24442360,21545608,171544,258912240,24273,5
101926989,LOC101926989,chr22,F,36470727,36472139,21547020,1412,258913652,24274,1
101927051,LOC101927051,chr22,R,37641831,37658377,21563566,16546,258930198,24275,5
101927119,LOC101927119,chr22,F,38081788,38088741,21570519,6953,258937151,24276,5
101927183,LOC101927183,chr22,F,38424274,38432007,21578252,7733,258944884,24277,2
101927202,LOC101927202,chr22,F,39090730,39092851,21580373,2121,258947005,24278,2
101927257,LOC101927257,chr22,F,40521799,40526707,21585281,4908,258951913,24279,3
101927279,EP300-AS1,chr22,R,41185213,41197501,21597569,12288,258964201,24280,2
101927344,LOC101927344,chr22,F,42438022,42450776,21610323,12754,258976955,24281,5
101927372,LOC101927372,chr22,R,42501898,42505859,21614284,3961,258980916,24282,1
101927393,LOC101927393,chr22,F,42871413,42873388,21616259,1975,258982891,24283,1
101927447,LOC101927447,chr22,F,43275941,43283830,21624148,7889,258990780,24284,1
101927474,LOC101927474,chr22,F,43570087,43571760,21625821,1673,258992453,24285,2
101927499,LOC101927499,chr22,F,44312941,44314999,21627879,2058,258994511,24286,1
101927526,LOC101927526,chr22,F,44443326,44444788,21629341,1462,258995973,24287,2
101927551,LOC101927551,chr22,R,44997733,45003619,21635227,5886,259001859,24288,2
101927722,LL22NC03-75H12.2,chr22,R,47461298,47487111,21661040,25813,259027672,24289,2
101927859,LOC101927859,chr22,F,20337983,20361250,21684307,23267,259050939,24290,9
101928719,LOC101928719,chr22,R,50199087,50200884,21686104,1797,259052736,24291,1
101928824,LOC101928824,chr22,F,20495965,20500835,21690974,4870,259057606,24292,3
101928891,LOC101928891,chr22,F,20957091,20964680,21698563,7589,259065195,24293,1
101929255,LOC101929255,chr22,R,22402788,22409182,21704957,6394,259071589,24294,2
101929350,LOC101929350,chr22,R,16746868,16748633,21706722,1765,259073354,24295,1
101929372,LOC101929372,chr22,R,17580156,17589192,21715758,9036,259082390,24296,3
101929374,LOC101929374,chr22,F,23433563,23435071,21717266,1508,259083898,24297,2
101929426,LOC101929426,chr22,R,18092898,18094449,21718817,1551,259085449,24298,1
101929539,LINC01422,chr22,F,26903291,26920611,21736137,17320,259102769,24299,2
101929594,LOC101929594,chr22,R,28514559,28517252,21738830,2693,259105462,24300,2
101929638,LOC101929638,chr22,R,29180622,29205822,21764030,25200,259130662,24301,7
101929664,HORMAD2-AS1,chr22,R,30008741,30080480,21835769,71739,259202401,24302,4
101929728,LOC101929728,chr22,F,30667581,30669016,21837204,1435,259203836,24303,0
101929738,LOC101929738,chr22,F,18846448,18848852,21839608,2404,259206240,24304,0
101929760,PIK3IP1-AS1,chr22,F,31335348,31338021,21842281,2673,259208913,24305,1
101929839,LOC101929839,chr22,F,15819005,15821252,21844528,2247,259211160,24306,0
101930531,LOC101930531,chr22,F,12602291,12629455,21871692,27164,259238324,24307,9
101978785,PCAT14,chr22,F,23538101,23547306,21880897,9205,259247529,24308,3
102464824,MIR6069,chr22,R,35336720,35336799,21880976,79,259247608,24309,0
102465490,MIR6816,chr22,R,20114685,20114751,21881042,66,259247674,24310,0
102465491,MIR6819,chr22,R,36286846,36286907,21881103,61,259247735,24311,0
102465492,MIR6820,chr22,F,37967562,37967624,21881165,62,259247797,24312,0
102465493,MIR6821,chr22,F,49962865,49962939,21881239,74,259247871,24313,0
102465666,MIR7109,chr22,R,31621466,31621531,21881304,65,259247936,24314,0
102466081,MIR5739,chr22,F,28459868,28459948,21881384,80,259248016,24315,0
102466198,MIR6817,chr22,F,25455645,25455711,21881450,66,259248082,24316,0
102466742,MIR6818,chr22,F,30007048,30007113,21881515,65,259248147,24317,0
102466758,MIR6889,chr22,R,41252991,41253050,21881574,59,259248206,24318,0
102723305,LOC102723305,chr22,R,29409569,29415438,21887443,5869,259254075,24319,2
102723507,LOC102723507,chr22,R,36121181,36136398,21902660,15217,259269292,24320,6
102723706,LOC102723706,chr22,R,41986085,41998659,21915234,12574,259281866,24321,4
102723722,LOC102723722,chr22,F,42129870,42132085,21917449,2215,259284081,24322,3
102723769,LOC102723769,chr22,F,11897405,11956534,21976578,59129,259343210,24323,2
102723775,LINC01315,chr22,R,42364399,42369208,21981387,4809,259348019,24324,1
102723780,LOC102723780,chr22,R,10936829,10961529,22006087,24700,259372719,24325,9
102724123,LOC102724123,chr22,R,18794435,18805215,22016867,10780,259383499,24326,1
102724378,LOC102724378,chr22,R,37729415,37747434,22034886,18019,259401518,24327,4
102724608,LOC102724608,chr22,F,50541413,50543013,22036486,1600,259403118,24328,1
102724638,LOC102724638,chr22,R,22877535,22881125,22040076,3590,259406708,24329,5
102724653,LOC102724653,chr22,R,22087766,22104619,22056929,16853,259423561,24330,3
102724679,LOC102724679,chr22,F,23326132,23342583,22073380,16451,259440012,24331,3
102724801,LOC102724801,chr22,R,26108551,26154901,22119730,46350,259486362,24332,4
102724827,MIATNB,chr22,F,26672842,26780893,22227781,108051,259594413,24333,5
102724900,LOC102724900,chr22,F,27331703,27357550,22253628,25847,259620260,24334,4
102725072,LOC102725072,chr22,F,18850160,18855879,22259347,5719,259625979,24335,5
102725204,LOC102725204,chr22,R,24006087,24008824,22262084,2737,259628716,24336,1
102800317,LOC400927-CSNK1E,chr22,R,38290690,38398522,22369916,107832,259736548,24337,14
104310353,LINC01399,chr22,R,35119823,35231056,22481149,111233,259847781,24338,5
104502417,MGAT3-AS1,chr22,R,39475806,39476822,22482165,1016,259848797,24339,1
105369160,LOC105369160,chr22,F,41469187,41488965,22501943,19778,259868575,24340,2
105369161,LOC105369161,chr22,F,46948194,46956082,22509831,7888,259876463,24341,1
105369162,LOC105369162,chr22,F,48577176,48595846,22528501,18670,259895133,24342,2
105369185,LOC105369185,chr22,F,18425398,18433513,22536616,8115,259903248,24343,2
105369188,LOC105369188,chr22,F,37986322,37988098,22538392,1776,259905024,24344,0
105369191,LOC105369191,chr22,F,18486359,18493078,22545111,6719,259911743,24345,4
105369215,LOC105369215,chr22,R,21300984,21308381,22552508,7397,259919140,24346,8
105372845,LOC105372845,chr22,F,15651868,15689274,22589914,37406,259956546,24347,10
105372846,LOC105372846,chr22,F,15517077,15543919,22616756,26842,259983388,24348,2
105372848,LOC105372848,chr22,R,17085952,17094027,22624831,8075,259991463,24349,2
105372849,LOC105372849,chr22,F,17247488,17261748,22639091,14260,260005723,24350,2
105372850,LOC105372850,chr22,R,17563727,17570154,22645518,6427,260012150,24351,2
105372851,LOC105372851,chr22,F,17878119,17881192,22648591,3073,260015223,24352,2
105372852,LOC105372852,chr22,F,17866019,17868003,22650575,1984,260017207,24353,3
105372853,LOC105372853,chr22,F,18056786,18073113,22666902,16327,260033534,24354,6
105372855,LOC105372855,chr22,R,18996512,18998725,22669115,2213,260035747,24355,1
105372858,LOC105372858,chr22,F,18205809,18211924,22675230,6115,260041862,24356,2
105372859,LOC105372859,chr22,F,19291913,19351129,22734446,59216,260101078,24357,6
105372860,LOC105372860,chr22,F,19448237,19451688,22737897,3451,260104529,24358,1
105372861,LOC105372861,chr22,F,19727702,19738707,22748902,11005,260115534,24359,2
105372862,LOC105372862,chr22,R,20206037,20212157,22755022,6120,260121654,24360,2
105372863,LOC105372863,chr22,F,20226944,20235955,22764033,9011,260130665,24361,2
105372864,LOC105372864,chr22,F,20244792,20253854,22773095,9062,260139727,24362,1
105372866,LOC105372866,chr22,R,20343228,20354333,22784200,11105,260150832,24363,3
105372867,LOC105372867,chr22,F,18750561,18757906,22791545,7345,260158177,24364,5
105372870,LOC105372870,chr22,F,18548797,18574563,22817311,25766,260183943,24365,2
105372871,LOC105372871,chr22,F,18634540,18635687,22818458,1147,260185090,24366,1
105372935,LOC105372935,chr22,R,21192789,21204019,22829688,11230,260196320,24367,1
105372938,LOC105372938,chr22,R,20522069,20524365,22831984,2296,260198616,24368,2
105372939,LOC105372939,chr22,F,20482708,20489051,22838327,6343,260204959,24369,2
105372940,LOC105372940,chr22,F,20460649,20475576,22853254,14927,260219886,24370,2
105372942,LOC105372942,chr22,F,18349937,18361189,22864506,11252,260231138,24371,1
105372944,LOC105372944,chr22,F,21354241,21357968,22868233,3727,260234865,24372,4
105372946,LOC105372946,chr22,F,21488351,21512698,22892580,24347,260259212,24373,3
105372947,LOC105372947,chr22,R,22920011,22924966,22897535,4955,260264167,24374,5
105372948,LOC105372948,chr22,R,22820980,23016133,23092688,195153,260459320,24375,5
105372949,LOC105372949,chr22,R,22692755,22711594,23111527,18839,260478159,24376,6
105372951,LOC105372951,chr22,R,22305110,22310219,23116636,5109,260483268,24377,1
105372952,LOC105372952,chr22,R,22289236,22298030,23125430,8794,260492062,24378,2
105372954,LOC105372954,chr22,F,23494293,23510197,23141334,15904,260507966,24379,2
105372955,LOC105372955,chr22,R,23510513,23513334,23144155,2821,260510787,24380,2
105372957,LOC105372957,chr22,F,23566969,23573098,23150284,6129,260516916,24381,4
105372960,LOC105372960,chr22,R,24394213,24408485,23164556,14272,260531188,24382,1
105372961,LOC105372961,chr22,R,24576064,24580246,23168738,4182,260535370,24383,1
105372962,LOC105372962,chr22,R,24700936,24707758,23175560,6822,260542192,24384,2
105372963,LOC105372963,chr22,R,25883140,25901020,23193440,17880,260560072,24385,3
105372964,LOC105372964,chr22,F,25636779,25642226,23198887,5447,260565519,24386,2
105372965,LOC105372965,chr22,F,25481194,25512847,23230540,31653,260597172,24387,2
105372966,LOC105372966,chr22,F,25476217,25479939,23234262,3722,260600894,24388,1
105372967,LOC105372967,chr22,R,25419103,25423374,23238533,4271,260605165,24389,2
105372968,LOC105372968,chr22,F,25282890,25302453,23258096,19563,260624728,24390,2
105372969,LOC105372969,chr22,R,25280702,25283065,23260459,2363,260627091,24391,3
105372971,LOC105372971,chr22,R,26161909,26169304,23267854,7395,260634486,24392,5
105372972,LOC105372972,chr22,F,26152150,26164287,23279991,12137,260646623,24393,3
105372973,LOC105372973,chr22,R,26352179,26354675,23282487,2496,260649119,24394,2
105372974,LOC105372974,chr22,R,26240610,26254059,23295936,13449,260662568,24395,4
105372975,LOC105372975,chr22,F,26445283,26446409,23297062,1126,260663694,24396,1
105372976,LOC105372976,chr22,F,26795117,26803012,23304957,7895,260671589,24397,2
105372977,LOC105372977,chr22,F,27187510,27189260,23306707,1750,260673339,24398,2
105372978,LOC105372978,chr22,R,27221663,27224710,23309754,3047,260676386,24399,3
105372979,LOC105372979,chr22,R,27320540,27322221,23311435,1681,260678067,24400,2
105372980,LOC105372980,chr22,F,27436317,27441934,23317052,5617,260683684,24401,2
105372981,LOC105372981,chr22,R,27504920,27561485,23373617,56565,260740249,24402,5
105372982,LOC105372982,chr22,F,28116740,28161375,23418252,44635,260784884,24403,3
105372983,LOC105372983,chr22,F,29032778,29036568,23422042,3790,260788674,24404,2
105372985,LOC105372985,chr22,R,29223407,29226482,23425117,3075,260791749,24405,2
105372986,LOC105372986,chr22,F,29260864,29261191,23425444,327,260792076,24406,1
105372987,LOC105372987,chr22,R,29392825,29402914,23435533,10089,260802165,24407,2
105372988,LOC105372988,chr22,R,30182934,30207134,23459733,24200,260826365,24408,2
105372989,LOC105372989,chr22,R,30421205,30423452,23461980,2247,260828612,24409,1
105372990,LOC105372990,chr22,F,30431980,30436462,23466462,4482,260833094,24410,3
105372991,LOC105372991,chr22,F,30447951,30452774,23471285,4823,260837917,24411,3
105372992,LOC105372992,chr22,F,30929947,30930633,23471971,686,260838603,24412,1
105372993,LOC105372993,chr22,R,30889642,30922223,23504552,32581,260871184,24413,2
105372994,LOC105372994,chr22,R,30872269,30879797,23512080,7528,260878712,24414,2
105372995,LOC105372995,chr22,R,31107797,31122949,23527232,15152,260893864,24415,3
105372996,LOC105372996,chr22,R,31150837,31159716,23536111,8879,260902743,24416,2
105372997,LOC105372997,chr22,R,31292946,31303297,23546462,10351,260913094,24417,3
105372999,LOC105372999,chr22,F,31970829,32037566,23613199,66737,260979831,24418,7
105373000,LOC105373000,chr22,R,32068611,32121748,23666336,53137,261032968,24419,4
105373001,LOC105373001,chr22,F,32167431,32190857,23689762,23426,261056394,24420,2
105373002,LOC105373002,chr22,F,32641198,32661215,23709779,20017,261076411,24421,3
105373003,LOC105373003,chr22,F,32587213,32589050,23711616,1837,261078248,24422,1
105373004,LOC105373004,chr22,F,32582643,32587010,23715983,4367,261082615,24423,3
105373005,LOC105373005,chr22,R,33066630,33221758,23871111,155128,261237743,24424,3
105373006,LOC105373006,chr22,F,33108528,33110638,23873221,2110,261239853,24425,2
105373007,LOC105373007,chr22,F,33573541,33598361,23898041,24820,261264673,24426,3
105373008,LOC105373008,chr22,F,33926363,33936950,23908628,10587,261275260,24427,2
105373009,LOC105373009,chr22,R,34192026,34210540,23927142,18514,261293774,24428,3
105373010,LOC105373010,chr22,F,34017444,34218732,24128430,201288,261495062,24429,12
105373012,LOC105373012,chr22,R,34349671,34362313,24141072,12642,261507704,24430,3
105373013,LOC105373013,chr22,F,34628598,34665829,24178303,37231,261544935,24431,3
105373014,LOC105373014,chr22,F,34764127,34767698,24181874,3571,261548506,24432,2
105373015,LOC105373015,chr22,R,34947085,34952782,24187571,5697,261554203,24433,2
105373016,LOC105373016,chr22,F,34946389,34968018,24209200,21629,261575832,24434,3
105373017,LOC105373017,chr22,R,35232640,35262311,24238871,29671,261605503,24435,5
105373018,LOC105373018,chr22,R,36461085,36462804,24240590,1719,261607222,24436,2
105373019,LOC105373019,chr22,F,36498164,36498931,24241357,767,261607989,24437,1
105373020,LOC105373020,chr22,F,36496168,36497984,24243173,1816,261609805,24438,2
105373021,LOC105373021,chr22,F,36703917,36721203,24260459,17286,261627091,24439,1
105373022,LOC105373022,chr22,R,36888029,36889304,24261734,1275,261628366,24440,1
105373023,LOC105373023,chr22,R,36918471,36925979,24269242,7508,261635874,24441,1
105373024,LOC105373024,chr22,R,37290753,37332126,24310615,41373,261677247,24442,5
105373026,LOC105373026,chr22,F,37972152,38026755,24365218,54603,261731850,24443,2
105373027,LOC105373027,chr22,F,38078640,38080841,24367419,2201,261734051,24444,2
105373028,LOC105373028,chr22,F,38075985,38078192,24369626,2207,261736258,24445,2
105373029,LOC105373029,chr22,F,38434315,38436696,24372007,2381,261738639,24446,2
105373030,LOC105373030,chr22,R,38410356,38423930,24385581,13574,261752213,24447,5
105373031,LOC105373031,chr22,F,38570499,38571202,24386284,703,261752916,24448,1
105373032,LOC105373032,chr22,F,38886837,38925336,24424783,38499,261791415,24449,2
105373033,LOC105373033,chr22,R,38963258,38969367,24430892,6109,261797524,24450,2
105373035,LOC105373035,chr22,R,39500491,39502150,24432551,1659,261799183,24451,3
105373036,LOC105373036,chr22,R,40260184,40277067,24449434,16883,261816066,24452,2
105373037,LOC105373037,chr22,F,40555176,40564466,24458724,9290,261825356,24453,4
105373038,LOC105373038,chr22,F,40651885,40655216,24462055,3331,261828687,24454,2
105373039,LOC105373039,chr22,R,40660737,40684920,24486238,24183,261852870,24455,2
105373040,LOC105373040,chr22,R,40753073,40758681,24491846,5608,261858478,24456,2
105373042,LOC105373042,chr22,R,41370652,41381842,24503036,11190,261869668,24457,3
105373043,LOC105373043,chr22,F,41447857,41448898,24504077,1041,261870709,24458,1
105373044,LOC105373044,chr22,R,41551708,41560937,24513306,9229,261879938,24459,1
105373045,LOC105373045,chr22,F,41885185,41892439,24520560,7254,261887192,24460,2
105373047,LOC105373047,chr22,R,42121000,42123590,24523150,2590,261889782,24461,1
105373048,LOC105373048,chr22,F,42396546,42398204,24524808,1658,261891440,24462,2
105373049,LOC105373049,chr22,F,42898514,42907387,24533681,8873,261900313,24463,2
105373050,LOC105373050,chr22,F,43232010,43237084,24538755,5074,261905387,24464,2
105373051,LOC105373051,chr22,F,43212598,43213684,24539841,1086,261906473,24465,1
105373052,LOC105373052,chr22,F,43210246,43212578,24542173,2332,261908805,24466,2
105373053,LOC105373053,chr22,R,43373993,43391396,24559576,17403,261926208,24467,3
105373054,LOC105373054,chr22,F,43399901,43409717,24569392,9816,261936024,24468,4
105373055,LOC105373055,chr22,F,43698656,43700111,24570847,1455,261937479,24469,2
105373057,LOC105373057,chr22,F,43836041,43838860,24573666,2819,261940298,24470,1
105373058,LOC105373058,chr22,F,43818558,43824421,24579529,5863,261946161,24471,3
105373059,LOC105373059,chr22,R,44537967,44549526,24591088,11559,261957720,24472,2
105373060,LOC105373060,chr22,F,44624077,44624792,24591803,715,261958435,24473,1
105373062,LOC105373062,chr22,R,44859462,44864239,24596580,4777,261963212,24474,3
105373063,LOC105373063,chr22,R,44949343,44974146,24621383,24803,261988015,24475,2
105373065,LOC105373065,chr22,R,45262271,45269122,24628234,6851,261994866,24476,1
105373066,LOC105373066,chr22,R,45498289,45500983,24630928,2694,261997560,24477,2
105373067,LOC105373067,chr22,R,45635992,45641953,24636889,5961,262003521,24478,2
105373068,LOC105373068,chr22,R,45647366,45656679,24646202,9313,262012834,24479,2
105373069,LOC105373069,chr22,F,45647283,45657227,24656146,9944,262022778,24480,3
105373070,LOC105373070,chr22,R,45773795,45786392,24668743,12597,262035375,24481,2
105373071,LOC105373071,chr22,F,45882055,45894406,24681094,12351,262047726,24482,4
105373072,LOC105373072,chr22,R,46011248,46014442,24684288,3194,262050920,24483,2
105373074,LOC105373074,chr22,R,46161041,46172349,24695596,11308,262062228,24484,1
105373075,LOC105373075,chr22,F,46548747,46553360,24700209,4613,262066841,24485,1
105373077,LOC105373077,chr22,R,46734611,46737726,24703324,3115,262069956,24486,1
105373078,LOC105373078,chr22,R,47141246,47144648,24706726,3402,262073358,24487,2
105373079,LOC105373079,chr22,R,47368814,47373707,24711619,4893,262078251,24488,2
105373080,LOC105373080,chr22,F,48340029,48341748,24713338,1719,262079970,24489,2
105373081,LOC105373081,chr22,F,48351339,48360755,24722754,9416,262089386,24490,3
105373082,LOC105373082,chr22,F,48466320,48468510,24724944,2190,262091576,24491,1
105373083,LOC105373083,chr22,R,48554617,48559446,24729773,4829,262096405,24492,1
105373084,LOC105373084,chr22,F,48518062,48521265,24732976,3203,262099608,24493,1
105373085,LOC105373085,chr22,R,49047479,49052405,24737902,4926,262104534,24494,1
105373086,LOC105373086,chr22,F,49095655,49098633,24740880,2978,262107512,24495,2
105373087,LOC105373087,chr22,F,49497215,49524246,24767911,27031,262134543,24496,3
105373088,LOC105373088,chr22,F,49534100,49535499,24769310,1399,262135942,24497,2
105373089,LOC105373089,chr22,R,49538001,49541612,24772921,3611,262139553,24498,1
105373090,LOC105373090,chr22,F,49781804,49783435,24774552,1631,262141184,24499,1
105373091,LOC105373091,chr22,F,49849634,49851067,24775985,1433,262142617,24500,1
105373092,LOC105373092,chr22,F,49891814,49897676,24781847,5862,262148479,24501,2
105373094,LOC105373094,chr22,F,41969246,41975904,24788505,6658,262155137,24502,2
105373095,LOC105373095,chr22,R,50208460,50210174,24790219,1714,262156851,24503,1
105373096,LOC105373096,chr22,F,50318027,50321416,24793608,3389,262160240,24504,3
105373098,LOC105373098,chr22,R,50542302,50544261,24795567,1959,262162199,24505,2
105373099,LOC105373099,chr22,F,50606998,50610205,24798774,3207,262165406,24506,1
105373100,LOC105373100,chr22,R,50735828,50738169,24801115,2341,262167747,24507,1
105373101,LOC105373101,chr22,R,50710349,50711608,24802374,1259,262169006,24508,1
105377182,LOC105377182,chr22,R,18758534,18769783,24813623,11249,262180255,24509,1
105377184,LOC105377184,chr22,F,19136208,19136435,24813850,227,262180482,24510,1
105377185,LOC105377185,chr22,F,19933598,19937972,24818224,4374,262184856,24511,2
105377189,LOC105377189,chr22,F,20360708,20362095,24819611,1387,262186243,24512,1
105377190,LOC105377190,chr22,R,21359595,21360724,24820740,1129,262187372,24513,1
105377191,LOC105377191,chr22,R,21420299,21442749,24843190,22450,262209822,24514,2
105377195,LOC105377195,chr22,F,29359965,29434513,24917738,74548,262284370,24515,9
105377197,LOC105377197,chr22,F,35314112,35314890,24918516,778,262285148,24516,1
105377199,LOC105377199,chr22,F,36388166,36411036,24941386,22870,262308018,24517,2
105377201,LOC105377201,chr22,F,36872545,36872992,24941833,447,262308465,24518,2
105377203,LOC105377203,chr22,R,42145450,42149500,24945883,4050,262312515,24519,2
105377204,LOC105377204,chr22,F,45607783,45609092,24947192,1309,262313824,24520,1
105377205,LOC105377205,chr22,R,49832411,49857660,24972441,25249,262339073,24521,4
105379418,LOC105379418,chr22,F,10742026,10753081,24983496,11055,262350128,24522,2
105379427,LOC105379427,chr22,F,11473857,11484612,24994251,10755,262360883,24523,3
105379428,LOC105379428,chr22,R,12798043,12815761,25011969,17718,262378601,24524,3
105379429,LOC105379429,chr22,F,11709500,11716715,25019184,7215,262385816,24525,2
105379430,LOC105379430,chr22,F,10846696,10848407,25020895,1711,262387527,24526,1
105379515,LOC105379515,chr22,F,11969666,11971963,25023192,2297,262389824,24527,2
105379516,LOC105379516,chr22,R,12131700,12167053,25058545,35353,262425177,24528,3
105379518,LOC105379518,chr22,F,18233148,18235228,25060625,2080,262427257,24529,2
105379519,LOC105379519,chr22,R,18361817,18369146,25067954,7329,262434586,24530,3
13,AADAC,chr3,F,151814024,151828488,14464,14464,262449050,24531,4
30,ACAA1,chr3,R,38122709,38137242,28997,14533,262463583,24532,11
55,ACPP,chr3,F,132317366,132368302,79933,50936,262514519,24533,11
86,ACTL6A,chr3,F,179562879,179588405,105459,25526,262540045,24534,13
93,ACVR2B,chr3,F,38454298,38493142,144303,38844,262578889,24535,11
95,ACY1,chr3,F,51983283,51989202,150222,5919,262584808,24536,14
111,ADCY5,chr3,R,123282295,123448638,316565,166343,262751151,24537,28
141,ADPRH,chr3,F,119579432,119589945,327078,10513,262761664,24538,4
185,AGTR1,chr3,F,148697870,148743003,372211,45133,262806797,24539,4
197,AHSG,chr3,F,186613060,186621318,380469,8258,262815055,24540,6
211,ALAS1,chr3,F,52198082,52214327,396714,16245,262831300,24541,11
214,ALCAM,chr3,F,105366712,105576913,606915,210201,263041501,24542,15
275,AMT,chr3,R,49416777,49422678,612816,5901,263047402,24543,8
327,APEH,chr3,F,49673129,49683504,623191,10375,263057777,24544,22
347,APOD,chr3,R,195568701,195584205,638695,15504,263073281,24545,4
378,ARF4,chr3,R,57571362,57597488,664821,26126,263099407,24546,5
387,RHOA,chr3,R,49359135,49412093,717779,52958,263152365,24547,5
483,ATP1B3,chr3,F,141876627,141926540,767692,49913,263202278,24548,6
491,ATP2B2,chr3,R,10324022,10707993,1151663,383971,263586249,24549,30
523,ATP6V1A,chr3,F,113747018,113812058,1216703,65040,263651289,24550,14
545,ATR,chr3,R,142449234,142578826,1346295,129592,263780881,24551,47
590,BCHE,chr3,R,165772903,165837472,1410864,64569,263845450,24552,3
604,BCL6,chr3,R,187721376,187745725,1435213,24349,263869799,24553,11
622,BDH1,chr3,R,197509782,197573323,1498754,63541,263933340,24554,12
668,FOXL2,chr3,R,138944223,138947140,1501671,2917,263936257,24555,0
686,BTD,chr3,F,15601351,15647642,1547962,46291,263982548,24556,7
711,ERC2-IT1,chr3,R,55657205,55659469,1550226,2264,263984812,24557,0
776,CACNA1D,chr3,F,53494975,53813151,1868402,318176,264302988,24558,54
788,SLC25A20,chr3,R,48856922,48898993,1910473,42071,264345059,24559,8
820,CAMP,chr3,F,48223346,48225491,1912618,2145,264347204,24560,3
846,CASR,chr3,F,122183666,122286503,2015455,102837,264450041,24561,11
859,CAV3,chr3,F,8733799,8746765,2028421,12966,264463007,24562,1
868,CBLB,chr3,R,105655460,105869552,2242513,214092,264677099,24563,21
885,CCK,chr3,R,42257825,42266170,2250858,8345,264685444,24564,5
941,CD80,chr3,R,119523947,119559634,2286545,35687,264721131,24565,9
942,CD86,chr3,F,122055361,122121143,2352327,65782,264786913,24566,7
956,ENTPD3,chr3,F,40387155,40428626,2393798,41471,264828384,24567,12
961,CD47,chr3,R,108043093,108091088,2441793,47995,264876379,24568,12
993,CDC25A,chr3,R,48157177,48188658,2473274,31481,264907860,24569,14
1154,CISH,chr3,R,50606453,50611831,2478652,5378,264913238,24570,2
1173,AP2M1,chr3,F,184174845,184184091,2487898,9246,264922484,24571,11
1181,CLCN2,chr3,R,184346184,184361651,2503365,15467,264937951,24572,24
1230,CCR1,chr3,R,46201708,46208341,2509998,6633,264944584,24573,1
1232,CCR3,chr3,F,46210694,46266706,2566010,56012,265000596,24574,4
1233,CCR4,chr3,F,32951573,32954911,2569348,3338,265003934,24575,1
1234,CCR5,chr3,F,46370141,46376206,2575413,6065,265009999,24576,2
1237,CCR8,chr3,F,39329705,39333680,2579388,3975,265013974,24577,1
1238,ACKR2,chr3,F,42809471,42867283,2637200,57812,265071786,24578,2
1294,COL7A1,chr3,R,48564072,48595302,2668430,31230,265103016,24579,119
1295,COL8A1,chr3,F,99638595,99796733,2826568,158138,265261154,24580,4
1356,CP,chr3,R,149162409,149222050,2886209,59641,265320795,24581,22
1359,CPA3,chr3,F,148865255,148897087,2918041,31832,265352627,24582,10
1360,CPB1,chr3,F,148791179,148860192,2987054,69013,265421640,24583,12
1370,CPN2,chr3,R,194339764,194351345,2998635,11581,265433221,24584,2
1371,CPOX,chr3,R,98576413,98593668,3015890,17255,265450476,24585,8
1427,CRYGS,chr3,R,186538442,186544378,3021826,5936,265456412,24586,2
1475,CSTA,chr3,F,122325163,122341969,3038632,16806,265473218,24587,2
1499,CTNNB1,chr3,F,41199450,41240448,3079630,40998,265514216,24588,16
1524,CX3CR1,chr3,R,39263493,39281735,3097872,18242,265532458,24589,4
1582,CYP8B1,chr3,R,42872191,42876141,3101822,3950,265536408,24590,0
1605,DAG1,chr3,F,49468702,49535618,3168738,66916,265603324,24591,8
1608,DGKG,chr3,R,186147200,186362234,3383772,215034,265818358,24592,24
1618,DAZL,chr3,R,16586791,16605499,3402480,18708,265837066,24593,11
1739,DLG1,chr3,R,197042559,197299272,3659193,256713,266093779,24594,33
1776,DNASE1L3,chr3,R,58192625,58211003,3677571,18378,266112157,24595,7
1795,DOCK3,chr3,F,50674968,51384198,4386801,709230,266821387,24596,58
1814,DRD3,chr3,R,114127796,114199407,4458412,71611,266892998,24597,11
1849,DUSP7,chr3,R,52048918,52056445,4465939,7527,266900525,24598,2
1857,DVL3,chr3,F,184155310,184173526,4484155,18216,266918741,24599,13
1894,ECT2,chr3,F,172750681,172829265,4562739,78584,266997325,24600,28
1951,CELSR3,chr3,R,48636462,48662915,4589192,26453,267023778,24601,34
1962,EHHADH,chr3,R,185190623,185282886,4681455,92263,267116041,24602,8
1974,EIF4A2,chr3,F,186783571,186789897,4687781,6326,267122367,24603,10
1981,EIF4G1,chr3,F,184314494,184335358,4708645,20864,267143231,24604,33
2042,EPHA3,chr3,F,89107523,89482134,5083256,374611,267517842,24605,16
2047,EPHB1,chr3,F,134795256,135260467,5548467,465211,267983053,24606,20
2049,EPHB3,chr3,F,184561798,184582408,5569077,20610,268003663,24607,15
2119,ETV5,chr3,R,186046316,186109112,5631873,62796,268066459,24608,12
2122,MECOM,chr3,R,169083498,169663786,6212161,580288,268646747,24609,21
2177,FANCD2,chr3,F,10026386,10101932,6287707,75546,268722293,24610,46
2199,FBLN2,chr3,F,13549124,13638422,6377005,89298,268811591,24611,18
2257,FGF12,chr3,R,192139243,192727599,6965361,588356,269399947,24612,9
2272,FHIT,chr3,R,59747586,61251459,8469234,1503873,270903820,24613,13
2317,FLNB,chr3,F,58008399,58172255,8633090,163856,271067676,24614,47
2596,GAP43,chr3,F,115623303,115721487,8731274,98184,271165860,24615,3
2624,GATA2,chr3,R,128479421,128493187,8745040,13766,271179626,24616,7
2632,GBE1,chr3,R,81489698,81761799,9017141,272101,271451727,24617,15
2693,GHSR,chr3,R,172443290,172448456,9022307,5166,271456893,24618,1
2720,GLB1,chr3,R,32996607,33097202,9122902,100595,271557488,24619,16
2771,GNAI2,chr3,F,50226687,50259354,9155569,32667,271590155,24620,12
2779,GNAT1,chr3,F,50191609,50197696,9161656,6087,271596242,24621,9
2803,GOLGA4,chr3,F,37243190,37366879,9285345,123689,271719931,24622,27
2804,GOLGB1,chr3,R,121663198,121750811,9372958,87613,271807544,24623,25
2814,GP5,chr3,R,194394820,194399266,9377404,4446,271811990,24624,1
2815,GP9,chr3,F,129055448,129062411,9384367,6963,271818953,24625,5
2829,XCR1,chr3,R,46020798,46027487,9391056,6689,271825642,24626,2
2838,GPR15,chr3,F,98531898,98533150,9392308,1252,271826894,24627,0
2850,GPR27,chr3,F,71754049,71755177,9393436,1128,271828022,24628,0
2876,GPX1,chr3,R,49357175,49358358,9394619,1183,271829205,24629,0
2912,GRM2,chr3,F,51707032,51718616,9406203,11584,271840789,24630,6
2917,GRM7,chr3,F,6861096,7741531,10286638,880435,272721224,24631,16
2932,GSK3B,chr3,R,119821320,120094417,10559735,273097,272994321,24632,11
2960,GTF2E1,chr3,F,120742710,120783070,10600095,40360,273034681,24633,6
2992,GYG1,chr3,F,148991407,149027669,10636357,36262,273070943,24634,7
3059,HCLS1,chr3,R,121631397,121660948,10665908,29551,273100494,24635,13
3081,HGD,chr3,R,120628167,120682571,10720312,54404,273154898,24636,15
3269,HRH1,chr3,F,11137092,11263253,10846473,126161,273281059,24637,7
3273,HRG,chr3,F,186665957,186678235,10858751,12278,273293337,24638,6
3280,HES1,chr3,F,194136141,194138612,10861222,2471,273295808,24639,3
3355,HTR1F,chr3,F,87792766,87994856,11063312,202090,273497898,24640,6
3373,HYAL1,chr3,R,50299888,50312419,11075843,12531,273510429,24641,5
3556,IL1RAP,chr3,F,190514050,190657197,11218990,143147,273653576,24642,14
3568,IL5RA,chr3,R,3066323,3110374,11263041,44051,273697627,24643,14
3592,IL12A,chr3,F,159988835,159996019,11270225,7184,273704811,24644,6
3615,IMPDH2,chr3,R,49024324,49029701,11275602,5377,273710188,24645,14
3656,IRAK2,chr3,F,10164878,10243745,11354469,78867,273789055,24646,12
3680,ITGA9,chr3,F,37452321,37819790,11721938,367469,274156524,24647,27
3693,ITGB5,chr3,R,124761947,124887538,11847529,125591,274282115,24648,14
3697,ITIH1,chr3,F,52777585,52792068,11862012,14483,274296598,24649,22
3699,ITIH3,chr3,F,52794767,52809009,11876254,14242,274310840,24650,22
3700,ITIH4,chr3,R,52812989,52830701,11893966,17712,274328552,24651,23
3708,ITPR1,chr3,F,4493347,4847840,12248459,354493,274683045,24652,62
3827,KNG1,chr3,F,186717308,186744410,12275561,27102,274710147,24653,10
3836,KPNA1,chr3,R,122421900,122514939,12368600,93039,274803186,24654,16
3840,KPNA4,chr3,R,160494994,160565588,12439194,70594,274873780,24655,16
3913,LAMB2,chr3,R,49121113,49133166,12451247,12053,274885833,24656,31
3921,RPSA,chr3,F,39406688,39412542,12457101,5854,274891687,24657,6
4026,LPP,chr3,F,188152142,188890671,13195630,738529,275630216,24658,21
4045,LSAMP,chr3,R,115802362,116445542,13838810,643180,276273396,24659,13
4057,LTF,chr3,R,46436004,46465142,13867948,29138,276302534,24660,17
4071,TM4SF1,chr3,R,149369017,149377860,13876791,8843,276311377,24661,4
4134,MAP4,chr3,R,47850689,48089279,14115381,238590,276549967,24662,26
4154,MBNL1,chr3,F,152244320,152465780,14336841,221460,276771427,24663,19
4171,MCM2,chr3,F,127598356,127622436,14360921,24080,276795507,24664,15
4241,MFI2,chr3,R,196987558,197029816,14403179,42258,276837765,24665,18
4286,MITF,chr3,F,69739434,69968337,14632082,228903,277066668,24666,15
4291,MLF1,chr3,F,158571162,158606460,14667380,35298,277101966,24667,9
4292,MLH1,chr3,F,36993349,37050846,14724877,57497,277159463,24668,20
4311,MME,chr3,F,155024123,155183729,14884483,159606,277319069,24669,28
4336,MOBP,chr3,F,39467572,39529497,14946408,61925,277380994,24670,6
4345,CD200,chr3,F,112332346,112362812,14976874,30466,277411460,24671,9
4485,MST1,chr3,R,49683946,49689528,14982456,5582,277417042,24672,16
4486,MST1R,chr3,R,49886980,49903873,14999349,16893,277433935,24673,19
4585,MUC4,chr3,R,195746764,195811973,15064558,65209,277499144,24674,24
4615,MYD88,chr3,F,38138477,38143022,15069103,4545,277503689,24675,4
4634,MYL3,chr3,R,46857866,46863483,15074720,5617,277509306,24676,6
4638,MYLK,chr3,R,123612295,123884302,15346727,272007,277781313,24677,33
4690,NCK1,chr3,F,136862207,136951610,15436130,89403,277870716,24678,4
4710,NDUFB4,chr3,F,120596280,120602411,15442261,6131,277876847,24679,1
4711,NDUFB5,chr3,F,179604786,179624500,15461975,19714,277896561,24680,5
4820,NKTR,chr3,F,42600654,42648741,15510062,48087,277944648,24681,14
4968,OGG1,chr3,F,9749943,9788246,15548365,38303,277982951,24682,9
4976,OPA1,chr3,F,193593143,193697811,15653033,104668,278087619,24683,31
5010,CLDN11,chr3,F,170418864,170434691,15668860,15827,278103446,24684,3
5021,OXTR,chr3,R,8750407,8854549,15773002,104142,278207588,24685,7
5028,P2RY1,chr3,F,152834946,152838056,15776112,3110,278210698,24686,0
5062,PAK2,chr3,F,196739856,196832647,15868903,92791,278303489,24687,15
5067,CNTN3,chr3,R,74262567,74614445,16220781,351878,278655367,24688,24
5096,PCCB,chr3,F,136250324,136330171,16300628,79847,278735214,24689,16
5130,PCYT1A,chr3,R,196238381,196287713,16349960,49332,278784546,24690,9
5162,PDHB,chr3,R,58427629,58433852,16356183,6223,278790769,24691,8
5210,PFKFB4,chr3,R,48517683,48562774,16401274,45091,278835860,24692,17
5217,PFN2,chr3,R,149964903,149970954,16407325,6051,278841911,24693,2
5274,SERPINI1,chr3,F,167735643,167825569,16497251,89926,278931837,24694,8
5276,SERPINI2,chr3,R,167441788,167474132,16529595,32344,278964181,24695,9
5290,PIK3CA,chr3,F,179148113,179240084,16621566,91971,279056152,24696,22
5291,PIK3CB,chr3,R,138652697,138834938,16803807,182241,279238393,24697,24
5333,PLCD1,chr3,R,38007495,38029663,16825975,22168,279260561,24698,14
5337,PLD1,chr3,R,171600404,171810494,17036065,210090,279470651,24699,32
5352,PLOD2,chr3,R,146069435,146161495,17128125,92060,279562711,24700,21
5357,PLS1,chr3,F,142596386,142713664,17245403,117278,279679989,24701,21
5359,PLSCR1,chr3,R,146515177,146544841,17275067,29664,279709653,24702,9
5361,PLXNA1,chr3,F,126982118,127037392,17330341,55274,279764927,24703,32
5364,PLXNB1,chr3,R,48403853,48430324,17356812,26471,279791398,24704,42
5437,POLR2H,chr3,F,184361713,184368595,17363694,6882,279798280,24705,5
5449,POU1F1,chr3,R,87259632,87276587,17380649,16955,279815235,24706,5
5468,PPARG,chr3,F,12287849,12471013,17563813,183164,279998399,24707,10
5504,PPP1R2,chr3,R,195514421,195543401,17592793,28980,280027379,24708,6
5523,PPP2R3A,chr3,F,135965672,136147910,17775031,182238,280209617,24709,17
5576,PRKAR2A,chr3,R,48744600,48847837,17878268,103237,280312854,24710,13
5580,PRKCD,chr3,F,53161206,53192717,17909779,31511,280344365,24711,21
5584,PRKCI,chr3,F,170222431,170305982,17993330,83551,280427916,24712,17
5627,PROS1,chr3,R,93873036,93974090,18094384,101054,280528970,24713,15
5648,MASP1,chr3,R,187216084,187292022,18170322,75938,280604908,24714,18
5708,PSMD2,chr3,F,184299097,184309054,18180279,9957,280614865,24715,21
5745,PTH1R,chr3,F,46877716,46903799,18206362,26083,280640948,24716,17
5793,PTPRG,chr3,F,61561568,62297609,18942403,736041,281376989,24717,30
5806,PTX3,chr3,F,157436790,157443628,18949241,6838,281383827,24718,2
5859,QARS,chr3,R,49095931,49105129,18958439,9198,281393025,24719,23
5868,RAB5A,chr3,F,19947079,19985175,18996535,38096,281431121,24720,5
5894,RAF1,chr3,R,12583600,12664201,19077136,80601,281511722,24721,19
5912,RAP2B,chr3,F,153162211,153170624,19085549,8413,281520135,24722,0
5915,RARB,chr3,F,25174331,25597932,19509150,423601,281943736,24723,10
5918,RARRES1,chr3,R,158696891,158732691,19544950,35800,281979536,24724,5
5922,RASA2,chr3,F,141487046,141615363,19673267,128317,282107853,24725,26
5947,RBP1,chr3,R,139517433,139539829,19695663,22396,282130249,24726,5
5948,RBP2,chr3,R,139452883,139476510,19719290,23627,282153876,24727,3
5984,RFC4,chr3,R,186789891,186806695,19736094,16804,282170680,24728,10
6010,RHO,chr3,F,129528638,129535344,19742800,6706,282177386,24729,4
6043,SNORA63,chr3,F,186787298,186787433,19742935,135,282177521,24730,0
6044,SNORA62,chr3,F,39411053,39411207,19743089,154,282177675,24731,0
6091,ROBO1,chr3,R,78597237,79767998,20913850,1170761,283348436,24732,34
6092,ROBO2,chr3,F,75906674,77649964,22657140,1743290,285091726,24733,33
6138,RPL15,chr3,F,23916803,23923696,22664033,6893,285098619,24734,5
6152,RPL24,chr3,R,101681089,101686719,22669663,5630,285104249,24735,5
6159,RPL29,chr3,R,51993627,51995942,22671978,2315,285106564,24736,3
6161,RPL32,chr3,R,12834944,12841582,22678616,6638,285113202,24737,3
6165,RPL35A,chr3,F,197950180,197955851,22684287,5671,285118873,24738,4
6184,RPN1,chr3,R,128619969,128650876,22715194,30907,285149780,24739,9
6259,RYK,chr3,R,134157132,134250843,22808905,93711,285243491,24740,14
6304,SATB1,chr3,R,18345805,18445588,22908688,99783,285343274,24741,15
6314,ATXN7,chr3,F,63864556,64003462,23047594,138906,285482180,24742,14
6331,SCN5A,chr3,R,38548057,38649673,23149210,101616,285583796,24743,29
6336,SCN10A,chr3,R,38696890,38794010,23246330,97120,285680916,24744,26
6396,SEC13,chr3,R,10300928,10321188,23266590,20260,285701176,24745,10
6405,SEMA3F,chr3,F,50155062,50189075,23300603,34013,285735189,24746,21
6419,SETMAR,chr3,F,4303303,4317265,23314565,13962,285749151,24747,4
6434,TRA2B,chr3,R,185914567,185938136,23338134,23569,285772720,24748,10
6474,SHOX2,chr3,R,158096010,158106202,23348326,10192,285782912,24749,5
6476,SI,chr3,R,164978892,165078495,23447929,99603,285882515,24750,47
6478,SIAH2,chr3,R,150741122,150763476,23470283,22354,285904869,24751,1
6480,ST6GAL1,chr3,F,186930342,187078553,23618494,148211,286053080,24752,15
6498,SKIL,chr3,F,170357677,170396849,23657666,39172,286092252,24753,7
6514,SLC2A2,chr3,R,170995364,171026979,23689281,31615,286123867,24754,12
6529,SLC6A1,chr3,F,10992728,11039249,23735802,46521,286170388,24755,16
6533,SLC6A6,chr3,F,14402575,14489349,23822576,86774,286257162,24756,19
6538,SLC6A11,chr3,F,10816199,10941471,23947848,125272,286382434,24757,15
6565,SLC15A2,chr3,F,121894323,121944187,23997712,49864,286432298,24758,22
6578,SLCO2A1,chr3,R,133932695,134030076,24095093,97381,286529679,24759,14
6596,HLTF,chr3,R,149030116,149086554,24151531,56438,286586117,24760,24
6599,SMARCC1,chr3,R,47585887,47781915,24347559,196028,286782145,24761,29
6657,SOX2,chr3,F,181711923,181714436,24350072,2513,286784658,24762,0
6747,SSR3,chr3,R,156540139,156555184,24365117,15045,286799703,24763,4
6750,SST,chr3,R,187668905,187670413,24366625,1508,286801211,24764,1
6769,STAC,chr3,F,36380423,36548011,24534213,167588,286968799,24765,12
6787,NEK4,chr3,R,52710779,52770949,24594383,60170,287028969,24766,17
6854,SYN2,chr3,F,12004359,12192032,24782056,187673,287216642,24767,15
6988,TCTA,chr3,F,49412205,49416476,24786327,4271,287220913,24768,2
6997,TDGF1,chr3,F,46574554,46582463,24794236,7909,287228822,24769,6
7012,TERC,chr3,R,169764609,169765060,24794687,451,287229273,24770,0
7018,TF,chr3,F,133661997,133779006,24911696,117009,287346282,24771,23
7029,TFDP2,chr3,R,141944427,142149544,25116813,205117,287551399,24772,17
7037,TFRC,chr3,R,196049283,196082161,25149691,32878,287584277,24773,19
7047,TGM4,chr3,F,44874591,44914601,25189701,40010,287624287,24774,14
7048,TGFBR2,chr3,F,30606492,30694142,25277351,87650,287711937,24775,8
7066,THPO,chr3,R,184371934,184379688,25285105,7754,287719691,24776,6
7068,THRB,chr3,R,24117152,24495281,25663234,378129,288097820,24777,15
7079,TIMP4,chr3,R,12153067,12159351,25669518,6284,288104104,24778,4
7086,TKT,chr3,R,53224706,53256114,25700926,31408,288135512,24779,15
7095,SEC62,chr3,F,169966791,169998373,25732508,31582,288167094,24780,8
7104,TM4SF4,chr3,F,149474580,149503394,25761322,28814,288195908,24781,4
7110,TMF1,chr3,R,69019826,69052333,25793829,32507,288228415,24782,16
7123,CLEC3B,chr3,F,45026266,45036071,25803634,9805,288238220,24783,3
7134,TNNC1,chr3,R,52451090,52454041,25806585,2951,288241171,24784,5
7155,TOP2B,chr3,R,25597904,25664905,25873586,67001,288308172,24785,35
7182,NR2C2,chr3,F,14947583,15049279,25975282,101696,288409868,24786,19
7200,TRH,chr3,F,129974392,129977938,25978828,3546,288413414,24787,2
7220,TRPC1,chr3,F,142724031,142807888,26062685,83857,288497271,24788,14
7318,UBA7,chr3,R,49805204,49813958,26071439,8754,288506025,24789,22
7324,UBE2E1,chr3,F,23805892,23891640,26157187,85748,288591773,24790,6
7325,UBE2E2,chr3,F,23203006,23590805,26544986,387799,288979572,24791,11
7342,UBP1,chr3,R,33388335,33440813,26597464,52478,289032050,24792,17
7348,UPK1B,chr3,F,119173577,119205153,26629040,31576,289063626,24793,7
7372,UMPS,chr3,F,124730365,124749273,26647948,18908,289082534,24794,6
7375,USP4,chr3,R,49277143,49340103,26710908,62960,289145494,24795,22
7384,UQCRC1,chr3,R,48598998,48609665,26721575,10667,289156161,24796,12
7401,CLRN1,chr3,R,150918910,150973020,26775685,54110,289210271,24797,6
7428,VHL,chr3,F,10141634,10153670,26787721,12036,289222307,24798,3
7433,VIPR1,chr3,F,42489298,42537573,26835996,48275,289270582,24799,15
7474,WNT5A,chr3,R,55465714,55505261,26875543,39547,289310129,24800,15
7476,WNT7A,chr3,R,13818216,13880121,26937448,61905,289372034,24801,4
7508,XPC,chr3,R,14145146,14178672,26970974,33526,289405560,24802,17
7545,ZIC1,chr3,F,147409393,147416719,26978300,7326,289412886,24803,2
7555,CNBP,chr3,R,129167814,129183967,26994453,16153,289429039,24804,4
7584,ZNF35,chr3,F,44648740,44660791,27006504,12051,289441090,24805,3
7634,ZNF80,chr3,R,114234630,114237578,27009452,2948,289444038,24806,0
7707,ZNF148,chr3,R,125225668,125375354,27159138,149686,289593724,24807,8
7862,BRPF1,chr3,F,9731728,9748015,27175425,16287,289610011,24808,14
7866,IFRD2,chr3,R,50287731,50292595,27180289,4864,289614875,24809,11
7867,MAPKAPK3,chr3,F,50611861,50649297,27217725,37436,289652311,24810,13
7869,SEMA3B,chr3,F,50267557,50277171,27227339,9614,289661925,24811,17
7871,SLMAP,chr3,F,57756220,57930003,27401122,173783,289835708,24812,25
7873,MANF,chr3,F,51385236,51389397,27405283,4161,289839869,24813,3
7879,RAB7A,chr3,F,128726135,128814798,27493946,88663,289928532,24814,5
7881,KCNAB1,chr3,F,156120547,156539138,27912537,418591,290347123,24815,17
8087,FXR1,chr3,F,180912445,180982753,27982845,70308,290417431,24816,18
8292,COLQ,chr3,R,15450132,15521751,28054464,71619,290489050,24817,17
8309,ACOX2,chr3,R,58505135,58537348,28086677,32213,290521263,24818,15
8314,BAP1,chr3,R,52401003,52410105,28095779,9102,290530365,24819,16
8320,EOMES,chr3,R,27715948,27722715,28102546,6767,290537132,24820,5
8372,HYAL3,chr3,R,50292827,50299468,28109187,6641,290543773,24821,4
8403,SOX14,chr3,F,137764291,137766334,28111230,2043,290545816,24822,0
8419,BFSP2,chr3,F,133399994,133475212,28186448,75218,290621034,24823,6
8536,CAMK1,chr3,R,9757344,9769987,28199091,12643,290633677,24824,10
8545,CGGBP1,chr3,R,88051949,88149866,28297008,97917,290731594,24825,5
8553,BHLHE40,chr3,F,4979411,4985181,28302778,5770,290737364,24826,4
8607,RUVBL1,chr3,R,128064876,128153909,28391811,89033,290826397,24827,13
8618,CADPS,chr3,R,62398345,62875389,28868855,477044,291303441,24828,36
8626,TP63,chr3,F,189566860,189897279,29199274,330419,291633860,24829,19
8646,CHRD,chr3,F,184380072,184389835,29209037,9763,291643623,24830,21
8692,HYAL2,chr3,R,50317789,50322850,29214098,5061,291648684,24831,5
8702,B4GALT4,chr3,R,119211741,119240905,29243262,29164,291677848,24832,12
8706,B3GALNT1,chr3,R,161083882,161105630,29265010,21748,291699596,24833,8
8723,SNX4,chr3,R,125446643,125520214,29338581,73571,291773167,24834,13
8743,TNFSF10,chr3,R,172505507,172523507,29356581,18000,291791167,24835,5
8801,SUCLG2,chr3,R,67360459,67654614,29650736,294155,292085322,24836,13
8820,HESX1,chr3,R,57197837,57227632,29680531,29795,292115117,24837,5
8833,GMPS,chr3,F,155869429,155939608,29750710,70179,292185296,24838,17
8850,KAT2B,chr3,F,20040031,20154404,29865083,114373,292299669,24839,19
8856,NR1I2,chr3,F,119780483,119818485,29903085,38002,292337671,24840,9
8893,EIF2B5,chr3,F,184134434,184145311,29913962,10877,292348548,24841,16
8927,BSN,chr3,F,49554488,49671549,30031023,117061,292465609,24842,11
8930,MBD4,chr3,R,129430943,129440179,30040259,9236,292474845,24843,7
8971,H1FX,chr3,R,129314770,129316277,30041766,1507,292476352,24844,0
8975,USP13,chr3,F,179653144,179789401,30178023,136257,292612609,24845,20
8994,LIMD1,chr3,F,45594187,45681263,30265099,87076,292699685,24846,9
8997,KALRN,chr3,F,124033338,124726325,30958086,692987,293392672,24847,65
9034,CCRL2,chr3,F,46407165,46409523,30960444,2358,293395030,24848,3
9039,UBA3,chr3,R,69054729,69080373,30986088,25644,293420674,24849,17
9045,RPL14,chr3,F,40457291,40462372,30991169,5081,293425755,24850,5
9076,CLDN1,chr3,R,190305700,190322446,31007915,16746,293442501,24851,3
9117,SEC22C,chr3,R,42547966,42601080,31061029,53114,293495615,24852,11
9136,RRP9,chr3,R,51933425,51941941,31069545,8516,293504131,24853,14
9175,MAP3K13,chr3,F,185282940,185489094,31275699,206154,293710285,24854,17
9197,SLC33A1,chr3,R,155826510,155854459,31303648,27949,293738234,24855,5
9209,LRRFIP2,chr3,R,37052625,37176817,31427840,124192,293862426,24856,31
9223,MAGI1,chr3,R,65330763,66038836,32135913,708073,294570499,24857,30
9254,CACNA2D2,chr3,R,50362612,50504244,32277545,141632,294712131,24858,39
9276,COPB2,chr3,R,139357586,139389680,32309639,32094,294744225,24859,21
9370,ADIPOQ,chr3,F,186842667,186858463,32325435,15796,294760021,24860,4
9389,SLC22A14,chr3,F,38281429,38318522,32362528,37093,294797114,24861,11
9390,SLC22A13,chr3,F,38265806,38278315,32375037,12509,294809623,24862,9
9435,CHST2,chr3,F,143119775,143124014,32379276,4239,294813862,24863,1
9467,SH3BP5,chr3,R,15254352,15341394,32466318,87042,294900904,24864,11
9497,SLC4A7,chr3,R,27372720,27484420,32578018,111700,295012604,24865,26
9515,STXBP5L,chr3,F,120908202,121424761,33094577,516559,295529163,24866,32
9616,RNF7,chr3,F,141738208,141746803,33103172,8595,295537758,24867,3
9626,GUCA1C,chr3,R,108907643,108955188,33150717,47545,295585303,24868,4
9657,IQCB1,chr3,R,121769762,121835079,33216034,65317,295650620,24869,14
9666,DZIP3,chr3,F,108589489,108694846,33321391,105357,295755977,24870,35
9686,VGLL4,chr3,R,11556066,11720768,33486093,164702,295920679,24871,12
9695,EDEM1,chr3,F,5187673,5219965,33518385,32292,295952971,24872,12
9711,KIAA0226,chr3,R,197671392,197749727,33596720,78335,296031306,24873,22
9718,ECE2,chr3,F,184249656,184293031,33640095,43375,296074681,24874,21
9730,VPRBP,chr3,R,51395866,51505618,33749847,109752,296184433,24875,27
9779,TBC1D5,chr3,R,17157161,17742739,34335425,585578,296770011,24876,32
9797,TATDN2,chr3,F,10248492,10281222,34368155,32730,296802741,24877,7
9807,IP6K1,chr3,R,49724294,49786540,34430401,62246,296864987,24878,6
9819,TSC22D2,chr3,F,150408334,150460119,34482186,51785,296916772,24879,8
9852,EPM2AIP1,chr3,R,36985865,36993304,34489625,7439,296924211,24880,0
9861,PSMD6,chr3,R,64010548,64024010,34503087,13462,296937673,24881,9
9868,TOMM70A,chr3,R,100363458,100401398,34541027,37940,296975613,24882,11
9881,TRANK1,chr3,R,36826816,36990981,34705192,164165,297139778,24883,27
9901,SRGAP3,chr3,R,8980590,9362929,35087531,382339,297522117,24884,31
9922,IQSEC1,chr3,R,12897042,13282998,35473487,385956,297908073,24885,24
9934,P2RY14,chr3,R,151212114,151278628,35540001,66514,297974587,24886,4
9940,DLEC1,chr3,F,38038604,38122737,35624134,84133,298058720,24887,37
9941,EXOG,chr3,F,38496126,38526305,35654313,30179,298088899,24888,12
9942,XYLB,chr3,F,38346759,38453041,35760595,106282,298195181,24889,22
9943,OXSR1,chr3,F,38165259,38255488,35850824,90229,298285410,24890,20
9975,NR1D2,chr3,F,23945259,23980618,35886183,35359,298320769,24891,9
10015,PDCD6IP,chr3,F,33798570,33869707,35957320,71137,298391906,24892,19
10039,PARP3,chr3,F,51942286,51948867,35963901,6581,298398487,24893,11
10051,SMC4,chr3,F,160399303,160434962,35999560,35659,298434146,24894,23
10057,ABCC5,chr3,R,183919933,184018010,36097637,98077,298532223,24895,35
10063,COX17,chr3,R,119669524,119677396,36105509,7872,298540095,24896,2
10093,ARPC4,chr3,F,9792494,9807105,36120120,14611,298554706,24897,5
10168,ZNF197,chr3,F,44625018,44648471,36143573,23453,298578159,24898,6
10180,RBM6,chr3,F,49940037,50077252,36280788,137215,298715374,24899,22
10181,RBM5,chr3,F,50088907,50118964,36310845,30057,298745431,24900,24
10188,TNK2,chr3,R,195863363,195909009,36356491,45646,298791077,24901,21
10195,ALG3,chr3,R,184242328,184249525,36363688,7197,298798274,24902,11
10201,NME6,chr3,R,48292316,48302246,36373618,9930,298808204,24903,5
10217,CTDSPL,chr3,F,37862177,37984469,36495910,122292,298930496,24904,7
10225,CD96,chr3,F,111542078,111665996,36619828,123918,299054414,24905,18
10242,KCNMB2,chr3,F,178536297,178844429,36927960,308132,299362546,24906,7
10274,STAG1,chr3,R,136336233,136752403,37344130,416170,299778716,24907,36
10289,EIF1B,chr3,F,40309681,40312424,37346873,2743,299781459,24908,3
10293,TRAIP,chr3,R,49828594,49856564,37374843,27970,299809429,24909,15
10342,TFG,chr3,F,100709283,100748967,37414527,39684,299849113,24910,9
10402,ST3GAL6,chr3,F,98732235,98797054,37479346,64819,299913932,24911,16
10425,ARIH2,chr3,F,48918820,48985541,37546067,66721,299980653,24912,20
10474,TADA3,chr3,R,9779963,9793011,37559115,13048,299993701,24913,8
10491,CRTAP,chr3,F,33113957,33147773,37592931,33816,300027517,24914,6
10533,ATG7,chr3,F,11272323,11557665,37878273,285342,300312859,24915,26
10550,ARL6IP5,chr3,F,69084938,69106088,37899423,21150,300334009,24916,2
10641,NPRL2,chr3,R,50347486,50351055,37902992,3569,300337578,24917,10
10644,IGF2BP2,chr3,R,185643130,185825039,38084901,181909,300519487,24918,22
10663,CXCR6,chr3,F,45940398,45948354,38092857,7956,300527443,24919,3
10675,CSPG5,chr3,R,47562237,47580240,38110860,18003,300545446,24920,5
10686,CLDN16,chr3,F,190387871,190412143,38135132,24272,300569718,24921,4
10721,POLQ,chr3,R,121431419,121546006,38249719,114587,300684305,24922,31
10752,CHL1,chr3,F,196595,409417,38462541,212822,300897127,24923,32
10777,ARPP21,chr3,F,35639173,35794496,38617864,155323,301052450,24924,24
10803,CCR9,chr3,F,45886503,45903177,38634538,16674,301069124,24925,4
10840,ALDH1L1,chr3,R,126103560,126181526,38712504,77966,301147090,24926,24
10869,USP19,chr3,R,49108045,49120938,38725397,12893,301159983,24927,28
10954,PDIA5,chr3,F,123067008,123162106,38820495,95098,301255081,24928,16
10991,SLC38A3,chr3,F,50205245,50220979,38836229,15734,301270815,24929,16
11068,CYB561D2,chr3,F,50350694,50368197,38853732,17503,301288318,24930,6
11070,TMEM115,chr3,R,50354748,50359508,38858492,4760,301293078,24931,1
11073,TOPBP1,chr3,R,133600604,133661918,38919806,61314,301354392,24932,27
11102,RPP14,chr3,F,58306244,58320193,38933755,13949,301368341,24933,6
11148,HHLA2,chr3,F,108296484,108388971,39026242,92487,301460828,24934,14
11167,FSTL1,chr3,R,120394213,120451071,39083100,56858,301517686,24935,10
11170,FAM107A,chr3,R,58564111,58627610,39146599,63499,301581185,24936,7
11180,WDR6,chr3,F,49007203,49015953,39155349,8750,301589935,24937,6
11186,RASSF1,chr3,R,50329785,50340936,39166500,11151,301601086,24938,9
11188,NISCH,chr3,F,52455507,52493072,39204065,37565,301638651,24939,21
11222,MRPL3,chr3,R,131462200,131503016,39244881,40816,301679467,24940,9
11235,PDCD10,chr3,R,167683734,167735422,39296569,51688,301731155,24941,11
11259,FILIP1L,chr3,R,99833143,100114513,39577939,281370,302012525,24942,8
11277,TREX1,chr3,F,48465519,48467645,39580065,2126,302014651,24943,0
11280,SCN11A,chr3,R,38845768,38953651,39687948,107883,302122534,24944,27
11334,TUSC2,chr3,R,50324908,50328238,39691278,3330,302125864,24945,2
11342,RNF13,chr3,F,149812483,149962139,39840934,149656,302275520,24946,12
11343,MGLL,chr3,R,127689061,127823250,39975123,134189,302409709,24947,11
11344,TWF2,chr3,R,52228609,52239167,39985681,10558,302420267,24948,8
22808,MRAS,chr3,F,138347647,138405535,40043569,57888,302478155,24949,8
22820,COPG1,chr3,F,129249574,129277773,40071768,28199,302506354,24950,24
22865,SLITRK3,chr3,R,165186719,165196681,40081730,9962,302516316,24951,3
22871,NLGN1,chr3,F,173396489,174286644,40971885,890155,303406471,24952,14
22906,TRAK1,chr3,F,42013801,42225890,41183974,212089,303618560,24953,23
22907,DHX30,chr3,F,47802908,47850196,41231262,47288,303665848,24954,26
22908,SACM1L,chr3,F,45689261,45745409,41287410,56148,303721996,24955,20
22916,NCBP2,chr3,R,196935401,196942593,41294602,7192,303729188,24956,4
22937,SCAP,chr3,R,47413693,47477126,41358035,63433,303792621,24957,23
22973,LAMB2P1,chr3,R,49152858,49154401,41359578,1543,303794164,24958,0
22989,MYH15,chr3,R,108380367,108549465,41528676,169098,303963262,24959,42
23007,PLCH1,chr3,R,155479880,155745089,41793885,265209,304228471,24960,30
23016,EXOSC7,chr3,F,44976229,45012668,41830324,36439,304264910,24961,8
23023,TMCC1,chr3,R,129647791,129893597,42076130,245806,304510716,24962,15
23024,PDZRN3,chr3,R,73382429,73624921,42318622,242492,304753208,24963,13
23043,TNIK,chr3,R,171062502,171460408,42716528,397906,305151114,24964,33
23066,CAND2,chr3,F,12796652,12834818,42754694,38166,305189280,24965,16
23101,MCF2L2,chr3,R,183178003,183428619,43005310,250616,305439896,24966,31
23122,CLASP2,chr3,R,33496244,33718356,43227422,222112,305662008,24967,45
23129,PLXND1,chr3,R,129555212,129606739,43278949,51527,305713535,24968,36
23132,RAD54L2,chr3,F,51538682,51668660,43408927,129978,305843513,24969,24
23150,FRMD4B,chr3,R,69168781,69541340,43781486,372559,306216072,24970,31
23166,STAB1,chr3,F,52495337,52524495,43810644,29158,306245230,24971,67
23171,GPD1L,chr3,F,32106510,32168715,43872849,62205,306307435,24972,7
23180,RFTN1,chr3,R,16315844,16513715,44070720,197871,306505306,24973,14
23200,ATP11B,chr3,F,182793502,182921635,44198853,128133,306633439,24974,35
23218,NBEAL2,chr3,F,46979682,47009704,44228875,30022,306663461,24975,56
23225,NUP210,chr3,R,13316229,13420319,44332965,104090,306767551,24976,42
23228,PLCL2,chr3,F,16884958,17090606,44538613,205648,306973199,24977,7
23243,ANKRD28,chr3,R,15667235,15859555,44730933,192320,307165519,24978,31
23272,FAM208A,chr3,R,56620131,56683242,44794044,63111,307228630,24979,23
23276,KLHL18,chr3,F,47282839,47346816,44858021,63977,307292607,24980,10
23317,DNAJC13,chr3,F,132417531,132539032,44979522,121501,307414108,24981,56
23350,U2SURP,chr3,F,143001523,143060725,45038724,59202,307473310,24982,27
23355,VPS8,chr3,F,184812136,185052614,45279202,240478,307713788,24983,52
23395,LARS2,chr3,F,45388560,45548842,45439484,160282,307874070,24984,22
23429,RYBP,chr3,R,72374592,72446623,45511515,72031,307946101,24985,3
23434,LINC01565,chr3,R,128571999,128576086,45515602,4087,307950188,24986,2
23473,CAPN7,chr3,F,15206225,15252916,45562293,46691,307996879,24987,22
23527,ACAP2,chr3,R,195274735,195443176,45730734,168441,308165320,24988,27
23609,MKRN2,chr3,F,12557013,12583713,45757434,26700,308192020,24989,7
24142,NAT6,chr3,R,50296401,50299421,45760454,3020,308195040,24990,2
25827,FBXL2,chr3,F,33277441,33403554,45886567,126113,308321153,24991,17
25847,ANAPC13,chr3,R,134477703,134486023,45894887,8320,308329473,24992,2
25852,ARMC8,chr3,F,138187247,138298389,46006029,111142,308440615,24993,23
25864,ABHD14A,chr3,F,51975025,51981200,46012204,6175,308446790,24994,4
25871,C3orf17,chr3,R,113002443,113019851,46029612,17408,308464198,24995,8
25886,POC1A,chr3,R,52075232,52154690,46109070,79458,308543656,24996,12
25890,ABI3BP,chr3,R,100749334,100993493,46353229,244159,308787815,24997,67
25904,CNOT10,chr3,F,32685144,32773875,46441960,88731,308876546,24998,22
25907,TMEM158,chr3,R,45224463,45226322,46443819,1859,308878405,24999,0
25915,NDUFAF3,chr3,F,49020474,49023495,46446840,3021,308881426,25000,6
25917,THUMPD3,chr3,F,9362975,9386791,46470656,23816,308905242,25001,10
25924,MYRIP,chr3,F,39808913,40260321,46922064,451408,309356650,25002,19
25930,PTPN23,chr3,F,47380981,47413441,46954524,32460,309389110,25003,24
25937,WWTR1,chr3,R,149517234,149703273,47140563,186039,309575149,25004,8
25945,PVRL3,chr3,F,111071758,111269283,47338088,197525,309772674,25005,13
25976,TIPARP,chr3,F,156674415,156706770,47370443,32355,309805029,25006,10
25978,CHMP2B,chr3,F,87227262,87255548,47398729,28286,309833315,25007,6
25981,DNAH1,chr3,F,52316318,52400497,47482908,84179,309917494,25008,80
25994,HIGD1A,chr3,R,42782907,42804535,47504536,21628,309939122,25009,3
26018,LRIG1,chr3,R,66378796,66501263,47627003,122467,310061589,25010,19
26032,SUSD5,chr3,R,33150044,33219215,47696174,69171,310130760,25011,5
26043,UBXN7,chr3,R,196353489,196454318,47797003,100829,310231589,25012,11
26059,ERC2,chr3,R,55508307,56468366,48757062,960059,311191648,25013,19
26060,APPL1,chr3,F,57227736,57273471,48802797,45735,311237383,25014,22
26061,HACL1,chr3,R,15560703,15601852,48843946,41149,311278532,25015,16
26084,ARHGEF26,chr3,F,154121002,154257827,48980771,136825,311415357,25016,15
26137,ZBTB20,chr3,R,114314499,115147280,49813552,832781,312248138,25017,20
26140,TTLL3,chr3,F,9809959,9836356,49839949,26397,312274535,25018,11
26339,OR5K1,chr3,F,98469576,98470528,49840901,952,312275487,25019,0
26341,OR5H1,chr3,F,98132697,98133639,49841843,942,312276429,25020,0
26354,GNL3,chr3,F,52685919,52694497,49850421,8578,312285007,25021,14
26355,FAM162A,chr3,F,122384175,122410114,49876360,25939,312310946,25022,4
26577,PCOLCE2,chr3,R,142817859,142889203,49947704,71344,312382290,25023,8
26984,SEC22A,chr3,F,123201926,123274136,50019914,72210,312454500,25024,8
26996,GPR160,chr3,F,170037542,170085418,50067790,47876,312502376,25025,7
26998,FETUB,chr3,F,186635831,186653008,50084967,17177,312519553,25026,7
27031,NPHP3,chr3,R,132680608,132722459,50126818,41851,312561404,25027,26
27032,ATP2C1,chr3,F,130850482,131016712,50293048,166230,312727634,25028,30
27074,LAMP3,chr3,R,183122214,183162879,50333713,40665,312768299,25029,9
27086,FOXP1,chr3,R,70954713,71583989,50962989,629276,313397575,25030,34
27094,KCNMB3,chr3,R,179239748,179267050,50990291,27302,313424877,25031,5
27107,ZBTB11,chr3,R,101649438,101677144,51017997,27706,313452583,25032,12
27136,MORC1,chr3,R,108958238,109118146,51177905,159908,313612491,25033,29
27230,SERP1,chr3,R,150541992,150603177,51239090,61185,313673676,25034,3
27255,CNTN6,chr3,F,1008134,1403610,51634566,395476,314069152,25035,29
27258,LSM3,chr3,F,14178727,14198369,51654208,19642,314088794,25036,3
27303,RBMS3,chr3,F,29280859,30010395,52383744,729536,314818330,25037,21
27333,GOLIM4,chr3,R,168008668,168095924,52471000,87256,314905586,25038,15
28512,NKIRAS1,chr3,R,23892080,23917046,52495966,24966,314930552,25039,4
28972,SPCS1,chr3,F,52705840,52708182,52498308,2342,314932894,25040,3
28976,ACAD9,chr3,F,128879489,128913114,52531933,33625,314966519,25041,17
28990,ASTE1,chr3,R,131013872,131026854,52544915,12982,314979501,25042,7
28999,KLF15,chr3,R,126342634,126357393,52559674,14759,314994260,25043,4
29072,SETD2,chr3,R,47016407,47163977,52707244,147570,315141830,25044,25
29083,GTPBP8,chr3,F,112990481,113001374,52718137,10893,315152723,25045,5
29114,TAGLN3,chr3,F,111998738,112013888,52733287,15150,315167873,25046,4
29122,PRSS50,chr3,R,46712115,46717883,52739055,5768,315173641,25047,5
29890,RBM15B,chr3,F,51391267,51397908,52745696,6641,315180282,25048,0
29909,GPR171,chr3,R,151197753,151203222,52751165,5469,315185751,25049,3
29925,GMPPB,chr3,R,49721475,49723974,52753664,2499,315188250,25050,7
29927,SEC61A1,chr3,F,128052368,128071683,52772979,19315,315207565,25051,11
29931,LINC00312,chr3,F,8571781,8574668,52775866,2887,315210452,25052,0
29970,SCHIP1,chr3,F,159273246,159897366,53399986,624120,315834572,25053,8
29995,LMCD1,chr3,F,8501806,8568125,53466305,66319,315900891,25054,7
30849,PIK3R4,chr3,R,130678933,130746852,53534224,67919,315968810,25055,19
50512,PODXL2,chr3,F,127629158,127672810,53577876,43652,316012462,25056,7
50650,ARHGEF3,chr3,R,56727417,57079308,53929767,351891,316364353,25057,20
50852,TRAT1,chr3,F,108822783,108854867,53961851,32084,316396437,25058,5
50853,VILL,chr3,F,37987974,38007185,53981062,19211,316415648,25059,23
50939,IMPG2,chr3,R,101222545,101320575,54079092,98030,316513678,25060,17
51066,SSUH2,chr3,R,8590121,8745035,54234006,154914,316668592,25061,29
51068,NMD3,chr3,F,161221261,161252294,54265039,31033,316699625,25062,15
51095,TRNT1,chr3,F,3126915,3152503,54290627,25588,316725213,25063,11
51099,ABHD5,chr3,F,43690882,43722725,54322470,31843,316757056,25064,7
51122,COMMD2,chr3,R,149738469,149752510,54336511,14041,316771097,25065,5
51143,DYNC1LI1,chr3,R,32525970,32570874,54381415,44904,316816001,25066,12
51146,A4GNT,chr3,R,138123717,138132387,54390085,8670,316824671,25067,2
51161,C3orf18,chr3,R,50558024,50574002,54406063,15978,316840649,25068,7
51163,DBR1,chr3,R,138160987,138174949,54420025,13962,316854611,25069,7
51185,CRBN,chr3,R,3149632,3179717,54450110,30085,316884696,25070,11
51188,SS18L2,chr3,F,42581839,42594998,54463269,13159,316897855,25071,3
51193,ZNF639,chr3,F,179322990,179335535,54475814,12545,316910400,25072,8
51208,CLDN18,chr3,F,137998815,138033652,54510651,34837,316945237,25073,5
51244,CCDC174,chr3,F,14651745,14672659,54531565,20914,316966151,25074,10
51246,SHISA5,chr3,R,48467797,48504826,54568594,37029,317003180,25075,8
51300,TIMMDC1,chr3,F,119498520,119524281,54594355,25761,317028941,25076,6
51304,ZDHHC3,chr3,R,44915260,44976182,54655277,60922,317089863,25077,10
51319,RSRC1,chr3,F,158110051,158544835,55090061,434784,317524647,25078,10
51364,ZMYND10,chr3,R,50341105,50346028,55094984,4923,317529570,25079,11
51365,PLA1A,chr3,F,119597847,119629811,55126948,31964,317561534,25080,11
51368,TEX264,chr3,F,51671174,51704323,55160097,33149,317594683,25081,7
51372,TMA7,chr3,F,48440275,48444129,55163951,3854,317598537,25082,3
51385,ZNF589,chr3,F,48241105,48270990,55193836,29885,317628422,25083,3
51409,HEMK1,chr3,F,50569179,50589050,55213707,19871,317648293,25084,11
51421,AMOTL2,chr3,R,134355344,134375417,55233780,20073,317668366,25085,13
51447,IP6K2,chr3,R,48688002,48717278,55263056,29276,317697642,25086,8
51460,SFMBT1,chr3,R,52899981,53046655,55409730,146674,317844316,25087,23
51517,NCKIPSD,chr3,R,48673838,48685933,55421825,12095,317856411,25088,12
51533,PHF7,chr3,F,52410557,52423641,55434909,13084,317869495,25089,10
51554,ACKR4,chr3,F,132597236,132602644,55440317,5408,317874903,25090,1
51555,PEX5L,chr3,R,179794957,180037053,55682413,242096,318116999,25091,21
51560,RAB6B,chr3,R,133824234,133895847,55754026,71613,318188612,25092,8
51714,SELT,chr3,F,150603278,150630447,55781195,27169,318215781,25093,5
51725,FBXO40,chr3,F,121593322,121630292,55818165,36970,318252751,25094,3
51726,DNAJB11,chr3,F,186570675,186585800,55833290,15125,318267876,25095,9
51738,GHRL,chr3,R,10285749,10292947,55840488,7198,318275074,25096,5
53829,P2RY13,chr3,R,151326307,151329549,55843730,3242,318278316,25097,1
53833,IL20RB,chr3,F,136957864,137011085,55896951,53221,318331537,25098,8
53836,GPR87,chr3,R,151294085,151316848,55919714,22763,318354300,25099,2
54106,TLR9,chr3,R,52221079,52226163,55924798,5084,318359384,25100,1
54165,DCUN1D1,chr3,R,182938157,182985947,55972588,47790,318407174,25101,9
54437,SEMA5B,chr3,R,122909192,123028605,56092001,119413,318526587,25102,25
54464,XRN1,chr3,R,142306606,142448062,56233457,141456,318668043,25103,43
54554,WDR5B,chr3,R,122411852,122416035,56237640,4183,318672226,25104,0
54585,LZTFL1,chr3,R,45823315,45915724,56330049,92409,318764635,25105,15
54625,PARP14,chr3,F,122680762,122730840,56380127,50078,318814713,25106,17
54681,P4HTM,chr3,F,48989099,49007149,56398177,18050,318832763,25107,9
54716,SLC6A20,chr3,R,45755448,45796561,56439290,41113,318873876,25108,12
54756,IL17RD,chr3,R,57089981,57170317,56519626,80336,318954212,25109,16
54762,GRAMD1C,chr3,F,113828181,113947174,56638619,118993,319073205,25110,21
54763,ROPN1,chr3,R,123969005,123992170,56661784,23165,319096370,25111,8
54800,KLHL24,chr3,F,183635010,183684519,56711293,49509,319145879,25112,9
54847,SIDT1,chr3,F,113532370,113632097,56811020,99727,319245606,25113,26
54859,ELP6,chr3,R,47495639,47513722,56829103,18083,319263689,25114,11
54861,SNRK,chr3,F,43286511,43351143,56893735,64632,319328321,25115,8
54870,QRICH1,chr3,R,49029706,49094071,56958100,64365,319392686,25116,11
54899,PXK,chr3,F,58332889,58426127,57051338,93238,319485924,25117,20
54918,CMTM6,chr3,R,32481311,32502911,57072938,21600,319507524,25118,3
54931,TRMT10C,chr3,F,101561835,101566446,57077549,4611,319512135,25119,1
54946,SLC41A3,chr3,R,126006356,126101550,57172743,95194,319607329,25120,15
54965,PIGX,chr3,F,196712373,196736007,57196377,23634,319630963,25121,6
54977,SLC25A38,chr3,F,39383323,39397328,57210382,14005,319644968,25122,9
54986,ULK4,chr3,R,41239986,41962887,57933283,722901,320367869,25123,44
54995,OXSM,chr3,F,25790071,25794534,57937746,4463,320372332,25124,3
55032,SLC35A5,chr3,F,112561708,112584439,57960477,22731,320395063,25125,7
55076,TMEM45A,chr3,F,100492618,100577453,58045312,84835,320479898,25126,7
55079,FEZF2,chr3,R,62369671,62373515,58049156,3844,320483742,25127,4
55081,IFT57,chr3,R,108160811,108222570,58110915,61759,320545501,25128,10
55096,EBLN2,chr3,F,73061658,73063337,58112594,1679,320547180,25129,0
55129,ANO10,chr3,R,43366325,43691594,58437863,325269,320872449,25130,20
55152,DALRD3,chr3,R,49015487,49021386,58443762,5899,320878348,25131,9
55164,SHQ1,chr3,R,72749276,72848475,58542961,99199,320977547,25132,16
55167,MSL2,chr3,R,136148917,136197393,58591437,48476,321026023,25133,6
55171,TBCCD1,chr3,R,186546066,186570543,58615914,24477,321050500,25134,8
55179,FAIM,chr3,F,138608593,138633376,58640697,24783,321075283,25135,7
55186,SLC25A36,chr3,F,140941819,140979943,58678821,38124,321113407,25136,10
55193,PBRM1,chr3,R,52545351,52685898,58819368,140547,321253954,25137,36
55207,ARL8B,chr3,F,5122244,5180916,58878040,58672,321312626,25138,6
55209,SETD5,chr3,F,9397699,9478154,58958495,80455,321393081,25139,32
55211,DPPA4,chr3,R,109326140,109337572,58969927,11432,321404513,25140,7
55214,P3H2,chr3,R,189956727,190122437,59135637,165710,321570223,25141,16
55254,TMEM39A,chr3,R,119428959,119463682,59170360,34723,321604946,25142,11
55279,ZNF654,chr3,F,88139111,88144664,59175913,5553,321610499,25143,1
55287,TMEM40,chr3,R,12733529,12769457,59211841,35928,321646427,25144,14
55324,ABCF3,chr3,F,184186074,184194452,59220219,8378,321654805,25145,20
55341,LSG1,chr3,R,194640787,194672477,59251909,31690,321686495,25146,13
55347,ABHD10,chr3,F,111978875,111993368,59266402,14493,321700988,25147,5
55349,CHDH,chr3,R,53816296,53846393,59296499,30097,321731085,25148,10
55486,PARL,chr3,R,183826487,183884905,59354917,58418,321789503,25149,10
55540,IL17RB,chr3,F,53846549,53865800,59374168,19251,321808754,25150,11
55573,CDV3,chr3,F,133573589,133590274,59390853,16685,321825439,25151,5
55669,MFN1,chr3,F,179347691,179393226,59436388,45535,321870974,25152,18
55689,YEATS2,chr3,F,183697803,183812625,59551210,114822,321985796,25153,34
55764,IFT122,chr3,F,129440035,129520507,59631682,80472,322066268,25154,33
55768,NGLY1,chr3,R,25718943,25790039,59702778,71096,322137364,25155,15
55773,TBC1D23,chr3,F,100260816,100325252,59767214,64436,322201800,25156,19
55779,CFAP44,chr3,R,113286929,113445190,59925475,158261,322360061,25157,44
55799,CACNA2D3,chr3,F,54122592,55074557,60877440,951965,323312026,25158,42
55802,DCP1A,chr3,R,53283422,53347627,60941645,64205,323376231,25159,10
55830,GLT8D1,chr3,R,52694483,52706083,60953245,11600,323387831,25160,11
55831,EMC3,chr3,R,9962681,10011116,61001680,48435,323436266,25161,8
55840,EAF2,chr3,F,121835186,121886526,61053020,51340,323487606,25162,7
55845,BRK1,chr3,F,10115648,10127190,61064562,11542,323499148,25163,2
55888,ZKSCAN7,chr3,F,44555174,44583464,61092852,28290,323527438,25164,6
55892,MYNN,chr3,F,169769648,169789716,61112920,20068,323547506,25165,9
56203,LMOD3,chr3,R,69108671,69122595,61126844,13924,323561430,25166,2
56648,EIF5A2,chr3,R,170888414,170908637,61147067,20223,323581653,25167,4
56650,CLDND1,chr3,R,98515472,98523066,61154661,7594,323589247,25168,5
56667,MUC13,chr3,R,124905441,124934751,61183971,29310,323618557,25169,11
56670,SUCNR1,chr3,F,151873642,151882088,61192417,8446,323627003,25170,2
56852,RAD18,chr3,R,8877195,8963475,61278697,86280,323713283,25171,12
56920,SEMA3G,chr3,R,52433251,52445027,61290473,11776,323725059,25172,15
56922,MCCC1,chr3,R,183015217,183099587,61374843,84370,323809429,25173,20
56925,LXN,chr3,R,158666413,158672693,61381123,6280,323815709,25174,5
56941,HMCES,chr3,F,129278815,129306186,61408494,27371,323843080,25175,8
56945,MRPS22,chr3,F,139343993,139357129,61421630,13136,323856216,25176,8
56954,NIT2,chr3,F,100334717,100355634,61442547,20917,323877133,25177,9
56983,POGLUT1,chr3,F,119468937,119494708,61468318,25771,323902904,25178,13
56987,BBX,chr3,F,107522935,107811329,61756712,288394,324191298,25179,21
56992,KIF15,chr3,F,44761713,44868656,61863655,106943,324298241,25180,39
56999,ADAMTS9,chr3,R,64515653,64688000,62036002,172347,324470588,25181,40
57018,CCNL1,chr3,R,157146363,157160693,62050332,14330,324484918,25182,12
57047,PLSCR2,chr3,R,146391362,146496012,62154982,104650,324589568,25183,21
57060,PCBP4,chr3,R,51957453,51967466,62164995,10013,324599581,25184,15
57088,PLSCR4,chr3,R,146192334,146251179,62223840,58845,324658426,25185,11
57092,PCNP,chr3,F,101573533,101594437,62244744,20904,324679330,25186,4
57110,HRASLS,chr3,F,193241127,193300939,62304556,59812,324739142,25187,9
57129,MRPL47,chr3,R,179588464,179604646,62320738,16182,324755324,25188,6
57337,SENP7,chr3,R,101324188,101513883,62510433,189695,324945019,25189,26
57406,ABHD6,chr3,F,58237505,58294738,62567666,57233,325002252,25190,9
57408,LRTM1,chr3,R,54918236,54967088,62616518,48852,325051104,25191,4
57415,C3orf14,chr3,F,62318972,62336213,62633759,17241,325068345,25192,6
57456,KIAA1143,chr3,R,44748743,44761697,62646713,12954,325081299,25193,2
57461,ISY1,chr3,R,129127415,129161230,62680528,33815,325115114,25194,12
57467,HHATL,chr3,R,42692662,42702848,62690714,10186,325125300,25195,13
57493,HEG1,chr3,R,124965709,125055958,62780963,90249,325215549,25196,17
57501,KIAA1257,chr3,R,128910185,129026519,62897297,116334,325331883,25197,16
57514,ARHGAP31,chr3,F,119294288,119419476,63022485,125188,325457071,25198,12
57552,NCEH1,chr3,R,172630644,172711218,63103059,80574,325537645,25199,4
57560,IFT80,chr3,R,160256985,160399532,63245606,142547,325680192,25200,20
57577,KIAA1407,chr3,R,113964136,114056641,63338111,92505,325772697,25201,17
57599,WDR48,chr3,F,39051985,39096671,63382797,44686,325817383,25202,19
57633,LRRN1,chr3,F,3799401,3849834,63433230,50433,325867816,25203,2
57650,KIAA1524,chr3,R,108545751,108589644,63477123,43893,325911709,25204,21
57709,SLC7A14,chr3,R,170459553,170586074,63603644,126521,326038230,25205,8
58477,SRPRB,chr3,F,133784032,133821492,63641104,37460,326075690,25206,7
58515,SELK,chr3,R,53885198,53891962,63647868,6764,326082454,25207,4
59343,SENP2,chr3,F,185586227,185631101,63692742,44874,326127328,25208,16
59345,GNB4,chr3,R,179396087,179451583,63748238,55496,326182824,25209,12
60467,BPESC1,chr3,F,139104184,139125167,63769221,20983,326203807,25210,2
60675,PROK2,chr3,R,71771654,71785206,63782773,13552,326217359,25211,3
60678,EEFSEC,chr3,F,128153456,128426193,64055510,272737,326490096,25212,9
63891,RNF123,chr3,F,49689142,49721529,64087897,32387,326522483,25213,39
63899,NSUN3,chr3,F,94063010,94127740,64152627,64730,326587213,25214,7
63924,CIDEC,chr3,R,9866709,9880262,64166180,13553,326600766,25215,8
64084,CLSTN2,chr3,F,139935184,140568077,64799073,632893,327233659,25216,16
64091,POPDC2,chr3,R,119642054,119660590,64817609,18536,327252195,25217,5
64108,RTP4,chr3,F,187368379,187371584,64820814,3205,327255400,25218,1
64110,MAGEF1,chr3,R,184710366,184712048,64822496,1682,327257082,25219,0
64145,RBSN,chr3,R,15070068,15099157,64851585,29089,327286171,25220,15
64147,KIF9,chr3,R,47228025,47282847,64906407,54822,327340993,25221,23
64332,NFKBIZ,chr3,F,101827989,101861025,64939443,33036,327374029,25222,13
64343,AZI2,chr3,R,28322352,28349424,64966515,27072,327401101,25223,10
64393,ZMAT3,chr3,R,179017222,179072279,65021572,55057,327456158,25224,6
64419,MTMR14,chr3,F,9649432,9702394,65074534,52962,327509120,25225,19
64422,ATG3,chr3,R,112532506,112561963,65103991,29457,327538577,25226,10
64432,MRPS25,chr3,R,15042250,15065311,65127052,23061,327561638,25227,3
64651,CSRNP1,chr3,R,39141850,39154597,65139799,12747,327574385,25228,6
64689,GORASP1,chr3,R,39096598,39108363,65151564,11765,327586150,25229,11
64747,MFSD1,chr3,F,158801449,158829719,65179834,28270,327614420,25230,16
64770,CCDC14,chr3,R,123887352,123961409,65253891,74057,327688477,25231,13
64778,FNDC3B,chr3,F,172039627,172400703,65614967,361076,328049553,25232,27
64805,P2RY12,chr3,R,151336842,151384812,65662937,47970,328097523,25233,2
64866,CDCP1,chr3,R,45082273,45146422,65727086,64149,328161672,25234,8
64925,CCDC71,chr3,R,49162534,49166352,65730904,3818,328165490,25235,1
64943,NT5DC2,chr3,R,52524368,52535077,65741613,10709,328176199,25236,16
65010,SLC26A6,chr3,R,48625722,48635493,65751384,9771,328185970,25237,20
66000,TMEM108,chr3,F,133038287,133397775,66110872,359488,328545458,25238,11
78987,CRELD1,chr3,F,9933787,9945413,66122498,11626,328557084,25239,10
79012,CAMKV,chr3,R,49857980,49869955,66134473,11975,328569059,25240,10
79188,TMEM43,chr3,F,14124939,14143680,66153214,18741,328587800,25241,12
79295,OR5H6,chr3,F,98263259,98265350,66155305,2091,328589891,25242,1
79310,OR5H2,chr3,F,98282887,98283832,66156250,945,328590836,25243,0
79364,ZXDC,chr3,R,126437600,126475933,66194583,38333,328629169,25244,9
79413,ZBED2,chr3,R,111592899,111595335,66197019,2436,328631605,25245,1
79442,LRRC2,chr3,R,46515384,46580060,66261695,64676,328696281,25246,9
79443,FYCO1,chr3,R,45917898,45995824,66339621,77926,328774207,25247,20
79572,ATP13A3,chr3,R,194402673,194486654,66423602,83981,328858188,25248,36
79598,CEP97,chr3,F,101724083,101770562,66470081,46479,328904667,25249,11
79663,HSPBAP1,chr3,R,122739996,122795216,66525301,55220,328959887,25250,12
79669,C3orf52,chr3,F,112086334,112131095,66570062,44761,329004648,25251,8
79674,VEPH1,chr3,R,157259741,157503626,66813947,243885,329248533,25252,18
79691,QTRTD1,chr3,F,114056730,114088422,66845639,31692,329280225,25253,11
79714,CCDC51,chr3,R,48432169,48441078,66854548,8909,329289134,25254,4
79718,TBL1XR1,chr3,R,177020753,177197260,67031055,176507,329465641,25255,20
79740,ZBBX,chr3,R,167178424,167380405,67233036,201981,329667622,25256,31
79750,ZNF385D,chr3,R,21412221,22372641,68193456,960420,330628042,25257,21
79782,LRRC31,chr3,R,169839240,169869935,68224151,30695,330658737,25258,9
79825,EFCC1,chr3,F,129001250,129040742,68263643,39492,330698229,25259,11
79858,NEK11,chr3,F,131026849,131350465,68587259,323616,331021845,25260,27
79876,UBA5,chr3,F,132654445,132678253,68611067,23808,331045653,25261,14
79885,HDAC11,chr3,F,13480170,13506424,68637321,26254,331071907,25262,11
79929,MAP6D1,chr3,R,183815875,183825605,68647051,9730,331081637,25263,2
80012,PHC3,chr3,R,170086730,170181749,68742070,95019,331176656,25264,21
80111,C3orf36,chr3,R,133928144,133929812,68743738,1668,331178324,25265,0
80117,ARL14,chr3,F,160677159,160678448,68745027,1289,331179613,25266,0
80145,THOC7,chr3,R,63833869,63864399,68775557,30530,331210143,25267,8
80218,NAA50,chr3,R,113716459,113746273,68805371,29814,331239957,25268,4
80235,PIGZ,chr3,R,196946342,196968871,68827900,22529,331262486,25269,4
80254,CEP63,chr3,F,134485732,134575013,68917181,89281,331351767,25270,20
80321,CEP70,chr3,R,138494338,138594383,69017226,100045,331451812,25271,22
80325,ABTB1,chr3,F,127672937,127680926,69025215,7989,331459801,25272,12
80335,WDR82,chr3,R,52254421,52287876,69058670,33455,331493256,25273,10
80723,SLC35G2,chr3,F,136819018,136855892,69095544,36874,331530130,25274,3
80746,TSEN2,chr3,F,12484431,12539622,69150735,55191,331585321,25275,15
80852,GRIP2,chr3,R,14489110,14602996,69264621,113886,331699207,25276,27
81050,OR5AC2,chr3,F,98087172,98088102,69265551,930,331700137,25277,0
83597,RTP3,chr3,F,46497994,46500949,69268506,2955,331703092,25278,1
83598,LRRC2-AS1,chr3,F,46557397,46559688,69270797,2291,331705383,25279,2
83666,PARP9,chr3,R,122527909,122564676,69307564,36767,331742150,25280,13
83850,ESYT3,chr3,F,138434572,138479942,69352934,45370,331787520,25281,23
83893,SPATA16,chr3,R,172889356,173141268,69604846,251912,332039432,25282,13
83939,EIF2A,chr3,F,150546689,150586016,69644173,39327,332078759,25283,13
84002,B3GNT5,chr3,F,183253225,183273391,69664339,20166,332098925,25284,5
84077,C3orf20,chr3,F,14674224,14773036,69763151,98812,332197737,25285,20
84100,ARL6,chr3,F,97764520,97801242,69799873,36722,332234459,25286,13
84107,ZIC4,chr3,R,147386047,147407476,69821302,21429,332255888,25287,4
84126,ATRIP,chr3,F,48446709,48465655,69840248,18946,332274834,25288,14
84129,ACAD11,chr3,R,132558137,132660131,69942242,101994,332376828,25289,19
84223,IQCG,chr3,R,197887207,197960015,70015050,72808,332449636,25290,12
84239,ATP13A4,chr3,R,193398966,193555122,70171206,156156,332605792,25291,31
84248,FYTTD1,chr3,F,197749552,197784446,70206100,34894,332640686,25292,11
84276,NICN1,chr3,R,49422332,49429324,70213092,6992,332647678,25293,5
84303,CHCHD6,chr3,F,126704219,126960420,70469293,256201,332903879,25294,15
84315,MON1A,chr3,R,49908868,49930357,70490782,21489,332925368,25295,7
84319,CMSS1,chr3,F,99817833,100178632,70851581,360799,333286167,25296,10
84343,HPS3,chr3,F,149129583,149173518,70895516,43935,333330102,25297,16
84517,ACTRT3,chr3,R,169766920,169769895,70898491,2975,333333077,25298,1
84522,JAGN1,chr3,F,9890586,9894349,70902254,3763,333336840,25299,1
84541,KBTBD8,chr3,F,66998302,67011211,70915163,12909,333349749,25300,3
84561,SLC12A8,chr3,R,125082635,125212765,71045293,130130,333479879,25301,13
84657,LINC00852,chr3,F,10284418,10285746,71046621,1328,333481207,25302,0
84666,RETNLB,chr3,R,108755638,108757283,71048266,1645,333482852,25303,2
84692,CCDC54,chr3,F,107377340,107378634,71049560,1294,333484146,25304,0
84789,MGC2889,chr3,F,193241778,193243972,71051754,2194,333486340,25305,0
84818,IL17RC,chr3,F,9917073,9933621,71068302,16548,333502888,25306,17
84836,ABHD14B,chr3,R,51968509,51974630,71074423,6121,333509009,25307,3
84859,LRCH3,chr3,F,197791225,197884310,71167508,93085,333602094,25308,25
84864,MINA,chr3,R,97941816,97972451,71198143,30635,333632729,25309,11
84873,ADGRG7,chr3,F,100609588,100695479,71284034,85891,333718620,25310,15
84892,POMGNT2,chr3,R,43079228,43106083,71310889,26855,333745475,25311,3
84925,DIRC2,chr3,F,122795053,122881139,71396975,86086,333831561,25312,8
84984,CEP19,chr3,R,196706272,196712294,71402997,6022,333837583,25313,2
85003,BFSP2-AS1,chr3,R,133429285,133456237,71429949,26952,333864535,25314,5
85403,EAF1,chr3,F,15427556,15442613,71445006,15057,333879592,25315,6
85443,DCLK3,chr3,R,36712421,36764204,71496789,51783,333931375,25316,6
85476,GFM1,chr3,F,158644496,158692572,71544865,48076,333979451,25317,18
89782,LMLN,chr3,F,197960199,198043720,71628386,83521,334062972,25318,17
89857,KLHL6,chr3,R,183487530,183555712,71696568,68182,334131154,25319,4
89876,MAATS1,chr3,F,119703021,119767102,71760649,64081,334195235,25320,18
90102,PHLDB2,chr3,F,111732479,111976517,72004687,244038,334439273,25321,20
90113,VWA5B2,chr3,F,184229587,184242330,72017430,12743,334452016,25322,19
90226,UCN2,chr3,R,48561717,48563768,72019481,2051,334454067,25323,1
90246,LOC90246,chr3,F,128507834,128510595,72022242,2761,334456828,25324,0
90288,EFCAB12,chr3,R,129401320,129428651,72049573,27331,334484159,25325,11
90407,TMEM41A,chr3,R,185482670,185499057,72065960,16387,334500546,25326,7
91392,ZNF502,chr3,F,44712642,44723831,72077149,11189,334511735,25327,5
91653,BOC,chr3,F,113211002,113287463,72153610,76461,334588196,25328,21
91775,NXPE3,chr3,F,101779184,101828231,72202657,49047,334637243,25329,8
91869,RFT1,chr3,R,53071151,53130459,72261965,59308,334696551,25330,17
92106,OXNAD1,chr3,F,16265159,16386979,72383785,121820,334818371,25331,17
92369,SPSB4,chr3,F,141050794,141148611,72481602,97817,334916188,25332,5
92370,PXYLP1,chr3,F,141231824,141294903,72544681,63079,334979267,25333,12
92999,ZBTB47,chr3,F,42653683,42667580,72558578,13897,334993164,25334,5
93109,TMEM44,chr3,R,194587672,194633780,72604686,46108,335039272,25335,12
93556,EGFEM1P,chr3,F,168249521,168830599,73185764,581078,335620350,25336,15
93973,ACTR8,chr3,R,53864930,53882202,73203036,17272,335637622,25337,14
94032,CAMK2N2,chr3,R,184259214,184261463,73205285,2249,335639871,25338,1
112616,CMTM7,chr3,F,32391670,32454841,73268456,63171,335703042,25339,5
114112,TXNRD3,chr3,R,126607051,126655124,73316529,48073,335751115,25340,15
114884,OSBPL10,chr3,R,31660824,31981850,73637555,321026,336072141,25341,15
114885,OSBPL11,chr3,R,125528857,125595537,73704235,66680,336138821,25342,12
115286,SLC25A26,chr3,F,66133609,66380021,73950647,246412,336385233,25343,13
115560,ZNF501,chr3,F,44729605,44737083,73958125,7478,336392711,25344,2
115795,FANCD2OS,chr3,R,10081319,10108339,73985145,27020,336419731,25345,4
116064,LRRC58,chr3,R,120324728,120349361,74009778,24633,336444364,25346,4
116135,LRRC3B,chr3,F,26622808,26710776,74097746,87968,336532332,25347,7
116211,TM4SF19,chr3,R,196323545,196338420,74112621,14875,336547207,25348,4
116441,TM4SF18,chr3,R,149318497,149333761,74127885,15264,336562471,25349,5
116832,RPL39L,chr3,R,187120952,187139475,74146408,18523,336580994,25350,2
116931,MED12L,chr3,F,151085664,151436678,74497422,351014,336932008,25351,51
116933,CLRN1-AS1,chr3,F,150972677,151079830,74604575,107153,337039161,25352,5
117248,GALNT15,chr3,F,16174578,16246333,74676330,71755,337110916,25353,11
118442,GPR62,chr3,F,51955313,51957504,74678521,2191,337113107,25354,0
131034,CPNE4,chr3,R,131533559,132285547,75430509,751988,337865095,25355,24
131076,CCDC58,chr3,R,122359588,122383281,75454202,23693,337888788,25356,6
131096,KCNH8,chr3,F,19147092,19535643,75842753,388551,338277339,25357,18
131118,DNAJC19,chr3,R,180983708,180989774,75848819,6066,338283405,25358,6
131149,OTOL1,chr3,F,161429600,161503975,75923194,74375,338357780,25359,4
131177,FAM3D,chr3,R,58633942,58666844,75956096,32902,338390682,25360,10
131368,ZPLD1,chr3,F,102357480,102479841,76078457,122361,338513043,25361,13
131375,LYZL4,chr3,R,42360767,42410652,76128342,49885,338562928,25362,5
131377,KLHL40,chr3,F,42685518,42692446,76135270,6928,338569856,25363,5
131405,TRIM71,chr3,F,32818017,32892279,76209532,74262,338644118,25364,3
131408,FAM131A,chr3,F,184335928,184346275,76219879,10347,338654465,25365,8
131450,CD200R1,chr3,R,112921056,112975122,76273945,54066,338708531,25366,6
131474,CHCHD4,chr3,R,14112076,14124871,76286740,12795,338721326,25367,3
131540,ZDHHC19,chr3,R,196197442,196211437,76300735,13995,338735321,25368,9
131544,CRYBG3,chr3,F,97821936,97944986,76423785,123050,338858371,25369,21
131566,DCBLD2,chr3,R,98795969,98901689,76529505,105720,338964091,25370,15
131578,LRRC15,chr3,R,194355246,194369743,76544002,14497,338978588,25371,2
131583,FAM43A,chr3,F,194685892,194689037,76547147,3145,338981733,25372,0
131601,TPRA1,chr3,R,127573063,127595059,76569143,21996,339003729,25373,15
131616,TMEM42,chr3,F,44861722,44865667,76573088,3945,339007674,25374,1
131669,UROC1,chr3,R,126481164,126517773,76609697,36609,339044283,25375,20
131831,ERICH6,chr3,R,150659881,150704563,76654379,44682,339088965,25376,13
131870,NUDT16,chr3,F,131381670,131388830,76661539,7160,339096125,25377,2
131873,COL6A6,chr3,F,130517176,130678135,76822498,160959,339257084,25378,43
131890,GRK7,chr3,F,141749983,141817370,76889885,67387,339324471,25379,6
131909,FAM172BP,chr3,F,101518866,101523887,76894906,5021,339329492,25380,1
131920,TMEM207,chr3,R,190428654,190449876,76916128,21222,339350714,25381,5
131965,METTL6,chr3,R,15381062,15427547,76962613,46485,339397199,25382,9
132001,TAMM41,chr3,R,11790441,11846919,77019091,56478,339453677,25383,13
132014,IL17RE,chr3,F,9902061,9916402,77033432,14341,339468018,25384,19
132112,RTP1,chr3,F,187197485,187201465,77037412,3980,339471998,25385,1
132141,IQCF1,chr3,R,51894875,51903370,77045907,8495,339480493,25386,5
132158,GLYCTK,chr3,F,52287819,52295256,77053344,7437,339487930,25387,4
132160,PPM1M,chr3,F,52245724,52250599,77058219,4875,339492805,25388,10
132200,C3orf49,chr3,F,63819364,63848636,77087491,29272,339522077,25389,6
132203,SNTN,chr3,F,63652667,63665217,77100041,12550,339534627,25390,3
132204,SYNPR,chr3,F,63200408,63616924,77516557,416516,339951143,25391,11
132228,LSMEM2,chr3,F,50277914,50288114,77526757,10200,339961343,25392,6
132241,RPL32P3,chr3,R,129382833,129399439,77543363,16606,339977949,25393,3
132243,H1FOO,chr3,F,129543213,129551467,77551617,8254,339986203,25394,5
140464,PISRT1,chr3,R,139232991,139233522,77552148,531,339986734,25395,0
142686,ASB14,chr3,R,57268350,57292720,77576518,24370,340011104,25396,10
151613,TTC14,chr3,F,180602129,180618347,77592736,16218,340027322,25397,10
151636,DTX3L,chr3,F,122564337,122575203,77603602,10866,340038188,25398,4
151647,FAM19A4,chr3,R,68731763,68932610,77804449,200847,340239035,25399,5
151648,SGOL1,chr3,R,20159045,20188131,77833535,29086,340268121,25400,11
151649,PP2D1,chr3,R,19979960,20012780,77866355,32820,340300941,25401,8
151651,EFHB,chr3,R,19879471,19947456,77934340,67985,340368926,25402,15
151658,LINC00635,chr3,R,107841661,107878068,77970747,36407,340405333,25403,10
151742,PPM1L,chr3,F,160755531,161078902,78294118,323371,340728704,25404,5
151760,LOC151760,chr3,R,110892122,110970917,78372913,78795,340807499,25405,4
151790,WDR49,chr3,R,167478683,167653501,78547731,174818,340982317,25406,14
151827,LRRC34,chr3,R,169793005,169812866,78567592,19861,341002178,25407,10
151835,CPNE9,chr3,F,9703811,9729908,78593689,26097,341028275,25408,21
151871,DPPA2,chr3,R,109293787,109316535,78616437,22748,341051023,25409,11
151887,CCDC80,chr3,R,112604385,112641143,78653195,36758,341087781,25410,7
151888,BTLA,chr3,R,112463965,112499702,78688932,35737,341123518,25411,4
151903,CCDC12,chr3,R,46921729,46982018,78749221,60289,341183807,25412,10
151963,MB21D2,chr3,R,192796814,192918161,78870568,121347,341305154,25413,1
151987,PPP4R2,chr3,F,72996967,73065860,78939461,68893,341374047,25414,8
152002,XXYLT1,chr3,R,195068275,195271166,79142352,202891,341576938,25415,15
152015,ROPN1B,chr3,F,125969143,125983454,79156663,14311,341591249,25416,8
152024,LINC00691,chr3,R,24099973,24103247,79159937,3274,341594523,25417,1
152065,C3orf22,chr3,R,126521996,126558965,79196906,36969,341631492,25418,12
152078,PQLC2L,chr3,F,157543343,157677750,79331313,134407,341765899,25419,8
152098,ZCWPW2,chr3,F,28349148,28525142,79507307,175994,341941893,25420,9
152100,CMC1,chr3,F,28241588,28319776,79585495,78188,342020081,25421,10
152110,NEK10,chr3,R,27107335,27369460,79847620,262125,342282206,25422,48
152118,C3orf79,chr3,F,153484494,153502697,79865823,18203,342300409,25423,2
152137,CCDC50,chr3,F,191329081,191398670,79935412,69589,342369998,25424,12
152138,PYDC2,chr3,F,191461162,191461456,79935706,294,342370292,25425,0
152185,SPICE1,chr3,R,113442717,113515187,80008176,72470,342442762,25426,18
152189,CMTM8,chr3,F,32238678,32370321,80139819,131643,342574405,25427,4
152195,NUDT16P1,chr3,F,131361844,131365122,80143097,3278,342577683,25428,1
152206,CCDC13,chr3,R,42704117,42773253,80212233,69136,342646819,25429,19
152217,NCBP2-AS2,chr3,F,196942622,196944013,80213624,1391,342648210,25430,0
152225,LOC152225,chr3,F,101940858,101997926,80270692,57068,342705278,25431,3
152273,FGD5,chr3,F,14818961,14934565,80386296,115604,342820882,25432,19
152274,LOC152274,chr3,R,14802893,14811414,80394817,8521,342829403,25433,2
152302,CIDECP,chr3,R,10017552,10026136,80403401,8584,342837987,25434,2
152330,CNTN4,chr3,F,2098865,3057961,81362497,959096,343797083,25435,30
152404,IGSF11,chr3,R,118900629,119146068,81607936,245439,344042522,25436,13
152405,C3orf30,chr3,F,119146149,119151455,81613242,5306,344047828,25437,2
165631,PARP15,chr3,F,122577453,122639047,81674836,61594,344109422,25438,12
165679,SPTSSB,chr3,R,161344791,161372938,81702983,28147,344137569,25439,3
165721,DNAJB8,chr3,R,128462431,128467248,81707800,4817,344142386,25440,2
165829,GPR156,chr3,R,120165480,120285124,81827444,119644,344262030,25441,14
165904,XIRP1,chr3,R,39183214,39192620,81836850,9406,344271436,25442,1
165918,RNF168,chr3,R,196468782,196503768,81871836,34986,344306422,25443,6
166012,CHST13,chr3,F,126524287,126543291,81890840,19004,344325426,25444,2
166336,PRICKLE2,chr3,R,64093849,64445476,82242467,351627,344677053,25445,13
166348,KBTBD12,chr3,F,127915231,127987685,82314921,72454,344749507,25446,8
170506,DHX36,chr3,R,154275667,154324497,82363751,48830,344798337,25447,24
170572,HTR3C,chr3,F,184053046,184060673,82371378,7627,344805964,25448,8
199221,DZIP1L,chr3,R,138061984,138115818,82425212,53834,344859798,25449,24
199223,TTC21A,chr3,F,39107660,39138994,82456546,31334,344891132,25450,30
200810,ALG1L,chr3,R,125928839,125952098,82479805,23259,344914391,25451,7
200844,C3orf67,chr3,R,58734471,59050078,82795412,315607,345229998,25452,25
200845,KCTD6,chr3,F,58492095,58502360,82805677,10265,345240263,25453,3
200879,LIPH,chr3,R,185506865,185552655,82851467,45790,345286053,25454,11
200894,ARL13B,chr3,F,93980133,94055678,82927012,75545,345361598,25455,13
200895,DHFRL1,chr3,R,94057921,94063389,82932480,5468,345367066,25456,2
200909,HTR3D,chr3,F,184031543,184039369,82940306,7826,345374892,25457,9
200916,RPL22L1,chr3,R,170864874,170870256,82945688,5382,345380274,25458,3
200931,SLC51A,chr3,F,196216511,196233430,82962607,16919,345397193,25459,8
200933,FBXO45,chr3,F,196568853,196589059,82982813,20206,345417399,25460,2
200942,KLHDC8B,chr3,F,49171119,49176486,82988180,5367,345422766,25461,5
200958,MUC20,chr3,F,195720881,195733553,83000852,12672,345435438,25462,3
200959,GABRR3,chr3,R,97986682,98035304,83049474,48622,345484060,25463,9
201562,HACD2,chr3,R,123494515,123585077,83140036,90562,345574622,25464,6
201595,STT3B,chr3,F,31532500,31637622,83245158,105122,345679744,25465,16
201617,LINC00870,chr3,F,72151256,72174339,83268241,23083,345702827,25466,2
201625,DNAH12,chr3,R,57293698,57544344,83518887,250646,345953473,25467,78
201626,PDE12,chr3,F,57556251,57654979,83617615,98728,346052201,25468,3
201627,DENND6A,chr3,R,57625453,57693089,83685251,67636,346119837,25469,20
201633,TIGIT,chr3,F,114293985,114310288,83701554,16303,346136140,25470,3
201651,AADACP1,chr3,F,151770455,151784894,83715993,14439,346150579,25471,2
205428,C3orf58,chr3,F,143971797,143992368,83736564,20571,346171150,25472,3
205564,SENP5,chr3,F,196867855,196934714,83803423,66859,346238009,25473,11
205717,KIAA2018,chr3,R,113648384,113696646,83851685,48262,346286271,25474,6
220729,LOC220729,chr3,R,197614026,197627881,83865540,13855,346300126,25475,7
253461,ZBTB38,chr3,F,141324212,141449792,83991120,125580,346425706,25476,13
253559,CADM2,chr3,F,84958981,86074429,85106568,1115448,347541154,25477,12
253573,LOC253573,chr3,R,186454980,186493661,85145249,38681,347579835,25478,7
253639,ZNF620,chr3,F,40504988,40518221,85158482,13233,347593068,25479,5
254827,NAALADL2,chr3,F,174440994,175809510,86526998,1368516,348961584,25480,21
254887,ZDHHC23,chr3,F,113947900,113992167,86571265,44267,349005851,25481,7
255025,LINC00879,chr3,F,94938262,94991328,86624331,53066,349058917,25482,7
255330,NUP210P1,chr3,F,126662080,126671939,86634190,9859,349068776,25483,4
255758,TCTEX1D2,chr3,R,196291218,196318294,86661266,27076,349095852,25484,4
255798,SMCO1,chr3,R,196506878,196515366,86669754,8488,349104340,25485,2
255812,SDHAP1,chr3,R,195959920,195990279,86700113,30359,349134699,25486,16
256076,COL6A5,chr3,F,130345515,130484846,86839444,139331,349274030,25487,43
256356,GK5,chr3,R,142157526,142225607,86907525,68081,349342111,25488,16
257068,PLCXD2,chr3,F,111674675,111846447,87079297,171772,349513883,25489,4
257144,GCSAM,chr3,R,112120840,112136705,87095162,15865,349529748,25490,5
257313,UTS2B,chr3,R,191267154,191330536,87158544,63382,349593130,25491,9
259173,ALS2CL,chr3,R,46668994,46693704,87183254,24710,349617840,25492,24
259236,TMIE,chr3,F,46693841,46710923,87200336,17082,349634922,25493,4
285194,TUSC7,chr3,F,116709787,116717040,87207589,7253,349642175,25494,3
285195,SLC9A9,chr3,R,143265220,143848531,87790900,583311,350225486,25495,18
285203,EOGT,chr3,R,68975211,69013961,87829650,38750,350264236,25496,20
285205,LINC00636,chr3,F,107883204,107928907,87875353,45703,350309939,25497,2
285220,EPHA6,chr3,F,96814580,97764977,88825750,950397,351260336,25498,31
285224,DNAJB8-AS1,chr3,F,128463593,128472317,88834474,8724,351269060,25499,2
285231,FBXW12,chr3,F,48372174,48394791,88857091,22617,351291677,25500,10
285237,C3orf38,chr3,F,88149742,88157965,88865314,8223,351299900,25501,2
285242,HTR3E,chr3,F,184097063,184106995,88875246,9932,351309832,25502,8
285266,ENTPD3-AS1,chr3,R,40390950,40453308,88937604,62358,351372190,25503,3
285267,ZNF619,chr3,F,40477112,40490237,88950729,13125,351385315,25504,6
285268,ZNF621,chr3,F,40524315,40539794,88966208,15479,351400794,25505,6
285282,RABL3,chr3,R,120686680,120742537,89022065,55857,351456651,25506,7
285286,LINC00877,chr3,R,72035518,72100455,89087002,64937,351521588,25507,6
285311,C3orf56,chr3,F,127193130,127198185,89092057,5055,351526643,25508,1
285313,IGSF10,chr3,R,151435989,151619926,89275994,183937,351710580,25509,12
285315,C3orf33,chr3,R,155762611,155806287,89319670,43676,351754256,25510,8
285326,LINC00692,chr3,R,25858531,25873695,89334834,15164,351769420,25511,7
285331,CCDC66,chr3,F,56557110,56621836,89399560,64726,351834146,25512,21
285335,SLC9C1,chr3,R,112140897,112362986,89621649,222089,352056235,25513,36
285343,TCAIM,chr3,F,44338118,44409448,89692979,71330,352127565,25514,12
285346,ZNF852,chr3,R,44498969,44510640,89704650,11671,352139236,25515,3
285349,ZNF660,chr3,F,44584848,44599699,89719501,14851,352154087,25516,4
285352,KIF9-AS1,chr3,F,47164369,47244116,89799248,79747,352233834,25517,6
285359,PDCL3P4,chr3,F,101712433,101713416,89800231,983,352234817,25518,0
285362,SUMF1,chr3,R,4065933,4467282,90201580,401349,352636166,25519,13
285367,RPUSD3,chr3,R,9837848,9844018,90207750,6170,352642336,25520,8
285368,PRRT3,chr3,R,9945541,9952394,90214603,6853,352649189,25521,5
285370,LINC00606,chr3,R,10759483,10764192,90219312,4709,352653898,25522,2
285375,LINC00620,chr3,F,13650720,13746635,90315227,95915,352749813,25523,5
285381,DPH3,chr3,R,16257060,16264989,90323156,7929,352757742,25524,2
285382,C3orf70,chr3,R,185078049,185153014,90398121,74965,352832707,25525,1
285386,TPRG1,chr3,F,189099458,189323482,90622145,224024,353056731,25526,21
285389,LOC285389,chr3,R,194005206,194071044,90687983,65838,353122569,25527,13
285401,LINC00698,chr3,F,63102687,63125062,90710358,22375,353144944,25528,6
286676,ILDR1,chr3,R,121987322,122060516,90783552,73194,353218138,25529,8
286827,TRIM59,chr3,R,160435502,160449838,90797888,14336,353232474,25530,2
287015,TRIM42,chr3,F,140678023,140701150,90821015,23127,353255601,25531,6
317649,EIF4E3,chr3,R,71679288,71754773,90896500,75485,353331086,25532,11
339122,RAB43,chr3,R,129087568,129122150,90931082,34582,353365668,25533,6
339829,CCDC39,chr3,R,180614007,180679495,90996570,65488,353431156,25534,19
339834,CCDC36,chr3,F,49198427,49258157,91056300,59730,353490886,25535,12
339855,KY,chr3,R,134599922,134651677,91108055,51755,353542641,25536,11
339862,LOC339862,chr3,F,17962571,18268922,91414406,306351,353848992,25537,4
339874,LOC339874,chr3,R,131325091,131381475,91470790,56384,353905376,25538,3
339883,C3orf35,chr3,F,37386268,37435497,91520019,49229,353954605,25539,6
339894,LINC00880,chr3,R,157081666,157123002,91561355,41336,353995941,25540,3
339896,GADL1,chr3,R,30726199,30894661,91729817,168462,354164403,25541,14
339902,LOC339902,chr3,R,59637295,59658560,91751082,21265,354185668,25542,4
339906,PRSS42,chr3,R,46830403,46834095,91754774,3692,354189360,25543,4
339926,EHHADH-AS1,chr3,F,185162900,185191955,91783829,29055,354218415,25544,6
339929,LPP-AS2,chr3,R,188151205,188154088,91786712,2883,354221298,25545,0
339942,H1FX-AS1,chr3,F,129316270,129324569,91795011,8299,354229597,25546,4
344595,LINC00883,chr3,F,107240691,107326964,91881284,86273,354315870,25547,4
344657,LRRIQ4,chr3,F,169812946,169838007,91906345,25061,354340931,25548,7
344658,SAMD7,chr3,F,169905105,169939175,91940415,34070,354375001,25549,11
344752,AADACL2,chr3,F,151733915,151758016,91964516,24101,354399102,25550,5
344758,GPR149,chr3,R,154337671,154429715,92056560,92044,354491146,25551,3
344787,ZNF860,chr3,F,31981773,31991736,92066523,9963,354501109,25552,1
344805,TMPRSS7,chr3,F,112039066,112081269,92108726,42203,354543312,25553,18
344807,CD200R1L,chr3,R,112812238,112846889,92143377,34651,354577963,25554,10
344838,PAQR9,chr3,R,142961230,142963336,92145483,2106,354580069,25555,0
344875,COL6A4P1,chr3,R,15165361,15205959,92186081,40598,354620667,25556,4
344887,LOC344887,chr3,F,185959968,185980877,92206990,20909,354641576,25557,5
344892,RTP2,chr3,R,187698258,187716720,92225452,18462,354660038,25558,6
344901,OSTN,chr3,F,191199141,191263338,92289649,64197,354724235,25559,4
344905,ATP13A5,chr3,R,193274788,193378824,92393685,104036,354828271,25560,29
347689,SOX2-OT,chr3,F,181056679,181742228,93079234,685549,355513820,25561,9
347736,NME9,chr3,R,138261436,138330149,93147947,68713,355582533,25562,15
348793,WDR53,chr3,R,196554182,196568610,93162375,14428,355596961,25563,4
348801,LNP1,chr3,F,100401192,100456326,93217509,55134,355652095,25564,3
348807,CCDC37,chr3,F,126394892,126436556,93259173,41664,355693759,25565,20
348808,NPHP3-AS1,chr3,F,132722341,132874206,93411038,151865,355845624,25566,10
348825,TPRXL,chr3,F,13937306,14065984,93539716,128678,355974302,25567,2
348840,ANKRD18DP,chr3,R,198057530,198080671,93562857,23141,355997443,25568,9
349565,NMNAT3,chr3,R,139560179,139678043,93680721,117864,356115307,25569,10
353274,ZNF445,chr3,R,44439769,44477670,93718622,37901,356153208,25570,8
353324,SPATA12,chr3,F,57060440,57076068,93734250,15628,356168836,25571,2
375323,LHFPL4,chr3,R,9498360,9553802,93789692,55442,356224278,25572,3
375337,TOPAZ1,chr3,F,44241885,44336610,93884417,94725,356319003,25573,20
375341,C3orf62,chr3,R,49268596,49277075,93892896,8479,356327482,25574,2
375346,TMEM110,chr3,R,52836755,52897581,93953722,60826,356388308,25575,9
375387,NRROS,chr3,F,196639695,196662004,93976031,22309,356410617,25576,2
377047,PRSS45,chr3,R,46742090,46744755,93978696,2665,356413282,25577,3
386724,AMIGO3,chr3,R,49716833,49719805,93981668,2972,356416254,25578,0
389114,ZNF662,chr3,F,42905909,42919333,93995092,13424,356429678,25579,4
389118,CDHR4,chr3,R,49790731,49803164,94007525,12433,356442111,25580,22
389119,FAM212A,chr3,F,49803232,49805033,94009326,1801,356443912,25581,1
389123,IQCF2,chr3,F,51861628,51863424,94011122,1796,356445708,25582,2
389124,IQCF5,chr3,R,51873720,51875584,94012986,1864,356447572,25583,2
389125,MUSTN1,chr3,R,52833114,52835219,94015091,2105,356449677,25584,2
389136,VGLL3,chr3,R,86937972,86991287,94068406,53315,356502992,25585,4
389151,PRR23B,chr3,R,139019030,139020926,94070302,1896,356504888,25586,0
389152,PRR23C,chr3,R,139042101,139044892,94073093,2791,356507679,25587,0
389158,PLSCR5,chr3,R,146576607,146606216,94102702,29609,356537288,25588,8
389161,ANKUB1,chr3,R,149760647,149792843,94134898,32196,356569484,25589,5
389170,LEKR1,chr3,F,156826306,157047659,94356251,221353,356790837,25590,20
389177,TMEM212,chr3,F,171843348,171867846,94380749,24498,356815335,25591,6
391518,VENTXP7,chr3,F,21405725,21406708,94381732,983,356816318,25592,0
401052,LOC401052,chr3,R,10006417,10011095,94386410,4678,356820996,25593,3
401067,IQCF3,chr3,F,51826882,51830858,94390386,3976,356824972,25594,6
401074,LINC00960,chr3,F,75672280,75679303,94397409,7023,356831995,25595,5
401081,FLJ22763,chr3,F,109136713,109150109,94410805,13396,356845391,25596,2
401082,LINC01205,chr3,F,109409989,109495167,94495983,85178,356930569,25597,4
401089,FOXL2NB,chr3,F,138947233,138953990,94502740,6757,356937326,25598,3
401093,MBNL1-AS1,chr3,R,152262615,152269626,94509751,7011,356944337,25599,1
401097,C3orf80,chr3,F,160223783,160290143,94576111,66360,357010697,25600,3
401103,FLJ46066,chr3,R,182446969,182486362,94615504,39393,357050090,25601,3
401105,FLJ42393,chr3,F,188178542,188180808,94617770,2266,357052356,25602,0
401106,LINC00884,chr3,F,194487139,194488545,94619176,1406,357053762,25603,1
401109,LINC00885,chr3,F,196142635,196160890,94637431,18255,357072017,25604,2
402135,OR5K2,chr3,F,98497680,98498631,94638382,951,357072968,25605,0
403273,OR5H14,chr3,F,98148717,98150399,94640064,1682,357074650,25606,1
403274,OR5H15,chr3,F,98168699,98169641,94641006,942,357075592,25607,0
403277,OR5K3,chr3,F,98390665,98391631,94641972,966,357076558,25608,0
403278,OR5K4,chr3,F,98353853,98354819,94642938,966,357077524,25609,0
406890,MIRLET7G,chr3,R,52268277,52268361,94643022,84,357077608,25610,0
406916,MIR128-2,chr3,F,35744475,35744559,94643106,84,357077692,25611,0
406925,MIR135A1,chr3,R,52294218,52294308,94643196,90,357077782,25612,0
406929,MIR138-1,chr3,F,44114211,44114310,94643295,99,357077881,25613,0
406949,MIR15B,chr3,F,160404587,160404685,94643393,98,357077979,25614,0
406951,MIR16-2,chr3,F,160404744,160404825,94643474,81,357078060,25615,0
406966,MIR191,chr3,R,49020617,49020709,94643566,92,357078152,25616,0
406975,MIR198,chr3,R,120395667,120395729,94643628,62,357078214,25617,0
407015,MIR26A1,chr3,F,37969403,37969480,94643705,77,357078291,25618,0
407020,MIR28,chr3,F,188688780,188688866,94643791,86,357078377,25619,0
407738,FAM19A1,chr3,F,67991591,68545621,95197821,554030,357632407,25620,5
415117,STX19,chr3,R,94014364,94028776,95212233,14412,357646819,25621,2
440944,THUMPD3-AS1,chr3,R,9388852,9397490,95220871,8638,357655457,25622,2
440952,EIF1B-AS1,chr3,R,40173144,40309698,95357425,136554,357792011,25623,2
440955,TMEM89,chr3,R,48620841,48621756,95358340,915,357792926,25624,1
440956,IQCF6,chr3,R,51778560,51779773,95359553,1213,357794139,25625,2
440957,SMIM4,chr3,F,52535985,52540570,95364138,4585,357798724,25626,2
440970,LINC00971,chr3,R,84638404,84869575,95595309,231171,358029895,25627,20
440982,LOC440982,chr3,F,147421326,147509910,95683893,88584,358118479,25628,2
440993,LINC00969,chr3,F,195688497,195711875,95707271,23378,358141857,25629,4
442075,EMC3-AS1,chr3,F,9986892,10007004,95727383,20112,358161969,25630,2
494337,MIR425,chr3,R,49020147,49020234,95727470,87,358162056,25631,0
503582,ARGFX,chr3,F,121562302,121590622,95755790,28320,358190376,25632,5
574040,SNORA6,chr3,F,39408390,39408539,95755939,149,358190525,25633,0
619563,SNORA7A,chr3,R,12840311,12840450,95756078,139,358190664,25634,0
619567,SNORD2,chr3,F,186784795,186784865,95756148,70,358190734,25635,0
619568,SNORA4,chr3,F,186787612,186787749,95756285,137,358190871,25636,0
643853,TMPPE,chr3,R,33090415,33096801,95762671,6386,358197257,25637,1
644444,TMEM30C,chr3,F,100185823,100194186,95771034,8363,358205620,25638,2
644714,LIMD1-AS1,chr3,R,45678164,45688882,95781752,10718,358216338,25639,2
644974,ALG1L2,chr3,F,130081830,130098467,95798389,16637,358232975,25640,7
644990,THRB-AS1,chr3,F,24494086,24500011,95804314,5925,358238900,25641,1
645206,LINC00693,chr3,F,28575277,28758337,95987374,183060,358421960,25642,4
645840,TXNRD3NB,chr3,R,126571778,126608555,96024151,36777,358458737,25643,3
645843,TMEM14E,chr3,R,152339697,152340990,96025444,1293,358460030,25644,0
646168,LINC01330,chr3,F,167895947,167924011,96053508,28064,358488094,25645,7
646300,COL6A4P2,chr3,F,130212819,130273806,96114495,60987,358549081,25646,22
646424,SPINK8,chr3,R,48306845,48328341,96135991,21496,358570577,25647,4
646450,ARIH2OS,chr3,R,48917787,48919385,96137589,1598,358572175,25648,0
646498,C3orf84,chr3,R,49177538,49192181,96152232,14643,358586818,25649,4
646600,IGF2BP2-AS1,chr3,F,185713251,185729787,96168768,16536,358603354,25650,7
646730,LOC646730,chr3,F,141660343,141730357,96238782,70014,358673368,25651,10
646903,LOC646903,chr3,F,149971278,149973242,96240746,1964,358675332,25652,0
647033,PA2G4P4,chr3,R,156809270,156812021,96243497,2751,358678083,25653,0
647107,LINC01192,chr3,R,163177242,163303301,96369556,126059,358804142,25654,6
647265,CYP2AB1P,chr3,R,183895164,183908547,96382939,13383,358817525,25655,6
647309,GMNC,chr3,R,190843267,190862743,96402415,19476,358837001,25656,6
647323,LOC647323,chr3,R,193957371,194003659,96448703,46288,358883289,25657,2
653659,TMEM183B,chr3,R,149981660,149983366,96450409,1706,358884995,25658,0
653712,LOC653712,chr3,R,128861507,128871541,96460443,10034,358895029,25659,4
654502,IQCJ,chr3,F,159069251,159266307,96657499,197056,359092085,25660,4
677767,SCARNA7,chr3,R,160514906,160515236,96657829,330,359092415,25661,0
677779,LINC00488,chr3,F,109178164,109185261,96664926,7097,359099512,25662,2
677797,SNORA7B,chr3,R,129397209,129397348,96665065,139,359099651,25663,0
677836,SNORA58,chr3,R,131478997,131479233,96665301,236,359099887,25664,0
677847,SNORA81,chr3,F,186786674,186786852,96665479,178,359100065,25665,0
692089,SNORD19,chr3,F,52689239,52689315,96665555,76,359100141,25666,0
692099,FAM86DP,chr3,R,75421551,75435115,96679119,13564,359113705,25667,7
692107,SNORD66,chr3,F,184325695,184325771,96679195,76,359113781,25668,0
692109,SNORD69,chr3,F,52692735,52692812,96679272,77,359113858,25669,0
693136,MIR551B,chr3,F,168551853,168551949,96679368,96,359113954,25670,0
693148,MIR563,chr3,F,15873770,15873849,96679447,79,359114033,25671,0
693149,MIR564,chr3,F,44861887,44861981,96679541,94,359114127,25672,0
693151,MIR566,chr3,F,50173325,50173419,96679635,94,359114221,25673,0
693152,MIR567,chr3,F,112112800,112112898,96679733,98,359114319,25674,0
693153,MIR568,chr3,R,114316474,114316569,96679828,95,359114414,25675,0
693154,MIR569,chr3,R,171106663,171106759,96679924,96,359114510,25676,0
693155,MIR570,chr3,F,195699400,195699497,96680021,97,359114607,25677,0
727936,GXYLT2,chr3,F,72848521,72975374,96806874,126853,359241460,25678,8
727956,SDHAP2,chr3,F,195658038,195688871,96837707,30833,359272293,25679,14
727978,LOC727978,chr3,F,195935612,195942008,96844103,6396,359278689,25680,1
728262,FAM157A,chr3,F,198151973,198211810,96903940,59837,359338526,25681,10
728290,LOC728290,chr3,F,80993833,81095425,97005532,101592,359440118,25682,2
729083,LOC729083,chr3,F,42770611,42773635,97008556,3024,359443142,25683,1
729085,FAM198A,chr3,F,42979266,43057715,97087005,78449,359521591,25684,4
729230,CCR2,chr3,F,46353743,46360940,97094202,7197,359528788,25685,2
729375,FAM86HP,chr3,R,130097781,130111433,97107854,13652,359542440,25686,4
729627,PRR23A,chr3,R,139003961,139006268,97110161,2307,359544747,25687,0
730091,LINC00886,chr3,R,156747342,156817062,97179881,69720,359614467,25688,2
730109,LINC01100,chr3,F,160020648,160031423,97190656,10775,359625242,25689,2
790952,ESRG,chr3,R,54632123,54639857,97198390,7734,359632976,25690,3
100009676,ZBTB11-AS1,chr3,F,101676429,101679217,97201178,2788,359635764,25691,0
100113381,SNORD19B,chr3,F,52690737,52690830,97201271,93,359635857,25692,0
100125556,FAM86JP,chr3,F,125916600,125930024,97214695,13424,359649281,25693,4
100126321,MIR922,chr3,R,197674495,197674576,97214776,81,359649362,25694,0
100126334,MIR885,chr3,R,10394488,10394562,97214850,74,359649436,25695,0
100126340,MIR944,chr3,F,189829921,189830009,97214938,88,359649524,25696,0
100126791,EGOT,chr3,R,4749191,4751590,97217337,2399,359651923,25697,1
100126793,GHRLOS,chr3,F,10280951,10293449,97229835,12498,359664421,25698,6
100128023,DPPA2P3,chr3,R,193993092,193994238,97230981,1146,359665567,25699,0
100128025,WWTR1-AS1,chr3,F,149658209,149661364,97234136,3155,359668722,25700,2
100128164,LOC100128164,chr3,R,169943983,169966734,97256887,22751,359691473,25701,2
100128378,LINC00696,chr3,R,52062093,52065112,97259906,3019,359694492,25702,0
100128640,ACVR2B-AS1,chr3,R,38451026,38454820,97263700,3794,359698286,25703,1
100129354,NRADDP,chr3,F,47011541,47013467,97265626,1926,359700212,25704,3
100129480,MKRN2OS,chr3,R,12539716,12561056,97286966,21340,359721552,25705,5
100129516,LOC100129516,chr3,R,197506186,197506747,97287527,561,359722113,25706,0
100129550,LOC100129550,chr3,F,122886512,122892416,97293431,5904,359728017,25707,0
100130207,LOC100130207,chr3,R,3684803,3827421,97436049,142618,359870635,25708,7
100130345,LOC100130345,chr3,R,63749815,63785022,97471256,35207,359905842,25709,6
100130701,LOC100130701,chr3,F,120366538,120384909,97489627,18371,359924213,25710,3
100131117,ZBTB20-AS1,chr3,F,114351810,114388978,97526795,37168,359961381,25711,8
100131551,LINC00887,chr3,R,194301198,194312804,97538401,11606,359972987,25712,2
100131635,LOC100131635,chr3,F,187702365,187732415,97568451,30050,360003037,25713,2
100131827,ZNF717,chr3,R,75716444,75785583,97637590,69139,360072176,25714,9
100132146,LOC100132146,chr3,F,46612434,46626543,97651699,14109,360086285,25715,2
100132526,FGD5P1,chr3,F,13933055,13936944,97655588,3889,360090174,25716,1
100132677,BSN-AS2,chr3,R,49549305,49554366,97660649,5061,360095235,25717,2
100170222,SNAR-I,chr3,F,190877929,190878050,97660770,121,360095356,25718,0
100187716,MIR1224,chr3,F,184241404,184241489,97660855,85,360095441,25719,0
100189103,TRR-ACG2-1,chr3,R,45688998,45689071,97660928,73,360095514,25720,0
100189179,TRC-GCA6-1,chr3,R,132229099,132229171,97661000,72,360095586,25721,0
100189250,TRC-GCA9-1,chr3,R,132231797,132231869,97661072,72,360095658,25722,0
100189318,TRV-AAC1-1,chr3,F,169772229,169772302,97661145,73,360095731,25723,0
100287227,TIPARP-AS1,chr3,R,156673170,156675713,97663688,2543,360098274,25724,0
100287290,LOC100287290,chr3,F,158732440,158784039,97715287,51599,360149873,25725,12
100287362,PRSS46,chr3,R,46719582,46736431,97732136,16849,360166722,25726,3
100287639,MTHFD2P1,chr3,R,95654422,95683193,97760907,28771,360195493,25727,4
100287879,LINC00994,chr3,R,64078360,64087363,97769910,9003,360204496,25728,3
100288428,LMCD1-AS1,chr3,R,8221146,8501658,98050422,280512,360485008,25729,3
100288801,FRG2C,chr3,F,75646782,75667217,98070857,20435,360505443,25730,5
100288831,SRGAP3-AS3,chr3,F,9216894,9219508,98073471,2614,360508057,25731,4
100288960,PRSS43,chr3,R,46753042,46812420,98132849,59378,360567435,25732,6
100289361,LOC100289361,chr3,R,143000844,143001467,98133472,623,360568058,25733,0
100293612,LOC100293612,chr3,R,13647104,13654178,98140546,7074,360575132,25734,1
100302112,MIR1284,chr3,R,71541969,71542089,98140666,120,360575252,25735,0
100302143,MIR1248,chr3,F,186786671,186786777,98140772,106,360575358,25736,0
100302148,MIR1263,chr3,R,164171470,164171556,98140858,86,360575444,25737,0
100302204,MIR548I1,chr3,R,125790403,125790552,98141007,149,360575593,25738,0
100302212,MIR1324,chr3,F,75630762,75630858,98141103,96,360575689,25739,0
100302232,MIR1226,chr3,F,47849554,47849629,98141178,75,360575764,25740,0
100302640,LINC00882,chr3,R,107109789,107240638,98272027,130849,360706613,25741,3
100302742,RNU6-42P,chr3,R,196784979,196785086,98272134,107,360706720,25742,0
100313840,MIR2115,chr3,R,48316359,48316459,98272234,100,360706820,25743,0
100313843,MIR711,chr3,R,48578901,48578977,98272310,76,360706896,25744,0
100422859,MIR3136,chr3,R,69048957,69049035,98272388,78,360706974,25745,0
100422864,MIR544B,chr3,F,124732438,124732516,98272466,78,360707052,25746,0
100422868,MIR4270,chr3,R,15496238,15496308,98272536,70,360707122,25747,0
100422901,MIR3135A,chr3,F,20137564,20137641,98272613,77,360707199,25748,0
100422926,MIR3137,chr3,R,195134505,195134580,98272688,75,360707274,25749,0
100422933,MIR378B,chr3,F,10330228,10330285,98272745,57,360707331,25750,0
100422941,MIR4272,chr3,F,67225463,67225527,98272809,64,360707395,25751,0
100422952,MIR4271,chr3,F,49274119,49274186,98272876,67,360707462,25752,0
100422955,MIR4273,chr3,F,75738279,75738363,98272960,84,360707546,25753,0
100422990,MIR3134,chr3,R,15697297,15697371,98273034,74,360707620,25754,0
100423038,MIR466,chr3,R,31161703,31161787,98273118,84,360707704,25755,0
100498859,LINC00881,chr3,F,157089880,157101135,98284373,11255,360718959,25756,2
100500803,MIR3919,chr3,F,159282645,159282734,98284462,89,360719048,25757,0
100500859,MIR3921,chr3,R,99964313,99964398,98284547,85,360719133,25758,0
100500875,MIR3938,chr3,R,55852491,55852594,98284650,103,360719236,25759,0
100500877,MIR3923,chr3,F,79507886,79507969,98284733,83,360719319,25760,0
100500913,MIR3714,chr3,F,16933195,16933260,98284798,65,360719384,25761,0
100505385,IQCJ-SCHIP1,chr3,F,159069251,159897366,99112913,828115,361547499,25762,8
100505547,LINC01208,chr3,R,176604147,176635532,99144298,31385,361578884,25763,2
100505566,LINC00578,chr3,F,177441920,177752704,99455082,310784,361889668,25764,3
100505609,LOC100505609,chr3,F,180414172,180422493,99463403,8321,361897989,25765,1
100505641,FGD5-AS1,chr3,R,14942778,14948441,99469066,5663,361903652,25766,3
100505687,LINC00888,chr3,F,183447607,183456013,99477472,8406,361912058,25767,3
100505696,SH3BP5-AS1,chr3,F,15254183,15264498,99487787,10315,361922373,25768,2
100505877,UBE2E2-AS1,chr3,R,23195069,23203045,99495763,7976,361930349,25769,2
100505920,LOC100505920,chr3,R,194203015,194250153,99542901,47138,361977487,25770,3
100506243,KRBOX1,chr3,F,42936341,42942792,99549352,6451,361983938,25771,4
100506275,KRBOX1-AS1,chr3,R,42934243,42936785,99551894,2542,361986480,25772,1
100506319,LOC100506319,chr3,F,44424140,44429529,99557283,5389,361991869,25773,4
100506555,PVRL3-AS1,chr3,R,111045314,111069959,99581928,24645,362016514,25774,3
100506621,LINC01279,chr3,R,112596793,112601969,99587104,5176,362021690,25775,0
100506637,PRKAR2A-AS1,chr3,F,48847936,48851982,99591150,4046,362025736,25776,1
100506724,LINC00901,chr3,F,116921430,116932238,99601958,10808,362036544,25777,1
100506765,IGSF11-AS1,chr3,F,118943075,118948241,99607124,5166,362041710,25778,3
100506826,MYLK-AS1,chr3,F,123585512,123630821,99652433,45309,362087019,25779,2
100506840,IQCF4,chr3,F,51817602,51819635,99654466,2033,362089052,25780,3
100506907,CCDC37-AS1,chr3,R,126393031,126394798,99656233,1767,362090819,25781,2
100506944,LOC100506944,chr3,F,88338294,88468050,99785989,129756,362220575,25782,8
100506994,PTPRG-AS1,chr3,R,62261818,62318947,99843118,57129,362277704,25783,5
100507032,TMCC1-AS1,chr3,F,129893870,129908912,99858160,15042,362292746,25784,2
100507057,MFI2-AS1,chr3,F,197002905,197004744,99859999,1839,362294585,25785,3
100507062,PSMD6-AS2,chr3,F,64004021,64012243,99868221,8222,362302807,25786,2
100507086,DLG1-AS1,chr3,F,197298246,197303751,99873726,5505,362308312,25787,2
100507098,ADAMTS9-AS2,chr3,F,64684869,65011468,100200325,326599,362634911,25788,5
100507210,LOC100507210,chr3,R,134055252,134057734,100202807,2482,362637393,25789,1
100507274,LINC01210,chr3,F,137771910,137780878,100211775,8968,362646361,25790,4
100507291,LOC100507291,chr3,F,139389802,139583319,100405292,193517,362839878,25791,5
100507297,TMEM44-AS1,chr3,F,194584267,194590832,100411857,6565,362846443,25792,3
100507389,LOC100507389,chr3,F,142926674,142942536,100427719,15862,362862305,25793,4
100507391,LOC100507391,chr3,F,194708420,194782168,100501467,73748,362936053,25794,3
100507461,LOC100507461,chr3,F,148078126,148088029,100511370,9903,362945956,25795,1
100507524,ARHGEF26-AS1,chr3,R,154024400,154121210,100608180,96810,363042766,25796,3
100507537,LOC100507537,chr3,R,155290231,155293700,100611649,3469,363046235,25797,2
100507582,BHLHE40-AS1,chr3,R,4896808,4979961,100694802,83153,363129388,25798,4
100507661,LOC100507661,chr3,F,168901944,168921996,100714854,20052,363149440,25799,4
100526693,ARPC4-TTLL3,chr3,F,9792547,9836356,100758663,43809,363193249,25800,11
100526760,ABHD14A-ACY1,chr3,F,51975025,51989202,100772840,14177,363207426,25801,14
100526772,TMEM110-MUSTN1,chr3,R,52833114,52897581,100837307,64467,363271893,25802,9
100532724,NPHP3-ACAD11,chr3,R,132558137,132722459,101001629,164322,363436215,25803,26
100534599,ISY1-RAB43,chr3,R,129087568,129161230,101075291,73662,363509877,25804,12
100534611,TM4SF19-TCTEX1D2,chr3,R,196316084,196338420,101097627,22336,363532213,25805,4
100616112,MIR4793,chr3,R,48644193,48644280,101097714,87,363532300,25806,0
100616127,MIR4448,chr3,F,183886799,183886885,101097800,86,363532386,25807,0
100616129,MIR4445,chr3,F,109602827,109602897,101097870,70,363532456,25808,0
100616138,MIR4787,chr3,F,50675079,50675163,101097954,84,363532540,25809,0
100616161,MIR4795,chr3,R,87226188,87226277,101098043,89,363532629,25810,0
100616166,MIR4796,chr3,R,114743444,114743525,101098124,81,363532710,25811,0
100616216,MIR4797,chr3,R,197293877,197293948,101098195,71,363532781,25812,0
100616281,MIR4788,chr3,F,134437826,134437906,101098275,80,363532861,25813,0
100616291,MIR4791,chr3,R,19314847,19314931,101098359,84,363532945,25814,0
100616334,MIR4790,chr3,R,5250176,5250255,101098438,79,363533024,25815,0
100616336,MIR548AB,chr3,R,103524032,103524116,101098522,84,363533108,25816,0
100616395,MIR4789,chr3,F,175369539,175369621,101098604,82,363533190,25817,0
100616407,MIR4443,chr3,F,48196563,48196616,101098657,53,363533243,25818,0
100616448,MIR4792,chr3,R,24521361,24521435,101098731,74,363533317,25819,0
100616476,MIR4446,chr3,F,113594875,113594942,101098798,67,363533384,25820,0
100616477,MIR4442,chr3,R,25664872,25664939,101098865,67,363533451,25821,0
100616485,MIR4447,chr3,R,116850276,116850367,101098956,91,363533542,25822,0
100652759,PRICKLE2-AS1,chr3,F,64067963,64103131,101134124,35168,363568710,25823,2
100652807,LOC100652807,chr3,R,28575590,28576491,101135025,901,363569611,25824,0
100775107,RBM5-AS1,chr3,R,50099602,50100988,101136411,1386,363570997,25825,0
100820709,LINC00501,chr3,F,177294441,177323435,101165405,28994,363599991,25826,1
100846978,LINC00506,chr3,F,87089279,87157069,101233195,67790,363667781,25827,3
100846999,MIR4444-2,chr3,F,75214475,75214549,101233269,74,363667855,25828,0
100847021,MIR5002,chr3,F,124132928,124133025,101233366,97,363667952,25829,0
100847036,MIR5186,chr3,R,151565875,151565995,101233486,120,363668072,25830,0
100847039,MIR5092,chr3,R,125151464,125151552,101233574,88,363668160,25831,0
100847040,MIR5704,chr3,R,131985854,131985931,101233651,77,363668237,25832,0
100847043,MIR5682,chr3,F,121049639,121049715,101233727,76,363668313,25833,0
100847054,MIR5588,chr3,R,185253209,185253272,101233790,63,363668376,25834,0
100847077,MIR5688,chr3,F,85385709,85385792,101233873,83,363668459,25835,0
100847078,MIR548AQ,chr3,R,185767846,185767904,101233931,58,363668517,25836,0
100847079,MIR5193,chr3,R,49806136,49806245,101234040,109,363668626,25837,0
100862662,ALDH1L1-AS2,chr3,F,126180064,126210169,101264145,30105,363698731,25838,1
100862679,NAALADL2-AS3,chr3,R,175079311,175115242,101300076,35931,363734662,25839,3
100873741,RNU6-26P,chr3,R,98804977,98805084,101300183,107,363734769,25840,0
100873917,LPP-AS1,chr3,R,188562236,188568666,101306613,6430,363741199,25841,1
100873937,GRM7-AS1,chr3,R,7519740,7535284,101322157,15544,363756743,25842,2
100873940,MYLK-AS2,chr3,F,123689643,123692407,101324921,2764,363759507,25843,2
100873941,OPA1-AS1,chr3,R,193618598,193627332,101333655,8734,363768241,25844,2
100873945,HLTF-AS1,chr3,F,149086331,149102823,101350147,16492,363784733,25845,2
100873947,LMLN-AS1,chr3,R,198038320,198039467,101351294,1147,363785880,25846,3
100873954,SNRK-AS1,chr3,R,43346918,43351962,101356338,5044,363790924,25847,2
100873975,CNTN4-AS1,chr3,R,3039660,3061145,101377823,21485,363812409,25848,3
100873976,CNTN4-AS2,chr3,R,2110408,2144241,101411656,33833,363846242,25849,2
100873977,RBMS3-AS1,chr3,R,29926810,29934156,101419002,7346,363853588,25850,2
100873978,RBMS3-AS2,chr3,R,29615150,29643080,101446932,27930,363881518,25851,2
100873979,RBMS3-AS3,chr3,R,29264193,29280939,101463678,16746,363898264,25852,2
100873982,ABCC5-AS1,chr3,F,184006337,184011419,101468760,5082,363903346,25853,2
100873983,MAGI1-AS1,chr3,F,65893815,65925297,101500242,31482,363934828,25854,2
100873986,FGF12-AS1,chr3,F,192238629,192283097,101544710,44468,363979296,25855,4
100873988,FGF12-AS3,chr3,F,192514843,192521899,101551766,7056,363986352,25856,2
100873993,ITIH4-AS1,chr3,F,52823934,52825314,101553146,1380,363987732,25857,2
100874007,VIPR1-AS1,chr3,R,42530895,42532606,101554857,1711,363989443,25858,2
100874010,NLGN1-AS1,chr3,R,173910497,173920796,101565156,10299,363999742,25859,3
100874016,SYNPR-AS1,chr3,R,63423595,63550051,101691612,126456,364126198,25860,4
100874019,KLHL6-AS1,chr3,F,183548734,183552326,101695204,3592,364129790,25861,1
100874027,TPRG1-AS2,chr3,R,189238685,189240594,101697113,1909,364131699,25862,2
100874028,SGOL1-AS1,chr3,F,20174243,20186427,101709297,12184,364143883,25863,2
100874029,CFAP44-AS1,chr3,F,113403997,113433992,101739292,29995,364173878,25864,5
100874032,PRRT3-AS1,chr3,F,9947403,9954787,101746676,7384,364181262,25865,3
100874035,PLCH1-AS1,chr3,F,155449184,155457753,101755245,8569,364189831,25866,1
100874036,PLCH1-AS2,chr3,F,155485716,155487121,101756650,1405,364191236,25867,1
100874037,CADM2-AS2,chr3,R,85799986,85828050,101784714,28064,364219300,25868,3
100874038,CADM2-AS1,chr3,R,85992182,86028007,101820539,35825,364255125,25869,1
100874039,THOC7-AS1,chr3,F,63860644,63861819,101821714,1175,364256300,25870,1
100874043,TPRG1-AS1,chr3,R,188941714,188947639,101827639,5925,364262225,25871,1
100874083,KCNAB1-AS2,chr3,R,156215559,156227883,101839963,12324,364274549,25872,3
100874084,KCNAB1-AS1,chr3,R,156441156,156446905,101845712,5749,364280298,25873,2
100874089,RUVBL1-AS1,chr3,F,128075809,128079056,101848959,3247,364283545,25874,1
100874090,SLC6A1-AS1,chr3,R,11006097,11019224,101862086,13127,364296672,25875,2
100874091,TM4SF1-AS1,chr3,F,149377777,149386583,101870892,8806,364305478,25876,2
100874092,UBE2E1-AS1,chr3,R,23804023,23806905,101873774,2882,364308360,25877,1
100874094,ZNF197-AS1,chr3,R,44617127,44624797,101881444,7670,364316030,25878,1
100874095,ADIPOQ-AS1,chr3,R,186851885,186856123,101885682,4238,364320268,25879,2
100874101,HDAC11-AS1,chr3,R,13476986,13480053,101888749,3067,364323335,25880,1
100874110,GLYCTK-AS1,chr3,R,52288579,52289733,101889903,1154,364324489,25881,0
100874114,CCDC13-AS1,chr3,F,42732574,42745158,101902487,12584,364337073,25882,3
100874115,PLCXD2-AS1,chr3,R,111676265,111677433,101903655,1168,364338241,25883,1
100874131,ZBTB20-AS4,chr3,F,115100422,115103061,101906294,2639,364340880,25884,1
100874200,ARHGEF3-AS1,chr3,F,56940039,56960854,101927109,20815,364361695,25885,2
100874201,B4GALT4-AS1,chr3,F,119226485,119235141,101935765,8656,364370351,25886,2
100874204,ALDH1L1-AS1,chr3,F,126103639,126108069,101940195,4430,364374781,25887,3
100874206,OSBPL10-AS1,chr3,F,31704212,31721586,101957569,17374,364392155,25888,4
100874207,ST3GAL6-AS1,chr3,R,98714332,98732651,101975888,18319,364410474,25889,4
100874214,TM4SF19-AS1,chr3,F,196318331,196325570,101983127,7239,364417713,25890,2
100874216,ZNF385D-AS1,chr3,F,21542788,21579959,102020298,37171,364454884,25891,2
100874218,ATP13A5-AS1,chr3,F,193307243,193314521,102027576,7278,364462162,25892,1
100874219,TMEM212-AS1,chr3,R,171876351,171900740,102051965,24389,364486551,25893,2
100874221,ZNF385D-AS2,chr3,F,21957138,21979828,102074655,22690,364509241,25894,3
100874237,CACNA2D3-AS1,chr3,R,54874604,54901255,102101306,26651,364535892,25895,6
100874242,PRICKLE2-AS2,chr3,F,64103469,64106358,102104195,2889,364538781,25896,3
100874243,PRICKLE2-AS3,chr3,F,64187543,64201561,102118213,14018,364552799,25897,3
100874244,NAALADL2-AS2,chr3,R,175235091,175271096,102154218,36005,364588804,25898,2
100874245,NAALADL2-AS1,chr3,R,175773577,175776333,102156974,2756,364591560,25899,2
100874246,ARHGAP31-AS1,chr3,R,119314292,119322760,102165442,8468,364600028,25900,1
100874325,ATP2B2-IT2,chr3,R,10626014,10626807,102166235,793,364600821,25901,1
100874330,LINC01014,chr3,F,178419200,178457305,102204340,38105,364638926,25902,2
100874433,IQCJ-SCHIP1-AS1,chr3,R,159765381,159768612,102207571,3231,364642157,25903,2
100874528,XXYLT1-AS1,chr3,F,195094587,195096057,102209041,1470,364643627,25904,3
100885795,LARS2-AS1,chr3,R,45482694,45509545,102235892,26851,364670478,25905,3
100885796,SLC9A9-AS1,chr3,F,143342245,143347071,102240718,4826,364675304,25906,3
100996447,LOC100996447,chr3,R,158545219,158571066,102266565,25847,364701151,25907,4
100996490,LINC01206,chr3,F,181952363,182010678,102324880,58315,364759466,25908,7
100996539,ITPR1-AS1,chr3,R,4490316,4493163,102327727,2847,364762313,25909,1
100996597,LINC00690,chr3,F,16536317,16541373,102332783,5056,364767369,25910,2
100996624,LOC100996624,chr3,R,27830887,27834136,102336032,3249,364770618,25911,1
101060195,LOC101060195,chr3,R,48290278,48291375,102337129,1097,364771715,25912,0
101243545,LOC101243545,chr3,F,161426426,161448242,102358945,21816,364793531,25913,3
101410543,XXYLT1-AS2,chr3,F,195147870,195152856,102363931,4986,364798517,25914,1
101926886,LOC101926886,chr3,F,115147621,115334252,102550562,186631,364985148,25915,8
101926903,LSAMP-AS1,chr3,F,116360023,116370085,102560624,10062,364995210,25916,3
101926923,LOC101926923,chr3,F,197333687,197341152,102568089,7465,365002675,25917,3
101926953,LOC101926953,chr3,F,117719899,117793622,102641812,73723,365076398,25918,12
101926968,LOC101926968,chr3,F,118641767,118644157,102644202,2390,365078788,25919,2
101926983,LOC101926983,chr3,R,120812180,120836386,102668408,24206,365102994,25920,1
101927010,LOC101927010,chr3,F,121988416,121990450,102670442,2034,365105028,25921,1
101927056,LOC101927056,chr3,R,125827236,125886077,102729283,58841,365163869,25922,4
101927097,LOC101927097,chr3,F,198222626,198233940,102740597,11314,365175183,25923,3
101927111,SUCLG2-AS1,chr3,F,67654696,67947713,103033614,293017,365468200,25924,7
101927123,LOC101927123,chr3,R,127322306,127390670,103101978,68364,365536564,25925,4
101927149,LINC01471,chr3,R,127497600,127537780,103142158,40180,365576744,25926,6
101927152,LINC01212,chr3,F,69999743,70015301,103157716,15558,365592302,25927,3
101927167,GATA2-AS1,chr3,F,128489202,128503207,103171721,14005,365606307,25928,2
101927174,LOC101927174,chr3,R,112165,163349,103222905,51184,365657491,25929,6
101927193,CHL1-AS1,chr3,R,363372,385795,103245328,22423,365679914,25930,2
101927215,LINC01266,chr3,F,592104,846015,103499239,253911,365933825,25931,3
101927225,LOC101927225,chr3,R,72682359,72693241,103510121,10882,365944707,25932,4
101927249,PDZRN3-AS1,chr3,F,73623567,73627899,103514453,4332,365949039,25933,1
101927296,LOC101927296,chr3,F,73521321,73569774,103562906,48453,365997492,25934,1
101927321,LOC101927321,chr3,F,73406211,73421024,103577719,14813,366012305,25935,2
101927346,LOC101927346,chr3,F,73999804,74005609,103583524,5805,366018110,25936,1
101927347,GRM7-AS3,chr3,R,6632357,6805449,103756616,173092,366191202,25937,5
101927374,LOC101927374,chr3,F,79411726,79435227,103780117,23501,366214703,25938,2
101927394,LOC101927394,chr3,R,7952804,8016307,103843620,63503,366278206,25939,3
101927416,LOC101927416,chr3,F,9192492,9194453,103845581,1961,366280167,25940,2
101927432,LOC101927432,chr3,R,133333576,133386339,103898344,52763,366332930,25941,10
101927439,LOC101927439,chr3,F,83218093,83273324,103953575,55231,366388161,25942,3
101927440,LOC101927440,chr3,F,9249723,9257604,103961456,7881,366396042,25943,2
101927455,TMEM108-AS1,chr3,R,133246447,133257121,103972130,10674,366406716,25944,2
101927467,LOC101927467,chr3,F,11062293,11099148,104008985,36855,366443571,25945,3
101927494,LOC101927494,chr3,F,86481942,86496996,104024039,15054,366458625,25946,1
101927518,LOC101927518,chr3,F,86659066,86737260,104102233,78194,366536819,25947,4
101927565,LINC01267,chr3,R,14348450,14352568,104106351,4118,366540937,25948,2
101927568,LOC101927568,chr3,F,134595263,134673081,104184169,77818,366618755,25949,5
101927597,NCK1-AS1,chr3,R,136841975,136862063,104204257,20088,366638843,25950,3
101927647,LOC101927647,chr3,F,15739387,15766274,104231144,26887,366665730,25951,4
101927777,SATB1-AS1,chr3,F,18445236,18530114,104316022,84878,366750608,25952,6
101927805,LOC101927805,chr3,F,18585385,18607187,104337824,21802,366772410,25953,4
101927808,CLSTN2-AS1,chr3,R,140505617,140508789,104340996,3172,366775582,25954,1
101927829,LOC101927829,chr3,F,20342467,20350928,104349457,8461,366784043,25955,4
101927832,PAQR9-AS1,chr3,F,142964057,143001090,104386490,37033,366821076,25956,4
101927854,LOC101927854,chr3,F,24151323,24189956,104425123,38633,366859709,25957,3
101927866,LOC101927866,chr3,F,146921962,146925218,104428379,3256,366862965,25958,1
101927874,LOC101927874,chr3,F,24829343,25120621,104719657,291278,367154243,25959,3
101927942,LOC101927942,chr3,F,149224289,149226353,104721721,2064,367156307,25960,3
101927992,LINC01213,chr3,F,150238518,150240206,104723409,1688,367157995,25961,3
101927995,LOC101927995,chr3,F,30349723,30469224,104842910,119501,367277496,25962,5
101928015,LOC101928015,chr3,F,30518757,30527193,104851346,8436,367285932,25963,2
101928022,LINC01214,chr3,R,150265406,150323747,104909687,58341,367344273,25964,4
101928085,ERICH6-AS1,chr3,F,150703563,150720146,104926270,16583,367360856,25965,4
101928105,LOC101928105,chr3,R,150734470,150738985,104930785,4515,367365371,25966,2
101928114,LOC101928114,chr3,F,34159164,34436072,105207693,276908,367642279,25967,14
101928135,LOC101928135,chr3,R,34875794,35394023,105725922,518229,368160508,25968,3
101928142,AADACL2-AS1,chr3,R,151751178,151928175,105902919,176997,368337505,25969,3
101928153,ITGA9-AS1,chr3,R,37753688,37861780,106011011,108092,368445597,25970,6
101928166,LOC101928166,chr3,R,152157472,152205440,106058979,47968,368493565,25971,2
101928190,LINC01487,chr3,F,155240944,155243124,106061159,2180,368495745,25972,2
101928234,LOC101928234,chr3,R,38156045,38165478,106070592,9433,368505178,25973,5
101928236,LOC101928236,chr3,F,157163565,157381196,106288223,217631,368722809,25974,15
101928263,LOC101928263,chr3,F,39150902,39173071,106310392,22169,368744978,25975,3
101928323,LOC101928323,chr3,R,42612309,42654388,106352471,42079,368787057,25976,2
101928351,LOC101928351,chr3,R,159799100,159824599,106377970,25499,368812556,25977,4
101928376,IL12A-AS1,chr3,R,159913399,160207092,106671663,293693,369106249,25978,9
101928405,LOC101928405,chr3,R,165150005,165158164,106679822,8159,369114408,25979,1
101928529,LOC101928529,chr3,F,44477740,44483900,106685982,6160,369120568,25980,3
101928583,LOC101928583,chr3,F,170656561,170662123,106691544,5562,369126130,25981,1
101928592,LOC101928592,chr3,R,44680776,44685782,106696550,5006,369131136,25982,1
101928636,LOC101928636,chr3,F,45199969,45216773,106713354,16804,369147940,25983,4
101928684,LINC01209,chr3,R,176814154,176817001,106716201,2847,369150787,25984,1
101928711,LOC101928711,chr3,F,177765618,177767316,106717899,1698,369152485,25985,2
101928739,LOC101928739,chr3,R,179101370,179147973,106764502,46603,369199088,25986,2
101928790,LOC101928790,chr3,F,179898193,179921899,106788208,23706,369222794,25987,4
101928814,LOC101928814,chr3,F,48996584,48999783,106791407,3199,369225993,25988,1
101928856,LOC101928856,chr3,R,180456642,180602102,106936867,145460,369371453,25989,11
101928882,LOC101928882,chr3,R,180707588,180870178,107099457,162590,369534043,25990,13
101928931,SEMA3B-AS1,chr3,R,50266640,50267371,107100188,731,369534774,25991,1
101928992,LOC101928992,chr3,R,184756388,184773155,107116955,16767,369551541,25992,2
101928999,IQCF5-AS1,chr3,F,51873595,51875767,107119127,2172,369553713,25993,2
101929018,LOC101929018,chr3,R,185475813,185481259,107124573,5446,369559159,25994,5
101929054,LOC101929054,chr3,F,52239257,52241097,107126413,1840,369560999,25995,1
101929079,LOC101929079,chr3,R,186985752,186992175,107132836,6423,369567422,25996,2
101929106,LOC101929106,chr3,R,187197089,187207629,107143376,10540,369577962,25997,4
101929130,LOC101929130,chr3,F,187291271,187297933,107150038,6662,369584624,25998,1
101929138,LOC101929138,chr3,F,53679284,53681274,107152028,1990,369586614,25999,1
101929152,P3H2-AS1,chr3,F,190120963,190144846,107175911,23883,369610497,26000,3
101929159,LOC101929159,chr3,F,57693067,57696651,107179495,3584,369614081,26001,1
101929198,ATP13A4-AS1,chr3,F,193553212,193555584,107181867,2372,369616453,26002,3
101929238,C3orf67-AS1,chr3,F,58824470,59019093,107376490,194623,369811076,26003,2
101929278,LOC101929278,chr3,R,97287983,97439566,107528073,151583,369962659,26004,15
101929298,LOC101929298,chr3,R,97800804,97821776,107549045,20972,369983631,26005,2
101929316,LOC101929316,chr3,F,64445230,64456070,107559885,10840,369994471,26006,4
101929320,LOC101929320,chr3,R,98235524,98237373,107561734,1849,369996320,26007,2
101929335,ADAMTS9-AS1,chr3,F,64561345,64590084,107590473,28739,370025059,26008,2
101929337,LOC101929337,chr3,F,194247647,194257772,107600598,10125,370035184,26009,3
101929357,HP09053,chr3,R,99816631,99823865,107607832,7234,370042418,26010,2
101929411,LOC101929411,chr3,F,102163637,102164879,107609074,1242,370043660,26011,1
101929433,LOC101929433,chr3,R,65981867,65988356,107615563,6489,370050149,26012,2
101929435,LOC101929435,chr3,F,103098228,103146788,107664123,48560,370098709,26013,3
101929453,LOC101929453,chr3,F,103146805,103152394,107669712,5589,370104298,26014,2
101929485,LOC101929485,chr3,R,106378118,106631881,107923475,253763,370358061,26015,14
101929530,LOC101929530,chr3,F,11870883,11901607,107954199,30724,370388785,26016,14
101929534,LOC101929534,chr3,R,106810640,106838386,107981945,27746,370416531,26017,5
101929579,LOC101929579,chr3,R,107380475,107382159,107983629,1684,370418215,26018,1
101929607,LOC101929607,chr3,F,107430929,107463912,108016612,32983,370451198,26019,2
101929623,LINC01215,chr3,F,108125063,108138610,108030159,13547,370464745,26020,3
101929644,LOC101929644,chr3,R,108652807,108668570,108045922,15763,370480508,26021,2
101929694,LOC101929694,chr3,R,112736448,112749319,108058793,12871,370493379,26022,4
101929697,LOC101929697,chr3,R,195836225,195854303,108076871,18078,370511457,26023,3
101929717,LOC101929717,chr3,R,113142349,113167731,108102253,25382,370536839,26024,3
101929754,LOC101929754,chr3,F,114453592,114520132,108168793,66540,370603379,26025,2
101929769,LINC01063,chr3,R,196631497,196632696,108169992,1199,370604578,26026,1
102060282,RASSF1-AS1,chr3,F,50337510,50338300,108170782,790,370605368,26027,0
102464817,MIR5787,chr3,F,50227435,50227490,108170837,55,370605423,26028,0
102464832,MIR6083,chr3,F,124374331,124374437,108170943,106,370605529,26029,0
102465247,MIR548AY,chr3,R,32506282,32506389,108171050,107,370605636,26030,0
102465494,MIR6823,chr3,R,48549960,48550021,108171111,61,370605697,26031,0
102465495,MIR6824,chr3,R,48633635,48633698,108171174,63,370605760,26032,0
102465496,MIR6826,chr3,F,129272145,129272243,108171272,98,370605858,26033,0
102465497,MIR6828,chr3,F,170423102,170423162,108171332,60,370605918,26034,0
102465526,MIR6872,chr3,F,50273235,50273297,108171394,62,370605980,26035,0
102465536,MIR6890,chr3,R,49099853,49099914,108171455,61,370606041,26036,0
102465667,MIR7110,chr3,F,123161793,123161879,108171541,86,370606127,26037,0
102465857,MIR7976,chr3,R,127587110,127587176,108171607,66,370606193,26038,0
102465858,MIR7977,chr3,F,176515102,176515151,108171656,49,370606242,26039,0
102465864,MIR8060,chr3,F,96359963,96360039,108171732,76,370606318,26040,0
102465866,MIR8064,chr3,R,52846462,52846552,108171822,90,370606408,26041,0
102465977,MIR6829,chr3,R,195882328,195882395,108171889,67,370606475,26042,0
102466199,MIR6825,chr3,R,127575265,127575331,108171955,66,370606541,26043,0
102466253,MIR8076,chr3,R,113432117,113432200,108172038,83,370606624,26044,0
102466743,MIR6822,chr3,F,39138205,39138266,108172099,61,370606685,26045,0
102466744,MIR6827,chr3,R,134367803,134367862,108172158,59,370606744,26046,0
102723364,LOC102723364,chr3,R,86134720,86267390,108304828,132670,370739414,26047,7
102723430,LOC102723430,chr3,F,113157925,113174954,108321857,17029,370756443,26048,4
102723448,LOC102723448,chr3,F,11750,24501,108334608,12751,370769194,26049,3
102723512,LOC102723512,chr3,F,4001908,4028064,108360764,26156,370795350,26050,5
102723582,LOC102723582,chr3,F,122416205,122443247,108387806,27042,370822392,26051,2
102723589,LOC102723589,chr3,R,197577152,197579243,108389897,2091,370824483,26052,1
102723596,LOC102723596,chr3,F,5962731,5985254,108412420,22523,370847006,26053,4
102723597,LOC102723597,chr3,F,123275624,123283983,108420779,8359,370855365,26054,3
102723611,LOC102723611,chr3,F,123384394,123387305,108423690,2911,370858276,26055,4
102723643,LOC102723643,chr3,F,198185964,198189923,108427649,3959,370862235,26056,3
102723663,LOC102723663,chr3,R,11193031,11207321,108441939,14290,370876525,26057,3
102723696,LOC102723696,chr3,R,125908518,125916486,108449907,7968,370884493,26058,5
102723759,LOC102723759,chr3,R,128033394,128052824,108469337,19430,370903923,26059,5
102724019,LOC102724019,chr3,R,135139825,135147801,108477313,7976,370911899,26060,2
102724040,LOC102724040,chr3,F,139583465,139600368,108494216,16903,370928802,26061,2
102724048,LOC102724048,chr3,F,34543795,34563139,108513560,19344,370948146,26062,8
102724068,LOC102724068,chr3,R,140581876,140677957,108609641,96081,371044227,26063,8
102724104,LOC102724104,chr3,F,39232519,39259464,108636586,26945,371071172,26064,2
102724120,LOC102724120,chr3,F,143633875,143657759,108660470,23884,371095056,26065,2
102724145,LOC102724145,chr3,R,147736358,147758678,108682790,22320,371117376,26066,2
102724231,LOC102724231,chr3,R,44421131,44424058,108685717,2927,371120303,26067,1
102724289,LOC102724289,chr3,F,152650368,152737779,108773128,87411,371207714,26068,5
102724297,LOC102724297,chr3,R,46364659,46407059,108815528,42400,371250114,26069,3
102724305,LOC102724305,chr3,R,46468134,46485234,108832628,17100,371267214,26070,3
102724368,CELSR3-AS1,chr3,F,48663767,48669174,108838035,5407,371272621,26071,2
102724419,LOC102724419,chr3,R,164029275,164030685,108839445,1410,371274031,26072,1
102724438,LOC102724438,chr3,F,49899190,49925038,108865293,25848,371299879,26073,6
102724479,LOC102724479,chr3,F,171460553,171469177,108873917,8624,371308503,26074,2
102724535,LOC102724535,chr3,R,51668598,51671097,108876416,2499,371311002,26075,1
102724550,LOC102724550,chr3,F,177816864,177899224,108958776,82360,371393362,26076,2
102724604,LOC102724604,chr3,R,181421162,181442486,108980100,21324,371414686,26077,4
102724617,LOC102724617,chr3,F,182644486,182672846,109008460,28360,371443046,26078,3
102724699,LOC102724699,chr3,R,186810879,186825521,109023102,14642,371457688,26079,3
102724763,LOC102724763,chr3,F,65174976,65193497,109041623,18521,371476209,26080,4
102724808,LOC102724808,chr3,R,193647194,193683261,109077690,36067,371512276,26081,5
102724817,LOC102724817,chr3,F,72614227,72616367,109079830,2140,371514416,26082,2
102724877,LOC102724877,chr3,F,194070144,194123474,109133160,53330,371567746,26083,8
102724949,LOC102724949,chr3,F,76709612,76742522,109166070,32910,371600656,26084,3
103344926,LINCR-0002,chr3,F,191425523,191590356,109330903,164833,371765489,26085,6
103344930,LINC01391,chr3,R,138935188,138944020,109339735,8832,371774321,26086,2
103504735,MIR548BB,chr3,R,60617804,60617870,109339801,66,371774387,26087,0
103695433,LINC01322,chr3,F,165206959,165513728,109646570,306769,372081156,26088,5
104310350,LINC01327,chr3,F,167392795,167408519,109662294,15724,372096880,26089,3
104355289,LINC01324,chr3,R,164714094,164831480,109779680,117386,372214266,26090,3
104413890,ZBTB20-AS3,chr3,F,114873032,114876514,109783162,3482,372217748,26091,2
104502416,FOXP1-AS1,chr3,F,71289757,71305854,109799259,16097,372233845,26092,4
104797538,KCNMB2-AS1,chr3,R,178525466,178860405,110134198,334939,372568784,26093,8
105369194,LOC105369194,chr3,F,123692833,123717192,110158557,24359,372593143,26094,4
105373992,LOC105373992,chr3,F,94648075,94657263,110167745,9188,372602331,26095,2
105373993,LOC105373993,chr3,F,95096795,95152937,110223887,56142,372658473,26096,2
105373994,LOC105373994,chr3,R,97834487,97874588,110263988,40101,372698574,26097,8
105373995,LOC105373995,chr3,R,97717435,97758619,110305172,41184,372739758,26098,4
105373996,LOC105373996,chr3,R,98147978,98167850,110325044,19872,372759630,26099,2
105373997,LOC105373997,chr3,F,98191573,98196523,110329994,4950,372764580,26100,2
105373998,LOC105373998,chr3,R,98184779,98188858,110334073,4079,372768659,26101,2
105373999,LOC105373999,chr3,R,98262771,98314674,110385976,51903,372820562,26102,4
105374000,LOC105374000,chr3,R,98367877,98368256,110386355,379,372820941,26103,1
105374001,LOC105374001,chr3,F,98523073,98526120,110389402,3047,372823988,26104,1
105374002,LOC105374002,chr3,F,98902008,98905343,110392737,3335,372827323,26105,2
105374003,LOC105374003,chr3,F,98981296,98998402,110409843,17106,372844429,26106,2
105374004,LOC105374004,chr3,R,99329837,99337655,110417661,7818,372852247,26107,2
105374005,LOC105374005,chr3,R,99501757,99545753,110461657,43996,372896243,26108,6
105374006,LOC105374006,chr3,F,99506228,99514783,110470212,8555,372904798,26109,2
105374007,LOC105374007,chr3,R,99548906,99597972,110519278,49066,372953864,26110,4
105374008,LOC105374008,chr3,F,99598063,99637261,110558476,39198,372993062,26111,3
105374009,LOC105374009,chr3,R,100120057,100160369,110598788,40312,373033374,26112,6
105374010,LOC105374010,chr3,F,100023271,100033236,110608753,9965,373043339,26113,3
105374011,LOC105374011,chr3,F,99835481,99855814,110629086,20333,373063672,26114,1
105374012,LOC105374012,chr3,F,100765961,100792684,110655809,26723,373090395,26115,2
105374013,LOC105374013,chr3,F,101687197,101709759,110678371,22562,373112957,26116,2
105374014,LOC105374014,chr3,F,101868673,101892579,110702277,23906,373136863,26117,2
105374015,LOC105374015,chr3,R,102573963,102602123,110730437,28160,373165023,26118,4
105374016,LOC105374016,chr3,R,102660878,102710772,110780331,49894,373214917,26119,15
105374017,LOC105374017,chr3,F,102710843,102727620,110797108,16777,373231694,26120,4
105374018,LOC105374018,chr3,R,102899863,102926058,110823303,26195,373257889,26121,5
105374019,LOC105374019,chr3,R,104334238,104336218,110825283,1980,373259869,26122,1
105374020,LOC105374020,chr3,R,104359463,104456585,110922405,97122,373356991,26123,2
105374021,LOC105374021,chr3,R,104522755,104526870,110926520,4115,373361106,26124,3
105374022,LOC105374022,chr3,F,104773115,104806604,110960009,33489,373394595,26125,3
105374023,LOC105374023,chr3,F,104995640,105017986,110982355,22346,373416941,26126,2
105374024,LOC105374024,chr3,R,105872181,105880885,110991059,8704,373425645,26127,3
105374025,LOC105374025,chr3,R,106035474,106060321,111015906,24847,373450492,26128,2
105374026,LOC105374026,chr3,R,106060421,106070156,111025641,9735,373460227,26129,2
105374027,LOC105374027,chr3,F,106176882,106202585,111051344,25703,373485930,26130,3
105374028,LOC105374028,chr3,F,106417754,106428341,111061931,10587,373496517,26131,2
105374029,LOC105374029,chr3,R,106684900,106750844,111127875,65944,373562461,26132,6
105374030,LOC105374030,chr3,R,108088661,108090856,111130070,2195,373564656,26133,1
105374031,LOC105374031,chr3,F,108097991,108122067,111154146,24076,373588732,26134,7
105374032,LOC105374032,chr3,F,108222609,108293706,111225243,71097,373659829,26135,2
105374033,LOC105374033,chr3,R,108713548,108727630,111239325,14082,373673911,26136,3
105374034,LOC105374034,chr3,R,108742489,108748179,111245015,5690,373679601,26137,6
105374035,LOC105374035,chr3,F,109648035,109836157,111433137,188122,373867723,26138,3
105374036,LOC105374036,chr3,F,110447234,110471580,111457483,24346,373892069,26139,3
105374037,LOC105374037,chr3,R,110638486,110667287,111486284,28801,373920870,26140,2
105374038,LOC105374038,chr3,F,111270921,111275718,111491081,4797,373925667,26141,3
105374039,LOC105374039,chr3,F,111306355,111365814,111550540,59459,373985126,26142,2
105374040,LOC105374040,chr3,R,111803810,111861908,111608638,58098,374043224,26143,3
105374041,LOC105374041,chr3,R,112375688,112404394,111637344,28706,374071930,26144,3
105374042,LOC105374042,chr3,F,112301476,112329779,111665647,28303,374100233,26145,3
105374043,LOC105374043,chr3,F,112142793,112200721,111723575,57928,374158161,26146,3
105374044,LOC105374044,chr3,R,112429729,112462050,111755896,32321,374190482,26147,2
105374045,LOC105374045,chr3,R,113263090,113268292,111761098,5202,374195684,26148,1
105374046,LOC105374046,chr3,R,113223636,113241939,111779401,18303,374213987,26149,2
105374047,LOC105374047,chr3,R,113729781,113734132,111783752,4351,374218338,26150,2
105374048,LOC105374048,chr3,F,114001690,114016296,111798358,14606,374232944,26151,3
105374049,LOC105374049,chr3,F,114730203,114745735,111813890,15532,374248476,26152,3
105374050,LOC105374050,chr3,F,114530132,114554889,111838647,24757,374273233,26153,2
105374051,LOC105374051,chr3,F,115437623,115438600,111839624,977,374274210,26154,2
105374052,LOC105374052,chr3,R,116170817,116180516,111849323,9699,374283909,26155,4
105374053,LOC105374053,chr3,F,115870592,115871344,111850075,752,374284661,26156,1
105374054,LOC105374054,chr3,F,117239216,117259548,111870407,20332,374304993,26157,3
105374055,LOC105374055,chr3,F,117358143,117371737,111884001,13594,374318587,26158,2
105374056,LOC105374056,chr3,F,117513085,117539770,111910686,26685,374345272,26159,4
105374057,LOC105374057,chr3,R,117678692,117690978,111922972,12286,374357558,26160,4
105374058,LOC105374058,chr3,F,118488799,118493856,111928029,5057,374362615,26161,2
105374059,LOC105374059,chr3,R,118771420,118773172,111929781,1752,374364367,26162,2
105374060,LOC105374060,chr3,R,118507823,118802454,112224412,294631,374658998,26163,12
105374061,LOC105374061,chr3,R,119399727,119401814,112226499,2087,374661085,26164,1
105374062,LOC105374062,chr3,R,119599212,119606055,112233342,6843,374667928,26165,2
105374063,LOC105374063,chr3,F,119665614,119668565,112236293,2951,374670879,26166,1
105374064,LOC105374064,chr3,R,119699867,119702921,112239347,3054,374673933,26167,2
105374065,LOC105374065,chr3,F,120145694,120185355,112279008,39661,374713594,26168,2
105374066,LOC105374066,chr3,F,120285318,120289196,112282886,3878,374717472,26169,1
105374067,LOC105374067,chr3,R,120438119,120442572,112287339,4453,374721925,26170,1
105374068,LOC105374068,chr3,R,120423141,120431143,112295341,8002,374729927,26171,1
105374069,LOC105374069,chr3,R,120863324,120908079,112340096,44755,374774682,26172,7
105374070,LOC105374070,chr3,R,121569623,121601404,112371877,31781,374806463,26173,4
105374071,LOC105374071,chr3,F,122514965,122531898,112388810,16933,374823396,26174,6
105374072,LOC105374072,chr3,F,123016461,123023168,112395517,6707,374830103,26175,2
105374073,LOC105374073,chr3,F,123335163,123337826,112398180,2663,374832766,26176,2
105374074,LOC105374074,chr3,R,123246443,123277011,112428748,30568,374863334,26177,1
105374075,LOC105374075,chr3,F,123762937,123765174,112430985,2237,374865571,26178,1
105374076,LOC105374076,chr3,R,124545195,124584583,112470373,39388,374904959,26179,4
105374077,LOC105374077,chr3,F,124168177,124171712,112473908,3535,374908494,26180,2
105374078,LOC105374078,chr3,F,124812017,124827700,112489591,15683,374924177,26181,3
105374079,LOC105374079,chr3,F,125152358,125155198,112492431,2840,374927017,26182,2
105374080,LOC105374080,chr3,F,125376861,125386842,112502412,9981,374936998,26183,2
105374081,LOC105374081,chr3,R,125414838,125425880,112513454,11042,374948040,26184,2
105374082,LOC105374082,chr3,R,125904961,125908478,112516971,3517,374951557,26185,2
105374083,LOC105374083,chr3,F,126157522,126170467,112529916,12945,374964502,26186,3
105374084,LOC105374084,chr3,F,126094482,126103543,112538977,9061,374973563,26187,2
105374085,LOC105374085,chr3,F,126084226,126086380,112541131,2154,374975717,26188,1
105374086,LOC105374086,chr3,F,126213253,126247330,112575208,34077,375009794,26189,2
105374087,LOC105374087,chr3,R,126288120,126301397,112588485,13277,375023071,26190,3
105374088,LOC105374088,chr3,F,126312419,126323387,112599453,10968,375034039,26191,2
105374089,LOC105374089,chr3,R,126432795,126435544,112602202,2749,375036788,26192,0
105374090,LOC105374090,chr3,F,126559012,126604715,112647905,45703,375082491,26193,3
105374091,LOC105374091,chr3,F,126935166,126950505,112663244,15339,375097830,26194,1
105374092,LOC105374092,chr3,R,127038468,127043436,112668212,4968,375102798,26195,1
105374093,LOC105374093,chr3,F,127276541,127278237,112669908,1696,375104494,26196,1
105374094,LOC105374094,chr3,R,127384653,127388831,112674086,4178,375108672,26197,2
105374095,LOC105374095,chr3,F,127746936,127749473,112676623,2537,375111209,26198,1
105374096,LOC105374096,chr3,F,127855799,127859263,112680087,3464,375114673,26199,1
105374097,LOC105374097,chr3,F,128202683,128220190,112697594,17507,375132180,26200,2
105374098,LOC105374098,chr3,R,128171998,128194462,112720058,22464,375154644,26201,2
105374099,LOC105374099,chr3,F,128161728,128162994,112721324,1266,375155910,26202,2
105374100,LOC105374100,chr3,R,128999961,129001545,112722908,1584,375157494,26203,2
105374101,LOC105374101,chr3,F,129184027,129196302,112735183,12275,375169769,26204,1
105374102,LOC105374102,chr3,F,129230741,129236086,112740528,5345,375175114,26205,2
105374103,LOC105374103,chr3,R,130143280,130145044,112742292,1764,375176878,26206,1
105374104,LOC105374104,chr3,F,130111794,130120569,112751067,8775,375185653,26207,3
105374105,LOC105374105,chr3,R,130088880,130095090,112757277,6210,375191863,26208,5
105374106,LOC105374106,chr3,R,130274908,130276798,112759167,1890,375193753,26209,1
105374107,LOC105374107,chr3,F,130813722,130836545,112781990,22823,375216576,26210,6
105374108,LOC105374108,chr3,F,130844839,130846883,112784034,2044,375218620,26211,2
105374109,LOC105374109,chr3,R,130899410,130915056,112799680,15646,375234266,26212,1
105374110,LOC105374110,chr3,R,131431974,131442423,112810129,10449,375244715,26213,2
105374111,LOC105374111,chr3,F,132047044,132083115,112846200,36071,375280786,26214,2
105374112,LOC105374112,chr3,F,131998042,132013560,112861718,15518,375296304,26215,4
105374113,LOC105374113,chr3,F,131802702,131872160,112931176,69458,375365762,26216,6
105374114,LOC105374114,chr3,F,131501937,131689554,113118793,187617,375553379,26217,9
105374115,LOC105374115,chr3,R,132802393,132804631,113121031,2238,375555617,26218,1
105374116,LOC105374116,chr3,R,133784138,133805694,113142587,21556,375577173,26219,3
105374117,LOC105374117,chr3,R,134064585,134069053,113147055,4468,375581641,26220,3
105374118,LOC105374118,chr3,R,134325020,134327299,113149334,2279,375583920,26221,1
105374119,LOC105374119,chr3,F,134312188,134321167,113158313,8979,375592899,26222,2
105374120,LOC105374120,chr3,R,135108499,135125259,113175073,16760,375609659,26223,3
105374121,LOC105374121,chr3,R,134851756,134854520,113177837,2764,375612423,26224,3
105374122,LOC105374122,chr3,R,135354813,135516374,113339398,161561,375773984,26225,6
105374123,LOC105374123,chr3,R,135782615,135793932,113350715,11317,375785301,26226,2
105374124,LOC105374124,chr3,R,135832430,135840637,113358922,8207,375793508,26227,3
105374125,LOC105374125,chr3,F,136331971,136338003,113364954,6032,375799540,26228,1
105374126,LOC105374126,chr3,R,137626911,137713834,113451877,86923,375886463,26229,3
105374127,LOC105374127,chr3,R,138017339,138023661,113458199,6322,375892785,26230,1
105374128,LOC105374128,chr3,R,138046371,138058052,113469880,11681,375904466,26231,3
105374129,LOC105374129,chr3,F,138410304,138415087,113474663,4783,375909249,26232,2
105374130,LOC105374130,chr3,F,139600521,139606896,113481038,6375,375915624,26233,1
105374131,LOC105374131,chr3,R,139422190,139436609,113495457,14419,375930043,26234,2
105374132,LOC105374132,chr3,R,140449384,140474559,113520632,25175,375955218,26235,4
105374133,LOC105374133,chr3,R,141116699,141131164,113535097,14465,375969683,26236,2
105374134,LOC105374134,chr3,F,141851578,141861140,113544659,9562,375979245,26237,2
105374135,LOC105374135,chr3,R,141932513,141938356,113550502,5843,375985088,26238,2
105374136,LOC105374136,chr3,R,142596529,142656898,113610871,60369,376045457,26239,3
105374137,LOC105374137,chr3,R,143122501,143132846,113621216,10345,376055802,26240,1
105374138,LOC105374138,chr3,F,143084001,143108884,113646099,24883,376080685,26241,3
105374139,LOC105374139,chr3,R,144375633,144379498,113649964,3865,376084550,26242,1
105374140,LOC105374140,chr3,F,144416105,144475176,113709035,59071,376143621,26243,2
105374141,LOC105374141,chr3,F,144884608,144896335,113720762,11727,376155348,26244,2
105374142,LOC105374142,chr3,R,145556892,145569213,113733083,12321,376167669,26245,2
105374143,LOC105374143,chr3,R,145569267,145573597,113737413,4330,376171999,26246,2
105374144,LOC105374144,chr3,R,145625514,145650558,113762457,25044,376197043,26247,2
105374145,LOC105374145,chr3,R,146164656,146190531,113788332,25875,376222918,26248,3
105374146,LOC105374146,chr3,R,148193119,148220595,113815808,27476,376250394,26249,6
105374147,LOC105374147,chr3,R,148384765,148409741,113840784,24976,376275370,26250,3
105374148,LOC105374148,chr3,R,148312642,148339933,113868075,27291,376302661,26251,4
105374149,LOC105374149,chr3,F,148280992,148401075,113988158,120083,376422744,26252,5
105374150,LOC105374150,chr3,R,148440082,148464985,114013061,24903,376447647,26253,7
105374151,LOC105374151,chr3,R,149392725,149404785,114025121,12060,376459707,26254,2
105374152,LOC105374152,chr3,R,149952407,149959859,114032573,7452,376467159,26255,1
105374153,LOC105374153,chr3,F,150039220,150040741,114034094,1521,376468680,26256,2
105374154,LOC105374154,chr3,F,150275937,150281089,114039246,5152,376473832,26257,2
105374155,LOC105374155,chr3,F,150759104,150768728,114048870,9624,376483456,26258,2
105374156,LOC105374156,chr3,R,150871018,150878949,114056801,7931,376491387,26259,2
105374157,LOC105374157,chr3,F,151619928,151625992,114062865,6064,376497451,26260,2
105374158,LOC105374158,chr3,F,151628573,151657988,114092280,29415,376526866,26261,4
105374159,LOC105374159,chr3,F,151894333,151902924,114100871,8591,376535457,26262,2
105374160,LOC105374160,chr3,F,151796279,151806085,114110677,9806,376545263,26263,5
105374161,LOC105374161,chr3,R,152040959,152152197,114221915,111238,376656501,26264,5
105374162,LOC105374162,chr3,F,152317577,152320701,114225039,3124,376659625,26265,1
105374163,LOC105374163,chr3,R,152495380,152496854,114226513,1474,376661099,26266,2
105374164,LOC105374164,chr3,F,153203842,153248505,114271176,44663,376705762,26267,2
105374165,LOC105374165,chr3,R,153383525,153980105,114867756,596580,377302342,26268,7
105374166,LOC105374166,chr3,F,153320381,153386506,114933881,66125,377368467,26269,8
105374167,LOC105374167,chr3,R,154251012,154253108,114935977,2096,377370563,26270,1
105374168,LOC105374168,chr3,R,154258273,154274314,114952018,16041,377386604,26271,4
105374169,LOC105374169,chr3,F,154795868,154797774,114953924,1906,377388510,26272,2
105374170,LOC105374170,chr3,R,154863717,154887414,114977621,23697,377412207,26273,2
105374171,LOC105374171,chr3,R,154898739,154970232,115049114,71493,377483700,26274,5
105374172,LOC105374172,chr3,F,155315382,155318933,115052665,3551,377487251,26275,2
105374173,LOC105374173,chr3,F,155512245,155519741,115060161,7496,377494747,26276,2
105374174,LOC105374174,chr3,F,155854526,155862815,115068450,8289,377503036,26277,3
105374175,LOC105374175,chr3,F,156475447,156482466,115075469,7019,377510055,26278,2
105374176,LOC105374176,chr3,R,156448199,156457009,115084279,8810,377518865,26279,4
105374177,LOC105374177,chr3,F,157082832,157088523,115089970,5691,377524556,26280,3
105374178,LOC105374178,chr3,R,157242120,157251022,115098872,8902,377533458,26281,2
105374179,LOC105374179,chr3,R,157234308,157242111,115106675,7803,377541261,26282,2
105374180,LOC105374180,chr3,R,158702580,158704381,115108476,1801,377543062,26283,1
105374181,LOC105374181,chr3,F,158866997,158884636,115126115,17639,377560701,26284,3
105374182,LOC105374182,chr3,F,158924038,158926862,115128939,2824,377563525,26285,2
105374183,LOC105374183,chr3,R,159825278,159862747,115166408,37469,377600994,26286,3
105374184,LOC105374184,chr3,R,159706902,159763214,115222720,56312,377657306,26287,7
105374185,LOC105374185,chr3,R,161030592,161042495,115234623,11903,377669209,26288,2
105374186,LOC105374186,chr3,R,161173531,161182263,115243355,8732,377677941,26289,4
105374187,LOC105374187,chr3,F,161269245,161312003,115286113,42758,377720699,26290,5
105374188,LOC105374188,chr3,F,163304190,163381162,115363085,76972,377797671,26291,4
105374189,LOC105374189,chr3,F,164338926,164370676,115394835,31750,377829421,26292,2
105374190,LOC105374190,chr3,F,164402461,164419606,115411980,17145,377846566,26293,2
105374191,LOC105374191,chr3,F,164450708,164620475,115581747,169767,378016333,26294,8
105374192,LOC105374192,chr3,F,165072026,165083824,115593545,11798,378028131,26295,6
105374193,LOC105374193,chr3,R,166900655,166971623,115664513,70968,378099099,26296,12
105374194,LOC105374194,chr3,F,166898682,166931824,115697655,33142,378132241,26297,2
105374195,LOC105374195,chr3,R,166971878,166973797,115699574,1919,378134160,26298,2
105374196,LOC105374196,chr3,R,167098551,167106760,115707783,8209,378142369,26299,3
105374197,LOC105374197,chr3,F,167469300,167476367,115714850,7067,378149436,26300,2
105374198,LOC105374198,chr3,F,167671753,167683641,115726738,11888,378161324,26301,1
105374199,LOC105374199,chr3,R,168897432,168901868,115731174,4436,378165760,26302,2
105374200,LOC105374200,chr3,R,168609440,168627438,115749172,17998,378183758,26303,4
105374201,LOC105374201,chr3,F,169003013,169006031,115752190,3018,378186776,26304,2
105374202,LOC105374202,chr3,F,169659978,169661151,115753363,1173,378187949,26305,1
105374203,LOC105374203,chr3,R,169657481,169663004,115758886,5523,378193472,26306,1
105374204,LOC105374204,chr3,R,169533076,169536254,115762064,3178,378196650,26307,1
105374205,LOC105374205,chr3,F,169447774,169477052,115791342,29278,378225928,26308,5
105374206,LOC105374206,chr3,F,169281003,169282760,115793099,1757,378227685,26309,2
105374207,LOC105374207,chr3,F,169170947,169215685,115837837,44738,378272423,26310,2
105374208,LOC105374208,chr3,R,169775636,169776715,115838916,1079,378273502,26311,1
105374209,LOC105374209,chr3,F,170102946,170121923,115857893,18977,378292479,26312,2
105374210,LOC105374210,chr3,F,170410536,170418777,115866134,8241,378300720,26313,3
105374211,LOC105374211,chr3,F,170768814,170837620,115934940,68806,378369526,26314,2
105374212,LOC105374212,chr3,R,170710267,170734074,115958747,23807,378393333,26315,2
105374213,LOC105374213,chr3,F,170683120,170754724,116030351,71604,378464937,26316,4
105374214,LOC105374214,chr3,F,170434920,170460697,116056128,25777,378490714,26317,4
105374215,LOC105374215,chr3,F,171328261,171338406,116066273,10145,378500859,26318,3
105374216,LOC105374216,chr3,F,171101639,171161262,116125896,59623,378560482,26319,8
105374217,LOC105374217,chr3,F,171942485,171959585,116142996,17100,378577582,26320,2
105374218,LOC105374218,chr3,F,171900510,171938643,116181129,38133,378615715,26321,3
105374219,LOC105374219,chr3,R,172590773,172595594,116185950,4821,378620536,26322,3
105374220,LOC105374220,chr3,F,173111051,173200932,116275831,89881,378710417,26323,6
105374221,LOC105374221,chr3,F,172960523,172964079,116279387,3556,378713973,26324,2
105374222,LOC105374222,chr3,F,172945664,172947418,116281141,1754,378715727,26325,2
105374223,LOC105374223,chr3,F,173206682,173213669,116288128,6987,378722714,26326,2
105374224,LOC105374224,chr3,F,173259700,173268650,116297078,8950,378731664,26327,2
105374225,LOC105374225,chr3,R,173731375,173735975,116301678,4600,378736264,26328,1
105374226,LOC105374226,chr3,R,174417101,174422373,116306950,5272,378741536,26329,2
105374227,LOC105374227,chr3,F,175823131,175826959,116310778,3828,378745364,26330,1
105374228,LOC105374228,chr3,F,176362720,176395980,116344038,33260,378778624,26331,2
105374229,LOC105374229,chr3,F,176693718,176718590,116368910,24872,378803496,26332,3
105374230,LOC105374230,chr3,F,176544631,176565281,116389560,20650,378824146,26333,2
105374231,LOC105374231,chr3,F,177327207,177337453,116399806,10246,378834392,26334,3
105374232,LOC105374232,chr3,R,177569683,177594352,116424475,24669,378859061,26335,4
105374233,LOC105374233,chr3,R,177954104,177960138,116430509,6034,378865095,26336,2
105374234,LOC105374234,chr3,F,178015826,178065846,116480529,50020,378915115,26337,3
105374235,LOC105374235,chr3,R,178333127,178385392,116532794,52265,378967380,26338,2
105374237,LOC105374237,chr3,R,178908494,178921933,116546233,13439,378980819,26339,3
105374238,LOC105374238,chr3,R,179571522,179576837,116551548,5315,378986134,26340,1
105374239,LOC105374239,chr3,F,179969412,179979894,116562030,10482,378996616,26341,2
105374240,LOC105374240,chr3,F,180867986,180871402,116565446,3416,379000032,26342,2
105374241,LOC105374241,chr3,R,181331108,181338280,116572618,7172,379007204,26343,2
105374242,LOC105374242,chr3,R,182025653,182027708,116574673,2055,379009259,26344,2
105374243,LOC105374243,chr3,R,182149524,182182761,116607910,33237,379042496,26345,7
105374244,LOC105374244,chr3,R,182498213,182536766,116646463,38553,379081049,26346,6
105374245,LOC105374245,chr3,R,182783330,182793353,116656486,10023,379091072,26347,3
105374246,LOC105374246,chr3,F,182980941,182986729,116662274,5788,379096860,26348,1
105374247,LOC105374247,chr3,F,183108213,183114410,116668471,6197,379103057,26349,2
105374248,LOC105374248,chr3,F,183630028,183632957,116671400,2929,379105986,26350,2
105374249,LOC105374249,chr3,R,184132941,184134799,116673258,1858,379107844,26351,2
105374250,LOC105374250,chr3,F,184395350,184451071,116728979,55721,379163565,26352,8
105374251,LOC105374251,chr3,F,184508528,184552863,116773314,44335,379207900,26353,3
105374252,LOC105374252,chr3,F,184490935,184504476,116786855,13541,379221441,26354,2
105374253,LOC105374253,chr3,F,184773272,184779295,116792878,6023,379227464,26355,3
105374254,LOC105374254,chr3,F,185499139,185504493,116798232,5354,379232818,26356,2
105374255,LOC105374255,chr3,R,185452480,185461586,116807338,9106,379241924,26357,2
105374256,LOC105374256,chr3,R,186095119,186097674,116809893,2555,379244479,26358,1
105374257,LOC105374257,chr3,F,186121541,186127275,116815627,5734,379250213,26359,2
105374258,LOC105374258,chr3,R,186641152,186715028,116889503,73876,379324089,26360,9
105374259,LOC105374259,chr3,F,186753226,186761048,116897325,7822,379331911,26361,2
105374260,LOC105374260,chr3,F,187224955,187226382,116898752,1427,379333338,26362,2
105374261,LOC105374261,chr3,F,187447040,187449953,116901665,2913,379336251,26363,3
105374262,LOC105374262,chr3,R,187522839,187535944,116914770,13105,379349356,26364,5
105374263,LOC105374263,chr3,R,187792594,187795687,116917863,3093,379352449,26365,2
105374264,LOC105374264,chr3,R,187835691,187890242,116972414,54551,379407000,26366,2
105374265,LOC105374265,chr3,R,187931468,187933225,116974171,1757,379408757,26367,1
105374266,LOC105374266,chr3,R,187966855,187976421,116983737,9566,379418323,26368,1
105374267,LOC105374267,chr3,R,187958402,187965520,116990855,7118,379425441,26369,1
105374268,LOC105374268,chr3,F,188072887,188081047,116999015,8160,379433601,26370,2
105374269,LOC105374269,chr3,R,189261242,189270190,117007963,8948,379442549,26371,2
105374270,LOC105374270,chr3,R,189461880,189478191,117024274,16311,379458860,26372,2
105374271,LOC105374271,chr3,F,189645062,189655993,117035205,10931,379469791,26373,2
105374272,LOC105374272,chr3,R,190696277,190699253,117038181,2976,379472767,26374,2
105374273,LOC105374273,chr3,R,190782314,190787221,117043088,4907,379477674,26375,2
105374274,LOC105374274,chr3,R,190788497,190793679,117048270,5182,379482856,26376,3
105374275,LOC105374275,chr3,R,191748619,191759658,117059309,11039,379493895,26377,4
105374276,LOC105374276,chr3,R,191781108,191808573,117086774,27465,379521360,26378,3
105374277,LOC105374277,chr3,R,192005106,192037435,117119103,32329,379553689,26379,3
105374278,LOC105374278,chr3,F,192566795,192574213,117126521,7418,379561107,26380,2
105374279,LOC105374279,chr3,F,192294173,192299758,117132106,5585,379566692,26381,3
105374280,LOC105374280,chr3,R,193237988,193240998,117135116,3010,379569702,26382,2
105374281,LOC105374281,chr3,R,193589885,193593109,117138340,3224,379572926,26383,1
105374282,LOC105374282,chr3,R,193770958,193772375,117139757,1417,379574343,26384,1
105374283,LOC105374283,chr3,F,193787248,193792084,117144593,4836,379579179,26385,3
105374284,LOC105374284,chr3,R,193832778,193838008,117149823,5230,379584409,26386,2
105374285,LOC105374285,chr3,R,193840598,193844009,117153234,3411,379587820,26387,2
105374286,LOC105374286,chr3,F,193874782,193885446,117163898,10664,379598484,26388,5
105374287,LOC105374287,chr3,R,193873306,193940154,117230746,66848,379665332,26389,3
105374288,LOC105374288,chr3,F,194110004,194111829,117232571,1825,379667157,26390,2
105374289,LOC105374289,chr3,F,194276596,194278113,117234088,1517,379668674,26391,2
105374290,LOC105374290,chr3,R,194499006,194527436,117262518,28430,379697104,26392,5
105374291,LOC105374291,chr3,F,194600734,194603448,117265232,2714,379699818,26393,2
105374292,LOC105374292,chr3,F,194769560,194825688,117321360,56128,379755946,26394,6
105374293,LOC105374293,chr3,R,194762172,194773151,117332339,10979,379766925,26395,3
105374294,LOC105374294,chr3,R,194981641,194998957,117349655,17316,379784241,26396,4
105374295,LOC105374295,chr3,R,195005768,195014874,117358761,9106,379793347,26397,2
105374296,LOC105374296,chr3,R,195148458,195151262,117361565,2804,379796151,26398,1
105374297,LOC105374297,chr3,R,195647420,195653263,117367408,5843,379801994,26399,1
105374298,LOC105374298,chr3,F,195636884,195640642,117371166,3758,379805752,26400,1
105374299,LOC105374299,chr3,F,195815606,195818776,117374336,3170,379808922,26401,2
105374300,LOC105374300,chr3,R,196018634,196035453,117391155,16819,379825741,26402,4
105374301,LOC105374301,chr3,F,195995071,196005093,117401177,10022,379835763,26403,2
105374302,LOC105374302,chr3,F,196052119,196055071,117404129,2952,379838715,26404,1
105374303,LOC105374303,chr3,F,196192784,196193534,117404879,750,379839465,26405,2
105374304,LOC105374304,chr3,R,196212953,196220393,117412319,7440,379846905,26406,5
105374305,LOC105374305,chr3,F,196455874,196460736,117417181,4862,379851767,26407,1
105374306,LOC105374306,chr3,R,196496213,196500706,117421674,4493,379856260,26408,1
105374307,LOC105374307,chr3,F,196505844,196506892,117422722,1048,379857308,26409,2
105374308,LOC105374308,chr3,R,197419864,197458406,117461264,38542,379895850,26410,8
105374309,LOC105374309,chr3,F,197477985,197479651,117462930,1666,379897516,26411,1
105374310,LOC105374310,chr3,R,197830806,197852553,117484677,21747,379919263,26412,3
105374311,LOC105374311,chr3,R,198028010,198035876,117492543,7866,379927129,26413,4
105374312,LOC105374312,chr3,F,125756191,125769389,117505741,13198,379940327,26414,3
105374313,LOC105374313,chr3,F,150090268,150151046,117566519,60778,380001105,26415,6
105374314,LOC105374314,chr3,R,160032258,160040364,117574625,8106,380009211,26416,3
105376920,LOC105376920,chr3,R,60176,77689,117592138,17513,380026724,26417,2
105376921,LOC105376921,chr3,F,54197,67717,117605658,13520,380040244,26418,2
105376922,LOC105376922,chr3,F,483638,493542,117615562,9904,380050148,26419,3
105376923,LOC105376923,chr3,R,1182206,1194419,117627775,12213,380062361,26420,3
105376924,LOC105376924,chr3,F,1165711,1177237,117639301,11526,380073887,26421,2
105376925,LOC105376925,chr3,F,3008943,3012076,117642434,3133,380077020,26422,2
105376926,LOC105376926,chr3,R,2810850,2853757,117685341,42907,380119927,26423,3
105376928,LOC105376928,chr3,R,3249882,3382650,117818109,132768,380252695,26424,4
105376929,LOC105376929,chr3,R,4269294,4303242,117852057,33948,380286643,26425,3
105376930,LOC105376930,chr3,F,4041377,4045953,117856633,4576,380291219,26426,2
105376931,LOC105376931,chr3,R,3925111,3963144,117894666,38033,380329252,26427,2
105376932,LOC105376932,chr3,R,4705180,4710356,117899842,5176,380334428,26428,2
105376933,LOC105376933,chr3,R,4581919,4584241,117902164,2322,380336750,26429,1
105376934,LOC105376934,chr3,R,4994673,5027038,117934529,32365,380369115,26430,4
105376935,LOC105376935,chr3,R,5156838,5187376,117965067,30538,380399653,26431,5
105376936,LOC105376936,chr3,R,5437576,5441605,117969096,4029,380403682,26432,2
105376937,LOC105376937,chr3,R,5673674,5684180,117979602,10506,380414188,26433,2
105376938,LOC105376938,chr3,R,5691053,5699455,117988004,8402,380422590,26434,1
105376939,LOC105376939,chr3,F,5684335,5697634,118001303,13299,380435889,26435,2
105376940,LOC105376940,chr3,F,5740695,5755710,118016318,15015,380450904,26436,3
105376941,LOC105376941,chr3,F,5815039,5842609,118043888,27570,380478474,26437,5
105376942,LOC105376942,chr3,F,6067095,6366159,118342952,299064,380777538,26438,6
105376943,LOC105376943,chr3,F,6780424,6783195,118345723,2771,380780309,26439,2
105376944,LOC105376944,chr3,F,6694753,6735810,118386780,41057,380821366,26440,8
105376945,LOC105376945,chr3,F,6828630,6847774,118405924,19144,380840510,26441,2
105376946,LOC105376946,chr3,R,6883469,6895322,118417777,11853,380852363,26442,2
105376947,LOC105376947,chr3,F,8091243,8120195,118446729,28952,380881315,26443,4
105376949,LOC105376949,chr3,R,9598420,9600687,118448996,2267,380883582,26444,2
105376950,LOC105376950,chr3,R,10913949,10928067,118463114,14118,380897700,26445,2
105376951,LOC105376951,chr3,R,11141371,11154389,118476132,13018,380910718,26446,7
105376952,LOC105376952,chr3,F,11565752,11576352,118486732,10600,380921318,26447,1
105376953,LOC105376953,chr3,R,12792303,12797304,118491733,5001,380926319,26448,2
105376954,LOC105376954,chr3,F,13007887,13010674,118494520,2787,380929106,26449,1
105376955,LOC105376955,chr3,R,12882359,12885099,118497260,2740,380931846,26450,1
105376956,LOC105376956,chr3,F,12876343,12942962,118563879,66619,380998465,26451,6
105376957,LOC105376957,chr3,F,13895529,13926911,118595261,31382,381029847,26452,5
105376958,LOC105376958,chr3,F,14224678,14230753,118601336,6075,381035922,26453,2
105376959,LOC105376959,chr3,R,14390293,14399181,118610224,8888,381044810,26454,6
105376960,LOC105376960,chr3,F,14601051,14609305,118618478,8254,381053064,26455,2
105376961,LOC105376961,chr3,R,14587951,14594765,118625292,6814,381059878,26456,2
105376962,LOC105376962,chr3,R,14655639,14665801,118635454,10162,381070040,26457,2
105376963,LOC105376963,chr3,R,14920443,14922404,118637415,1961,381072001,26458,2
105376964,LOC105376964,chr3,F,15499647,15504180,118641948,4533,381076534,26459,1
105376965,LOC105376965,chr3,R,15444317,15450061,118647692,5744,381082278,26460,2
105376966,LOC105376966,chr3,F,16128072,16132757,118652377,4685,381086963,26461,2
105376967,LOC105376967,chr3,R,16125424,16130614,118657567,5190,381092153,26462,3
105376968,LOC105376968,chr3,F,16001379,16049684,118705872,48305,381140458,26463,2
105376969,LOC105376969,chr3,F,16472790,16480777,118713859,7987,381148445,26464,2
105376970,LOC105376970,chr3,F,16605576,16631681,118739964,26105,381174550,26465,2
105376972,LOC105376972,chr3,R,16881790,16884164,118742338,2374,381176924,26466,2
105376974,LOC105376974,chr3,F,17140981,17157719,118759076,16738,381193662,26467,2
105376975,LOC105376975,chr3,F,17742877,17745665,118761864,2788,381196450,26468,1
105376976,LOC105376976,chr3,F,18745976,18843164,118859052,97188,381293638,26469,3
105376978,LOC105376978,chr3,R,18949262,18991062,118900852,41800,381335438,26470,6
105376981,LOC105376981,chr3,R,19003664,19012232,118909420,8568,381344006,26471,2
105376982,LOC105376982,chr3,R,19390759,19484728,119003389,93969,381437975,26472,2
105376983,LOC105376983,chr3,R,19342616,19348351,119009124,5735,381443710,26473,2
105376984,LOC105376984,chr3,F,19703638,19728957,119034443,25319,381469029,26474,2
105376987,LOC105376987,chr3,F,21041229,21150115,119143329,108886,381577915,26475,5
105376988,LOC105376988,chr3,F,21169368,21221327,119195288,51959,381629874,26476,3
105376990,LOC105376990,chr3,F,21645290,21657732,119207730,12442,381642316,26477,3
105376991,LOC105376991,chr3,F,23417435,23419769,119210064,2334,381644650,26478,2
105376993,LOC105376993,chr3,F,23643668,23654875,119221271,11207,381655857,26479,4
105376994,LOC105376994,chr3,F,24446190,24473379,119248460,27189,381683046,26480,2
105376997,LOC105376997,chr3,R,25383109,25384942,119250293,1833,381684879,26481,1
105376998,LOC105376998,chr3,R,25226342,25255436,119279387,29094,381713973,26482,2
105376999,LOC105376999,chr3,F,25783638,25785159,119280908,1521,381715494,26483,1
105377000,LOC105377000,chr3,F,25831301,25850056,119299663,18755,381734249,26484,6
105377001,LOC105377001,chr3,F,26064873,26080722,119315512,15849,381750098,26485,2
105377002,LOC105377002,chr3,F,26143649,26208261,119380124,64612,381814710,26486,2
105377003,LOC105377003,chr3,R,26619648,26622655,119383131,3007,381817717,26487,2
105377004,LOC105377004,chr3,F,27216574,27220883,119387440,4309,381822026,26488,1
105377005,LOC105377005,chr3,R,27512613,27532654,119407481,20041,381842067,26489,3
105377006,LOC105377006,chr3,F,27712336,27714006,119409151,1670,381843737,26490,1
105377007,LOC105377007,chr3,F,27797587,27860325,119471889,62738,381906475,26491,7
105377008,LOC105377008,chr3,R,28089250,28137033,119519672,47783,381954258,26492,2
105377009,LOC105377009,chr3,R,29037907,29057585,119539350,19678,381973936,26493,5
105377010,LOC105377010,chr3,F,28590475,28616673,119565548,26198,382000134,26494,2
105377011,LOC105377011,chr3,F,29260786,29261760,119566522,974,382001108,26495,1
105377012,LOC105377012,chr3,R,30180493,30184848,119570877,4355,382005463,26496,1
105377013,LOC105377013,chr3,R,30422265,30467207,119615819,44942,382050405,26497,3
105377014,LOC105377014,chr3,R,30511720,30523547,119627646,11827,382062232,26498,2
105377015,LOC105377015,chr3,R,30603885,30606485,119630246,2600,382064832,26499,1
105377016,LOC105377016,chr3,F,30653481,30663487,119640252,10006,382074838,26500,1
105377017,LOC105377017,chr3,F,30783662,30796774,119653364,13112,382087950,26501,3
105377018,LOC105377018,chr3,R,31201431,31202631,119654564,1200,382089150,26502,2
105377019,LOC105377019,chr3,F,31462570,31469799,119661793,7229,382096379,26503,2
105377020,LOC105377020,chr3,F,31533326,31537413,119665880,4087,382100466,26504,1
105377021,LOC105377021,chr3,R,32814868,32817341,119668353,2473,382102939,26505,0
105377022,LOC105377022,chr3,R,32961107,32975839,119683085,14732,382117671,26506,2
105377023,LOC105377023,chr3,R,33783823,33798491,119697753,14668,382132339,26507,4
105377024,LOC105377024,chr3,F,33878853,33880213,119699113,1360,382133699,26508,2
105377025,LOC105377025,chr3,R,34174973,34181702,119705842,6729,382140428,26509,3
105377026,LOC105377026,chr3,R,34540173,34543756,119709425,3583,382144011,26510,2
105377027,LOC105377027,chr3,R,35509997,35529153,119728581,19156,382163167,26511,2
105377028,LOC105377028,chr3,R,35814631,35833875,119747825,19244,382182411,26512,2
105377029,LOC105377029,chr3,R,36768994,36772585,119751416,3591,382186002,26513,2
105377030,LOC105377030,chr3,R,36775891,36784280,119759805,8389,382194391,26514,2
105377031,LOC105377031,chr3,R,36819282,36822892,119763415,3610,382198001,26515,1
105377032,LOC105377032,chr3,F,37379120,37383264,119767559,4144,382202145,26516,3
105377033,LOC105377033,chr3,R,38103489,38122350,119786420,18861,382221006,26517,1
105377034,LOC105377034,chr3,F,38813623,38816345,119789142,2722,382223728,26518,1
105377035,LOC105377035,chr3,F,39177763,39181521,119792900,3758,382227486,26519,1
105377036,LOC105377036,chr3,F,39201799,39210654,119801755,8855,382236341,26520,3
105377037,LOC105377037,chr3,F,39374721,39381013,119808047,6292,382242633,26521,4
105377038,LOC105377038,chr3,F,39456698,39459303,119810652,2605,382245238,26522,1
105377039,LOC105377039,chr3,F,39778653,39802904,119834903,24251,382269489,26523,11
105377040,LOC105377040,chr3,R,40062086,40083774,119856591,21688,382291177,26524,2
105377041,LOC105377041,chr3,F,40627614,40645433,119874410,17819,382308996,26525,3
105377042,LOC105377042,chr3,F,40871131,40875601,119878880,4470,382313466,26526,2
105377043,LOC105377043,chr3,F,40719861,40911068,120070087,191207,382504673,26527,8
105377044,LOC105377044,chr3,R,41041225,41043973,120072835,2748,382507421,26528,3
105377045,LOC105377045,chr3,R,41050536,41058139,120080438,7603,382515024,26529,2
105377046,LOC105377046,chr3,F,41261329,41267816,120086925,6487,382521511,26530,2
105377047,LOC105377047,chr3,R,42128139,42131437,120090223,3298,382524809,26531,2
105377048,LOC105377048,chr3,F,42247924,42253494,120095793,5570,382530379,26532,5
105377049,LOC105377049,chr3,R,42669452,42683801,120110142,14349,382544728,26533,2
105377051,LOC105377051,chr3,F,43151578,43153124,120111688,1546,382546274,26534,2
105377052,LOC105377052,chr3,R,43260356,43262575,120113907,2219,382548493,26535,2
105377053,LOC105377053,chr3,F,43305749,43322716,120130874,16967,382565460,26536,2
105377054,LOC105377054,chr3,R,43754340,43757591,120134125,3251,382568711,26537,1
105377055,LOC105377055,chr3,R,44326552,44338015,120145588,11463,382580174,26538,4
105377056,LOC105377056,chr3,R,44715797,44729553,120159344,13756,382593930,26539,6
105377057,LOC105377057,chr3,R,44937900,44943802,120165246,5902,382599832,26540,1
105377059,LOC105377059,chr3,F,45068105,45082343,120179484,14238,382614070,26541,3
105377061,LOC105377061,chr3,F,45307888,45313277,120184873,5389,382619459,26542,3
105377062,LOC105377062,chr3,R,45327832,45346520,120203561,18688,382638147,26543,3
105377063,LOC105377063,chr3,F,45995942,46001283,120208902,5341,382643488,26544,2
105377065,LOC105377065,chr3,F,46067692,46084076,120225286,16384,382659872,26545,2
105377066,LOC105377066,chr3,R,46061082,46085851,120250055,24769,382684641,26546,2
105377067,LOC105377067,chr3,F,46130893,46190381,120309543,59488,382744129,26547,2
105377068,LOC105377068,chr3,R,46414778,46424092,120318857,9314,382753443,26548,6
105377069,LOC105377069,chr3,F,46471549,46476219,120323527,4670,382758113,26549,2
105377070,LOC105377070,chr3,R,46504976,46514933,120333484,9957,382768070,26550,2
105377071,LOC105377071,chr3,R,46646419,46665048,120352113,18629,382786699,26551,5
105377072,LOC105377072,chr3,F,46812082,46813142,120353173,1060,382787759,26552,1
105377073,LOC105377073,chr3,F,47476215,47482470,120359428,6255,382794014,26553,2
105377074,LOC105377074,chr3,F,47532994,47537671,120364105,4677,382798691,26554,2
105377075,LOC105377075,chr3,F,47599333,47615687,120380459,16354,382815045,26555,2
105377076,LOC105377076,chr3,F,48275181,48287631,120392909,12450,382827495,26556,1
105377077,LOC105377077,chr3,F,48430148,48432207,120394968,2059,382829554,26557,1
105377078,LOC105377078,chr3,R,48729739,48740328,120405557,10589,382840143,26558,2
105377079,LOC105377079,chr3,R,48985484,48987083,120407156,1599,382841742,26559,1
105377080,LOC105377080,chr3,R,48979909,48982934,120410181,3025,382844767,26560,1
105377081,LOC105377081,chr3,F,49553622,49554072,120410631,450,382845217,26561,1
105377082,LOC105377082,chr3,F,50454086,50455566,120412111,1480,382846697,26562,1
105377083,LOC105377083,chr3,R,50534961,50539700,120416850,4739,382851436,26563,2
105377084,LOC105377084,chr3,R,50598982,50600922,120418790,1940,382853376,26564,2
105377085,LOC105377085,chr3,F,51507069,51536393,120448114,29324,382882700,26565,3
105377086,LOC105377086,chr3,R,51627771,51662415,120482758,34644,382917344,26566,2
105377087,LOC105377087,chr3,F,51754637,51807090,120535211,52453,382969797,26567,2
105377088,LOC105377088,chr3,R,52031120,52035987,120540078,4867,382974664,26568,2
105377089,LOC105377089,chr3,F,52046147,52050405,120544336,4258,382978922,26569,1
105377091,LOC105377091,chr3,F,52443075,52448421,120549682,5346,382984268,26570,1
105377092,LOC105377092,chr3,F,52606291,52619538,120562929,13247,382997515,26571,2
105377093,LOC105377093,chr3,R,52796755,52797810,120563984,1055,382998570,26572,1
105377094,LOC105377094,chr3,R,53350497,53371273,120584760,20776,383019346,26573,3
105377095,LOC105377095,chr3,R,53986290,54035004,120633474,48714,383068060,26574,10
105377096,LOC105377096,chr3,F,55186728,55189602,120636348,2874,383070934,26575,2
105377097,LOC105377097,chr3,F,55228282,55259344,120667410,31062,383101996,26576,10
105377098,LOC105377098,chr3,F,55286323,55299743,120680830,13420,383115416,26577,2
105377099,LOC105377099,chr3,F,56435969,56441377,120686238,5408,383120824,26578,2
105377100,LOC105377100,chr3,F,55609466,55613097,120689869,3631,383124455,26579,2
105377101,LOC105377101,chr3,R,57149881,57153150,120693138,3269,383127724,26580,1
105377102,LOC105377102,chr3,F,57276348,57278129,120694919,1781,383129505,26581,1
105377103,LOC105377103,chr3,R,57904284,57920752,120711387,16468,383145973,26582,5
105377104,LOC105377104,chr3,F,57959567,57986620,120738440,27053,383173026,26583,3
105377105,LOC105377105,chr3,R,58162546,58170635,120746529,8089,383181115,26584,1
105377106,LOC105377106,chr3,R,58351626,58354408,120749311,2782,383183897,26585,2
105377107,LOC105377107,chr3,F,58617067,58618624,120750868,1557,383185454,26586,1
105377108,LOC105377108,chr3,F,58606359,58613713,120758222,7354,383192808,26587,2
105377109,LOC105377109,chr3,F,58663141,58706070,120801151,42929,383235737,26588,2
105377110,LOC105377110,chr3,F,59050175,59536998,121287974,486823,383722560,26589,9
105377111,LOC105377111,chr3,F,60989253,60990633,121289354,1380,383723940,26590,1
105377112,LOC105377112,chr3,F,59984902,59987531,121291983,2629,383726569,26591,2
105377113,LOC105377113,chr3,F,59850925,59879503,121320561,28578,383755147,26592,4
105377114,LOC105377114,chr3,R,61284400,61428677,121464838,144277,383899424,26593,6
105377115,LOC105377115,chr3,F,61251597,61315055,121528296,63458,383962882,26594,3
105377116,LOC105377116,chr3,R,62211393,62218799,121535702,7406,383970288,26595,3
105377117,LOC105377117,chr3,R,62144897,62150052,121540857,5155,383975443,26596,2
105377118,LOC105377118,chr3,R,62086622,62130271,121584506,43649,384019092,26597,2
105377119,LOC105377119,chr3,R,63703707,63711737,121592536,8030,384027122,26598,2
105377120,LOC105377120,chr3,R,63969985,63973999,121596550,4014,384031136,26599,1
105377121,LOC105377121,chr3,F,64024104,64026360,121598806,2256,384033392,26600,2
105377122,LOC105377122,chr3,F,64089956,64091318,121600168,1362,384034754,26601,1
105377123,LOC105377123,chr3,R,64453512,64494217,121640873,40705,384075459,26602,9
105377124,LOC105377124,chr3,R,64876394,64988817,121753296,112423,384187882,26603,10
105377125,LOC105377125,chr3,R,65107816,65115415,121760895,7599,384195481,26604,2
105377126,LOC105377126,chr3,F,65113795,65131047,121778147,17252,384212733,26605,2
105377127,LOC105377127,chr3,R,65161631,65174828,121791344,13197,384225930,26606,3
105377128,LOC105377128,chr3,F,66038719,66041999,121794624,3280,384229210,26607,3
105377129,LOC105377129,chr3,R,65974388,65980286,121800522,5898,384235108,26608,2
105377130,LOC105377130,chr3,R,65717324,65720231,121803429,2907,384238015,26609,2
105377132,LOC105377132,chr3,F,37175863,37196722,121824288,20859,384258874,26610,1
105377133,LOC105377133,chr3,F,48424609,48429742,121829421,5133,384264007,26611,3
105377135,LOC105377135,chr3,F,52999044,53048123,121878500,49079,384313086,26612,2
105377140,LOC105377140,chr3,R,66620272,66636841,121895069,16569,384329655,26613,2
105377141,LOC105377141,chr3,F,66567244,66640280,121968105,73036,384402691,26614,3
105377142,LOC105377142,chr3,R,66701053,66718224,121985276,17171,384419862,26615,2
105377143,LOC105377143,chr3,R,66730377,66738314,121993213,7937,384427799,26616,4
105377144,LOC105377144,chr3,R,66780076,66972393,122185530,192317,384620116,26617,3
105377145,LOC105377145,chr3,R,67240854,67246465,122191141,5611,384625727,26618,1
105377146,LOC105377146,chr3,F,68500646,68505875,122196370,5229,384630956,26619,1
105377147,LOC105377147,chr3,R,67858575,67888150,122225945,29575,384660531,26620,2
105377148,LOC105377148,chr3,R,67617022,67620497,122229420,3475,384664006,26621,3
105377149,LOC105377149,chr3,F,69794311,69799693,122234802,5382,384669388,26622,2
105377150,LOC105377150,chr3,F,70191366,70249668,122293104,58302,384727690,26623,2
105377151,LOC105377151,chr3,F,70167808,70172568,122297864,4760,384732450,26624,1
105377152,LOC105377152,chr3,R,70575129,70598459,122321194,23330,384755780,26625,5
105377153,LOC105377153,chr3,F,70617885,70622434,122325743,4549,384760329,26626,2
105377154,LOC105377154,chr3,F,71566701,71571112,122330154,4411,384764740,26627,1
105377155,LOC105377155,chr3,F,71627684,71628667,122331137,983,384765723,26628,1
105377156,LOC105377156,chr3,F,71785330,71789374,122335181,4044,384769767,26629,5
105377157,LOC105377157,chr3,F,71993698,71996134,122337617,2436,384772203,26630,1
105377158,LOC105377158,chr3,R,72234119,72307259,122410757,73140,384845343,26631,7
105377159,LOC105377159,chr3,R,72312364,72316968,122415361,4604,384849947,26632,2
105377160,LOC105377160,chr3,F,72458719,72463575,122420217,4856,384854803,26633,2
105377161,LOC105377161,chr3,R,72582129,72647837,122485925,65708,384920511,26634,5
105377162,LOC105377162,chr3,R,72663300,72664253,122486878,953,384921464,26635,1
105377163,LOC105377163,chr3,R,72912586,72929887,122504179,17301,384938765,26636,2
105377164,LOC105377164,chr3,R,73693883,73707023,122517319,13140,384951905,26637,2
105377165,LOC105377165,chr3,F,73813625,73903392,122607086,89767,385041672,26638,4
105377166,LOC105377166,chr3,F,74614972,74622500,122614614,7528,385049200,26639,2
105377167,LOC105377167,chr3,F,74825209,74884243,122673648,59034,385108234,26640,8
105377168,LOC105377168,chr3,F,74900470,74907586,122680764,7116,385115350,26641,3
105377169,LOC105377169,chr3,R,75383652,75393267,122690379,9615,385124965,26642,2
105377170,LOC105377170,chr3,R,75393738,75396371,122693012,2633,385127598,26643,0
105377171,LOC105377171,chr3,R,77846643,78029866,122876235,183223,385310821,26644,6
105377172,LOC105377172,chr3,R,78038716,78048884,122886403,10168,385320989,26645,4
105377173,LOC105377173,chr3,F,78052737,78065497,122899163,12760,385333749,26646,3
105377174,LOC105377174,chr3,R,80823157,80825427,122901433,2270,385336019,26647,3
105377175,LOC105377175,chr3,F,80764841,80789378,122925970,24537,385360556,26648,5
105377176,LOC105377176,chr3,F,80679965,80722517,122968522,42552,385403108,26649,2
105377177,LOC105377177,chr3,R,80519773,80769829,123218578,250056,385653164,26650,6
105377178,LOC105377178,chr3,F,81840546,81872955,123250987,32409,385685573,26651,4
105377179,LOC105377179,chr3,F,81922853,81953255,123281389,30402,385715975,26652,3
105377180,LOC105377180,chr3,F,81986182,82204637,123499844,218455,385934430,26653,4
105377181,LOC105377181,chr3,R,83391659,83404337,123512522,12678,385947108,26654,3
105377183,LOC105377183,chr3,F,83412542,83451661,123551641,39119,385986227,26655,4
105377186,LOC105377186,chr3,R,83818380,83819967,123553228,1587,385987814,26656,2
105377187,LOC105377187,chr3,R,83851575,83857499,123559152,5924,385993738,26657,3
105377188,LOC105377188,chr3,F,83953627,84052828,123658353,99201,386092939,26658,11
105377192,LOC105377192,chr3,F,84882013,84892953,123669293,10940,386103879,26659,2
105377193,LOC105377193,chr3,R,84910297,84918834,123677830,8537,386112416,26660,1
105377194,LOC105377194,chr3,F,85627284,85636277,123686823,8993,386121409,26661,2
105377196,LOC105377196,chr3,R,86904083,86937149,123719889,33066,386154475,26662,8
105377198,LOC105377198,chr3,R,87711672,87740949,123749166,29277,386183752,26663,2
105377200,LOC105377200,chr3,F,88059220,88129791,123819737,70571,386254323,26664,6
105377202,LOC105377202,chr3,F,88275216,88327779,123872300,52563,386306886,26665,3
105377206,LOC105377206,chr3,F,71580820,71584038,123875518,3218,386310104,26666,4
105377207,LOC105377207,chr3,F,75281932,75342180,123935766,60248,386370352,26667,4
105377640,LOC105377640,chr3,R,4162468,4252096,124025394,89628,386459980,26668,2
105377641,LOC105377641,chr3,F,16724264,16772204,124073334,47940,386507920,26669,4
105377642,LOC105377642,chr3,F,37203928,37209547,124078953,5619,386513539,26670,2
105377643,LOC105377643,chr3,R,38950447,39052002,124180508,101555,386615094,26671,12
105377644,LOC105377644,chr3,R,39342851,39383223,124220880,40372,386655466,26672,2
105377645,LOC105377645,chr3,R,40184377,40200230,124236733,15853,386671319,26673,1
105377646,LOC105377646,chr3,F,52829285,52830660,124238108,1375,386672694,26674,1
105377647,LOC105377647,chr3,R,62374233,62375799,124239674,1566,386674260,26675,2
105377648,LOC105377648,chr3,R,72561173,72561819,124240320,646,386674906,26676,1
105377649,LOC105377649,chr3,R,80760908,80761490,124240902,582,386675488,26677,1
105377650,LOC105377650,chr3,F,58171776,58181840,124250966,10064,386685552,26678,4
118,ADD1,chr4,F,2843726,2930076,86350,86350,386771902,26679,18
124,ADH1A,chr4,R,99276365,99291028,101013,14663,386786565,26680,8
125,ADH1B,chr4,R,99306386,99321442,116069,15056,386801621,26681,9
126,ADH1C,chr4,R,99336491,99353045,132623,16554,386818175,26682,9
127,ADH4,chr4,R,99123680,99144314,153257,20634,386838809,26683,10
128,ADH5,chr4,R,99070977,99088788,171068,17811,386856620,26684,8
130,ADH6,chr4,R,99202637,99219246,187677,16609,386873229,26685,7
131,ADH7,chr4,R,99412260,99435510,210927,23250,386896479,26686,9
152,ADRA2C,chr4,F,3766568,3768526,212885,1958,386898437,26687,0
173,AFM,chr4,F,73481744,73504001,235142,22257,386920694,26688,14
174,AFP,chr4,F,73423103,73455785,267824,32682,386953376,26689,15
175,AGA,chr4,R,177430773,177442503,279554,11730,386965106,26690,8
213,ALB,chr4,F,73404254,73421412,296712,17158,386982264,26691,14
258,AMBN,chr4,F,70592257,70607288,311743,15031,386997295,26692,12
287,ANK2,chr4,F,112818082,113383740,877401,565658,387562953,26693,54
291,SLC25A4,chr4,F,185143262,185150384,884523,7122,387570075,26694,3
303,ANXA2P1,chr4,R,153307468,153308811,885866,1343,387571418,26695,0
306,ANXA3,chr4,F,78551587,78610451,944730,58864,387630282,26696,14
308,ANXA5,chr4,R,121667996,121696992,973726,28996,387659278,26697,12
323,APBB2,chr4,R,40810026,41216714,1380414,406688,388065966,26698,24
374,AREG,chr4,F,74445097,74455009,1390326,9912,388075878,26699,5
399,RHOH,chr4,F,40191010,40244764,1444080,53754,388129632,26700,9
419,ART3,chr4,F,76011179,76112802,1545703,101623,388231255,26701,15
474,ATOH1,chr4,F,93828926,93829991,1546768,1065,388232320,26702,0
521,ATP5I,chr4,R,672435,674338,1548671,1903,388234223,26703,3
579,NKX3-2,chr4,R,13540829,13544490,1552332,3661,388237884,26704,1
651,BMP3,chr4,F,81030621,81057531,1579242,26910,388264794,26705,2
658,BMPR1B,chr4,F,94757976,95158450,1979716,400474,388665268,26706,16
683,BST1,chr4,F,15702949,15774190,2050957,71241,388736509,26707,14
685,BTC,chr4,R,74744758,74794672,2100871,49914,388786423,26708,6
817,CAMK2D,chr4,R,113451031,113762133,2411973,311102,389097525,26709,26
836,CASP3,chr4,R,184627695,184649475,2433753,21780,389119305,26710,7
839,CASP6,chr4,R,109688627,109713904,2459030,25277,389144582,26711,7
886,CCKAR,chr4,R,26481395,26490420,2468055,9025,389153607,26712,4
890,CCNA2,chr4,R,121816443,121823933,2475545,7490,389161097,26713,7
901,CCNG2,chr4,F,77157203,77170060,2488402,12857,389173954,26714,9
950,SCARB2,chr4,R,76158736,76213899,2543565,55163,389229117,26715,11
952,CD38,chr4,F,15778297,15849083,2614351,70786,389299903,26716,7
987,LRBA,chr4,R,150264658,151015727,3365420,751069,390050972,26717,59
1040,CDS1,chr4,F,84582903,84651340,3433857,68437,390119409,26718,12
1047,CLGN,chr4,R,140388452,140427661,3473066,39209,390158618,26719,15
1060,CENPC,chr4,R,67472270,67545538,3546334,73268,390231886,26720,19
1062,CENPE,chr4,R,103105805,103198409,3638938,92604,390324490,26721,48
1182,CLCN3,chr4,F,169620520,169723187,3741605,102667,390427157,26722,15
1259,CNGA1,chr4,R,47935014,48016679,3823270,81665,390508822,26723,12
1363,CPE,chr4,F,165378944,165498330,3942656,119386,390628208,26724,8
1400,CRMP1,chr4,R,5820763,5893083,4014976,72320,390700528,26725,16
1446,CSN1S1,chr4,F,69931061,69946570,4030485,15509,390716037,26726,15
1447,CSN2,chr4,R,69955255,69993629,4068859,38374,390754411,26727,7
1448,CSN3,chr4,F,70238305,70251432,4081986,13127,390767538,26728,7
1487,CTBP1,chr4,R,1211439,1250248,4120795,38809,390806347,26729,13
1519,CTSO,chr4,R,155924117,155953896,4150574,29779,390836126,26730,7
1609,DGKQ,chr4,R,958883,973560,4165251,14677,390850803,26731,24
1633,DCK,chr4,F,70993547,71030914,4202618,37367,390888170,26732,6
1635,DCTD,chr4,R,182890086,182917477,4230009,27391,390915561,26733,8
1665,DHX15,chr4,R,24527463,24584603,4287149,57140,390972701,26734,13
1758,DMP1,chr4,F,87650301,87664361,4301209,14060,390986761,26735,6
1816,DRD5,chr4,F,9781633,9784009,4303585,2376,390989137,26736,0
1834,DSPP,chr4,F,87608528,87616873,4311930,8345,390997482,26737,4
1909,EDNRA,chr4,F,147480916,147544954,4375968,64038,391061520,26738,7
1950,EGF,chr4,F,109912882,110012962,4476048,100080,391161600,26739,25
1977,EIF4E,chr4,R,98878455,98930635,4528228,52180,391213780,26740,9
1998,ELF2,chr4,R,139057716,139177218,4647730,119502,391333282,26741,15
2028,ENPEP,chr4,F,110476072,110563337,4734995,87265,391420547,26742,19
2044,EPHA5,chr4,R,65319562,65670495,5085928,350933,391771480,26743,20
2069,EREG,chr4,F,74365142,74388760,5109546,23618,391795098,26744,4
2110,ETFDH,chr4,F,158672100,158708713,5146159,36613,391831711,26745,12
2121,EVC,chr4,F,5711188,5829045,5264016,117857,391949568,26746,28
2160,F11,chr4,F,186265944,186289681,5287753,23737,391973305,26747,16
2169,FABP2,chr4,R,119317249,119322161,5292665,4912,391978217,26748,3
2180,ACSL1,chr4,R,184755594,184826114,5363185,70520,392048737,26749,27
2195,FAT1,chr4,R,186587782,186726915,5502318,139133,392187870,26750,28
2243,FGA,chr4,R,154583127,154590745,5509936,7618,392195488,26751,5
2244,FGB,chr4,F,154562979,154572763,5519720,9784,392205272,26752,7
2247,FGF2,chr4,F,122826707,122898235,5591248,71528,392276800,26753,2
2250,FGF5,chr4,F,80266587,80291017,5615678,24430,392301230,26754,3
2261,FGFR3,chr4,F,1793298,1808872,5631252,15574,392316804,26755,18
2266,FGG,chr4,R,154604133,154612750,5639869,8617,392325421,26756,9
2483,FRG1,chr4,F,189940818,189963204,5662255,22386,392347807,26757,9
2549,GAB1,chr4,F,143336761,143474565,5800059,137804,392485611,26758,13
2555,GABRA2,chr4,R,46243547,46390039,5946551,146492,392632103,26759,10
2557,GABRA4,chr4,R,46918899,46994407,6022059,75508,392707611,26760,8
2560,GABRB1,chr4,F,46993857,47427343,6455545,433486,393141097,26761,10
2565,GABRG1,chr4,R,46035768,46124065,6543842,88297,393229394,26762,8
2580,GAK,chr4,R,849276,932390,6626956,83114,393312508,26763,30
2638,GC,chr4,R,71741692,71805520,6690784,63828,393376336,26764,14
2712,GK2,chr4,R,79406352,79408218,6692650,1866,393378202,26765,0
2713,GK3P,chr4,R,165277791,165280023,6694882,2232,393380434,26766,0
2743,GLRB,chr4,F,157076124,157172099,6790857,95975,393476409,26767,11
2798,GNRHR,chr4,R,67737374,67756086,6809569,18712,393495121,26768,2
2823,GPM6A,chr4,R,175632936,176002691,7179324,369755,393864876,26769,10
2868,GRK4,chr4,F,2963504,3040752,7256572,77248,393942124,26770,20
2891,GRIA2,chr4,F,157220583,157366075,7402064,145492,394087616,26771,16
2895,GRID2,chr4,F,92304398,93774556,8872222,1470158,395557774,26772,19
2919,CXCL1,chr4,F,73869391,73871302,8874133,1911,395559685,26773,3
2920,CXCL2,chr4,R,74097034,74099280,8876379,2246,395561931,26774,3
2921,CXCL3,chr4,R,74036588,74038773,8878564,2185,395564116,26775,3
2926,GRSF1,chr4,R,70815781,70843274,8906057,27493,395591609,26776,11
2982,GUCY1A3,chr4,F,155666567,155737062,8976552,70495,395662104,26777,12
2983,GUCY1B3,chr4,F,155758972,155807642,9025222,48670,395710774,26778,16
2993,GYPA,chr4,R,144109302,144140752,9056672,31450,395742224,26779,6
2994,GYPB,chr4,R,143995187,144019427,9080912,24240,395766464,26780,7
2996,GYPE,chr4,R,143870865,143905563,9115610,34698,395801162,26781,4
3015,H2AFZ,chr4,R,99948086,99950355,9117879,2269,395803431,26782,4
3033,HADH,chr4,F,107989713,108035175,9163341,45462,395848893,26783,9
3064,HTT,chr4,F,3074509,3243960,9332792,169451,396018344,26784,66
3083,HGFAC,chr4,F,3441932,3449495,9340355,7563,396025907,26785,14
3093,UBE2K,chr4,F,39698043,39782792,9425104,84749,396110656,26786,6
3148,HMGB2,chr4,R,173331375,173334444,9428173,3069,396113725,26787,4
3166,HMX1,chr4,R,8846076,8871817,9453914,25741,396139466,26788,5
3184,HNRNPD,chr4,R,82353313,82373996,9474597,20683,396160149,26789,8
3248,HPGD,chr4,R,174490176,174522898,9507319,32722,396192871,26790,7
3346,HTN1,chr4,F,70050414,70058848,9515753,8434,396201305,26791,5
3347,HTN3,chr4,F,70028412,70036538,9523879,8126,396209431,26792,5
3381,IBSP,chr4,F,87799549,87812449,9536779,12900,396222331,26793,6
3425,IDUA,chr4,F,986996,1004557,9554340,17561,396239892,26794,12
3426,CFI,chr4,R,109731220,109802225,9625345,71005,396310897,26795,15
3490,IGFBP7,chr4,R,57031070,57110385,9704660,79315,396390212,26796,4
3512,IGJ,chr4,R,70655540,70676901,9726021,21361,396411573,26797,7
3516,RBPJ,chr4,F,26163493,26435131,9997659,271638,396683211,26798,15
3558,IL2,chr4,R,122451469,122456495,10002685,5026,396688237,26799,3
3576,CXCL8,chr4,F,73740505,73743716,10005896,3211,396691448,26800,3
3600,IL15,chr4,F,141636595,141733987,10103288,97392,396788840,26801,9
3622,ING2,chr4,F,183505049,183512428,10110667,7379,396796219,26802,3
3627,CXCL10,chr4,R,76021115,76023536,10113088,2421,396798640,26803,3
3660,IRF2,chr4,R,184387712,184474580,10199956,86868,396885508,26804,10
3791,KDR,chr4,R,55078258,55125595,10247293,47337,396932845,26805,29
3815,KIT,chr4,F,54657927,54740715,10330081,82788,397015633,26806,20
3818,KLKB1,chr4,F,186210752,186258474,10377803,47722,397063355,26807,17
3954,LETM1,chr4,R,1811478,1856247,10422572,44769,397108124,26808,14
4043,LRPAP1,chr4,R,3503596,3532497,10451473,28901,397137025,26809,8
4085,MAD2L1,chr4,R,120059421,120066858,10458910,7437,397144462,26810,4
4086,SMAD1,chr4,F,145481305,145559176,10536781,77871,397222333,26811,13
4126,MANBA,chr4,R,102631485,102760994,10666290,129509,397351842,26812,18
4258,MGST2,chr4,F,139665767,139740745,10741268,74978,397426820,26813,6
4283,CXCL9,chr4,R,76001341,76007523,10747450,6182,397433002,26814,3
4299,AFF1,chr4,F,86934510,87141054,10953994,206544,397639546,26815,23
4306,NR3C2,chr4,R,148078763,148445278,11320509,366515,398006061,26816,11
4487,MSX1,chr4,F,4859664,4863936,11324781,4272,398010333,26817,1
4543,MTNR1A,chr4,R,186532999,186555383,11347165,22384,398032717,26818,2
4547,MTTP,chr4,F,99564077,99623997,11407085,59920,398092637,26819,18
4589,MUC7,chr4,F,70430491,70482997,11459591,52506,398145143,26820,4
4636,MYL5,chr4,F,674211,682028,11467408,7817,398152960,26821,7
4717,NDUFC1,chr4,R,139289916,139302551,11480043,12635,398165595,26822,7
4750,NEK1,chr4,R,169393269,169612629,11699403,219360,398384955,26823,35
4790,NFKB1,chr4,F,102501328,102617302,11815377,115974,398500929,26824,25
4825,NKX6-1,chr4,R,84491986,84499141,11822532,7155,398508084,26825,3
4886,NPY1R,chr4,R,163323961,163344832,11843403,20871,398528955,26826,4
4887,NPY2R,chr4,F,155173753,155217096,11886746,43343,398572298,26827,2
4889,NPY5R,chr4,F,163343867,163352403,11895282,8536,398580834,26828,7
5099,PCDH7,chr4,F,30720318,31146801,12321765,426483,399007317,26829,7
5156,PDGFRA,chr4,F,54229096,54298245,12390914,69149,399076466,26830,27
5158,PDE6B,chr4,F,587324,670892,12474482,83568,399160034,26831,25
5161,PDHA2,chr4,F,95840087,95841474,12475869,1387,399161421,26832,0
5188,GATB,chr4,R,151670051,151761023,12566841,90972,399252393,26833,13
5196,PF4,chr4,R,73980824,73982124,12568141,1300,399253693,26834,3
5197,PF4V1,chr4,F,73853295,73854481,12569327,1186,399254879,26835,2
5308,PITX2,chr4,R,110617422,110642123,12594028,24701,399279580,26836,8
5311,PKD2,chr4,F,88007638,88077779,12664169,70141,399349721,26837,16
5356,PLRG1,chr4,R,154534996,154550433,12679606,15437,399365158,26838,14
5393,EXOSC9,chr4,F,121801294,121817021,12695333,15727,399380885,26839,13
5431,POLR2B,chr4,F,56978639,57031162,12747856,52523,399433408,26840,25
5458,POU4F2,chr4,F,146638892,146642471,12751435,3579,399436987,26841,1
5470,PPEF2,chr4,R,75859871,75902528,12794092,42657,399479644,26842,16
5471,PPAT,chr4,R,56393361,56435636,12836367,42275,399521919,26843,10
5473,PPBP,chr4,R,73986438,73988190,12838119,1752,399523671,26844,2
5481,PPID,chr4,R,158709126,158723400,12852393,14274,399537945,26845,9
5522,PPP2R2C,chr4,R,6320577,6563600,13095416,243023,399780968,26846,15
5530,PPP3CA,chr4,R,101023429,101347471,13419458,324042,400105010,26847,13
5593,PRKG2,chr4,R,81087369,81216743,13548832,129374,400234384,26848,23
5602,MAPK10,chr4,R,86012298,86594110,14130644,581812,400816196,26849,21
5783,PTPN13,chr4,F,86594306,86815179,14351517,220873,401037069,26850,48
5860,QDPR,chr4,R,17486392,17512234,14377359,25842,401062911,26851,6
5910,RAP1GDS1,chr4,F,98261375,98443861,14559845,182486,401245397,26852,15
5978,REST,chr4,F,56907875,56935845,14587815,27970,401273367,26853,7
5981,RFC1,chr4,R,39287448,39366381,14666748,78933,401352300,26854,24
6002,RGS12,chr4,F,3292977,3439913,14813684,146936,401499236,26855,20
6047,RNF4,chr4,F,2469067,2515859,14860476,46792,401546028,26856,9
6059,ABCE1,chr4,F,145098003,145129524,14891997,31521,401577549,26857,17
6133,RPL9,chr4,R,39454123,39458948,14896822,4825,401582374,26858,7
6164,RPL34,chr4,F,108620565,108630484,14906741,9919,401592293,26859,5
6189,RPS3A,chr4,F,151099572,151104652,14911821,5080,401597373,26860,4
6286,S100P,chr4,F,6693838,6697170,14915153,3332,401600705,26861,1
6307,MSMO1,chr4,F,165327665,165343164,14930652,15499,401616204,26862,5
6372,CXCL6,chr4,F,73836555,73838760,14932857,2205,401618409,26863,3
6373,CXCL11,chr4,R,76033681,76036197,14935373,2516,401620925,26864,3
6374,CXCL5,chr4,R,73995641,73998729,14938461,3088,401624013,26865,3
6423,SFRP2,chr4,R,153780589,153789076,14946948,8487,401632500,26866,2
6443,SGCB,chr4,R,52020694,52038319,14964573,17625,401650125,26867,6
6452,SH3BP2,chr4,F,2793022,2841096,15012647,48074,401698199,26868,20
6622,SNCA,chr4,R,89724098,89838314,15126863,114216,401812415,26869,8
6649,SOD3,chr4,F,24795462,24800845,15132246,5383,401817798,26870,1
6691,SPINK2,chr4,R,56809859,56822176,15144563,12317,401830115,26871,3
6696,SPP1,chr4,F,87975649,87983411,15152325,7762,401837877,26872,7
6731,SRP72,chr4,F,56467595,56503681,15188411,36086,401873963,26873,19
6779,STATH,chr4,F,69995930,70002456,15194937,6526,401880489,26874,5
6783,SULT1E1,chr4,R,69841211,69860765,15214491,19554,401900043,26875,9
6870,TACR3,chr4,R,103589467,103719816,15344840,130349,402030392,26876,4
6999,TDO2,chr4,F,155903692,155920406,15361554,16714,402047106,26877,11
7006,TEC,chr4,R,48135782,48269797,15495569,134015,402181121,26878,19
7092,TLL1,chr4,F,165873237,166105178,15727510,231941,402413062,26879,23
7096,TLR1,chr4,R,38787554,38805800,15745756,18246,402431308,26880,6
7097,TLR2,chr4,F,153684255,153706091,15767592,21836,402453144,26881,3
7098,TLR3,chr4,F,186069154,186085098,15783536,15944,402469088,26882,4
7222,TRPC3,chr4,R,121879027,121951891,15856400,72864,402541952,26883,13
7294,TXK,chr4,R,48066392,48134256,15924264,67864,402609816,26884,15
7323,UBE2D3,chr4,R,102794382,102868893,15998775,74511,402684327,26885,10
7345,UCHL1,chr4,F,41256880,41268429,16010324,11549,402695876,26886,8
7350,UCP1,chr4,R,140559393,140568902,16019833,9509,402705385,26887,6
7358,UGDH,chr4,R,39498754,39527598,16048677,28844,402734229,26888,12
7363,UGT2B4,chr4,R,69480164,69526014,16094527,45850,402780079,26889,6
7364,UGT2B7,chr4,F,69051248,69112987,16156266,61739,402841818,26890,9
7365,UGT2B10,chr4,F,68815992,68832017,16172291,16025,402857843,26891,5
7366,UGT2B15,chr4,R,68646596,68670776,16196471,24180,402882023,26892,5
7367,UGT2B17,chr4,R,68537183,68568527,16227815,31344,402913367,26893,5
7368,UGT8,chr4,F,114598402,114678225,16307638,79823,402993190,26894,7
7424,VEGFC,chr4,R,176683533,176792745,16416850,109212,403102402,26895,6
7466,WFS1,chr4,F,6269849,6303265,16450266,33416,403135818,26896,7
7468,WHSC1,chr4,F,1871395,1982207,16561078,110812,403246630,26897,27
7469,NELFA,chr4,R,1982713,2041914,16620279,59201,403305831,26898,14
7700,ZNF141,chr4,F,337806,373959,16656432,36153,403341984,26899,4
7884,SLBP,chr4,R,1692799,1712694,16676327,19895,403361879,26900,7
8001,GLRA3,chr4,R,174624140,174829315,16881502,205175,403567054,26901,12
8310,ACOX3,chr4,R,8366262,8440725,16955965,74463,403641517,26902,21
8404,SPARCL1,chr4,R,87473329,87529503,17012139,56174,403697691,26903,13
8467,SMARCA5,chr4,F,143513462,143557489,17056166,44027,403741718,26904,23
8470,SORBS2,chr4,R,185585443,185956716,17427439,371273,404112991,26905,36
8492,PRSS12,chr4,R,118280037,118352815,17500217,72778,404185769,26906,14
8532,CPZ,chr4,F,8592659,8619761,17527319,27102,404212871,26907,10
8602,NOP14,chr4,R,2937935,2963506,17552890,25571,404238442,26908,17
8603,FAM193A,chr4,F,2596287,2732575,17689178,136288,404374730,26909,26
8615,USO1,chr4,F,75724521,75814289,17778946,89768,404464498,26910,25
8633,UNC5C,chr4,R,95162503,95549210,18165653,386707,404851205,26911,16
8649,LAMTOR3,chr4,R,99878337,99894546,18181862,16209,404867414,26912,6
8654,PDE5A,chr4,R,119494394,119628826,18316294,134432,405001846,26913,22
8671,SLC4A4,chr4,F,71187285,71572087,18701096,384802,405386648,26914,26
8819,SAP30,chr4,F,173370941,173377532,18707687,6591,405393239,26915,3
8821,INPP4B,chr4,R,142028027,142846535,19526195,818508,406211747,26916,38
8842,PROM1,chr4,R,15968225,16119884,19677854,151659,406363406,26917,38
8916,HERC3,chr4,F,88592422,88709297,19794729,116875,406480281,26918,28
8929,PHOX2B,chr4,R,41744081,41748970,19799618,4889,406485170,26919,2
8944,SNORD73A,chr4,F,151103826,151103891,19799683,65,406485235,26920,0
8987,STBD1,chr4,F,76306025,76311130,19804788,5105,406490340,26921,6
8999,CDKL2,chr4,R,75576493,75630537,19858832,54044,406544384,26922,13
9061,PAPSS1,chr4,R,107613665,107720263,19965430,106598,406650982,26923,12
9079,LDB2,chr4,R,16501533,16898809,20362706,397276,407048258,26924,13
9227,LRAT,chr4,F,154626960,154753119,20488865,126159,407174417,26925,6
9255,AIMP1,chr4,F,106315609,106349225,20522481,33616,407208033,26926,8
9348,NDST3,chr4,F,118033825,118258634,20747290,224809,407432842,26927,16
9353,SLIT2,chr4,F,20251924,20620561,21115927,368637,407801479,26928,39
9364,RAB28,chr4,R,13296016,13484365,21304276,188349,407989828,26929,16
9407,TMPRSS11D,chr4,R,67820875,67883998,21367399,63123,408052951,26930,9
9429,ABCG2,chr4,R,88090263,88231417,21508553,141154,408194105,26931,18
9464,HAND2,chr4,R,173526500,173530227,21512280,3727,408197832,26932,1
9508,ADAMTS3,chr4,R,72280968,72568799,21800111,287831,408485663,26933,26
9575,CLOCK,chr4,R,55427900,55546909,21919120,119009,408604672,26934,26
9662,CEP135,chr4,F,55948807,56033363,22003676,84556,408689228,26935,25
9693,RAPGEF2,chr4,F,159104070,159360162,22259768,256092,408945320,26936,34
9778,KIAA0232,chr4,F,6782731,6884172,22361209,101441,409046761,26937,13
9848,MFAP3L,chr4,R,169986596,170033028,22407641,46432,409093193,26938,10
9871,SEC24D,chr4,R,118722822,118838683,22523502,115861,409209054,26939,25
9908,G3BP2,chr4,R,75642768,75724525,22605259,81757,409290811,26940,18
9948,WDR1,chr4,R,10074338,10116949,22647870,42611,409333422,26941,15
9957,HS3ST1,chr4,R,11398363,11429567,22679074,31204,409364626,26942,2
9982,FGFBP1,chr4,R,15935568,15938740,22682246,3172,409367798,26943,2
9987,HNRNPDL,chr4,R,82422563,82430225,22689908,7662,409375460,26944,8
10098,TSPAN5,chr4,R,98470366,98658661,22878203,188295,409563755,26945,7
10117,ENAM,chr4,F,70628743,70646819,22896279,18076,409581831,26946,7
10141,LINC01587,chr4,F,5524568,5527801,22899512,3233,409585064,26947,3
10144,FAM13A,chr4,R,88725953,89111398,23284957,385445,409970509,26948,29
10227,MFSD10,chr4,R,2930559,2934868,23289266,4309,409974818,26949,11
10252,SPRY1,chr4,F,123396790,123403760,23296236,6970,409981788,26950,3
10296,MAEA,chr4,F,1289850,1340148,23346534,50298,410032086,26951,13
10333,TLR6,chr4,R,38823703,38857711,23380542,34008,410066094,26952,5
10336,PCGF3,chr4,F,705747,770640,23445435,64893,410130987,26953,16
10393,ANAPC10,chr4,R,144967116,145098541,23576860,131425,410262412,26954,13
10396,ATP8A1,chr4,R,42408372,42657105,23825593,248733,410511145,26955,38
10417,SPON2,chr4,R,1166931,1208962,23867624,42031,410553176,26956,8
10424,PGRMC2,chr4,R,128269236,128288829,23887217,19593,410572769,26957,3
10427,SEC24B,chr4,F,109433771,109540459,23993905,106688,410679457,26958,27
10460,TACC3,chr4,F,1721489,1745178,24017594,23689,410703146,26959,17
10463,SLC30A9,chr4,F,41990471,42087534,24114657,97063,410800209,26960,17
10563,CXCL13,chr4,F,77511752,77611834,24214739,100082,410900291,26961,4
10568,SLC34A2,chr4,F,25655812,25678748,24237675,22936,410923227,26962,13
10586,MAB21L2,chr4,F,150581924,150584693,24240444,2769,410925996,26963,0
10606,PAICS,chr4,F,56435748,56461368,24266064,25620,410951616,26964,10
10608,MXD4,chr4,R,2247431,2262143,24280776,14712,410966328,26965,9
10611,PDLIM5,chr4,F,94451856,94668227,24497147,216371,411182699,26966,21
10692,RRH,chr4,F,109827993,109844707,24513861,16714,411199413,26967,6
10699,CORIN,chr4,R,47593997,47838106,24757970,244109,411443522,26968,21
10720,UGT2B11,chr4,R,69199654,69216768,24775084,17114,411460636,26969,5
10733,PLK4,chr4,F,127880860,127899224,24793448,18364,411479000,26970,16
10744,PTTG2,chr4,F,37960434,37961010,24794024,576,411479576,26971,0
10815,CPLX1,chr4,R,784956,826157,24835225,41201,411520777,26972,4
10855,HPSE,chr4,R,83292460,83335153,24877918,42693,411563470,26973,12
10861,SLC26A1,chr4,R,979072,994217,24893063,15145,411578615,26974,3
10874,NMU,chr4,R,55595228,55636698,24934533,41470,411620085,26975,12
10879,SMR3B,chr4,F,70383077,70390244,24941700,7167,411627252,26976,2
10886,NPFFR2,chr4,F,72031803,72148201,25058098,116398,411743650,26977,5
10891,PPARGC1A,chr4,R,23792020,24472771,25738849,680751,412424401,26978,23
10895,PPBPP2,chr4,R,74054037,74055399,25740211,1362,412425763,26979,0
10941,UGT2A1,chr4,R,69588416,69653249,25805044,64833,412490596,26980,8
10983,CCNI,chr4,R,77047154,77076013,25833903,28859,412519455,26981,6
11019,LIAS,chr4,F,39459023,39477653,25852533,18630,412538085,26982,10
11086,ADAM29,chr4,F,174918357,174978180,25912356,59823,412597908,26983,8
11107,PRDM5,chr4,R,120684927,120922866,26150295,237939,412835847,26984,20
11157,LSM6,chr4,F,146175682,146190061,26164674,14379,412850226,26985,3
11162,NUDT6,chr4,R,122892643,122923004,26195035,30361,412880587,26986,5
11199,ANXA10,chr4,F,168092525,168187742,26290252,95217,412975804,26987,12
11275,KLHL2,chr4,F,165207617,165323156,26405791,115539,413091343,26988,19
11341,SCRG1,chr4,R,173388147,173476691,26494335,88544,413179887,26989,4
22824,HSPA4L,chr4,F,127782208,127834073,26546200,51865,413231752,26990,20
22872,SEC31A,chr4,R,82818660,82891280,26618820,72620,413304372,26991,28
22902,RUFY3,chr4,F,70704685,70808622,26722757,103937,413408309,26992,22
22915,MMRN1,chr4,F,89894875,89954629,26782511,59754,413468063,26993,7
22998,LIMCH1,chr4,F,41359606,41700044,27122949,340438,413808501,26994,39
23001,WDFY3,chr4,R,84669536,84966391,27419804,296855,414105356,26995,71
23022,PALLD,chr4,F,168497063,168928457,27851198,431394,414536750,26996,27
23142,DCUN1D4,chr4,F,51842999,51916837,27925036,73838,414610588,26997,17
23158,TBC1D9,chr4,R,140620781,140756317,28060572,135536,414746124,26998,20
23173,METAP1,chr4,F,98995636,99062809,28127745,67173,414813297,26999,14
23216,TBC1D1,chr4,F,37891083,38139175,28375837,248092,415061389,27000,30
23231,SEL1L3,chr4,R,25721866,25863595,28517566,141729,415203118,27001,26
23240,KIAA0922,chr4,F,153466345,153637608,28688829,171263,415374381,27002,36
23244,PDS5A,chr4,R,39822862,39977956,28843923,155094,415529475,27003,34
23284,ADGRL3,chr4,F,61383123,62078335,29539135,695212,416224687,27004,26
23321,TRIM2,chr4,F,153152468,153339322,29725989,186854,416411541,27005,18
23324,MAN2B2,chr4,F,6575173,6622403,29773219,47230,416458771,27006,19
23520,ANP32C,chr4,R,164197006,164197711,29773924,705,416459476,27007,0
23657,SLC7A11,chr4,R,138164093,138312660,29922491,148567,416608043,27008,21
25819,CCRN4L,chr4,F,139015758,139045939,29952672,30181,416638224,27009,2
25849,PARM1,chr4,F,74933074,75050115,30069713,117041,416755265,27010,4
25854,FAM149A,chr4,F,186144286,186172663,30098090,28377,416783642,27011,16
25898,RCHY1,chr4,R,75479036,75514744,30133798,35708,416819350,27012,9
26057,ANKRD17,chr4,R,73074784,73259142,30318156,184358,417003708,27013,36
26228,STAP1,chr4,F,67558727,67607337,30366766,48610,417052318,27014,8
26234,FBXL5,chr4,R,15604383,15659917,30422300,55534,417107852,27015,13
26269,FBXO8,chr4,R,174236657,174284263,30469906,47606,417155458,27016,6
26511,CHIC2,chr4,R,54008372,54065427,30526961,57055,417212513,27017,7
26952,SMR3A,chr4,F,70360775,70367106,30533292,6331,417218844,27018,2
27065,NSG1,chr4,F,4386255,4419058,30566095,32803,417251647,27019,5
27068,PPA2,chr4,R,105369076,105474070,30671089,104994,417356641,27020,11
27071,DAPP1,chr4,F,99816823,99872249,30726515,55426,417412067,27021,12
27123,DKK2,chr4,R,106921801,107036296,30841010,114495,417526562,27022,3
27146,FAM184B,chr4,R,17632072,17781527,30990465,149455,417676017,27023,17
27152,INTU,chr4,F,127623270,127716779,31083974,93509,417769526,27024,19
27163,NAAA,chr4,R,75910654,75941013,31114333,30359,417799885,27025,14
27201,GPR78,chr4,F,8580236,8590023,31124120,9787,417809672,27026,2
27235,COQ2,chr4,R,83138600,83285089,31270609,146489,417956161,27027,21
27236,ARFIP1,chr4,F,152779936,152911912,31402585,131976,418088137,27028,13
27284,SULT1B1,chr4,R,69726119,69760712,31437178,34593,418122730,27029,9
27295,PDLIM3,chr4,R,185500659,185535607,31472126,34948,418157678,27030,8
27306,HPGDS,chr4,R,94298555,94342876,31516447,44321,418201999,27031,5
27309,ZNF330,chr4,F,141220293,141234697,31530851,14404,418216403,27032,10
28983,TMPRSS11E,chr4,F,68447448,68497604,31581007,50156,418266559,27033,9
29063,ZCCHC4,chr4,F,25312773,25373176,31641410,60403,418326962,27034,14
29945,ANAPC4,chr4,F,25377225,25418498,31682683,41273,418368235,27035,28
50859,SPOCK3,chr4,R,166733383,167234796,32184096,501413,418869648,27036,14
51023,MRPS18C,chr4,F,83455931,83461723,32189888,5792,418875440,27037,5
51056,LAP3,chr4,F,17577303,17607967,32220552,30664,418906104,27038,12
51088,KLHL5,chr4,F,39044800,39142823,32318575,98023,419004127,27039,15
51091,SEPSECS,chr4,R,25120004,25160582,32359153,40578,419044705,27040,12
51138,COPS4,chr4,F,83035085,83075818,32399886,40733,419085438,27041,10
51166,AADAT,chr4,R,170060221,170091699,32431364,31478,419116916,27042,17
51170,HSD17B11,chr4,R,87336521,87391303,32486146,54782,419171698,27043,7
51176,LEF1,chr4,R,108047544,108168956,32607558,121412,419293110,27044,12
51191,HERC5,chr4,F,88457116,88506170,32656612,49054,419342164,27045,23
51274,KLF3,chr4,F,38664168,38701508,32693952,37340,419379504,27046,7
51313,FAM198B,chr4,R,158124579,158173050,32742423,48471,419427975,27047,5
51316,PLAC8,chr4,R,83090047,83114758,32767134,24711,419452686,27048,5
51574,LARP7,chr4,F,112636963,112657592,32787763,20629,419473315,27049,15
51705,EMCN,chr4,R,100395340,100518093,32910516,122753,419596068,27050,12
51778,MYOZ2,chr4,F,119135783,119187789,32962522,52006,419648074,27051,6
51802,ASIC5,chr4,R,155829728,155866273,32999067,36545,419684619,27052,9
51809,GALNT7,chr4,F,173168752,173323967,33154282,155215,419839834,27053,13
53343,NUDT9,chr4,F,87422556,87459454,33191180,36898,419876732,27054,9
53371,NUP54,chr4,R,76114658,76148515,33225037,33857,419910589,27055,13
53407,STX18,chr4,R,4418967,4542232,33348302,123265,420033854,27056,14
53834,FGFRL1,chr4,F,1009978,1026898,33365222,16920,420050774,27057,10
53842,CLDN22,chr4,R,183318066,183320774,33367930,2708,420053482,27058,0
54360,CYTL1,chr4,R,5014585,5019470,33372815,4885,420058367,27059,3
54433,GAR1,chr4,F,109815509,109824737,33382043,9228,420067595,27060,6
54436,SH3TC1,chr4,F,8182071,8241103,33441075,59032,420126627,27061,19
54490,UGT2B28,chr4,F,69280467,69295050,33455658,14583,420141210,27062,5
54502,RBM47,chr4,R,40423254,40630786,33663190,207532,420348742,27063,14
54510,PCDH18,chr4,R,137518917,137532498,33676771,13581,420362323,27064,3
54532,USP53,chr4,F,119212617,119295518,33759672,82901,420445224,27065,20
54553,DKFZP434I0714,chr4,F,152536263,152539263,33762672,3000,420448224,27066,0
54726,OTUD4,chr4,R,145133649,145179973,33808996,46324,420494548,27067,21
54729,NKX1-1,chr4,R,1402931,1406442,33812507,3511,420498059,27068,1
54790,TET2,chr4,F,105145874,105279803,33946436,133929,420631988,27069,10
54798,DCHS2,chr4,R,154234374,154491778,34203840,257404,420889392,27070,29
54848,ARHGEF38,chr4,F,105552521,105682539,34333858,130018,421019410,27071,16
54872,PIGG,chr4,F,499199,539921,34374580,40722,421060132,27072,16
54876,DCAF16,chr4,R,17800654,17810769,34384695,10115,421070247,27073,3
54940,OCIAD1,chr4,F,48831042,48861817,34415470,30775,421101022,27074,8
54951,COMMD8,chr4,R,47450792,47463665,34428343,12873,421113895,27075,4
54959,ODAM,chr4,F,70195725,70204576,34437194,8851,421122746,27076,11
54969,C4orf27,chr4,R,169729467,169757942,34465669,28475,421151221,27077,7
55008,HERC6,chr4,F,88378534,88443097,34530232,64563,421215784,27078,22
55013,CCDC109B,chr4,F,109560198,109688645,34658679,128447,421344231,27079,8
55016,MARCH1,chr4,R,163524297,164383989,35518371,859692,422203923,27080,10
55024,BANK1,chr4,F,101790606,102074812,35802577,284206,422488129,27081,17
55132,LARP1B,chr4,F,128061265,128222931,35964243,161666,422649795,27082,27
55153,SDAD1,chr4,R,75949905,75990962,36005300,41057,422690852,27083,21
55161,TMEM33,chr4,F,41935119,41960807,36030988,25688,422716540,27084,6
55203,LGI2,chr4,R,24998848,25030792,36062932,31944,422748484,27085,8
55212,BBS7,chr4,R,121824328,121870497,36109101,46169,422794653,27086,18
55236,UBA6,chr4,R,67615760,67701171,36194512,85411,422880064,27087,32
55247,NEIL3,chr4,F,177309836,177362938,36247614,53102,422933166,27088,9
55276,PGM2,chr4,F,37826659,37862938,36283893,36279,422969445,27089,14
55286,C4orf19,chr4,F,37453453,37593510,36423950,140057,423109502,27090,7
55294,FBXW7,chr4,R,152321257,152536095,36638788,214838,423324340,27091,15
55296,TBC1D19,chr4,F,26583923,26769771,36824636,185848,423510188,27092,28
55300,PI4K2B,chr4,F,25234030,25279209,36869815,45179,423555367,27093,10
55314,TMEM144,chr4,F,158201603,158255287,36923499,53684,423609051,27094,15
55319,TMA16,chr4,F,163494288,163520539,36949750,26251,423635302,27095,7
55325,UFSP2,chr4,R,185399539,185425985,36976196,26446,423661748,27096,12
55330,BLOC1S4,chr4,F,6716114,6717660,36977742,1546,423663294,27097,0
55345,ZGRF1,chr4,R,112539332,112636995,37075405,97663,423760957,27098,30
55351,STK32B,chr4,F,5051210,5500998,37525193,449788,424210745,27099,21
55435,AP1AR,chr4,F,112231736,112272715,37566172,40979,424251724,27100,10
55534,MAML3,chr4,R,139716390,140154079,38003861,437689,424689413,27101,4
55584,CHRNA9,chr4,F,40335328,40355217,38023750,19889,424709302,27102,4
55589,BMP2K,chr4,F,78776377,78916365,38163738,139988,424849290,27103,17
55601,DDX60,chr4,R,168216290,168318807,38266255,102517,424951807,27104,39
55602,CDKN2AIP,chr4,F,183444634,183449064,38270685,4430,424956237,27105,2
55646,LYAR,chr4,R,4267700,4290169,38293154,22469,424978706,27106,9
55714,TENM3,chr4,F,182323983,182803024,38772195,479041,425457747,27107,30
55728,N4BP2,chr4,F,40056211,40185798,38901782,129587,425587334,27108,20
55751,TMEM184C,chr4,F,147617370,147635523,38919935,18153,425605487,27109,9
55752,SEPT11,chr4,F,76949741,77040154,39010348,90413,425695900,27110,12
55763,EXOC1,chr4,F,55853635,55905078,39061791,51443,425747343,27111,21
55805,LRP2BP,chr4,R,185363877,185396935,39094849,33058,425780401,27112,9
55858,TMEM165,chr4,F,55395912,55452974,39151911,57062,425837463,27113,7
56034,PDGFC,chr4,R,156761610,156971394,39361695,209784,426047247,27114,8
56606,SLC2A9,chr4,R,9771124,10040248,39630819,269124,426316371,27115,23
56884,FSTL5,chr4,R,161383891,162164034,40410962,780143,427096514,27116,15
56898,BDH2,chr4,R,103077624,103099867,40433205,22243,427118757,27117,11
56916,SMARCAD1,chr4,F,94207607,94291292,40516890,83685,427202442,27118,29
56955,MEPE,chr4,F,87821397,87846817,40542310,25420,427227862,27119,6
56977,STOX2,chr4,F,183796330,184023526,40769506,227196,427455058,27120,10
56978,PRDM8,chr4,F,80183740,80204329,40790095,20589,427475647,27121,12
57050,UTP3,chr4,F,70688478,70690551,40792168,2073,427477720,27122,0
57117,INTS12,chr4,R,105682626,105708729,40818271,26103,427503823,27123,10
57182,ANKRD50,chr4,R,124664047,124713220,40867444,49173,427552996,27124,5
57205,ATP10D,chr4,F,47485270,47593486,40975660,108216,427661212,27125,24
57291,DANCR,chr4,F,52712453,52714138,40977345,1685,427662897,27126,2
57482,KIAA1211,chr4,F,56049228,56330724,41258841,281496,427944393,27127,18
57484,RNF150,chr4,R,140859806,141212869,41611904,353063,428297456,27128,9
57495,NWD2,chr4,F,37245067,37449465,41816302,204398,428501854,27129,6
57533,TBC1D14,chr4,F,6909443,7033118,41939977,123675,428625529,27130,19
57537,SORCS2,chr4,F,7192606,7742837,42490208,550231,429175760,27131,29
57545,CC2D2A,chr4,F,15469860,15601971,42622319,132111,429307871,27132,39
57563,KLHL8,chr4,R,87160102,87220608,42682825,60506,429368377,27133,10
57575,PCDH10,chr4,F,133149289,133208606,42742142,59317,429427694,27134,5
57587,CFAP97,chr4,R,185151722,185209495,42799915,57773,429485467,27135,9
57600,FNIP2,chr4,F,158769029,158908050,42938936,139021,429624488,27136,21
57606,SLAIN2,chr4,F,48341479,48426201,43023658,84722,429709210,27137,8
57619,SHROOM3,chr4,F,76435099,76783253,43371812,348154,430057364,27138,17
57620,STIM2,chr4,F,26860690,27025381,43536503,164691,430222055,27139,13
57630,SH3RF1,chr4,R,169094255,169271098,43713346,176843,430398898,27140,11
57654,UVSSA,chr4,F,1345657,1388049,43755738,42392,430441290,27141,23
57721,METTL14,chr4,F,118685363,118712270,43782645,26907,430468197,27142,11
57728,WDR19,chr4,F,39182188,39285810,43886267,103622,430571819,27143,36
57732,ZFYVE28,chr4,R,2267523,2418690,44037434,151167,430722986,27144,17
57733,GBA3,chr4,F,22692913,22819575,44164096,126662,430849648,27145,5
58478,ENOPH1,chr4,F,82430479,82461175,44194792,30696,430880344,27146,5
58503,PROL1,chr4,F,70397881,70410197,44207108,12316,430892660,27147,3
58505,OSTC,chr4,F,108650584,108667822,44224346,17238,430909898,27148,4
59067,IL21,chr4,R,122612627,122621057,44232776,8430,430918328,27149,3
59350,RXFP1,chr4,F,158521713,158653372,44364435,131659,431049987,27150,21
60312,AFAP1,chr4,R,7758712,7939926,44545649,181214,431231201,27151,19
60558,GUF1,chr4,F,44678394,44700928,44568183,22534,431253735,27152,16
60559,SPCS3,chr4,F,176319938,176332245,44580490,12307,431266042,27153,4
60592,SCOC,chr4,F,140257285,140382556,44705761,125271,431391313,27154,5
60684,TRAPPC11,chr4,F,183659266,183713594,44760089,54328,431445641,27155,30
63973,NEUROG2,chr4,R,112513515,112516172,44762746,2657,431448298,27156,1
64116,SLC39A8,chr4,R,102251040,102345498,44857204,94458,431542756,27157,13
64151,NCAPG,chr4,F,17810812,17844865,44891257,34053,431576809,27158,20
64399,HHIP,chr4,F,144645995,144741400,44986662,95405,431672214,27159,12
64579,NDST4,chr4,R,114827774,115113876,45272764,286102,431958316,27160,13
64850,ETNPPL,chr4,R,108742039,108763079,45293804,21040,431979356,27161,13
64854,USP46,chr4,R,52590959,52659335,45362180,68376,432047732,27162,10
65008,MRPL1,chr4,F,77861954,77952790,45453016,90836,432138568,27163,11
65997,RASL11B,chr4,F,52862327,52866835,45457524,4508,432143076,27164,3
79071,ELOVL6,chr4,R,110049072,110199199,45607651,150127,432293203,27165,6
79155,TNIP2,chr4,R,2741659,2756376,45622368,14717,432307920,27166,5
79441,HAUS3,chr4,R,2231835,2242164,45632697,10329,432318249,27167,25
79625,NDNF,chr4,R,121035626,121072518,45669589,36892,432355141,27168,3
79633,FAT4,chr4,F,125315896,125492932,45846625,177036,432532177,27169,17
79642,ARSJ,chr4,R,113900283,113981430,45927772,81147,432613324,27170,5
79644,SRD5A3,chr4,F,55346220,55373100,45954652,26880,432640204,27171,4
79658,ARHGAP10,chr4,F,147732062,148072779,46295369,340717,432980921,27172,24
79667,KLF3-AS1,chr4,R,38612700,38664628,46347297,51928,433032849,27173,7
79682,CENPU,chr4,R,184694064,184734132,46387365,40068,433072917,27174,13
79725,THAP9,chr4,F,82900683,82920283,46406965,19600,433092517,27175,6
79730,NSUN7,chr4,F,40749896,40809985,46467054,60089,433152606,27176,11
79799,UGT2A3,chr4,R,68928458,68951798,46490394,23340,433175946,27177,6
79804,HAND2-AS1,chr4,F,173530457,173541830,46501767,11373,433187319,27178,3
79807,GSTCD,chr4,F,105708777,105847725,46640715,138948,433326267,27179,15
79884,MAP9,chr4,R,155342657,155376970,46675028,34313,433360580,27180,13
79931,TNIP3,chr4,R,121131407,121227609,46771230,96202,433456782,27181,19
79960,JADE1,chr4,F,128809622,128875224,46836832,65602,433522384,27182,14
79963,ABCA11P,chr4,R,425434,474209,46885607,48775,433571159,27183,2
79966,SCD5,chr4,R,82629536,82798857,47054928,169321,433740480,27184,5
79982,DNAJB14,chr4,R,99896247,99946726,47105407,50479,433790959,27185,12
80008,TMEM156,chr4,R,38966015,39032669,47172061,66654,433857613,27186,10
80014,WWC2,chr4,F,183098634,183320777,47394204,222143,434079756,27187,22
80144,FRAS1,chr4,F,78056967,78544269,47881506,487302,434567058,27188,73
80155,NAA15,chr4,F,139301466,139390781,47970821,89315,434656373,27189,19
80157,CWH43,chr4,F,48986246,49062079,48046654,75833,434732206,27190,17
80167,C4orf29,chr4,F,127965260,128036326,48117720,71066,434803272,27191,16
80216,ALPK1,chr4,F,112297335,112442618,48263003,145283,434948555,27192,16
80273,GRPEL1,chr4,R,7060052,7068073,48271024,8021,434956576,27193,3
80306,MED28,chr4,F,17614627,17625628,48282025,11001,434967577,27194,3
80319,CXXC4,chr4,R,104468305,104494901,48308621,26596,434994173,27195,3
80333,KCNIP4,chr4,R,20728605,21948801,49528817,1220196,436214369,27196,14
80817,CEP44,chr4,F,174283676,174334355,49579496,50679,436265048,27197,12
80854,SETD7,chr4,R,139495659,139557157,49640994,61498,436326546,27198,8
81579,PLA2G12A,chr4,R,109709988,109730086,49661092,20098,436346644,27199,3
81608,FIP1L1,chr4,F,53377645,53462611,49746058,84966,436431610,27200,18
81793,TLR10,chr4,R,38772237,38782990,49756811,10753,436442363,27201,4
83447,SLC25A31,chr4,F,127730374,127774299,49800736,43925,436486288,27202,6
83452,RAB33B,chr4,F,139453231,139475916,49823421,22685,436508973,27203,2
83478,ARHGAP24,chr4,F,85147741,86002670,50678350,854929,437363902,27204,14
83888,FGFBP2,chr4,R,15960239,15963236,50681347,2997,437366899,27205,1
83891,SNX25,chr4,F,185204241,185363969,50841075,159728,437526627,27206,22
83894,TTC29,chr4,R,146707026,146945882,51079931,238856,437765483,27207,16
84057,MND1,chr4,F,153344648,153415095,51150378,70447,437835930,27208,9
84068,SLC10A7,chr4,R,146253980,146521971,51418369,267991,438103921,27209,13
84076,TKTL2,chr4,R,163471094,163473895,51421170,2801,438106722,27210,0
84103,C4orf17,chr4,F,99511003,99542303,51452470,31300,438138022,27211,8
84109,QRFPR,chr4,R,121327210,121381059,51506319,53849,438191871,27212,7
84142,FAM175A,chr4,R,83460938,83485163,51530544,24225,438216096,27213,9
84162,KIAA1109,chr4,F,122152332,122362759,51740971,210427,438426523,27214,92
84179,MFSD7,chr4,R,674689,689468,51755750,14779,438441302,27215,11
84273,NOA1,chr4,R,56963349,56977660,51770061,14311,438455613,27216,6
84286,TMEM175,chr4,F,932386,958656,51796331,26270,438481883,27217,11
84448,ABLIM2,chr4,R,7965309,8158832,51989854,193523,438675406,27218,25
84525,HOPX,chr4,R,56647987,56681706,52023573,33719,438709125,27219,8
84570,COL25A1,chr4,R,108808724,109302752,52517601,494028,439203153,27220,50
84640,USP38,chr4,F,143184916,143223874,52556559,38958,439242111,27221,10
84708,LNX1,chr4,R,53460269,53652514,52748804,192245,439434356,27222,13
84709,MGARP,chr4,R,139266162,139280338,52762980,14176,439448532,27223,3
84740,AFAP1-AS1,chr4,F,7754089,7778928,52787819,24839,439473371,27224,1
84779,NAA11,chr4,R,79317117,79326017,52796719,8900,439482271,27225,1
84803,AGPAT9,chr4,F,83535913,83605875,52866681,69962,439552233,27226,15
84869,CBR4,chr4,R,168894622,169010317,52982376,115695,439667928,27227,8
84992,PIGY,chr4,R,88520977,88523801,52985200,2824,439670752,27228,1
85013,TMEM128,chr4,R,4235541,4248242,52997901,12701,439683453,27229,5
85438,CABS1,chr4,F,70334953,70337116,53000064,2163,439685616,27230,1
85460,ZNF518B,chr4,R,10439872,10457408,53017600,17536,439703152,27231,2
85462,FHDC1,chr4,F,152911569,152979696,53085727,68127,439771279,27232,16
90024,FLJ20021,chr4,F,101347776,101348883,53086834,1107,439772386,27233,1
90768,LOC90768,chr4,R,182138657,182144515,53092692,5858,439778244,27234,3
90826,PRMT9,chr4,R,147637784,147684230,53139138,46446,439824690,27235,11
91050,CCDC149,chr4,R,24806116,24980204,53313226,174088,439998778,27236,15
91351,DDX60L,chr4,R,168356734,168480515,53437007,123781,440122559,27237,45
91746,YTHDC1,chr4,R,68310386,68350106,53476727,39720,440162279,27238,16
92070,CTBP1-AS2,chr4,F,1249439,1253007,53480295,3568,440165847,27239,1
92305,TMEM129,chr4,R,1715951,1721357,53485701,5406,440171253,27240,5
92345,NAF1,chr4,R,163109132,163166921,53543490,57789,440229042,27241,13
92597,MOB1B,chr4,F,70901973,70988174,53629691,86201,440315243,27242,8
92610,TIFA,chr4,R,112275596,112285903,53639998,10307,440325550,27243,2
92689,FAM114A1,chr4,F,38867732,38945744,53718010,78012,440403562,27244,15
93587,TRMT10A,chr4,R,99546706,99564057,53735361,17351,440420913,27245,8
93621,MRFAP1,chr4,F,6640090,6642745,53738016,2655,440423568,27246,1
93622,LOC93622,chr4,F,6674093,6676047,53739970,1954,440425522,27247,1
93624,TADA2B,chr4,F,7043428,7057952,53754494,14524,440440046,27248,2
93627,TBCK,chr4,R,106044316,106316704,54026882,272388,440712434,27249,31
94031,HTRA3,chr4,F,8269753,8307111,54064240,37358,440749792,27250,9
113510,HELQ,chr4,R,83407342,83455883,54112781,48541,440798333,27251,19
113612,CYP2U1,chr4,F,107931548,107953461,54134694,21913,440820246,27252,4
114905,C1QTNF7,chr4,F,15339817,15446169,54241046,106352,440926598,27253,6
114932,MRFAP1L1,chr4,R,6707700,6709879,54243225,2179,440928777,27254,1
115265,DDIT4L,chr4,R,100185109,100190782,54248898,5673,440934450,27255,3
116449,CLNK,chr4,R,10489899,10734853,54493852,244954,441179404,27256,22
116966,WDR17,chr4,F,176065833,176182828,54610847,116995,441296399,27257,32
116984,ARAP2,chr4,R,36065997,36244357,54789207,178360,441474759,27258,32
118425,PCAT4,chr4,F,79827470,79863247,54824984,35777,441510536,27259,1
118429,ANTXR2,chr4,R,79901616,80073472,54996840,171856,441682392,27260,17
132299,OCIAD2,chr4,R,48885379,48906828,55018289,21449,441703841,27261,6
132320,SCLT1,chr4,R,128874417,129093607,55237479,219190,441923031,27262,26
132321,C4orf33,chr4,F,129093673,129112688,55256494,19015,441942046,27263,10
132332,TMEM155,chr4,R,121758929,121766042,55263607,7113,441949159,27264,9
132430,PABPC4L,chr4,R,134196332,134201748,55269023,5416,441954575,27265,1
132612,ADAD1,chr4,F,122378965,122429815,55319873,50850,442005425,27266,12
132625,ZFP42,chr4,F,187994053,188005050,55330870,10997,442016422,27267,4
132660,LIN54,chr4,R,82924602,83012941,55419209,88339,442104761,27268,13
132671,SPATA18,chr4,F,52051330,52097305,55465184,45975,442150736,27269,14
132720,C4orf32,chr4,F,112145396,112189081,55508869,43685,442194421,27270,1
132724,TMPRSS11B,chr4,R,68226652,68245694,55527911,19042,442213463,27271,9
132789,GNPDA2,chr4,R,44682410,44726634,55572135,44224,442257687,27272,9
132851,SPATA4,chr4,R,176184573,176195671,55583233,11098,442268785,27273,5
132864,CPEB2,chr4,F,15002450,15070153,55650936,67703,442336488,27274,13
132884,EVC2,chr4,R,5534396,5709548,55826088,175152,442511640,27275,23
132946,ARL9,chr4,F,56505208,56523983,55844863,18775,442530415,27276,6
132949,AASDH,chr4,R,56337686,56389418,55896595,51732,442582147,27277,16
132954,PDCL2,chr4,R,55556522,55592268,55932341,35746,442617893,27278,6
132989,C4orf36,chr4,R,86876204,86897123,55953260,20919,442638812,27279,6
133015,PACRGL,chr4,F,20696286,20766315,56023289,70029,442708841,27280,17
133022,TRAM1L1,chr4,R,117083553,117085580,56025316,2027,442710868,27281,0
133060,OTOP1,chr4,R,4188802,4226894,56063408,38092,442748960,27282,5
133121,ENPP6,chr4,R,184088705,184217961,56192664,129256,442878216,27283,7
133308,SLC9B2,chr4,R,103020229,103077371,56249806,57142,442935358,27284,13
140458,ASB5,chr4,R,176213672,176277571,56313705,63899,442999257,27285,10
150159,SLC9B1,chr4,R,102885047,103019739,56448397,134692,443133949,27286,17
152485,ZNF827,chr4,R,145757626,145938455,56629226,180829,443314778,27287,20
152503,SH3D19,chr4,R,151120280,151228030,56736976,107750,443422528,27288,22
152518,NFXL1,chr4,R,47847232,47914667,56804411,67435,443489963,27289,23
152519,NIPAL1,chr4,F,48016773,48040173,56827811,23400,443513363,27290,5
152559,PAQR3,chr4,R,78887222,78939428,56880017,52206,443565569,27291,14
152573,SHISA3,chr4,F,42397838,42402487,56884666,4649,443570218,27292,1
152578,LOC152578,chr4,F,52789993,52815464,56910137,25471,443595689,27293,4
152579,SCFD2,chr4,R,52872981,53366111,57403267,493130,444088819,27294,12
152586,MGAT4D,chr4,R,140442257,140499829,57460839,57572,444146391,27295,13
152641,WWC2-AS2,chr4,R,183097020,183099199,57463018,2179,444148570,27296,0
152687,ZNF595,chr4,F,53284,88211,57497945,34927,444183497,27297,5
152742,LINC01085,chr4,F,14111967,14140052,57526030,28085,444211582,27298,2
152756,FAM218A,chr4,F,164956947,164959121,57528204,2174,444213756,27299,0
152789,JAKMIP1,chr4,R,6026198,6200591,57702597,174393,444388149,27300,21
152815,THAP6,chr4,F,75509859,75544102,57736840,34243,444422392,27301,7
152816,C4orf26,chr4,F,75555509,75565893,57747224,10384,444432776,27302,4
152831,KLB,chr4,F,39406852,39451533,57791905,44681,444477457,27303,4
152877,FAM53A,chr4,R,1574061,1684313,57902157,110252,444587709,27304,8
152926,PPM1K,chr4,R,88257608,88284831,57929380,27223,444614932,27305,10
152940,C4orf45,chr4,R,158893531,159082867,58118716,189336,444804268,27306,9
152992,TRMT44,chr4,F,8440777,8516547,58194486,75770,444880038,27307,19
153020,RASGEF1B,chr4,R,81426392,81471928,58240022,45536,444925574,27308,13
166378,SPATA5,chr4,F,122923069,123319450,58636403,396381,445321955,27309,17
166379,BBS12,chr4,F,122700443,122744943,58680903,44500,445366455,27310,3
166614,DCLK2,chr4,F,150078273,150257457,58860087,179184,445545639,27311,17
166647,ADGRA3,chr4,R,22387373,22516058,58988772,128685,445674324,27312,22
166655,TRIM60,chr4,F,165025761,165041818,59004829,16057,445690381,27313,5
166752,FREM3,chr4,R,143577406,143700675,59128098,123269,445813650,27314,7
166785,MMAA,chr4,F,145619387,145660035,59168746,40648,445854298,27315,9
166793,ZBTB49,chr4,F,4290196,4321786,59200336,31590,445885888,27316,7
166815,TIGD2,chr4,F,89112816,89114901,59202421,2085,445887973,27317,0
166824,RASSF6,chr4,R,73571549,73620631,59251503,49082,445937055,27318,14
166863,RBM46,chr4,F,154781251,154828813,59299065,47562,445984617,27319,10
166929,SGMS2,chr4,F,107824334,107915047,59389778,90713,446075330,27320,11
170712,COX7B2,chr4,R,46734826,46909267,59564219,174441,446249771,27321,7
170825,GSX2,chr4,F,54100080,54101955,59566094,1875,446251646,27322,1
170960,ZNF721,chr4,R,439983,499171,59625282,59188,446310834,27323,2
171024,SYNPO2,chr4,F,118850687,119061247,59835842,210560,446521394,27324,6
201725,C4orf46,chr4,R,158666674,158672255,59841423,5581,446526975,27325,1
201780,SLC10A4,chr4,F,48483342,48489524,59847605,6182,446533157,27326,2
201798,TIGD4,chr4,R,152769353,152779789,59858041,10436,446543593,27327,3
201799,TMEM154,chr4,R,152626113,152680165,59912093,54052,446597645,27328,8
201853,LINC00504,chr4,R,14470464,14888169,60329798,417705,447015350,27329,6
201895,SMIM14,chr4,R,39547296,39638861,60421363,91565,447106915,27330,5
201931,TMEM192,chr4,R,165076077,165112913,60458199,36836,447143751,27331,5
201965,RWDD4,chr4,R,183639635,183659178,60477742,19543,447163294,27332,7
201973,PRIMPOL,chr4,F,184649612,184694959,60523089,45347,447208641,27333,15
202018,TAPT1,chr4,R,16160504,16227158,60589743,66654,447275295,27334,19
202020,TAPT1-AS1,chr4,F,16226662,16258187,60621268,31525,447306820,27335,2
205860,TRIML2,chr4,R,188091254,188109603,60639617,18349,447325169,27336,9
246175,CNOT6L,chr4,R,77713386,77820238,60746469,106852,447432021,27337,13
253017,TECRL,chr4,R,64276297,64409494,60879666,133197,447565218,27338,12
254251,LCORL,chr4,R,17841198,18021860,61060328,180662,447745880,27339,10
255119,C4orf22,chr4,F,80335325,80963756,61688759,628431,448374311,27340,10
255130,IGFBP7-AS1,chr4,F,57109761,57205299,61784297,95538,448469849,27341,4
255324,EPGN,chr4,F,74308269,74317298,61793326,9029,448478878,27342,5
255403,ZNF718,chr4,F,124475,202306,61871157,77831,448556709,27343,6
255520,ELMOD2,chr4,F,140524157,140553770,61900770,29613,448586322,27344,9
255743,NPNT,chr4,F,105894525,105971671,61977916,77146,448663468,27345,16
256309,CCDC110,chr4,R,185445181,185471759,62004494,26578,448690046,27346,11
256471,MFSD8,chr4,R,127917804,127965984,62052674,48180,448738226,27347,11
256880,LOC256880,chr4,F,99950493,100037705,62139886,87212,448825438,27348,3
257236,CCDC96,chr4,R,7040848,7043001,62142039,2153,448827591,27349,0
259282,BOD1L1,chr4,R,13568737,13627705,62201007,58968,448886559,27350,28
260436,FDCSP,chr4,F,70226070,70235252,62210189,9182,448895741,27351,4
266812,NAP1L5,chr4,R,88695914,88697872,62212147,1958,448897699,27352,0
285419,LINC01091,chr4,F,123652784,123930363,62489726,277579,449175278,27353,6
285422,LOC285422,chr4,R,145581464,145588021,62496283,6557,449181835,27354,2
285423,LOC285423,chr4,R,149150321,149815835,63161797,665514,449847349,27355,33
285429,DCAF4L1,chr4,F,41981695,41986467,63166569,4772,449852121,27356,0
285440,CYP4V2,chr4,F,186191410,186213463,63188622,22053,449874174,27357,10
285441,F11-AS1,chr4,R,186286097,186501058,63403583,214961,450089135,27358,3
285456,RPL34-AS1,chr4,R,108538189,108620457,63485851,82268,450171403,27359,3
285463,CTBP1-AS,chr4,F,1210119,1218591,63494323,8472,450179875,27360,5
285464,CRIPAK,chr4,F,1391551,1395994,63498766,4443,450184318,27361,0
285484,LOC285484,chr4,F,6200732,6233936,63531970,33204,450217522,27362,3
285489,DOK7,chr4,F,3463305,3501476,63570141,38171,450255693,27363,11
285492,LINC00955,chr4,F,3576868,3590985,63584258,14117,450269810,27364,2
285498,RNF212,chr4,R,1056247,1113794,63641805,57547,450327357,27365,16
285500,LOC285500,chr4,F,177444512,177677123,63874416,232611,450559968,27366,8
285501,LINC01098,chr4,F,177728756,177990750,64136410,261994,450821962,27367,5
285512,FAM13A-AS1,chr4,F,88709788,88730103,64156725,20315,450842277,27368,4
285513,GPRIN3,chr4,R,89241275,89308010,64223460,66735,450909012,27369,2
285521,COX18,chr4,R,73054695,73069759,64238524,15064,450924076,27370,5
285525,YIPF7,chr4,R,44621969,44651641,64268196,29672,450953748,27371,6
285527,FRYL,chr4,R,48497362,48780312,64551146,282950,451236698,27372,65
285533,RNF175,chr4,R,153707671,153760235,64603710,52564,451289262,27373,12
285540,SEPSECS-AS1,chr4,F,25160671,25198506,64641545,37835,451327097,27374,1
285547,LINC01097,chr4,R,13526318,13531417,64646644,5099,451332196,27375,3
285548,LINC01096,chr4,R,13546075,13547824,64648393,1749,451333945,27376,0
285550,FAM200B,chr4,F,15681728,15690447,64657112,8719,451342664,27377,1
285555,STPG2,chr4,R,97441145,98143470,65359437,702325,452044989,27378,20
285556,LOC285556,chr4,R,99636528,99822027,65544936,185499,452230488,27379,5
286828,CSN1S2AP,chr4,F,70067385,70085273,65562824,17888,452248376,27380,12
317648,NOP14-AS1,chr4,F,2935545,2951078,65578357,15533,452263909,27381,3
326340,ZAR1,chr4,F,48490251,48498122,65586228,7871,452271780,27382,4
339965,CCDC158,chr4,R,76313038,76421893,65695083,108855,452380635,27383,30
339967,TMPRSS11A,chr4,R,67910300,67963514,65748297,53214,452433849,27384,9
339975,LOC339975,chr4,R,187304082,187505613,65949828,201531,452635380,27385,4
339976,TRIML1,chr4,F,188138188,188147743,65959383,9555,452644935,27386,6
339977,LRRC66,chr4,R,51993639,52020311,65986055,26672,452671607,27387,5
339978,LOC339978,chr4,R,54603210,54607147,65989992,3937,452675544,27388,1
339983,NAT8L,chr4,F,2059511,2069089,65999570,9578,452685122,27389,2
339988,LOC339988,chr4,R,6687791,6690729,66002508,2938,452688060,27390,1
340017,LOC340017,chr4,F,157572489,157576154,66006173,3665,452691725,27391,2
344967,LOC344967,chr4,R,40042916,40057199,66020456,14283,452706008,27392,2
345051,LOC345051,chr4,F,146215156,146230875,66036175,15719,452721727,27393,5
345062,PRSS48,chr4,F,151276778,151291611,66051008,14833,452736560,27394,4
345079,SOWAHB,chr4,R,76894928,76897849,66053929,2921,452739481,27395,0
345193,LRIT3,chr4,F,109848183,109872315,66078061,24132,452763613,27396,4
345222,MSANTD1,chr4,F,3241597,3265085,66101549,23488,452787101,27397,6
345274,SLC10A6,chr4,R,86787606,86849360,66163303,61754,452848855,27398,7
345275,HSD17B13,chr4,R,87303788,87322906,66182421,19118,452867973,27399,6
348926,FAM86EP,chr4,R,3941759,3955428,66196090,13669,452881642,27400,4
353322,ANKRD37,chr4,F,185396685,185400243,66199648,3558,452885200,27401,3
353497,POLN,chr4,R,2071957,2242164,66369855,170207,453055407,27402,25
359806,PCNAP1,chr4,R,99160592,99161647,66370910,1055,453056462,27403,0
359822,KCNIP4-IT1,chr4,R,21843340,21853188,66380758,9848,453066310,27404,0
386617,KCTD8,chr4,R,44173902,44448885,66655741,274983,453341293,27405,3
389197,C4orf50,chr4,R,5957111,6008060,66706690,50949,453392242,27406,10
389199,LOC389199,chr4,F,7938920,7940296,66708066,1376,453393618,27407,0
389203,SMIM20,chr4,F,25914191,25929879,66723754,15688,453409306,27408,2
389206,BEND4,chr4,R,42110852,42152878,66765780,42026,453451332,27409,5
389207,GRXCR1,chr4,F,42893265,43030658,66903173,137393,453588725,27410,4
389208,TMPRSS11F,chr4,R,68053197,68129869,66979845,76672,453665397,27411,9
389247,LOC389247,chr4,R,183494736,183504515,66989624,9779,453675176,27412,2
391622,USP17L6P,chr4,F,9367873,9369070,66990821,1197,453676373,27413,0
391627,USP17L9P,chr4,F,9358381,9359974,66992414,1593,453677966,27414,0
391712,TRIM61,chr4,R,164954445,164977666,67015635,23221,453701187,27415,4
391723,HELT,chr4,F,185018840,185020804,67017599,1964,453703151,27416,3
401115,C4orf48,chr4,F,2035607,2043970,67025962,8363,453711514,27417,8
401124,DTHD1,chr4,F,36281610,36345756,67090108,64146,453775660,27418,12
401127,LOC401127,chr4,F,39480254,39481905,67091759,1651,453777311,27419,0
401134,LOC401134,chr4,R,64914280,65004500,67181979,90220,453867531,27420,6
401135,SYT14P1,chr4,R,68060609,68063297,67184667,2688,453870219,27421,1
401136,TMPRSS11BNL,chr4,R,68184128,68218080,67218619,33952,453904171,27422,9
401137,PRR27,chr4,F,70154186,70166609,67231042,12423,453916594,27423,4
401138,AMTN,chr4,F,70518571,70532743,67245214,14172,453930766,27424,8
401145,CCSER1,chr4,F,90127393,91602219,68720040,1474826,455405592,27425,32
401149,LINC01061,chr4,R,119405522,119410660,68725178,5138,455410730,27426,2
401152,C4orf3,chr4,R,119296418,119304445,68733205,8027,455418757,27427,2
401164,LINC01060,chr4,F,188455577,188601908,68879536,146331,455565088,27428,4
402160,CFAP99,chr4,F,2418892,2462963,68923607,44071,455609159,27429,14
402176,RPL21P44,chr4,R,53985485,53987282,68925404,1797,455610956,27430,0
403315,FAM92A1P2,chr4,F,183037664,183040119,68927859,2455,455613411,27431,0
404201,WDFY3-AS2,chr4,F,84966817,85007015,68968057,40198,455653609,27432,3
407000,MIR218-1,chr4,F,20528274,20528384,68968167,110,455653719,27433,0
407028,MIR302A,chr4,R,112648182,112648251,68968236,69,455653788,27434,0
407052,MIR95,chr4,R,8005300,8005381,68968317,81,455653869,27435,0
439933,LOC439933,chr4,F,36244115,36274215,68998417,30100,455683969,27436,6
439934,LINC00575,chr4,R,82613112,82621437,69006742,8325,455692294,27437,3
441009,CPEB2-AS1,chr4,R,14909960,15002045,69098827,92085,455784379,27438,7
441024,MTHFD2L,chr4,F,74114182,74303099,69287744,188917,455973296,27439,19
441025,LOC441025,chr4,F,75354075,75362566,69296235,8491,455981787,27440,3
441027,TMEM150C,chr4,R,82484450,82561973,69373758,77523,456059310,27441,7
441046,GUSBP5,chr4,F,143559471,143561460,69375747,1989,456061299,27442,0
441052,LOC441052,chr4,R,171812135,171813601,69377213,1466,456062765,27443,0
441054,C4orf47,chr4,F,185405234,185449828,69421807,44594,456107359,27444,11
442117,GALNTL6,chr4,F,171813423,173040408,70648792,1226985,457334344,27445,20
442894,MIR302B,chr4,R,112648484,112648557,70648865,73,457334417,27446,0
442895,MIR302C,chr4,R,112648362,112648430,70648933,68,457334485,27447,0
442896,MIR302D,chr4,R,112648003,112648071,70649001,68,457334553,27448,0
442912,MIR367,chr4,R,112647873,112647941,70649069,68,457334621,27449,0
448831,FRG2,chr4,R,190024366,190028348,70653051,3982,457338603,27450,4
493856,CISD2,chr4,F,102868977,102892807,70676881,23830,457362433,27451,2
550112,UBA6-AS1,chr4,F,67701277,67722505,70698109,21228,457383661,27452,1
550113,LOC550113,chr4,F,68053507,68073233,70717835,19726,457403387,27453,2
574537,UGT2A2,chr4,R,69588416,69639642,70769061,51226,457454613,27454,5
641364,SLC7A11-AS1,chr4,F,138089013,138178177,70858225,89164,457543777,27455,6
641365,LINC00616,chr4,R,138027421,138130685,70961489,103264,457647041,27456,10
641518,LEF1-AS1,chr4,F,108167524,108176430,70970395,8906,457655947,27457,3
642280,ZNF876P,chr4,F,212599,255985,71013781,43386,457699333,27458,1
643036,SLED1,chr4,R,184798295,184799046,71014532,751,457700084,27459,0
643675,LOC643675,chr4,F,104907382,104986701,71093851,79319,457779403,27460,5
643783,USP46-AS1,chr4,F,52659405,52661498,71095944,2093,457781496,27461,1
644145,LOC644145,chr4,F,55820070,55837264,71113138,17194,457798690,27462,2
644248,SNCA-AS1,chr4,F,89836400,89841991,71118729,5591,457804281,27463,3
644414,DEFB131,chr4,F,9444533,9450514,71124710,5981,457810262,27464,1
644759,TMPRSS11GP,chr4,R,67991811,67997439,71130338,5628,457815890,27465,3
644962,TNRC18P1,chr4,R,140641190,140643080,71132228,1890,457817780,27466,0
645078,ZCCHC23,chr4,F,109303034,109320823,71150017,17789,457835569,27467,4
645104,CLRN2,chr4,F,17515164,17527104,71161957,11940,457847509,27468,2
645455,CEP170P1,chr4,F,118516339,118554204,71199822,37865,457885374,27469,7
645513,LOC645513,chr4,F,119454782,119499592,71244632,44810,457930184,27470,8
646576,HHIP-AS1,chr4,R,144642915,144646019,71247736,3104,457933288,27471,1
646603,C4orf51,chr4,F,145680103,145800392,71368025,120289,458053577,27472,16
650293,LOC650293,chr4,F,8949750,8950401,71368676,651,458054228,27473,0
651430,FLJ38576,chr4,R,186189031,186191490,71371135,2459,458056687,27474,0
654254,ZNF732,chr4,R,270674,305321,71405782,34647,458091334,27475,3
677770,SCARNA22,chr4,F,1974635,1974760,71405907,125,458091459,27476,0
677809,SNORA24,chr4,F,118279189,118279320,71406038,131,458091590,27477,0
677810,SNORA26,chr4,F,52713248,52713370,71406160,122,458091712,27478,0
693156,MIR571,chr4,F,350156,350252,71406256,96,458091808,27479,0
693157,MIR572,chr4,F,11368826,11368921,71406351,95,458091903,27480,0
693158,MIR573,chr4,R,24520191,24520290,71406450,99,458092002,27481,0
693159,MIR574,chr4,F,38868031,38868127,71406546,96,458092098,27482,0
693160,MIR575,chr4,R,82753336,82753430,71406640,94,458092192,27483,0
693161,MIR576,chr4,F,109488697,109488795,71406738,98,458092290,27484,0
693162,MIR577,chr4,F,114656758,114656854,71406834,96,458092386,27485,0
693163,MIR578,chr4,F,165386241,165386337,71406930,96,458092482,27486,0
728040,LOC728040,chr4,F,73508802,73528533,71426661,19731,458112213,27487,3
728081,LINC00290,chr4,R,181064088,181159149,71521722,95061,458207274,27488,2
728175,LOC728175,chr4,R,184341030,184353977,71534669,12947,458220221,27489,2
728339,LOC728339,chr4,R,189863451,189940713,71611931,77262,458297483,27490,3
728369,USP17L24,chr4,F,9325164,9326757,71613524,1593,458299076,27491,0
728373,USP17L25,chr4,F,9329910,9331503,71615117,1593,458300669,27492,0
728379,USP17L26,chr4,F,9334657,9336250,71616710,1593,458302262,27493,0
728386,USP17L5,chr4,F,9339402,9340995,71618303,1593,458303855,27494,0
728393,USP17L27,chr4,F,9344147,9345740,71619896,1593,458305448,27495,0
728400,USP17L28,chr4,F,9348892,9350485,71621489,1593,458307041,27496,0
728405,USP17L29,chr4,F,9353637,9355230,71623082,1593,458308634,27497,0
728419,USP17L30,chr4,F,9363128,9364721,71624675,1593,458310227,27498,0
729218,LOC729218,chr4,F,118591743,118635025,71667957,43282,458353509,27499,10
729307,LOC729307,chr4,F,137193755,137198367,71672569,4612,458358121,27500,1
729338,CETN4P,chr4,R,122730188,122732458,71674839,2270,458360391,27501,2
729830,FAM160A1,chr4,F,151409155,151670503,71936187,261348,458621739,27502,16
729870,LOC729870,chr4,R,152934515,152938450,71940122,3935,458625674,27503,2
730971,FLJ36777,chr4,R,7097423,7103376,71946075,5953,458631627,27504,1
731424,LOC731424,chr4,R,184843295,184847046,71949826,3751,458635378,27505,1
768211,RELL1,chr4,R,37588058,37686377,72048145,98319,458733697,27506,9
768239,PSAPL1,chr4,R,7430293,7434973,72052825,4680,458738377,27507,0
100093630,SNHG8,chr4,F,118278761,118279823,72053887,1062,458739439,27508,2
100126332,MIR943,chr4,R,1986383,1986477,72053981,94,458739533,27509,0
100126354,MIR297,chr4,R,110860581,110860647,72054047,66,458739599,27510,0
100128055,SMARCA5-AS1,chr4,R,143513471,143514837,72055413,1366,458740965,27511,1
100129583,FAM47E,chr4,F,76214039,76283783,72125157,69744,458810709,27512,9
100129858,SCOC-AS1,chr4,R,140283725,140373392,72214824,89667,458900376,27513,4
100129917,LOC100129917,chr4,R,780148,781848,72216524,1700,458902076,27514,0
100129931,LOC100129931,chr4,R,7030553,7046231,72232202,15678,458917754,27515,3
100130017,FTLP10,chr4,F,68182291,68212470,72262381,30179,458947933,27516,2
100130872,LOC100130872,chr4,R,1195782,1208962,72275561,13180,458961113,27517,8
100132463,CLDN24,chr4,R,183321763,183322426,72276224,663,458961776,27518,0
100133461,LOC100133461,chr4,R,3673592,3677855,72280487,4263,458966039,27519,2
100144602,EPHA5-AS1,chr4,F,65669960,65693386,72303913,23426,458989465,27520,3
100189197,TRC-GCA2-4,chr4,R,123508849,123508921,72303985,72,458989537,27521,0
100192379,PP12613,chr4,F,121764584,121766808,72306209,2224,458991761,27522,0
100287013,FAM86KP,chr4,F,9153295,9161952,72314866,8657,459000418,27523,5
100287144,USP17L10,chr4,F,9210656,9212249,72316459,1593,459002011,27524,0
100287178,USP17L11,chr4,F,9215404,9216997,72318052,1593,459003604,27525,0
100287205,USP17L12,chr4,F,9220151,9221744,72319645,1593,459005197,27526,0
100287238,USP17L13,chr4,F,9224895,9226488,72321238,1593,459006790,27527,0
100287327,USP17L17,chr4,F,9243878,9245471,72322831,1593,459008383,27528,0
100287364,USP17L18,chr4,F,9248629,9250222,72324424,1593,459009976,27529,0
100287404,USP17L19,chr4,F,9253377,9254970,72326017,1593,459011569,27530,0
100287441,USP17L20,chr4,F,9258123,9259716,72327610,1593,459013162,27531,0
100287478,USP17L21,chr4,F,9262871,9264464,72329203,1593,459014755,27532,0
100287513,USP17L22,chr4,F,9267618,9269211,72330796,1593,459016348,27533,0
100288413,ERVMER34-1,chr4,R,52738951,52751640,72343485,12689,459029037,27534,4
100288520,USP17L15,chr4,F,9234384,9236334,72345435,1950,459030987,27535,1
100288687,DUX4,chr4,F,190173668,190175845,72347612,2177,459033164,27536,1
100302177,MIR1269A,chr4,F,66276823,66276928,72347717,105,459033269,27537,0
100302188,MIR1243,chr4,F,113106862,113106955,72347810,93,459033362,27538,0
100302193,MIR1255A,chr4,R,101330301,101330414,72347923,113,459033475,27539,0
100302267,MIR2054,chr4,F,125507258,125507307,72347972,49,459033524,27540,0
100302270,MIR1305,chr4,F,182169292,182169378,72348058,86,459033610,27541,0
100302277,MIR548I2,chr4,R,9556167,9556316,72348207,149,459033759,27542,0
100302290,MIR1973,chr4,F,116299724,116299768,72348251,44,459033803,27543,0
100313806,MIR1255B1,chr4,R,36426365,36426428,72348314,63,459033866,27544,0
100313938,MIR548G,chr4,R,147344628,147344717,72348403,89,459033955,27545,0
100337616,CSN1S2BP,chr4,F,70133603,70146704,72361504,13101,459047056,27546,7
100379220,TMED11P,chr4,R,1115196,1123164,72369472,7968,459055024,27547,3
100419743,DBET,chr4,F,190064501,190067864,72372835,3363,459058387,27548,0
100422826,MIR4274,chr4,F,7460027,7460118,72372926,91,459058478,27549,0
100422849,MIR548T,chr4,F,173268159,173268233,72373000,74,459058552,27550,0
100422896,MIR3140,chr4,R,152489326,152489416,72373090,90,459058642,27551,0
100422937,MIR4275,chr4,F,28819581,28819668,72373177,87,459058729,27552,0
100423011,MIR3138,chr4,R,10078610,10078692,72373259,82,459058811,27553,0
100423017,MIR3139,chr4,F,143343459,143343535,72373335,76,459058887,27554,0
100423042,MIR4276,chr4,F,174423794,174423864,72373405,70,459058957,27555,0
100499177,THAP9-AS1,chr4,R,82893451,82900916,72380870,7465,459066422,27556,5
100500818,MIR3945,chr4,R,184851012,184851110,72380968,98,459066520,27557,0
100500867,MIR3684,chr4,F,98997386,98997460,72381042,74,459066594,27558,0
100500881,MIR3688-1,chr4,R,159128801,159128894,72381135,93,459066687,27559,0
100505545,LINC01095,chr4,R,146109454,146121913,72393594,12459,459079146,27560,5
100505685,LOC100505685,chr4,F,151955964,151967587,72405217,11623,459090769,27561,1
100505702,LINC01094,chr4,F,78645993,78684501,72443725,38508,459129277,27562,4
100505784,LOC100505784,chr4,F,156642530,156643861,72445056,1331,459130608,27563,1
100505875,LINC01088,chr4,F,78971747,79308799,72782108,337052,459467660,27564,5
100505893,SLIT2-IT1,chr4,F,20392188,20394856,72784776,2668,459470328,27565,3
100505912,LOC100505912,chr4,R,22327353,22339666,72797089,12313,459482641,27566,3
100505989,LINC01207,chr4,F,164754130,164803795,72846754,49665,459532306,27567,2
100506013,APELA,chr4,F,164876987,164897527,72867294,20540,459552846,27568,2
100506035,LINC00989,chr4,F,79492592,79576460,72951162,83868,459636714,27569,3
100506085,LOC100506085,chr4,R,169917760,169975902,73009304,58142,459694856,27570,4
100506107,LOC100506107,chr4,R,170742594,170743749,73010459,1155,459696011,27571,1
100506122,LOC100506122,chr4,F,171040601,171059160,73029018,18559,459714570,27572,4
100506229,LINC01093,chr4,R,184892999,184899461,73035480,6462,459721032,27573,2
100506253,LOC100506253,chr4,R,75178627,75181227,73038080,2600,459723632,27574,2
100506272,LOC100506272,chr4,R,187532877,187672641,73177844,139764,459863396,27575,2
100506444,LOC100506444,chr4,F,53695900,53734358,73216302,38458,459901854,27576,2
100506462,SRD5A3-AS1,chr4,R,55366600,55385580,73235282,18980,459920834,27577,3
100506514,LOC100506514,chr4,F,56408788,56429005,73255499,20217,459941051,27578,7
100506564,THEGL,chr4,F,56530574,56641550,73366475,110976,460052027,27579,19
100506746,LOC100506746,chr4,R,86924893,86934850,73376432,9957,460061984,27580,2
100506827,LOC100506827,chr4,F,44016912,44022061,73381581,5149,460067133,27581,1
100507012,BMPR1B-AS1,chr4,R,94743667,94757533,73395447,13866,460080999,27582,2
100507053,LOC100507053,chr4,F,99088856,99301356,73607947,212500,460293499,27583,9
100507096,GIMD1,chr4,R,106357334,106368788,73619401,11454,460304953,27584,2
100507266,STX18-AS1,chr4,F,4542130,4710938,73788209,168808,460473761,27585,5
100507388,LOC100507388,chr4,R,74955973,74970362,73802598,14389,460488150,27586,3
100507487,LOC100507487,chr4,F,128428015,128519398,73893981,91383,460579533,27587,8
100507528,LINC00613,chr4,R,135866982,135913680,73940679,46698,460626231,27588,4
100507639,LOC100507639,chr4,R,141321123,141332617,73952173,11494,460637725,27589,3
100508631,LOC100508631,chr4,F,37001801,37020706,73971078,18905,460656630,27590,1
100533182,SEC24B-AS1,chr4,R,109429962,109433817,73974933,3855,460660485,27591,2
100616111,MIR4455,chr4,R,184938382,184938440,73974991,58,460660543,27592,0
100616193,MIR4453,chr4,F,152536427,152536516,73975080,89,460660632,27593,0
100616201,MIR378D1,chr4,R,5923274,5923328,73975134,54,460660686,27594,0
100616234,MIR4454,chr4,R,163093573,163093628,73975189,55,460660741,27595,0
100616246,MIR4799,chr4,F,147782594,147782668,73975263,74,460660815,27596,0
100616254,MIR548AH,chr4,F,76575550,76575626,73975339,76,460660891,27597,0
100616274,MIR4802,chr4,R,40502039,40502119,73975419,80,460660971,27598,0
100616299,MIR4450,chr4,F,76573567,76573632,73975484,65,460661036,27599,0
100616303,MIR3688-2,chr4,F,159128804,159128891,73975571,87,460661123,27600,0
100616349,MIR4451,chr4,F,85722467,85722533,73975637,66,460661189,27601,0
100616358,MIR4800,chr4,R,2250076,2250156,73975717,80,460661269,27602,0
100616427,MIR5096,chr4,F,78820751,78820821,73975787,70,460661339,27603,0
100616435,MIR4801,chr4,R,37241909,37241991,73975869,82,460661421,27604,0
100616436,MIR4449,chr4,F,52712681,52712747,73975935,66,460661487,27605,0
100616450,MIR548AG1,chr4,F,60922618,60922684,73976001,66,460661553,27606,0
100616463,MIR4452,chr4,R,86542481,86542552,73976072,71,460661624,27607,0
100616471,MIR4798,chr4,F,7310449,7310524,73976147,75,460661699,27608,0
100631383,FAM47E-STBD1,chr4,F,76251699,76311130,74035578,59431,460721130,27609,6
100750326,HTT-AS,chr4,R,3063245,3074514,74046847,11269,460732399,27610,2
100847023,MIR5091,chr4,F,13627864,13627957,74046940,93,460732492,27611,0
100847027,MIR5705,chr4,R,87300494,87300583,74047029,89,460732581,27612,0
100847065,MIR5591,chr4,F,39411909,39411974,74047094,65,460732646,27613,0
100873748,RNU6-33P,chr4,R,88684847,88684954,74047201,107,460732753,27614,0
100873749,RNU6-34P,chr4,R,96152298,96152403,74047306,105,460732858,27615,0
100873750,RNU6-35P,chr4,F,109992324,109992431,74047413,107,460732965,27616,0
100873939,LNX1-AS1,chr4,F,53500076,53523274,74070611,23198,460756163,27617,3
100873955,LNX1-AS2,chr4,F,53592955,53605382,74083038,12427,460768590,27618,1
100874047,LINC00499,chr4,F,138309710,138424344,74197672,114634,460883224,27619,2
100874275,LINC01216,chr4,R,100660278,100675113,74212507,14835,460898059,27620,3
100874374,ARHGEF38-IT1,chr4,F,105561590,105570238,74221155,8648,460906707,27621,2
100885776,UGDH-AS1,chr4,F,39527838,39594707,74288024,66869,460973576,27622,4
100996286,LOC100996286,chr4,F,152100752,152104720,74291992,3968,460977544,27623,3
100996694,LOC100996694,chr4,F,119939539,119964293,74316746,24754,461002298,27624,1
100996939,PYURF,chr4,R,88520977,88523801,74319570,2824,461005122,27625,1
100996941,IL21-AS1,chr4,F,122618982,122689156,74389744,70174,461075296,27626,10
101059914,LOC101059914,chr4,R,164929490,164930626,74390880,1136,461076432,27627,1
101060498,LOC101060498,chr4,F,40307184,40330419,74414115,23235,461099667,27628,4
101410542,UCHL1-AS1,chr4,R,41220073,41256727,74450769,36654,461136321,27629,2
101410545,STPG2-AS1,chr4,F,97366925,97490164,74574008,123239,461259560,27630,5
101926918,LOC101926918,chr4,R,119412501,119454651,74616158,42150,461301710,27631,25
101927007,LINC01365,chr4,R,119799105,119804515,74621568,5410,461307120,27632,4
101927074,LINC00682,chr4,R,41879520,41882611,74624659,3091,461310211,27633,1
101927087,LOC101927087,chr4,R,124499941,124558434,74683152,58493,461368704,27634,8
101927109,LOC101927109,chr4,F,126064158,126072277,74691271,8119,461376823,27635,3
101927145,LOC101927145,chr4,F,62133749,62221384,74778906,87635,461464458,27636,6
101927157,LOC101927157,chr4,F,47914226,47990737,74855417,76511,461540969,27637,2
101927163,LOC101927163,chr4,F,127933052,127938367,74860732,5315,461546284,27638,2
101927179,LOC101927179,chr4,F,47831344,47896848,74926236,65504,461611788,27639,2
101927186,ADGRL3-AS1,chr4,R,62071754,62161765,75016247,90011,461701799,27640,7
101927209,LOC101927209,chr4,F,49161313,49207720,75062654,46407,461748206,27641,4
101927237,LOC101927237,chr4,R,67417304,67422000,75067350,4696,461752902,27642,2
101927259,LOC101927259,chr4,R,128552589,128553593,75068354,1004,461753906,27643,1
101927282,LOC101927282,chr4,R,129724170,129771478,75115662,47308,461801214,27644,4
101927297,LOC101927297,chr4,F,70678676,70686816,75123802,8140,461809354,27645,5
101927305,LOC101927305,chr4,F,131764837,131791482,75150447,26645,461835999,27646,3
101927359,LOC101927359,chr4,R,133093859,133149116,75205704,55257,461891256,27647,8
101927363,LOC101927363,chr4,F,32351037,32353220,75207887,2183,461893439,27648,1
101927414,LOC101927414,chr4,R,137603713,137701055,75305229,97342,461990781,27649,13
101927451,LOC101927451,chr4,R,139413718,139454187,75345698,40469,462031250,27650,5
101927490,LOC101927490,chr4,R,139618138,139647339,75374899,29201,462060451,27651,2
101927516,LOC101927516,chr4,F,140127328,140138891,75386462,11563,462072014,27652,3
101927613,LOC101927613,chr4,F,142565936,142614111,75434637,48175,462120189,27653,4
101927636,LOC101927636,chr4,F,143912330,143982454,75504761,70124,462190313,27654,6
101927659,SMAD1-AS2,chr4,R,145497048,145502980,75510693,5932,462196245,27655,1
101927849,LOC101927849,chr4,F,149154294,149278123,75634522,123829,462320074,27656,12
101927947,LOC101927947,chr4,F,154005131,154298819,75928210,293688,462613762,27657,10
101928007,LOC101928007,chr4,R,158179051,158182737,75931896,3686,462617448,27658,2
101928052,LOC101928052,chr4,F,162022732,162047550,75956714,24818,462642266,27659,5
101928081,LOC101928081,chr4,F,163105504,163119873,75971083,14369,462656635,27660,2
101928131,LOC101928131,chr4,R,165730778,165743071,75983376,12293,462668928,27661,3
101928151,LINC01179,chr4,F,165684638,165762778,76061516,78140,462747068,27662,5
101928217,LOC101928217,chr4,F,4032390,4074289,76103415,41899,462788967,27663,7
101928223,LOC101928223,chr4,F,170226590,170283723,76160548,57133,462846100,27664,2
101928237,LOC101928237,chr4,R,4560367,4583317,76183498,22950,462869050,27665,7
101928279,LOC101928279,chr4,F,4761759,4787374,76209113,25615,462894665,27666,2
101928288,LOC101928288,chr4,R,171221413,171298146,76285846,76733,462971398,27667,2
101928306,LOC101928306,chr4,F,4920807,4988671,76353710,67864,463039262,27668,2
101928314,LOC101928314,chr4,R,172629931,172726878,76450657,96947,463136209,27669,6
101928383,LOC101928383,chr4,F,173384654,173479459,76545462,94805,463231014,27670,7
101928409,LOC101928409,chr4,F,173507465,173510957,76548954,3492,463234506,27671,2
101928439,LOC101928439,chr4,F,173516674,173521135,76553415,4461,463238967,27672,3
101928478,LOC101928478,chr4,F,173695510,173929717,76787622,234207,463473174,27673,11
101928509,LOC101928509,chr4,R,174094659,174220398,76913361,125739,463598913,27674,4
101928521,LOC101928521,chr4,R,652908,655946,76916399,3038,463601951,27675,2
101928532,LOC101928532,chr4,R,8745395,8747703,76918707,2308,463604259,27676,2
101928548,LOC101928548,chr4,R,1200378,1201262,76919591,884,463605143,27677,0
101928551,LOC101928551,chr4,F,174831727,174875964,76963828,44237,463649380,27678,4
101928588,LOC101928588,chr4,R,1234724,1237856,76966960,3132,463652512,27679,1
101928590,LOC101928590,chr4,F,175790306,175812189,76988843,21883,463674395,27680,7
101928621,LOC101928621,chr4,R,1323177,1327620,76993286,4443,463678838,27681,0
101928622,LOC101928622,chr4,R,33896338,34039893,77136841,143555,463822393,27682,4
101928656,LINC01099,chr4,R,177812045,177907936,77232732,95891,463918284,27683,2
101928658,LOC101928658,chr4,F,52930958,52951019,77252793,20061,463938345,27684,2
101928667,LOC101928667,chr4,R,36007007,36024200,77269986,17193,463955538,27685,5
101928679,LOC101928679,chr4,R,181260863,181265093,77274216,4230,463959768,27686,2
101928702,LOC101928702,chr4,R,74992237,74999166,77281145,6929,463966697,27687,2
101928721,LOC101928721,chr4,F,37073651,37133925,77341419,60274,464026971,27688,11
101928734,WWC2-AS1,chr4,R,183233627,183240634,77348426,7007,464033978,27689,1
101928760,LOC101928760,chr4,R,56229633,56246446,77365239,16813,464050791,27690,1
101928776,LINC01258,chr4,R,38420661,38523180,77467758,102519,464153310,27691,7
101928809,LOC101928809,chr4,F,75980789,76005942,77492911,25153,464178463,27692,2
101928810,LOC101928810,chr4,F,184894148,184963549,77562312,69401,464247864,27693,2
101928815,LOC101928815,chr4,F,56653358,56665018,77573972,11660,464259524,27694,3
101928848,LOC101928848,chr4,F,49512842,49536075,77597205,23233,464282757,27695,4
101928851,LOC101928851,chr4,F,57425871,57465986,77637320,40115,464322872,27696,5
101928864,LOC101928864,chr4,R,77154774,77156667,77639213,1893,464324765,27697,1
101928877,LOC101928877,chr4,F,185051875,185107262,77694600,55387,464380152,27698,11
101928879,LOC101928879,chr4,F,53575692,53576543,77695451,851,464381003,27699,0
101928893,LOC101928893,chr4,F,78716075,78743807,77723183,27732,464408735,27700,2
101928929,LOC101928929,chr4,F,185902941,185919458,77739700,16517,464425252,27701,5
101928942,LOC101928942,chr4,F,81164939,81193395,77768156,28456,464453708,27702,4
101928948,LOC101928948,chr4,F,9532032,9660852,77896976,128820,464582528,27703,3
101928963,LOC101928963,chr4,F,82374078,82384027,77906925,9949,464592477,27704,1
101928971,LINC01262,chr4,F,189659605,189661486,77908806,1881,464594358,27705,2
101928978,LOC101928978,chr4,R,83968081,84299169,78239894,331088,464925446,27706,8
101929019,LOC101929019,chr4,F,12223450,12251286,78267730,27836,464953282,27707,3
101929048,LOC101929048,chr4,R,13764507,13841125,78344348,76618,465029900,27708,8
101929064,LOC101929064,chr4,F,86119805,86219926,78444469,100121,465130021,27709,3
101929071,LINC01182,chr4,F,13655178,13931228,78720519,276050,465406071,27710,3
101929090,LOC101929090,chr4,R,87460810,87462765,78722474,1955,465408026,27711,1
101929095,LOC101929095,chr4,R,15004941,15427914,79145447,422973,465830999,27712,5
101929123,LOC101929123,chr4,R,17171756,17186057,79159748,14301,465845300,27713,5
101929134,LOC101929134,chr4,F,88523843,88524991,79160896,1148,465846448,27714,1
101929143,LOC101929143,chr4,R,17458612,17459963,79162247,1351,465847799,27715,1
101929161,LOC101929161,chr4,R,25517389,25569394,79214252,52005,465899804,27716,7
101929194,LOC101929194,chr4,R,92262497,92277302,79229057,14805,465914609,27717,2
101929199,LOC101929199,chr4,F,27217478,27282225,79293804,64747,465979356,27718,5
101929210,LOC101929210,chr4,R,94117819,94207556,79383541,89737,466069093,27719,8
101929250,LOC101929250,chr4,R,95356159,95358396,79385778,2237,466071330,27720,2
101929353,LOC101929353,chr4,F,100190032,100215505,79411251,25473,466096803,27721,4
101929401,LOC101929401,chr4,R,102560367,102578849,79429733,18482,466115285,27722,4
101929448,LOC101929448,chr4,F,103425041,103439728,79444420,14687,466129972,27723,3
101929468,LOC101929468,chr4,F,104490964,104697592,79651048,206628,466336600,27724,9
101929529,LOC101929529,chr4,R,105815144,105827172,79663076,12028,466348628,27725,3
101929558,LOC101929558,chr4,R,105743892,105896968,79816152,153076,466501704,27726,2
101929577,LOC101929577,chr4,R,106003316,106022478,79835314,19162,466520866,27727,3
101929595,LOC101929595,chr4,R,107863478,107932119,79903955,68641,466589507,27728,6
101929621,LOC101929621,chr4,F,108557232,108560392,79907115,3160,466592667,27729,1
101929654,LOC101929654,chr4,F,112516806,112518219,79908528,1413,466594080,27730,1
101929741,LOC101929741,chr4,R,118664086,118685341,79929783,21255,466615335,27731,6
101929762,LOC101929762,chr4,R,119192772,119212644,79949655,19872,466635207,27732,2
101929996,LOC101929996,chr4,F,183543603,183557201,79963253,13598,466648805,27733,3
101930028,LOC101930028,chr4,R,188768998,188818810,80013065,49812,466698617,27734,5
101930370,LOC101930370,chr4,R,173094671,173168961,80087355,74290,466772907,27735,7
102191832,DEAR,chr4,F,152337654,152338096,80087797,442,466773349,27736,1
102465837,MIR7849,chr4,F,146408582,146408688,80087903,106,466773455,27737,0
102465859,MIR7978,chr4,R,21464699,21464758,80087962,59,466773514,27738,0
102465868,MIR8066,chr4,R,101240794,101240872,80088040,78,466773592,27739,0
102465878,MIR8082,chr4,F,113152281,113152362,80088121,81,466773673,27740,0
102466953,MIR6082,chr4,F,171186183,171186292,80088230,109,466773782,27741,0
102467004,MIR8053,chr4,F,47652668,47652743,80088305,75,466773857,27742,0
102723331,LOC102723331,chr4,R,168848183,168865953,80106075,17770,466791627,27743,3
102723338,LOC102723338,chr4,R,84526819,84583155,80162411,56336,466847963,27744,12
102723415,LOC102723415,chr4,R,38594515,38610466,80178362,15951,466863914,27745,7
102723440,LOC102723440,chr4,R,173040007,173073050,80211405,33043,466896957,27746,8
102723458,LOC102723458,chr4,R,88411482,88467764,80267687,56282,466953239,27747,11
102723488,LOC102723488,chr4,F,88760641,88784082,80291128,23441,466976680,27748,2
102723497,LOC102723497,chr4,F,41108500,41131238,80313866,22738,466999418,27749,2
102723525,LOC102723525,chr4,F,10737574,10808919,80385211,71345,467070763,27750,7
102723576,LOC102723576,chr4,R,99378854,99404606,80410963,25752,467096515,27751,4
102723627,LOC102723627,chr4,F,174523037,174536676,80424602,13639,467110154,27752,6
102723645,LOC102723645,chr4,R,21520774,21528269,80432097,7495,467117649,27753,2
102723675,LOC102723675,chr4,F,24980351,25026861,80478607,46510,467164159,27754,5
102723704,LOC102723704,chr4,F,102777036,102799575,80501146,22539,467186698,27755,4
102723733,LOC102723733,chr4,F,25860606,25905684,80546224,45078,467231776,27756,1
102723755,LOC102723755,chr4,R,2254408,2255148,80546964,740,467232516,27757,1
102723763,LOC102723763,chr4,F,2761383,2775232,80560813,13849,467246365,27758,2
102723764,LOC102723764,chr4,F,28996516,29017255,80581552,20739,467267104,27759,7
102723766,LOC102723766,chr4,R,184365560,184382306,80598298,16746,467283850,27760,6
102723778,LOC102723778,chr4,F,31171143,31211675,80638830,40532,467324382,27761,4
102723779,LOC102723779,chr4,F,184474801,184489551,80653580,14750,467339132,27762,2
102723828,LOC102723828,chr4,F,31997378,32155406,80811608,158028,467497160,27763,2
102723846,LOC102723846,chr4,F,32225078,32238547,80825077,13469,467510629,27764,3
102723888,LOC102723888,chr4,R,186416043,186487637,80896671,71594,467582223,27765,6
102723896,LOC102723896,chr4,R,112880304,112886201,80902568,5897,467588120,27766,2
102723906,LOC102723906,chr4,F,186840662,187061215,81123121,220553,467808673,27767,3
102723914,LOC102723914,chr4,R,117815019,117828156,81136258,13137,467821810,27768,2
102723920,LOC102723920,chr4,F,187408775,187415697,81143180,6922,467828732,27769,2
102723928,LOC102723928,chr4,F,118635787,118679805,81187198,44018,467872750,27770,5
102723956,LOC102723956,chr4,R,119011172,119026619,81202645,15447,467888197,27771,2
102723967,LOC102723967,chr4,F,119100131,119133575,81236089,33444,467921641,27772,6
102723973,LOC102723973,chr4,R,189779351,189787641,81244379,8290,467929931,27773,2
102723981,LOC102723981,chr4,F,190184880,190195825,81255324,10945,467940876,27774,4
102724069,LOC102724069,chr4,F,119552584,119574167,81276907,21583,467962459,27775,4
102724158,LOC102724158,chr4,F,121950979,121989617,81315545,38638,468001097,27776,2
102724176,LOC102724176,chr4,R,124025294,124028069,81318320,2775,468003872,27777,1
102724210,LOC102724210,chr4,R,127073775,127352572,81597117,278797,468282669,27778,7
102724309,LOC102724309,chr4,F,128653752,128662528,81605893,8776,468291445,27779,2
102724326,LOC102724326,chr4,R,129324822,129327578,81608649,2756,468294201,27780,2
102724353,LOC102724353,chr4,R,130122076,130125779,81612352,3703,468297904,27781,2
102724672,LOC102724672,chr4,F,148219635,148230208,81622925,10573,468308477,27782,3
102724700,LOC102724700,chr4,R,151887542,151910184,81645567,22642,468331119,27783,5
102724776,LOC102724776,chr4,F,155354215,155360461,81651813,6246,468337365,27784,2
102724780,LOC102724780,chr4,F,67786811,67802860,81667862,16049,468353414,27785,4
102724785,LOC102724785,chr4,R,156112590,156143879,81699151,31289,468384703,27786,8
102724821,LOC102724821,chr4,R,71183700,71186523,81701974,2823,468387526,27787,2
102724832,LOC102724832,chr4,F,73258894,73369941,81813021,111047,468498573,27788,10
102724899,LOC102724899,chr4,F,162705375,162746263,81853909,40888,468539461,27789,3
102724916,LOC102724916,chr4,R,77918052,77952510,81888367,34458,468573919,27790,4
102725200,LOC102725200,chr4,R,661208,664172,81891331,2964,468576883,27791,3
102725220,LOC102725220,chr4,F,107286611,107304537,81909257,17926,468594809,27792,3
103689918,LINC01378,chr4,F,117428397,117689103,82169963,260706,468855515,27793,3
103695434,LINC01396,chr4,F,4844436,4850827,82176354,6391,468861906,27794,3
104326058,SMAD1-AS1,chr4,R,145514577,145517194,82178971,2617,468864523,27795,1
104355285,LINC01256,chr4,F,132591088,132678503,82266386,87415,468951938,27796,3
104384744,TET2-AS1,chr4,R,105171353,105352881,82447914,181528,469133466,27797,5
104472519,STX18-IT1,chr4,R,4476120,4481700,82453494,5580,469139046,27798,3
105369192,LOC105369192,chr4,F,88284713,88341825,82510606,57112,469196158,27799,6
105374335,LOC105374335,chr4,R,135235,138691,82514062,3456,469199614,27800,1
105374336,LOC105374336,chr4,R,307334,310075,82516803,2741,469202355,27801,1
105374338,LOC105374338,chr4,F,577001,584529,82524331,7528,469209883,27802,3
105374339,LOC105374339,chr4,F,787340,796440,82533431,9100,469218983,27803,3
105374340,LOC105374340,chr4,R,841703,846821,82538549,5118,469224101,27804,3
105374341,LOC105374341,chr4,F,872265,880752,82547036,8487,469232588,27805,1
105374342,LOC105374342,chr4,F,1005949,1007971,82549058,2022,469234610,27806,2
105374343,LOC105374343,chr4,F,1043642,1051502,82556918,7860,469242470,27807,1
105374344,LOC105374344,chr4,F,1113638,1132977,82576257,19339,469261809,27808,1
105374345,LOC105374345,chr4,F,1256419,1270109,82589947,13690,469275499,27809,2
105374346,LOC105374346,chr4,F,1287685,1288290,82590552,605,469276104,27810,1
105374347,LOC105374347,chr4,R,1285613,1289704,82594643,4091,469280195,27811,3
105374348,LOC105374348,chr4,R,1500919,1503642,82597366,2723,469282918,27812,2
105374349,LOC105374349,chr4,R,1627369,1629063,82599060,1694,469284612,27813,2
105374350,LOC105374350,chr4,R,1623703,1626874,82602231,3171,469287783,27814,2
105374351,LOC105374351,chr4,R,2049286,2054402,82607347,5116,469292899,27815,2
105374352,LOC105374352,chr4,R,2342580,2344660,82609427,2080,469294979,27816,1
105374353,LOC105374353,chr4,F,2463013,2466198,82612612,3185,469298164,27817,2
105374354,LOC105374354,chr4,F,3450103,3453280,82615789,3177,469301341,27818,1
105374355,LOC105374355,chr4,R,3474937,3476390,82617242,1453,469302794,27819,2
105374356,LOC105374356,chr4,F,3544859,3545928,82618311,1069,469303863,27820,2
105374357,LOC105374357,chr4,F,3645102,3653896,82627105,8794,469312657,27821,1
105374358,LOC105374358,chr4,F,3956371,3963889,82634623,7518,469320175,27822,2
105374359,LOC105374359,chr4,F,3988580,4006568,82652611,17988,469338163,27823,2
105374360,LOC105374360,chr4,F,4370371,4381912,82664152,11541,469349704,27824,2
105374361,LOC105374361,chr4,F,5004560,5034820,82694412,30260,469379964,27825,5
105374362,LOC105374362,chr4,R,5189717,5203914,82708609,14197,469394161,27826,5
105374364,LOC105374364,chr4,R,6203551,6221936,82726994,18385,469412546,27827,2
105374365,LOC105374365,chr4,F,6568728,6574227,82732493,5499,469418045,27828,2
105374366,LOC105374366,chr4,R,6670727,6673912,82735678,3185,469421230,27829,1
105374367,LOC105374367,chr4,F,6763515,6767620,82739783,4105,469425335,27830,1
105374368,LOC105374368,chr4,F,7064884,7066616,82741515,1732,469427067,27831,1
105374370,LOC105374370,chr4,F,7070575,7099217,82770157,28642,469455709,27832,2
105374371,LOC105374371,chr4,F,7257181,7263224,82776200,6043,469461752,27833,2
105374372,LOC105374372,chr4,F,7910372,7919635,82785463,9263,469471015,27834,2
105374373,LOC105374373,chr4,R,8268607,8269606,82786462,999,469472014,27835,1
105374374,LOC105374374,chr4,F,8322200,8323965,82788227,1765,469473779,27836,1
105374375,LOC105374375,chr4,F,8476937,8493515,82804805,16578,469490357,27837,2
105374376,LOC105374376,chr4,F,8436315,8439065,82807555,2750,469493107,27838,1
105374377,LOC105374377,chr4,R,48203,50279,82809631,2076,469495183,27839,1
105374379,LOC105374379,chr4,R,1032698,1039509,82816442,6811,469501994,27840,5
105374380,LOC105374380,chr4,R,6007971,6019180,82827651,11209,469513203,27841,2
105374390,LOC105374390,chr4,F,33565171,33571580,82834060,6409,469519612,27842,2
105374391,LOC105374391,chr4,F,33467431,33520434,82887063,53003,469572615,27843,3
105374392,LOC105374392,chr4,F,33888949,33905281,82903395,16332,469588947,27844,4
105374393,LOC105374393,chr4,R,34093953,34106062,82915504,12109,469601056,27845,2
105374394,LOC105374394,chr4,R,34120686,34269742,83064560,149056,469750112,27846,6
105374395,LOC105374395,chr4,F,35022231,35028289,83070618,6058,469756170,27847,2
105374396,LOC105374396,chr4,R,35859397,35887783,83099004,28386,469784556,27848,4
105374397,LOC105374397,chr4,R,35948340,35972234,83122898,23894,469808450,27849,2
105374398,LOC105374398,chr4,R,35981204,35985266,83126960,4062,469812512,27850,2
105374399,LOC105374399,chr4,F,36355417,36365931,83137474,10514,469823026,27851,2
105374400,LOC105374400,chr4,R,36496195,36582717,83223996,86522,469909548,27852,2
105374402,LOC105374402,chr4,R,37112004,37129587,83241579,17583,469927131,27853,3
105374403,LOC105374403,chr4,R,37454052,37472389,83259916,18337,469945468,27854,2
105374404,LOC105374404,chr4,R,37705408,37715086,83269594,9678,469955146,27855,3
105374406,LOC105374406,chr4,F,37761111,37781030,83289513,19919,469975065,27856,3
105374407,LOC105374407,chr4,F,37929204,37952375,83312684,23171,469998236,27857,2
105374408,LOC105374408,chr4,R,38233563,38243537,83322658,9974,470008210,27858,1
105374409,LOC105374409,chr4,F,38279998,38288140,83330800,8142,470016352,27859,4
105374410,LOC105374410,chr4,F,38330704,38385785,83385881,55081,470071433,27860,4
105374411,LOC105374411,chr4,F,38565758,38573332,83393455,7574,470079007,27861,2
105374412,LOC105374412,chr4,F,38748751,38753468,83398172,4717,470083724,27862,2
105374413,LOC105374413,chr4,F,38744121,38748737,83402788,4616,470088340,27863,3
105374415,LOC105374415,chr4,F,38718390,38729124,83413522,10734,470099074,27864,3
105374416,LOC105374416,chr4,R,38952695,38965784,83426611,13089,470112163,27865,2
105374417,LOC105374417,chr4,R,39113028,39121003,83434586,7975,470120138,27866,2
105374418,LOC105374418,chr4,R,39067936,39101763,83468413,33827,470153965,27867,2
105374419,LOC105374419,chr4,F,39638986,39666653,83496080,27667,470181632,27868,4
105374420,LOC105374420,chr4,F,40553557,40558355,83500878,4798,470186430,27869,2
105374421,LOC105374421,chr4,R,41683004,41697151,83515025,14147,470200577,27870,3
105374422,LOC105374422,chr4,F,41664006,41665624,83516643,1618,470202195,27871,1
105374423,LOC105374423,chr4,R,41540667,41555414,83531390,14747,470216942,27872,2
105374424,LOC105374424,chr4,F,41753411,41765314,83543293,11903,470228845,27873,3
105374425,LOC105374425,chr4,F,41794204,41799955,83549044,5751,470234596,27874,2
105374426,LOC105374426,chr4,R,41892448,41935081,83591677,42633,470277229,27875,3
105374428,LOC105374428,chr4,R,42299011,42391326,83683992,92315,470369544,27876,1
105374429,LOC105374429,chr4,F,42487577,42500137,83696552,12560,470382104,27877,1
105374430,LOC105374430,chr4,F,42675210,42704271,83725613,29061,470411165,27878,2
105374431,LOC105374431,chr4,F,42786002,42828168,83767779,42166,470453331,27879,2
105374432,LOC105374432,chr4,R,43223187,43282951,83827543,59764,470513095,27880,2
105374433,LOC105374433,chr4,F,43316067,43341359,83852835,25292,470538387,27881,3
105374434,LOC105374434,chr4,R,43296861,43330696,83886670,33835,470572222,27882,2
105374436,LOC105374436,chr4,R,43457568,43492566,83921668,34998,470607220,27883,2
105374437,LOC105374437,chr4,F,43760601,43766333,83927400,5732,470612952,27884,2
105374438,LOC105374438,chr4,R,43979998,44016794,83964196,36796,470649748,27885,5
105374439,LOC105374439,chr4,F,44726584,44776409,84014021,49825,470699573,27886,5
105374440,LOC105374440,chr4,F,44801711,44805359,84017669,3648,470703221,27887,2
105374441,LOC105374441,chr4,R,44897078,44924587,84045178,27509,470730730,27888,3
105374442,LOC105374442,chr4,R,47092846,47096145,84048477,3299,470734029,27889,3
105374443,LOC105374443,chr4,F,47638209,47645063,84055331,6854,470740883,27890,1
105374444,LOC105374444,chr4,F,47627313,47636543,84064561,9230,470750113,27891,2
105374445,LOC105374445,chr4,F,48269971,48288942,84083532,18971,470769084,27892,2
105374447,LOC105374447,chr4,R,49239245,49244366,84088653,5121,470774205,27893,2
105374474,LOC105374474,chr4,R,8847234,8853617,84095036,6383,470780588,27894,2
105374476,LOC105374476,chr4,F,9987981,10016540,84123595,28559,470809147,27895,6
105374477,LOC105374477,chr4,F,10062740,10074756,84135611,12016,470821163,27896,1
105374478,LOC105374478,chr4,R,10142808,10158233,84151036,15425,470836588,27897,1
105374479,LOC105374479,chr4,F,10785780,10789778,84155034,3998,470840586,27898,2
105374480,LOC105374480,chr4,F,10621047,10630285,84164272,9238,470849824,27899,4
105374481,LOC105374481,chr4,F,10569867,10577385,84171790,7518,470857342,27900,2
105374482,LOC105374482,chr4,F,10455040,10531030,84247780,75990,470933332,27901,4
105374483,LOC105374483,chr4,F,11776304,11789866,84261342,13562,470946894,27902,2
105374484,LOC105374484,chr4,R,11740946,11769852,84290248,28906,470975800,27903,2
105374485,LOC105374485,chr4,R,11730216,11734988,84295020,4772,470980572,27904,1
105374486,LOC105374486,chr4,F,11429159,11438574,84304435,9415,470989987,27905,4
105374487,LOC105374487,chr4,R,11309553,11312798,84307680,3245,470993232,27906,2
105374488,LOC105374488,chr4,F,11259799,11280653,84328534,20854,471014086,27907,2
105374489,LOC105374489,chr4,F,11822182,11823880,84330232,1698,471015784,27908,2
105374490,LOC105374490,chr4,F,12540086,12571354,84361500,31268,471047052,27909,2
105374492,LOC105374492,chr4,R,12469900,12609447,84501047,139547,471186599,27910,2
105374493,LOC105374493,chr4,R,12876607,12973023,84597463,96416,471283015,27911,4
105374494,LOC105374494,chr4,R,12996484,13241681,84842660,245197,471528212,27912,3
105374495,LOC105374495,chr4,F,13484448,13489889,84848101,5441,471533653,27913,2
105374496,LOC105374496,chr4,F,14513611,14518458,84852948,4847,471538500,27914,2
105374498,LOC105374498,chr4,R,14954420,14966710,84865238,12290,471550790,27915,3
105374499,LOC105374499,chr4,F,15374776,15379776,84870238,5000,471555790,27916,1
105374500,LOC105374500,chr4,R,15358560,15362520,84874198,3960,471559750,27917,2
105374501,LOC105374501,chr4,F,15124842,15131675,84881031,6833,471566583,27918,2
105374502,LOC105374502,chr4,R,16124283,16126143,84882891,1860,471568443,27919,2
105374503,LOC105374503,chr4,F,16287657,16355779,84951013,68122,471636565,27920,6
105374504,LOC105374504,chr4,F,16744749,16749331,84955595,4582,471641147,27921,2
105374505,LOC105374505,chr4,F,16400499,16598545,85153641,198046,471839193,27922,8
105374507,LOC105374507,chr4,R,17073858,17082615,85162398,8757,471847950,27923,3
105374508,LOC105374508,chr4,R,17612180,17614632,85164850,2452,471850402,27924,2
105374509,LOC105374509,chr4,R,17793445,17798349,85169754,4904,471855306,27925,1
105374510,LOC105374510,chr4,F,18521167,18832932,85481519,311765,472167071,27926,5
105374511,LOC105374511,chr4,F,19856281,19937686,85562924,81405,472248476,27927,2
105374512,LOC105374512,chr4,R,19998928,20003979,85567975,5051,472253527,27928,2
105374513,LOC105374513,chr4,F,20006916,20026275,85587334,19359,472272886,27929,2
105374514,LOC105374514,chr4,R,20206012,20212958,85594280,6946,472279832,27930,2
105374515,LOC105374515,chr4,F,20658445,20674272,85610107,15827,472295659,27931,1
105374516,LOC105374516,chr4,F,21582075,21613722,85641754,31647,472327306,27932,3
105374518,LOC105374518,chr4,F,21345027,21365258,85661985,20231,472347537,27933,2
105374519,LOC105374519,chr4,F,22350920,22361152,85672217,10232,472357769,27934,2
105374520,LOC105374520,chr4,F,22635674,22686904,85723447,51230,472408999,27935,3
105374521,LOC105374521,chr4,R,22733067,22744294,85734674,11227,472420226,27936,3
105374522,LOC105374522,chr4,F,23332412,23409367,85811629,76955,472497181,27937,3
105374523,LOC105374523,chr4,R,23302543,23400408,85909494,97865,472595046,27938,3
105374524,LOC105374524,chr4,F,22997575,23332387,86244306,334812,472929858,27939,19
105374525,LOC105374525,chr4,R,23578637,23581482,86247151,2845,472932703,27940,1
105374526,LOC105374526,chr4,R,23782553,23787773,86252371,5220,472937923,27941,1
105374527,LOC105374527,chr4,F,23769093,23782448,86265726,13355,472951278,27942,2
105374528,LOC105374528,chr4,F,23718577,23769046,86316195,50469,473001747,27943,3
105374529,LOC105374529,chr4,F,24436647,24470650,86350198,34003,473035750,27944,3
105374530,LOC105374530,chr4,R,24589190,24598366,86359374,9176,473044926,27945,3
105374532,LOC105374532,chr4,F,24788708,24790995,86361661,2287,473047213,27946,2
105374533,LOC105374533,chr4,R,24800484,24802726,86363903,2242,473049455,27947,1
105374534,LOC105374534,chr4,R,25107600,25112765,86369068,5165,473054620,27948,2
105374535,LOC105374535,chr4,R,25190211,25233864,86412721,43653,473098273,27949,5
105374536,LOC105374536,chr4,F,25425402,25467849,86455168,42447,473140720,27950,3
105374538,LOC105374538,chr4,R,25900813,25914093,86468448,13280,473154000,27951,4
105374539,LOC105374539,chr4,F,26020865,26024646,86472229,3781,473157781,27952,2
105374540,LOC105374540,chr4,F,26070760,26104251,86505720,33491,473191272,27953,2
105374541,LOC105374541,chr4,R,26151964,26158684,86512440,6720,473197992,27954,3
105374542,LOC105374542,chr4,R,26288141,26299235,86523534,11094,473209086,27955,1
105374544,LOC105374544,chr4,R,26268224,26275467,86530777,7243,473216329,27956,1
105374545,LOC105374545,chr4,R,26181105,26197981,86547653,16876,473233205,27957,2
105374546,LOC105374546,chr4,R,26859805,26860655,86548503,850,473234055,27958,1
105374547,LOC105374547,chr4,R,27645972,27656496,86559027,10524,473244579,27959,5
105374548,LOC105374548,chr4,F,27669971,27719249,86608305,49278,473293857,27960,4
105374549,LOC105374549,chr4,F,27736621,27750258,86621942,13637,473307494,27961,3
105374550,LOC105374550,chr4,F,27819187,27830173,86632928,10986,473318480,27962,2
105374551,LOC105374551,chr4,R,27967269,27977542,86643201,10273,473328753,27963,1
105374552,LOC105374552,chr4,F,27902567,28003072,86743706,100505,473429258,27964,3
105374553,LOC105374553,chr4,R,28024175,28108950,86828481,84775,473514033,27965,2
105374554,LOC105374554,chr4,F,28117557,28288204,86999128,170647,473684680,27966,2
105374556,LOC105374556,chr4,R,28393310,28402926,87008744,9616,473694296,27967,2
105374557,LOC105374557,chr4,F,28465154,28479381,87022971,14227,473708523,27968,2
105374558,LOC105374558,chr4,R,28522447,28585703,87086227,63256,473771779,27969,2
105374559,LOC105374559,chr4,F,28624553,28630095,87091769,5542,473777321,27970,2
105374560,LOC105374560,chr4,F,29118544,29156591,87129816,38047,473815368,27971,2
105374561,LOC105374561,chr4,F,29214285,29292295,87207826,78010,473893378,27972,5
105374562,LOC105374562,chr4,R,29797902,29801039,87210963,3137,473896515,27973,3
105374563,LOC105374563,chr4,R,30747984,30752119,87215098,4135,473900650,27974,2
105374564,LOC105374564,chr4,R,31499796,31506308,87221610,6512,473907162,27975,2
105374565,LOC105374565,chr4,F,31506467,31558821,87273964,52354,473959516,27976,6
105374566,LOC105374566,chr4,R,31702059,31729518,87301423,27459,473986975,27977,3
105377245,LOC105377245,chr4,R,58939320,58988152,87350255,48832,474035807,27978,2
105377246,LOC105377246,chr4,R,58976070,58984194,87358379,8124,474043931,27979,2
105377247,LOC105377247,chr4,F,59040586,59046957,87364750,6371,474050302,27980,1
105377248,LOC105377248,chr4,F,60750621,60795710,87409839,45089,474095391,27981,4
105377249,LOC105377249,chr4,F,61143687,61173212,87439364,29525,474124916,27982,4
105377250,LOC105377250,chr4,R,61808442,61818311,87449233,9869,474134785,27983,3
105377251,LOC105377251,chr4,R,62346531,62355105,87457807,8574,474143359,27984,3
105377252,LOC105377252,chr4,F,62522723,62563929,87499013,41206,474184565,27985,2
105377253,LOC105377253,chr4,R,63465831,63513435,87546617,47604,474232169,27986,7
105377254,LOC105377254,chr4,F,63761543,63794955,87580029,33412,474265581,27987,8
105377255,LOC105377255,chr4,R,64870686,64873426,87582769,2740,474268321,27988,2
105377256,LOC105377256,chr4,R,65153730,65241794,87670833,88064,474356385,27989,5
105377257,LOC105377257,chr4,F,65700364,65708264,87678733,7900,474364285,27990,2
105377258,LOC105377258,chr4,R,65780637,65784672,87682768,4035,474368320,27991,2
105377259,LOC105377259,chr4,F,65868475,65886184,87700477,17709,474386029,27992,4
105377260,LOC105377260,chr4,F,65944938,65948261,87703800,3323,474389352,27993,2
105377261,LOC105377261,chr4,F,66003267,66046620,87747153,43353,474432705,27994,5
105377262,LOC105377262,chr4,R,66862863,67077385,87961675,214522,474647227,27995,3
105377263,LOC105377263,chr4,F,68077466,68080981,87965190,3515,474650742,27996,1
105377264,LOC105377264,chr4,F,67748545,67753709,87970354,5164,474655906,27997,2
105377265,LOC105377265,chr4,R,69047082,69056931,87980203,9849,474665755,27998,3
105377266,LOC105377266,chr4,R,69220529,69225008,87984682,4479,474670234,27999,2
105377267,LOC105377267,chr4,F,69194352,69200539,87990869,6187,474676421,28000,1
105377268,LOC105377268,chr4,R,69822500,69838531,88006900,16031,474692452,28001,2
105377269,LOC105377269,chr4,F,69986833,69993435,88013502,6602,474699054,28002,1
105377270,LOC105377270,chr4,R,70171509,70185437,88027430,13928,474712982,28003,2
105377271,LOC105377271,chr4,F,71622508,71653233,88058155,30725,474743707,28004,2
105377272,LOC105377272,chr4,F,73710338,73734745,88082562,24407,474768114,28005,2
105377273,LOC105377273,chr4,F,72953841,72998555,88127276,44714,474812828,28006,2
105377274,LOC105377274,chr4,F,73998772,74007941,88136445,9169,474821997,28007,2
105377275,LOC105377275,chr4,F,74038761,74042622,88140306,3861,474825858,28008,2
105377276,LOC105377276,chr4,R,74278044,74330316,88192578,52272,474878130,28009,1
105377277,LOC105377277,chr4,R,74115443,74138287,88215422,22844,474900974,28010,2
105377278,LOC105377278,chr4,R,74831126,74835652,88219948,4526,474905500,28011,3
105377279,LOC105377279,chr4,R,74925703,74932997,88227242,7294,474912794,28012,2
105377280,LOC105377280,chr4,F,74883351,74896108,88239999,12757,474925551,28013,2
105377281,LOC105377281,chr4,F,74881531,74882935,88241403,1404,474926955,28014,1
105377282,LOC105377282,chr4,R,74841555,74881197,88281045,39642,474966597,28015,5
105377283,LOC105377283,chr4,R,75081924,75127205,88326326,45281,475011878,28016,4
105377284,LOC105377284,chr4,F,75822950,75838700,88342076,15750,475027628,28017,6
105377285,LOC105377285,chr4,F,75878148,75888466,88352394,10318,475037946,28018,1
105377286,LOC105377286,chr4,R,76239727,76251673,88364340,11946,475049892,28019,2
105377287,LOC105377287,chr4,F,76418763,76428702,88374279,9939,475059831,28020,2
105377288,LOC105377288,chr4,F,76353287,76354264,88375256,977,475060808,28021,1
105377289,LOC105377289,chr4,R,76742077,76802524,88435703,60447,475121255,28022,2
105377290,LOC105377290,chr4,R,76624148,76646863,88458418,22715,475143970,28023,4
105377291,LOC105377291,chr4,R,77030975,77041202,88468645,10227,475154197,28024,1
105377292,LOC105377292,chr4,R,76996622,77011727,88483750,15105,475169302,28025,1
105377293,LOC105377293,chr4,R,76971147,76987802,88500405,16655,475185957,28026,1
105377294,LOC105377294,chr4,R,76906677,76949691,88543419,43014,475228971,28027,2
105377295,LOC105377295,chr4,R,77392274,77409281,88560426,17007,475245978,28028,2
105377296,LOC105377296,chr4,R,77580908,77589175,88568693,8267,475254245,28029,4
105377297,LOC105377297,chr4,R,77630636,77636939,88574996,6303,475260548,28030,2
105377298,LOC105377298,chr4,R,79288758,79298703,88584941,9945,475270493,28031,2
105377299,LOC105377299,chr4,R,78787004,78811325,88609262,24321,475294814,28032,2
105377300,LOC105377300,chr4,F,79377824,79399209,88630647,21385,475316199,28033,5
105377301,LOC105377301,chr4,F,79663717,79696454,88663384,32737,475348936,28034,3
105377302,LOC105377302,chr4,R,79696906,79744315,88710793,47409,475396345,28035,4
105377303,LOC105377303,chr4,R,80181263,80191465,88720995,10202,475406547,28036,1
105377304,LOC105377304,chr4,F,80219528,80255440,88756907,35912,475442459,28037,2
105377305,LOC105377305,chr4,R,80488784,80491550,88759673,2766,475445225,28038,2
105377306,LOC105377306,chr4,F,81499238,81502129,88762564,2891,475448116,28039,3
105377307,LOC105377307,chr4,F,82285012,82297508,88775060,12496,475460612,28040,3
105377308,LOC105377308,chr4,R,82242958,82285250,88817352,42292,475502904,28041,3
105377309,LOC105377309,chr4,R,82430922,82441166,88827596,10244,475513148,28042,2
105377310,LOC105377310,chr4,F,82469578,82480384,88838402,10806,475523954,28043,2
105377311,LOC105377311,chr4,R,83115240,83138388,88861550,23148,475547102,28044,3
105377312,LOC105377312,chr4,F,83109940,83120977,88872587,11037,475558139,28045,1
105377313,LOC105377313,chr4,F,83297868,83316932,88891651,19064,475577203,28046,3
105377314,LOC105377314,chr4,F,83360570,83374227,88905308,13657,475590860,28047,2
105377315,LOC105377315,chr4,R,83796445,83803132,88911995,6687,475597547,28048,2
105377316,LOC105377316,chr4,R,84371613,84374900,88915282,3287,475600834,28049,2
105377317,LOC105377317,chr4,R,84443076,84456355,88928561,13279,475614113,28050,2
105377318,LOC105377318,chr4,R,84480882,84482987,88930666,2105,475616218,28051,3
105377319,LOC105377319,chr4,F,85646372,85660799,88945093,14427,475630645,28052,2
105377320,LOC105377320,chr4,F,87065372,87073658,88953379,8286,475638931,28053,1
105377321,LOC105377321,chr4,R,87462990,87468224,88958613,5234,475644165,28054,2
105377322,LOC105377322,chr4,F,87520252,87527531,88965892,7279,475651444,28055,1
105377323,LOC105377323,chr4,R,87657201,87673022,88981713,15821,475667265,28056,2
105377324,LOC105377324,chr4,R,87729836,87741413,88993290,11577,475678842,28057,2
105377325,LOC105377325,chr4,R,87999365,88003887,88997812,4522,475683364,28058,2
105377326,LOC105377326,chr4,F,88361574,88362153,88998391,579,475683943,28059,1
105377327,LOC105377327,chr4,F,88929975,88957527,89025943,27552,475711495,28060,3
105377328,LOC105377328,chr4,R,89456540,89485559,89054962,29019,475740514,28061,4
105377329,LOC105377329,chr4,F,89490971,89720426,89284417,229455,475969969,28062,16
105377330,LOC105377330,chr4,F,89739183,89741540,89286774,2357,475972326,28063,2
105377331,LOC105377331,chr4,R,90039613,90074847,89322008,35234,476007560,28064,3
105377332,LOC105377332,chr4,R,91268909,91303522,89356621,34613,476042173,28065,2
105377333,LOC105377333,chr4,R,90244056,90265847,89378412,21791,476063964,28066,3
105377334,LOC105377334,chr4,F,92635148,92673772,89417036,38624,476102588,28067,2
105377335,LOC105377335,chr4,F,95549141,95552322,89420217,3181,476105769,28068,1
105377336,LOC105377336,chr4,F,95400640,95431773,89451350,31133,476136902,28069,3
105377337,LOC105377337,chr4,F,95555608,95586299,89482041,30691,476167593,28070,3
105377338,LOC105377338,chr4,F,96170455,96631238,89942824,460783,476628376,28071,5
105377339,LOC105377339,chr4,F,96850386,96854590,89947028,4204,476632580,28072,2
105377340,LOC105377340,chr4,R,98183545,98203799,89967282,20254,476652834,28073,5
105377341,LOC105377341,chr4,F,98658911,98664550,89972921,5639,476658473,28074,1
105377342,LOC105377342,chr4,F,98658735,98678619,89992805,19884,476678357,28075,2
105377343,LOC105377343,chr4,R,98783793,98801296,90010308,17503,476695860,28076,4
105377344,LOC105377344,chr4,R,100483389,100487025,90013944,3636,476699496,28077,2
105377345,LOC105377345,chr4,F,100531935,100546470,90028479,14535,476714031,28078,2
105377346,LOC105377346,chr4,R,101640945,101650217,90037751,9272,476723303,28079,2
105377347,LOC105377347,chr4,R,102597669,102616271,90056353,18602,476741905,28080,3
105377348,LOC105377348,chr4,F,102828095,102844099,90072357,16004,476757909,28081,2
105377349,LOC105377349,chr4,F,103961619,104036522,90147260,74903,476832812,28082,3
105377350,LOC105377350,chr4,R,104283395,104394349,90258214,110954,476943766,28083,2
105377351,LOC105377351,chr4,F,104892898,104895394,90260710,2496,476946262,28084,2
105377352,LOC105377352,chr4,R,105537442,105552487,90275755,15045,476961307,28085,4
105377353,LOC105377353,chr4,F,105700028,105706265,90281992,6237,476967544,28086,2
105377354,LOC105377354,chr4,F,106279497,106296212,90298707,16715,476984259,28087,3
105377355,LOC105377355,chr4,F,106433494,106457332,90322545,23838,477008097,28088,5
105377356,LOC105377356,chr4,F,106525842,106843997,90640700,318155,477326252,28089,7
105377357,LOC105377357,chr4,F,107579144,107600550,90662106,21406,477347658,28090,2
105377358,LOC105377358,chr4,R,107546466,107590397,90706037,43931,477391589,28091,2
105377359,LOC105377359,chr4,F,108668141,108679401,90717297,11260,477402849,28092,2
105377360,LOC105377360,chr4,F,109185759,109206004,90737542,20245,477423094,28093,3
105377361,LOC105377361,chr4,R,109613093,109619117,90743566,6024,477429118,28094,2
105377362,LOC105377362,chr4,F,110365289,110373433,90751710,8144,477437262,28095,4
105377363,LOC105377363,chr4,F,110607974,110613503,90757239,5529,477442791,28096,1
105377364,LOC105377364,chr4,R,110986189,111013982,90785032,27793,477470584,28097,3
105377365,LOC105377365,chr4,F,111632224,111640477,90793285,8253,477478837,28098,2
105377366,LOC105377366,chr4,F,111642251,111648785,90799819,6534,477485371,28099,2
105377367,LOC105377367,chr4,R,111705580,111715305,90809544,9725,477495096,28100,2
105377368,LOC105377368,chr4,R,111826330,111844523,90827737,18193,477513289,28101,2
105377369,LOC105377369,chr4,F,111846141,111930877,90912473,84736,477598025,28102,6
105377370,LOC105377370,chr4,R,112120842,112131077,90922708,10235,477608260,28103,2
105377371,LOC105377371,chr4,R,112229560,112232381,90925529,2821,477611081,28104,1
105377372,LOC105377372,chr4,F,112523663,112546850,90948716,23187,477634268,28105,3
105377373,LOC105377373,chr4,R,113029507,113045225,90964434,15718,477649986,28106,4
105377374,LOC105377374,chr4,R,113402481,113434480,90996433,31999,477681985,28107,3
105377375,LOC105377375,chr4,F,113871745,113876592,91001280,4847,477686832,28108,2
105377376,LOC105377376,chr4,R,114023389,114036551,91014442,13162,477699994,28109,2
105377377,LOC105377377,chr4,F,114269417,114276941,91021966,7524,477707518,28110,2
105377378,LOC105377378,chr4,R,114334782,114364951,91052135,30169,477737687,28111,3
105377379,LOC105377379,chr4,F,114458111,114491099,91085123,32988,477770675,28112,4
105377380,LOC105377380,chr4,R,114549780,114555668,91091011,5888,477776563,28113,3
105377381,LOC105377381,chr4,F,114683066,114689484,91097429,6418,477782981,28114,1
105377382,LOC105377382,chr4,F,114724152,114731737,91105014,7585,477790566,28115,2
105377383,LOC105377383,chr4,R,116282073,116297174,91120115,15101,477805667,28116,1
105377384,LOC105377384,chr4,F,116344095,116355209,91131229,11114,477816781,28117,2
105377385,LOC105377385,chr4,F,116663937,116667507,91134799,3570,477820351,28118,2
105377386,LOC105377386,chr4,F,116770918,116774231,91138112,3313,477823664,28119,2
105377387,LOC105377387,chr4,F,117049109,117073107,91162110,23998,477847662,28120,4
105377388,LOC105377388,chr4,F,117081068,117105395,91186437,24327,477871989,28121,3
105377389,LOC105377389,chr4,R,117315157,117360795,91232075,45638,477917627,28122,4
105377390,LOC105377390,chr4,F,117361332,117389140,91259883,27808,477945435,28123,6
105377391,LOC105377391,chr4,F,117834399,117869948,91295432,35549,477980984,28124,2
105377392,LOC105377392,chr4,R,118251500,118265951,91309883,14451,477995435,28125,2
105377393,LOC105377393,chr4,F,118879224,118884685,91315344,5461,478000896,28126,2
105377394,LOC105377394,chr4,R,118961070,118984749,91339023,23679,478024575,28127,2
105377395,LOC105377395,chr4,R,119117845,119128366,91349544,10521,478035096,28128,3
105377396,LOC105377396,chr4,F,119628578,119636722,91357688,8144,478043240,28129,2
105377397,LOC105377397,chr4,F,119689432,119693463,91361719,4031,478047271,28130,2
105377398,LOC105377398,chr4,R,120563458,120571233,91369494,7775,478055046,28131,1
105377399,LOC105377399,chr4,F,120922945,120927628,91374177,4683,478059729,28132,2
105377400,LOC105377400,chr4,F,121072779,121081450,91382848,8671,478068400,28133,2
105377401,LOC105377401,chr4,F,121551526,121582702,91414024,31176,478099576,28134,2
105377402,LOC105377402,chr4,R,121642878,121650651,91421797,7773,478107349,28135,2
105377403,LOC105377403,chr4,R,122077249,122078310,91422858,1061,478108410,28136,1
105377404,LOC105377404,chr4,R,123325658,123326515,91423715,857,478109267,28137,1
105377405,LOC105377405,chr4,R,123533822,123546326,91436219,12504,478121771,28138,3
105377406,LOC105377406,chr4,F,124185260,124310723,91561682,125463,478247234,28139,6
105377407,LOC105377407,chr4,R,124033508,124252040,91780214,218532,478465766,28140,5
105377408,LOC105377408,chr4,R,124342722,124420328,91857820,77606,478543372,28141,3
105377409,LOC105377409,chr4,R,126221666,126243094,91879248,21428,478564800,28142,4
105377410,LOC105377410,chr4,F,126280040,126284395,91883603,4355,478569155,28143,3
105377411,LOC105377411,chr4,R,126462238,126464306,91885671,2068,478571223,28144,2
105377412,LOC105377412,chr4,R,127565062,127618205,91938814,53143,478624366,28145,3
105377413,LOC105377413,chr4,R,127618887,127632844,91952771,13957,478638323,28146,2
105377414,LOC105377414,chr4,R,127763372,127776918,91966317,13546,478651869,28147,2
105377415,LOC105377415,chr4,F,127827437,127829797,91968677,2360,478654229,28148,1
105377416,LOC105377416,chr4,R,129311028,129314000,91971649,2972,478657201,28149,2
105377417,LOC105377417,chr4,R,129363104,129383409,91991954,20305,478677506,28150,2
105377418,LOC105377418,chr4,F,130023077,130030760,91999637,7683,478685189,28151,2
105377419,LOC105377419,chr4,F,130124130,130138189,92013696,14059,478699248,28152,2
105377420,LOC105377420,chr4,F,130376253,130388079,92025522,11826,478711074,28153,2
105377421,LOC105377421,chr4,F,130896431,130901863,92030954,5432,478716506,28154,1
105377422,LOC105377422,chr4,R,131104703,131136251,92062502,31548,478748054,28155,2
105377423,LOC105377423,chr4,R,131341808,131343825,92064519,2017,478750071,28156,2
105377424,LOC105377424,chr4,F,131522922,131528144,92069741,5222,478755293,28157,2
105377425,LOC105377425,chr4,F,131804133,131837555,92103163,33422,478788715,28158,4
105377426,LOC105377426,chr4,R,131900278,131901281,92104166,1003,478789718,28159,2
105377427,LOC105377427,chr4,F,132002553,132006399,92108012,3846,478793564,28160,2
105377428,LOC105377428,chr4,R,132027264,132033697,92114445,6433,478799997,28161,2
105377429,LOC105377429,chr4,F,132531089,132547319,92130675,16230,478816227,28162,2
105377430,LOC105377430,chr4,F,132743336,132757295,92144634,13959,478830186,28163,2
105377431,LOC105377431,chr4,F,133012760,133029697,92161571,16937,478847123,28164,2
105377432,LOC105377432,chr4,F,133059044,133060028,92162555,984,478848107,28165,2
105377433,LOC105377433,chr4,R,134453316,134494241,92203480,40925,478889032,28166,2
105377434,LOC105377434,chr4,F,134382711,134457847,92278616,75136,478964168,28167,2
105377435,LOC105377435,chr4,F,134512087,134518019,92284548,5932,478970100,28168,2
105377436,LOC105377436,chr4,F,134544622,134640651,92380577,96029,479066129,28169,7
105377437,LOC105377437,chr4,F,134934261,134947019,92393335,12758,479078887,28170,3
105377438,LOC105377438,chr4,R,134932701,134940305,92400939,7604,479086491,28171,2
105377439,LOC105377439,chr4,R,135112762,135123645,92411822,10883,479097374,28172,3
105377440,LOC105377440,chr4,R,136690576,136750919,92472165,60343,479157717,28173,2
105377441,LOC105377441,chr4,R,136796674,136967318,92642809,170644,479328361,28174,2
105377442,LOC105377442,chr4,F,137483551,137486633,92645891,3082,479331443,28175,2
105377443,LOC105377443,chr4,F,137545730,137603430,92703591,57700,479389143,28176,1
105377444,LOC105377444,chr4,R,137707204,137734957,92731344,27753,479416896,28177,1
105377445,LOC105377445,chr4,F,137751400,137757644,92737588,6244,479423140,28178,3
105377446,LOC105377446,chr4,R,138386244,138414349,92765693,28105,479451245,28179,3
105377447,LOC105377447,chr4,F,137943278,138051701,92874116,108423,479559668,28180,9
105377448,LOC105377448,chr4,R,138995911,139012646,92890851,16735,479576403,28181,1
105377449,LOC105377449,chr4,R,139405366,139412933,92898418,7567,479583970,28182,2
105377450,LOC105377450,chr4,F,139393590,139420276,92925104,26686,479610656,28183,2
105377451,LOC105377451,chr4,F,139568547,139578883,92935440,10336,479620992,28184,2
105377452,LOC105377452,chr4,F,139929514,139931574,92937500,2060,479623052,28185,3
105377453,LOC105377453,chr4,R,139782145,139798525,92953880,16380,479639432,28186,1
105377454,LOC105377454,chr4,R,140301436,140303609,92956053,2173,479641605,28187,3
105377455,LOC105377455,chr4,R,141428812,141442575,92969816,13763,479655368,28188,2
105377456,LOC105377456,chr4,R,141568717,141577157,92978256,8440,479663808,28189,4
105377457,LOC105377457,chr4,F,142768636,142792128,93001748,23492,479687300,28190,4
105377458,LOC105377458,chr4,R,143817793,143829471,93013426,11678,479698978,28191,1
105377459,LOC105377459,chr4,F,143843838,143886988,93056576,43150,479742128,28192,8
105377460,LOC105377460,chr4,F,144080936,144090185,93065825,9249,479751377,28193,4
105377461,LOC105377461,chr4,R,144201485,144216119,93080459,14634,479766011,28194,4
105377462,LOC105377462,chr4,R,144216134,144562161,93426486,346027,480112038,28195,5
105377463,LOC105377463,chr4,F,145177542,145178747,93427691,1205,480113243,28196,1
105377464,LOC105377464,chr4,F,145197365,145232661,93462987,35296,480148539,28197,2
105377465,LOC105377465,chr4,R,145196744,145203554,93469797,6810,480155349,28198,2
105377466,LOC105377466,chr4,R,145335244,145343528,93478081,8284,480163633,28199,5
105377467,LOC105377467,chr4,F,145599062,145602281,93481300,3219,480166852,28200,2
105377468,LOC105377468,chr4,R,146040414,146059634,93500520,19220,480186072,28201,2
105377469,LOC105377469,chr4,F,146105676,146109625,93504469,3949,480190021,28202,2
105377470,LOC105377470,chr4,F,146122257,146131967,93514179,9710,480199731,28203,2
105377471,LOC105377471,chr4,F,146199981,146204436,93518634,4455,480204186,28204,1
105377472,LOC105377472,chr4,F,146294870,146299071,93522835,4201,480208387,28205,2
105377473,LOC105377473,chr4,F,146934007,146983894,93572722,49887,480258274,28206,11
105377474,LOC105377474,chr4,F,146833236,146833627,93573113,391,480258665,28207,2
105377475,LOC105377475,chr4,R,147002238,147020964,93591839,18726,480277391,28208,3
105377476,LOC105377476,chr4,F,147071146,147073226,93593919,2080,480279471,28209,1
105377477,LOC105377477,chr4,F,147569352,147594586,93619153,25234,480304705,28210,4
105377478,LOC105377478,chr4,R,147557286,147567438,93629305,10152,480314857,28211,6
105377479,LOC105377479,chr4,F,149516879,149521264,93633690,4385,480319242,28212,2
105377480,LOC105377480,chr4,R,148940940,148942425,93635175,1485,480320727,28213,2
105377481,LOC105377481,chr4,R,148783892,148835218,93686501,51326,480372053,28214,15
105377482,LOC105377482,chr4,R,148719364,148720357,93687494,993,480373046,28215,2
105377483,LOC105377483,chr4,R,148615115,148680767,93753146,65652,480438698,28216,3
105377484,LOC105377484,chr4,R,151256004,151325320,93822462,69316,480508014,28217,2
105377485,LOC105377485,chr4,F,151168033,151171934,93826363,3901,480511915,28218,1
105377486,LOC105377486,chr4,R,151401076,151409002,93834289,7926,480519841,28219,3
105377487,LOC105377487,chr4,F,151799448,151828603,93863444,29155,480548996,28220,2
105377488,LOC105377488,chr4,F,151912882,151940051,93890613,27169,480576165,28221,4
105377489,LOC105377489,chr4,R,152179489,152182360,93893484,2871,480579036,28222,1
105377490,LOC105377490,chr4,R,152206982,152225943,93912445,18961,480597997,28223,2
105377491,LOC105377491,chr4,R,152316468,152320442,93916419,3974,480601971,28224,2
105377492,LOC105377492,chr4,R,152268344,152310880,93958955,42536,480644507,28225,5
105377493,LOC105377493,chr4,R,152552249,152553758,93960464,1509,480646016,28226,2
105377494,LOC105377494,chr4,F,152666362,152670139,93964241,3777,480649793,28227,1
105377495,LOC105377495,chr4,F,152680119,152681656,93965778,1537,480651330,28228,3
105377496,LOC105377496,chr4,R,153226158,153249213,93988833,23055,480674385,28229,3
105377497,LOC105377497,chr4,F,153640173,153641506,93990166,1333,480675718,28230,2
105377498,LOC105377498,chr4,R,153527526,153542511,94005151,14985,480690703,28231,3
105377499,LOC105377499,chr4,F,153712737,153750679,94043093,37942,480728645,28232,6
105377500,LOC105377500,chr4,R,154766264,154781873,94058702,15609,480744254,28233,2
105377501,LOC105377501,chr4,R,155076201,155082503,94065004,6302,480750556,28234,2
105377502,LOC105377502,chr4,R,155286217,155304895,94083682,18678,480769234,28235,2
105377503,LOC105377503,chr4,F,155428513,155448605,94103774,20092,480789326,28236,3
105377504,LOC105377504,chr4,R,155521549,155522709,94104934,1160,480790486,28237,1
105377505,LOC105377505,chr4,F,155495881,155517196,94126249,21315,480811801,28238,3
105377506,LOC105377506,chr4,R,155713592,155758233,94170890,44641,480856442,28239,7
105377507,LOC105377507,chr4,F,155854760,155858898,94175028,4138,480860580,28240,2
105377508,LOC105377508,chr4,R,156305863,156330534,94199699,24671,480885251,28241,3
105377509,LOC105377509,chr4,R,157803424,158059684,94455959,256260,481141511,28242,7
105377510,LOC105377510,chr4,R,158356443,158394903,94494419,38460,481179971,28243,2
105377511,LOC105377511,chr4,F,159040768,159052408,94506059,11640,481191611,28244,2
105377512,LOC105377512,chr4,F,160518863,160553346,94540542,34483,481226094,28245,6
105377513,LOC105377513,chr4,R,160919295,160930793,94552040,11498,481237592,28246,3
105377514,LOC105377514,chr4,R,161066631,161124893,94610302,58262,481295854,28247,3
105377515,LOC105377515,chr4,R,161234007,161252202,94628497,18195,481314049,28248,2
105377516,LOC105377516,chr4,R,162705766,162736057,94658788,30291,481344340,28249,4
105377517,LOC105377517,chr4,F,163172275,163179118,94665631,6843,481351183,28250,2
105377518,LOC105377518,chr4,F,163521543,163528661,94672749,7118,481358301,28251,1
105377519,LOC105377519,chr4,F,165348410,165361542,94685881,13132,481371433,28252,2
105377520,LOC105377520,chr4,F,165505221,165507464,94688124,2243,481373676,28253,2
105377521,LOC105377521,chr4,R,165845606,165855704,94698222,10098,481383774,28254,2
105377522,LOC105377522,chr4,R,167308198,167424409,94814433,116211,481499985,28255,3
105377523,LOC105377523,chr4,R,168037650,168042709,94819492,5059,481505044,28256,3
105377524,LOC105377524,chr4,R,168169238,168199047,94849301,29809,481534853,28257,2
105377525,LOC105377525,chr4,R,168778904,168792280,94862677,13376,481548229,28258,2
105377526,LOC105377526,chr4,R,168650151,168677325,94889851,27174,481575403,28259,2
105377527,LOC105377527,chr4,R,169059360,169072194,94902685,12834,481588237,28260,3
105377528,LOC105377528,chr4,F,169201548,169229929,94931066,28381,481616618,28261,6
105377529,LOC105377529,chr4,R,169273994,169331093,94988165,57099,481673717,28262,4
105377530,LOC105377530,chr4,F,169912546,169941396,95017015,28850,481702567,28263,3
105377531,LOC105377531,chr4,F,170055174,170057423,95019264,2249,481704816,28264,2
105377532,LOC105377532,chr4,F,170092142,170107095,95034217,14953,481719769,28265,2
105377533,LOC105377533,chr4,F,170289845,170316537,95060909,26692,481746461,28266,8
105377534,LOC105377534,chr4,F,171276411,171288406,95072904,11995,481758456,28267,2
105377535,LOC105377535,chr4,F,171512353,171537237,95097788,24884,481783340,28268,2
105377536,LOC105377536,chr4,R,171635984,171656810,95118614,20826,481804166,28269,2
105377537,LOC105377537,chr4,R,172002980,172031055,95146689,28075,481832241,28270,2
105377538,LOC105377538,chr4,R,173322051,173329694,95154332,7643,481839884,28271,1
105377539,LOC105377539,chr4,R,173314748,173318041,95157625,3293,481843177,28272,1
105377540,LOC105377540,chr4,R,173363779,173370689,95164535,6910,481850087,28273,2
105377541,LOC105377541,chr4,F,173334744,173357566,95187357,22822,481872909,28274,3
105377542,LOC105377542,chr4,F,173527381,173583168,95243144,55787,481928696,28275,1
105377543,LOC105377543,chr4,R,173909736,173937358,95270766,27622,481956318,28276,7
105377544,LOC105377544,chr4,F,173953891,173980185,95297060,26294,481982612,28277,3
105377545,LOC105377545,chr4,F,174086762,174191903,95402201,105141,482087753,28278,2
105377546,LOC105377546,chr4,F,174005835,174018083,95414449,12248,482100001,28279,2
105377547,LOC105377547,chr4,F,174354728,174396697,95456418,41969,482141970,28280,5
105377548,LOC105377548,chr4,F,174536715,174541049,95460752,4334,482146304,28281,2
105377549,LOC105377549,chr4,F,174610105,174612239,95462886,2134,482148438,28282,2
105377550,LOC105377550,chr4,F,174613624,174614497,95463759,873,482149311,28283,1
105377551,LOC105377551,chr4,F,174630418,174635436,95468777,5018,482154329,28284,2
105377552,LOC105377552,chr4,F,175013051,175034309,95490035,21258,482175587,28285,2
105377553,LOC105377553,chr4,F,175948363,175951614,95493286,3251,482178838,28286,2
105377554,LOC105377554,chr4,F,176380827,176521706,95634165,140879,482319717,28287,5
105377555,LOC105377555,chr4,F,176654156,176706143,95686152,51987,482371704,28288,3
105377556,LOC105377556,chr4,F,176875711,176908072,95718513,32361,482404065,28289,3
105377557,LOC105377557,chr4,R,177220430,177226776,95724859,6346,482410411,28290,2
105377558,LOC105377558,chr4,R,177342347,177381354,95763866,39007,482449418,28291,5
105377559,LOC105377559,chr4,R,177686672,177691160,95768354,4488,482453906,28292,1
105377560,LOC105377560,chr4,R,177756382,177758371,95770343,1989,482455895,28293,2
105377561,LOC105377561,chr4,R,178007856,178038597,95801084,30741,482486636,28294,3
105377562,LOC105377562,chr4,F,178136774,178163582,95827892,26808,482513444,28295,4
105377563,LOC105377563,chr4,F,178813039,178817326,95832179,4287,482517731,28296,2
105377564,LOC105377564,chr4,R,179964858,180029565,95896886,64707,482582438,28297,2
105377565,LOC105377565,chr4,R,180460329,180532829,95969386,72500,482654938,28298,2
105377566,LOC105377566,chr4,R,180095499,180117090,95990977,21591,482676529,28299,2
105377567,LOC105377567,chr4,F,180058956,180554846,96486867,495890,483172419,28300,8
105377568,LOC105377568,chr4,R,180905495,180929240,96510612,23745,483196164,28301,4
105377569,LOC105377569,chr4,R,181036446,181060566,96534732,24120,483220284,28302,3
105377570,LOC105377570,chr4,R,182793923,182799582,96540391,5659,483225943,28303,2
105377571,LOC105377571,chr4,R,182762147,182767986,96546230,5839,483231782,28304,2
105377572,LOC105377572,chr4,R,182204527,182216815,96558518,12288,483244070,28305,5
105377573,LOC105377573,chr4,R,181820004,181821630,96560144,1626,483245696,28306,1
105377574,LOC105377574,chr4,F,181447618,181867837,96980363,420219,483665915,28307,2
105377575,LOC105377575,chr4,R,182826352,182832727,96986738,6375,483672290,28308,2
105377576,LOC105377576,chr4,R,182871594,182881167,96996311,9573,483681863,28309,4
105377577,LOC105377577,chr4,F,182937522,182943279,97002068,5757,483687620,28310,2
105377578,LOC105377578,chr4,R,183073368,183092283,97020983,18915,483706535,28311,4
105377579,LOC105377579,chr4,F,183559181,183564692,97026494,5511,483712046,28312,2
105377580,LOC105377580,chr4,R,183558583,183567306,97035217,8723,483720769,28313,2
105377581,LOC105377581,chr4,F,183725788,183733808,97043237,8020,483728789,28314,2
105377582,LOC105377582,chr4,R,184262608,184293682,97074311,31074,483759863,28315,7
105377583,LOC105377583,chr4,F,184287689,184296524,97083146,8835,483768698,28316,1
105377584,LOC105377584,chr4,F,184265035,184274264,97092375,9229,483777927,28317,2
105377585,LOC105377585,chr4,R,184506459,184538536,97124452,32077,483810004,28318,2
105377586,LOC105377586,chr4,R,184618615,184625697,97131534,7082,483817086,28319,3
105377587,LOC105377587,chr4,F,184826229,184844206,97149511,17977,483835063,28320,2
105377588,LOC105377588,chr4,R,185081108,185086206,97154609,5098,483840161,28321,2
105377589,LOC105377589,chr4,R,185323809,185341987,97172787,18178,483858339,28322,2
105377590,LOC105377590,chr4,F,185471673,185472263,97173377,590,483858929,28323,1
105377591,LOC105377591,chr4,F,185370724,185392840,97195493,22116,483881045,28324,1
105377592,LOC105377592,chr4,F,186015182,186018644,97198955,3462,483884507,28325,2
105377593,LOC105377593,chr4,R,185990124,186022965,97231796,32841,483917348,28326,2
105377594,LOC105377594,chr4,F,186104787,186124062,97251071,19275,483936623,28327,1
105377595,LOC105377595,chr4,F,186158228,186158843,97251686,615,483937238,28328,0
105377596,LOC105377596,chr4,F,186501068,186545752,97296370,44684,483981922,28329,2
105377597,LOC105377597,chr4,F,186666514,186673420,97303276,6906,483988828,28330,2
105377598,LOC105377598,chr4,F,186921166,186930893,97313003,9727,483998555,28331,2
105377599,LOC105377599,chr4,F,186891258,186892983,97314728,1725,484000280,28332,2
105377600,LOC105377600,chr4,F,187201979,187214091,97326840,12112,484012392,28333,3
105377601,LOC105377601,chr4,F,187421481,187437691,97343050,16210,484028602,28334,2
105377602,LOC105377602,chr4,F,187370075,187372098,97345073,2023,484030625,28335,2
105377603,LOC105377603,chr4,F,187613339,187712233,97443967,98894,484129519,28336,8
105377604,LOC105377604,chr4,R,187555619,187646425,97534773,90806,484220325,28337,9
105377605,LOC105377605,chr4,R,187945821,187992886,97581838,47065,484267390,28338,3
105377606,LOC105377606,chr4,F,188159216,188161142,97583764,1926,484269316,28339,1
105377607,LOC105377607,chr4,F,188175271,188181120,97589613,5849,484275165,28340,2
105377608,LOC105377608,chr4,R,188376282,188378118,97591449,1836,484277001,28341,2
105377609,LOC105377609,chr4,R,188433215,188460145,97618379,26930,484303931,28342,3
105377610,LOC105377610,chr4,F,188776563,188816899,97658715,40336,484344267,28343,4
105377611,LOC105377611,chr4,R,189054893,189058836,97662658,3943,484348210,28344,2
105377612,LOC105377612,chr4,R,189058980,189096944,97700622,37964,484386174,28345,3
105377613,LOC105377613,chr4,R,189114215,189126175,97712582,11960,484398134,28346,3
105377614,LOC105377614,chr4,F,189364339,189391692,97739935,27353,484425487,28347,2
105377615,LOC105377615,chr4,F,189550781,189551957,97741111,1176,484426663,28348,2
105377616,LOC105377616,chr4,R,189714055,189722576,97749632,8521,484435184,28349,2
105377617,LOC105377617,chr4,F,189881691,189888086,97756027,6395,484441579,28350,2
105377618,LOC105377618,chr4,R,189821614,189829110,97763523,7496,484449075,28351,2
105377619,LOC105377619,chr4,F,189817573,189820145,97766095,2572,484451647,28352,2
105377620,LOC105377620,chr4,F,189808189,189817564,97775470,9375,484461022,28353,4
105377621,LOC105377621,chr4,R,102418706,102501891,97858655,83185,484544207,28354,2
105377622,LOC105377622,chr4,R,139600623,139608579,97866611,7956,484552163,28355,5
105377623,LOC105377623,chr4,R,143177736,143185297,97874172,7561,484559724,28356,2
105377624,LOC105377624,chr4,R,185570101,185580930,97885001,10829,484570553,28357,2
105377651,LOC105377651,chr4,R,32005857,32022484,97901628,16627,484587180,28358,3
105377652,LOC105377652,chr4,F,52044802,52046924,97903750,2122,484589302,28359,2
105377653,LOC105377653,chr4,F,53038955,53051191,97915986,12236,484601538,28360,2
105377654,LOC105377654,chr4,R,53375302,53377646,97918330,2344,484603882,28361,1
105377655,LOC105377655,chr4,F,53908011,53917583,97927902,9572,484613454,28362,2
105377656,LOC105377656,chr4,F,54332872,54356104,97951134,23232,484636686,28363,1
105377657,LOC105377657,chr4,F,54756429,54818455,98013160,62026,484698712,28364,5
105377658,LOC105377658,chr4,R,54836076,54845413,98022497,9337,484708049,28365,1
105377659,LOC105377659,chr4,F,55378391,55386432,98030538,8041,484716090,28366,2
105377660,LOC105377660,chr4,F,55656471,55664655,98038722,8184,484724274,28367,2
105377661,LOC105377661,chr4,R,55821052,55825012,98042682,3960,484728234,28368,2
105377662,LOC105377662,chr4,R,55951392,55974326,98065616,22934,484751168,28369,4
105377663,LOC105377663,chr4,R,55890392,55948732,98123956,58340,484809508,28370,8
105377664,LOC105377664,chr4,R,56305855,56308284,98126385,2429,484811937,28371,1
105377665,LOC105377665,chr4,R,56523345,56530486,98133526,7141,484819078,28372,4
105377666,LOC105377666,chr4,F,56683189,56696367,98146704,13178,484832256,28373,2
105377667,LOC105377667,chr4,R,56697216,56704466,98153954,7250,484839506,28374,3
105377668,LOC105377668,chr4,F,56794900,56800897,98159951,5997,484845503,28375,2
105377669,LOC105377669,chr4,F,57008429,57010236,98161758,1807,484847310,28376,1
105377670,LOC105377670,chr4,F,57849856,57854653,98166555,4797,484852107,28377,2
105377671,LOC105377671,chr4,R,58524514,58536379,98178420,11865,484863972,28378,2
105377672,LOC105377672,chr4,R,58776421,58786610,98188609,10189,484874161,28379,4
108,ADCY2,chr5,F,7396229,7830081,433852,433852,485308013,28380,24
147,ADRA1B,chr5,F,159916732,159986178,503298,69446,485377459,28381,7
154,ADRB2,chr5,F,148826592,148828634,505340,2042,485379501,28382,0
309,ANXA6,chr5,R,151100705,151157882,562517,57177,485436678,28383,26
324,APC,chr5,F,112707504,112846239,701252,138735,485575413,28384,17
373,TRIM23,chr5,R,65589679,65624360,735933,34681,485610094,28385,11
411,ARSB,chr5,R,78777208,78986534,945259,209326,485819420,28386,13
475,ATOX1,chr5,R,151742821,151758649,961087,15828,485835248,28387,3
501,ALDH7A1,chr5,R,126541840,126595390,1014637,53550,485888798,28388,18
635,BHMT,chr5,F,79111780,79132290,1035147,20510,485909308,28389,7
662,BNIP1,chr5,F,173144441,173164387,1055093,19946,485929254,28390,8
689,BTF3,chr5,F,73498424,73505623,1062292,7199,485936453,28391,5
729,C6,chr5,R,41142145,41261486,1181633,119341,486055794,28392,22
730,C7,chr5,F,40909472,41016004,1288165,106532,486162326,28393,18
735,C9,chr5,R,39284274,39364553,1368444,80279,486242605,28394,10
814,CAMK4,chr5,F,111224248,111494886,1639082,270638,486513243,28395,10
815,CAMK2A,chr5,R,150219490,150289840,1709432,70350,486583593,28396,18
819,CAMLG,chr5,F,134737926,134752160,1723666,14234,486597827,28397,3
821,CANX,chr5,F,179678645,179731641,1776662,52996,486650823,28398,16
831,CAST,chr5,F,96662036,96774683,1889309,112647,486763470,28399,35
891,CCNB1,chr5,F,69167009,69178245,1900545,11236,486774706,28400,8
900,CCNG1,chr5,F,163437269,163445016,1908292,7747,486782453,28401,6
902,CCNH,chr5,R,87391492,87413033,1929833,21541,486803994,28402,9
929,CD14,chr5,R,140631727,140633701,1931807,1974,486805968,28403,2
972,CD74,chr5,R,150401636,150412936,1943107,11300,486817268,28404,8
995,CDC25C,chr5,R,138285264,138338355,1996198,53091,486870359,28405,14
1004,CDH6,chr5,F,31193654,31329146,2131690,135492,487005851,28406,12
1007,CDH9,chr5,R,26880599,27121198,2372289,240599,487246450,28407,12
1008,CDH10,chr5,R,24487099,24645024,2530214,157925,487404375,28408,13
1010,CDH12,chr5,R,21750863,22853622,3632973,1102759,488507134,28409,15
1016,CDH18,chr5,R,19472929,20575873,4735917,1102944,489610078,28410,20
1022,CDK7,chr5,F,69234794,69277430,4778553,42636,489652714,28411,11
1036,CDO1,chr5,R,115804732,115816954,4790775,12222,489664936,28412,5
1044,CDX1,chr5,F,150166780,150184558,4808553,17778,489682714,28413,2
1070,CETN3,chr5,R,90393334,90409786,4825005,16452,489699166,28414,5
1105,CHD1,chr5,R,98855203,98928623,4898425,73420,489772586,28415,36
1160,CKMT2,chr5,F,81233319,81266398,4931504,33079,489805665,28416,10
1161,ERCC8,chr5,R,60873831,60945078,5002751,71247,489876912,28417,12
1176,AP3S1,chr5,F,115841921,115914081,5074911,72160,489949072,28418,7
1212,CLTB,chr5,R,176392454,176416569,5099026,24115,489973187,28419,7
1350,COX7C,chr5,F,86617966,86620766,5101826,2800,489975987,28420,2
1393,CRHBP,chr5,F,76952834,76981147,5130139,28313,490004300,28421,8
1404,HAPLN1,chr5,R,83638197,83721077,5213019,82880,490087180,28422,6
1436,CSF1R,chr5,R,150053290,150113372,5273101,60082,490147262,28423,21
1437,CSF2,chr5,F,132073791,132076170,5275480,2379,490149641,28424,3
1452,CSNK1A1,chr5,R,149495893,149551552,5331139,55659,490205300,28425,10
1456,CSNK1G3,chr5,F,123512098,123617045,5436086,104947,490310247,28426,13
1462,VCAN,chr5,F,83471673,83582303,5546716,110630,490420877,28427,14
1482,NKX2-5,chr5,R,173232103,173235312,5549925,3209,490424086,28428,1
1495,CTNNA1,chr5,F,138753395,138935034,5731564,181639,490605725,28429,21
1501,CTNND2,chr5,R,10971839,11904043,6663768,932204,491537929,28430,25
1601,DAB2,chr5,R,39371673,39425233,6717328,53560,491591489,28431,14
1611,DAP,chr5,R,10679229,10761275,6799374,82046,491673535,28432,3
1627,DBN1,chr5,R,177456612,177480336,6823098,23724,491697259,28433,18
1657,DMXL1,chr5,F,119071013,119249129,7001214,178116,491875375,28434,45
1719,DHFR,chr5,R,80626225,80654981,7029970,28756,491904131,28435,5
1729,DIAPH1,chr5,R,141515015,141619055,7134010,104040,492008171,28436,30
1767,DNAH5,chr5,R,13690327,14011759,7455442,321432,492329603,28437,79
1794,DOCK2,chr5,F,169637246,170083382,7901578,446136,492775739,28438,57
1809,DPYSL3,chr5,R,147390807,147510260,8021031,119453,492895192,28439,15
1812,DRD1,chr5,R,175440671,175444160,8024520,3489,492898681,28440,1
1836,SLC26A2,chr5,F,149960736,149987400,8051184,26664,492925345,28441,2
1839,HBEGF,chr5,R,140332842,140346603,8064945,13761,492939106,28442,5
1843,DUSP1,chr5,R,172768089,172771200,8068056,3111,492942217,28443,3
1879,EBF1,chr5,R,158695907,159099780,8471929,403873,493346090,28444,20
1946,EFNA5,chr5,R,107376888,107670895,8765936,294007,493640097,28445,6
1958,EGR1,chr5,F,138465491,138469315,8769760,3824,493643921,28446,1
2107,ETF1,chr5,R,138506092,138543300,8806968,37208,493681129,28447,12
2149,F2R,chr5,F,76716042,76735770,8826696,19728,493700857,28448,1
2150,F2RL1,chr5,F,76819007,76835315,8843004,16308,493717165,28449,1
2151,F2RL2,chr5,R,76615481,76623434,8850957,7953,493725118,28450,1
2161,F12,chr5,R,177402137,177416524,8865344,14387,493739505,28451,15
2172,FABP6,chr5,F,160187366,160238722,8916700,51356,493790861,28452,7
2196,FAT2,chr5,R,151504091,151652140,9064749,148049,493938910,28453,32
2201,FBN2,chr5,R,128257908,128538042,9344883,280134,494219044,28454,64
2241,FER,chr5,F,108746084,109187674,9786473,441590,494660634,28455,27
2246,FGF1,chr5,R,142592177,142698070,9892366,105893,494766527,28456,7
2255,FGF10,chr5,R,44303540,44389780,9978606,86240,494852767,28457,3
2264,FGFR4,chr5,F,177086871,177098142,9989877,11271,494864038,28458,18
2297,FOXD1,chr5,R,73446255,73448527,9992149,2272,494866310,28459,0
2299,FOXI1,chr5,F,170105896,170109725,9995978,3829,494870139,28460,2
2324,FLT4,chr5,R,180601505,180650271,10044744,48766,494918905,28461,33
2533,FYB,chr5,R,39105251,39274523,10214016,169272,495088177,28462,26
2554,GABRA1,chr5,F,161847190,161899959,10266785,52769,495140946,28463,12
2559,GABRA6,chr5,F,161685651,161702592,10283726,16941,495157887,28464,8
2561,GABRB2,chr5,R,161288418,161548124,10543432,259706,495417593,28465,11
2566,GABRG2,chr5,F,162067641,162155539,10631330,87898,495505491,28466,10
2568,GABRP,chr5,F,170772565,170814047,10672812,41482,495546973,28467,11
2661,GDF9,chr5,R,132861180,132866884,10678516,5704,495552677,28468,3
2668,GDNF,chr5,R,37812676,37839680,10705520,27004,495579681,28469,6
2676,GFRA3,chr5,R,138252379,138274564,10727705,22185,495601866,28470,7
2690,GHR,chr5,F,42423774,42721878,11025809,298104,495899970,28471,17
2741,GLRA1,chr5,R,151822512,151924866,11128163,102354,496002324,28472,9
2745,GLRX,chr5,R,95813848,95822873,11137188,9025,496011349,28473,2
2760,GM2A,chr5,F,151253051,151270394,11154531,17343,496028692,28474,3
2870,GRK6,chr5,F,177426495,177442849,11170885,16354,496045046,28475,17
2878,GPX3,chr5,F,151020437,151028993,11179441,8556,496053602,28476,4
2890,GRIA1,chr5,F,153489695,153813873,11503619,324178,496377780,28477,20
2908,NR3C1,chr5,R,143277930,143435512,11661201,157582,496535362,28478,14
2916,GRM6,chr5,R,178978326,178995123,11677998,16797,496552159,28479,9
2966,GTF2H2,chr5,R,71035123,71067670,11710545,32547,496584706,28480,15
3001,GZMA,chr5,F,55102645,55110252,11718152,7607,496592313,28481,4
3003,GZMK,chr5,F,55024278,55034132,11728006,9854,496602167,28482,4
3035,HARS,chr5,R,140673903,140691727,11745830,17824,496619991,28483,12
3074,HEXB,chr5,F,74640022,74721288,11827096,81266,496701257,28484,14
3094,HINT1,chr5,R,131159282,131165348,11833162,6066,496707323,28485,4
3101,HK3,chr5,R,176880868,176899373,11851667,18505,496725828,28486,20
3156,HMGCR,chr5,F,75336333,75362101,11877435,25768,496751596,28487,21
3157,HMGCS1,chr5,R,43287469,43313512,11903478,26043,496777639,28488,11
3161,HMMR,chr5,F,163460510,163491945,11934913,31435,496809074,28489,17
3182,HNRNPAB,chr5,F,178204506,178211183,11941590,6677,496815751,28490,7
3187,HNRNPH1,chr5,R,179614177,179634784,11962197,20607,496836358,28491,16
3274,HRH2,chr5,F,175657795,175710756,12015158,52961,496889319,28492,6
3295,HSD17B4,chr5,F,119452442,119542335,12105051,89893,496979212,28493,24
3308,HSPA4,chr5,F,133051969,133105017,12158099,53048,497032260,28494,18
3313,HSPA9,chr5,R,138554881,138575629,12178847,20748,497053008,28495,16
3340,NDST1,chr5,F,150485822,150558211,12251236,72389,497125397,28496,18
3350,HTR1A,chr5,R,63960047,63962292,12253481,2245,497127642,28497,0
3360,HTR4,chr5,R,148451031,148654527,12456977,203496,497331138,28498,11
3550,IK,chr5,F,140647798,140662480,12471659,14682,497345820,28499,19
3562,IL3,chr5,F,132060653,132063203,12474209,2550,497348370,28500,4
3565,IL4,chr5,F,132673985,132682678,12482902,8693,497357063,28501,3
3567,IL5,chr5,R,132541443,132556890,12498349,15447,497372510,28502,5
3572,IL6ST,chr5,R,55935094,55994993,12558248,59899,497432409,28503,18
3575,IL7R,chr5,F,35856874,35879603,12580977,22729,497455138,28504,7
3578,IL9,chr5,R,135892245,135895827,12584559,3582,497458720,28505,4
3593,IL12B,chr5,R,159314782,159330473,12600250,15691,497474411,28506,7
3596,IL13,chr5,F,132658172,132661109,12603187,2937,497477348,28507,3
3659,IRF1,chr5,R,132481608,132490777,12612356,9169,497486517,28508,9
3670,ISL1,chr5,F,51383123,51394738,12623971,11615,497498132,28509,6
3672,ITGA1,chr5,F,52788301,52953655,12789325,165354,497663486,28510,28
3673,ITGA2,chr5,F,52989325,53094779,12894779,105454,497768940,28511,29
3702,ITK,chr5,F,157180895,157255099,12968983,74204,497843144,28512,16
3779,KCNMB1,chr5,R,170378160,170389677,12980500,11517,497854661,28513,3
3781,KCNN2,chr5,F,114056005,114496500,13420995,440495,498295156,28514,14
3796,KIF2A,chr5,F,62306161,62387184,13502018,81023,498376179,28515,21
3842,TNPO1,chr5,F,72816590,72914388,13599816,97798,498473977,28516,25
3937,LCP2,chr5,R,170247753,170297818,13649881,50065,498524042,28517,20
3950,LECT2,chr5,R,135946910,135955034,13658005,8124,498532166,28518,3
3977,LIFR,chr5,R,38474962,38595405,13778448,120443,498652609,28519,23
4001,LMNB1,chr5,F,126776622,126837020,13838846,60398,498713007,28520,11
4012,LNPEP,chr5,F,96935641,97029411,13932616,93770,498806777,28521,18
4015,LOX,chr5,R,122063194,122078360,13947782,15166,498821943,28522,6
4056,LTC4S,chr5,F,179793984,179796512,13950310,2528,498824471,28523,4
4064,CD180,chr5,R,67181008,67196789,13966091,15781,498840252,28524,3
4090,SMAD5,chr5,F,136132844,136182734,14015981,49890,498890142,28525,8
4124,MAN2A1,chr5,F,109689365,109869625,14196241,180260,499070402,28526,24
4131,MAP1B,chr5,F,72107290,72209570,14298521,102280,499172682,28527,7
4163,MCC,chr5,R,113022098,113488830,14765253,466732,499639414,28528,20
4208,MEF2C,chr5,R,88718240,88904105,14951118,185865,499825279,28529,15
4214,MAP3K1,chr5,F,56815072,56896152,15032198,81080,499906359,28530,22
4238,MFAP3,chr5,F,154038958,154057454,15050694,18496,499924855,28531,2
4245,MGAT1,chr5,R,180790540,180815652,15075806,25112,499949967,28532,8
4338,MOCS2,chr5,R,53095678,53109772,15089900,14094,499964061,28533,6
4437,MSH3,chr5,F,80654647,80876815,15312068,222168,500186229,28534,23
4488,MSX2,chr5,F,174724571,174730899,15318396,6328,500192557,28535,1
4552,MTRR,chr5,F,7851185,7901124,15368335,49939,500242496,28536,20
4651,MYO10,chr5,R,16661906,16936276,15642705,274370,500516866,28537,43
4671,NAIP,chr5,R,70968482,71025114,15699337,56632,500573498,28538,19
4695,NDUFA2,chr5,R,140645362,140647785,15701760,2423,500575921,28539,1
4724,NDUFS4,chr5,F,53560622,53683341,15824479,122719,500698640,28540,6
4726,NDUFS6,chr5,F,1801381,1816051,15839149,14670,500713310,28541,3
4762,NEUROG1,chr5,R,135534281,135535949,15840817,1668,500714978,28542,0
4869,NPM1,chr5,F,171387647,171410884,15864054,23237,500738215,28543,11
4883,NPR3,chr5,F,32689075,32791724,15966703,102649,500840864,28544,13
4888,NPY6R,chr5,F,137801192,137810751,15976262,9559,500850423,28545,1
5019,OXCT1,chr5,R,41730064,41870689,16116887,140625,500991048,28546,16
5066,PAM,chr5,F,102755275,103031105,16392717,275830,501266878,28547,27
5097,PCDH1,chr5,R,141852318,141878813,16419212,26495,501293373,28548,8
5098,PCDHGC3,chr5,F,141476001,141512977,16456188,36976,501330349,28549,3
5122,PCSK1,chr5,R,96390335,96433281,16499134,42946,501373295,28550,14
5144,PDE4D,chr5,R,58969037,60522120,18052217,1553083,502926378,28551,35
5145,PDE6A,chr5,R,149857955,149959518,18153780,101563,503027941,28552,24
5159,PDGFRB,chr5,R,150113838,150155884,18195826,42046,503069987,28553,25
5201,PFDN1,chr5,R,140245049,140303104,18253881,58055,503128042,28554,4
5229,PGGT1B,chr5,R,115200240,115262887,18316528,62647,503190689,28555,9
5295,PIK3R1,chr5,F,68215755,68301821,18402594,86066,503276755,28556,19
5307,PITX1,chr5,R,135027733,135034274,18409135,6541,503283296,28557,2
5369,PMCHL1,chr5,F,22142351,22152272,18419056,9921,503293217,28558,3
5370,PMCHL2,chr5,F,71375784,71385993,18429265,10209,503303426,28559,3
5459,POU4F3,chr5,F,146339023,146340520,18430762,1497,503304923,28560,1
5480,PPIC,chr5,R,123023382,123036730,18444110,13348,503318271,28561,4
5515,PPP2CA,chr5,R,134196456,134226259,18473913,29803,503348074,28562,6
5521,PPP2R2B,chr5,R,146589503,147081520,18965930,492017,503840091,28563,13
5562,PRKAA1,chr5,R,40759378,40798195,19004747,38817,503878908,28564,9
5601,MAPK9,chr5,R,180233593,180292071,19063225,58478,503937386,28565,15
5618,PRLR,chr5,R,35048755,35230589,19245059,181834,504119220,28566,13
5626,PROP1,chr5,R,177992234,177996242,19249067,4008,504123228,28567,2
5734,PTGER4,chr5,F,40679497,40741764,19311334,62267,504185495,28568,6
5810,RAD1,chr5,R,34905259,34915675,19321750,10416,504195911,28569,5
5813,PURA,chr5,F,140114122,140119416,19327044,5294,504201205,28570,0
5884,RAD17,chr5,F,69369296,69414801,19372549,45505,504246710,28571,20
5917,RARS,chr5,F,168486457,168519306,19405398,32849,504279559,28572,14
5921,RASA1,chr5,F,87267800,87391926,19529524,124126,504403685,28573,26
5924,RASGRF2,chr5,F,80960671,81230162,19799015,269491,504673176,28574,27
6167,RPL37,chr5,R,40831327,40835285,19802973,3958,504677134,28575,3
6208,RPS14,chr5,R,150444228,150449756,19808501,5528,504682662,28576,4
6228,RPS23,chr5,R,82273319,82278416,19813598,5097,504687759,28577,3
6389,SDHA,chr5,F,218222,264816,19860192,46594,504734353,28578,15
6414,SEPP1,chr5,R,42799879,42811922,19872235,12043,504746396,28579,6
6444,SGCD,chr5,F,156117933,156767788,20522090,649855,505396251,28580,11
6500,SKP1,chr5,R,134156390,134177033,20542733,20643,505416894,28581,4
6502,SKP2,chr5,F,36151988,36192788,20583533,40800,505457694,28582,11
6507,SLC1A3,chr5,F,36606354,36688334,20665513,81980,505539674,28583,11
6531,SLC6A3,chr5,R,1392789,1445428,20718152,52639,505592313,28584,14
6534,SLC6A7,chr5,F,150189956,150211072,20739268,21116,505613429,28585,13
6550,SLC9A3,chr5,R,470509,570428,20839187,99919,505713348,28586,16
6558,SLC12A2,chr5,F,128083790,128189688,20945085,105898,505819246,28587,27
6569,SLC34A1,chr5,F,177384430,177398848,20959503,14418,505833664,28588,13
6583,SLC22A4,chr5,F,132294383,132344206,21009326,49823,505883487,28589,9
6584,SLC22A5,chr5,F,132369703,132395614,21035237,25911,505909398,28590,10
6586,SLIT3,chr5,R,168661732,169301129,21674634,639397,506548795,28591,35
6606,SMN1,chr5,F,70924940,70953015,21702709,28075,506576870,28592,9
6607,SMN2,chr5,F,70049522,70077595,21730782,28073,506604943,28593,9
6620,SNCB,chr5,R,176620208,176630556,21741130,10348,506615291,28594,6
6643,SNX2,chr5,F,122774995,122834539,21800674,59544,506674835,28595,14
6678,SPARC,chr5,R,151661095,151687054,21826633,25959,506700794,28596,9
6690,SPINK1,chr5,R,147824579,147839231,21841285,14652,506715446,28597,4
6695,SPOCK1,chr5,R,136975297,137499329,22365317,524032,507239478,28598,10
6715,SRD5A1,chr5,F,6633359,6669562,22401520,36203,507275681,28599,4
6728,SRP19,chr5,F,112861187,112893079,22433412,31892,507307573,28600,5
6793,STK10,chr5,R,172042069,172188342,22579685,146273,507453846,28601,19
6879,TAF7,chr5,R,141318489,141320784,22581980,2295,507456141,28602,0
6880,TAF9,chr5,R,69364742,69370013,22587251,5271,507461412,28603,5
6897,TARS,chr5,F,33440695,33468091,22614647,27396,507488808,28604,20
6902,TBCA,chr5,R,77691168,77776361,22699840,85193,507574001,28605,2
6932,TCF7,chr5,F,134114702,134148229,22733367,33527,507607528,28606,14
6940,ZNF354A,chr5,R,178711511,178730702,22752558,19191,507626719,28607,5
6949,TCOF1,chr5,F,150357638,150400308,22795228,42670,507669389,28608,28
7015,TERT,chr5,R,1253166,1295047,22837109,41881,507711270,28609,17
7025,NR2F1,chr5,F,93583336,93594611,22848384,11275,507722545,28610,2
7045,TGFBI,chr5,F,136028894,136063818,22883308,34924,507757469,28611,16
7060,THBS4,chr5,F,79991310,80083637,22975635,92327,507849796,28612,23
7204,TRIO,chr5,F,14143707,14510204,23342132,366497,508216293,28613,63
7219,TRP-TGG3-5,chr5,R,181188853,181188925,23342204,72,508216365,28614,0
7236,TRT-TGT6-1,chr5,R,181191686,181191758,23342276,72,508216437,28615,0
7239,TRV-AAC1-4,chr5,R,181218269,181218342,23342349,73,508216510,28616,0
7240,TRV-CAC1-2,chr5,F,181097069,181097142,23342422,73,508216583,28617,0
7241,TRV-AAC1-3,chr5,F,181169609,181169682,23342495,73,508216656,28618,0
7265,TTC1,chr5,F,160009099,160065545,23398941,56446,508273102,28619,7
7320,UBE2B,chr5,F,134371175,134392108,23419874,20933,508294035,28620,5
7322,UBE2D2,chr5,F,139561165,139628434,23487143,67269,508361304,28621,8
7416,VDAC1,chr5,R,133971874,134005389,23520658,33515,508394819,28622,8
7478,WNT8A,chr5,F,138083891,138096730,23533497,12839,508407658,28623,7
7518,XRCC4,chr5,F,83077408,83353760,23809849,276352,508684010,28624,11
7690,ZNF131,chr5,F,43120887,43176324,23865286,55437,508739447,28625,9
7903,ST8SIA4,chr5,R,100806934,100903285,23961637,96351,508835798,28626,5
7905,REEP5,chr5,R,112876383,112922334,24007588,45951,508881749,28627,4
8293,SERF1A,chr5,F,70900662,70918530,24025456,17868,508899617,28628,3
8382,NME5,chr5,R,138115171,138139443,24049728,24272,508923889,28629,7
8507,ENC1,chr5,R,74627405,74641424,24063747,14019,508937908,28630,3
8546,AP3B1,chr5,R,78002325,78294755,24356177,292430,509230338,28631,28
8572,PDLIM4,chr5,F,132257657,132273454,24371974,15797,509246135,28632,6
8611,PPAP2A,chr5,R,55424841,55535370,24482503,110529,509356664,28633,6
8614,STC2,chr5,R,173314722,173329503,24497284,14781,509371445,28634,3
8622,PDE8B,chr5,F,77180261,77428256,24745279,247995,509619440,28635,25
8637,EIF4EBP3,chr5,F,140547665,140549578,24747192,1913,509621353,28636,2
8641,PCDHGB4,chr5,F,141387884,141512979,24872287,125095,509746448,28637,3
8697,CDC23,chr5,R,138187647,138213343,24897983,25696,509772144,28638,15
8728,ADAM19,chr5,R,157477303,157575823,24996503,98520,509870664,28639,23
8817,FGF18,chr5,F,171419662,171457626,25034467,37964,509908628,28640,4
8841,HDAC3,chr5,R,141620875,141636856,25050448,15981,509924609,28641,14
8878,SQSTM1,chr5,F,179806387,179838078,25082139,31691,509956300,28642,11
8974,P4HA2,chr5,R,132192008,132227863,25117994,35855,509992155,28643,17
8988,HSPB3,chr5,F,54455600,54456384,25118778,784,509992939,28644,0
8992,ATP6V0E1,chr5,F,172983759,173034897,25169916,51138,510044077,28645,3
9037,SEMA5A,chr5,R,9035025,9546121,25681012,511096,510555173,28646,27
9140,ATG12,chr5,R,115828195,115841851,25694668,13656,510568829,28647,5
9180,OSMR,chr5,F,38845857,38945579,25794390,99722,510668551,28648,20
9232,PTTG1,chr5,F,160421806,160428744,25801328,6938,510675489,28649,5
9260,PDLIM7,chr5,R,177483393,177497619,25815554,14226,510689715,28650,14
9315,NREP,chr5,R,111729302,111976931,26063183,247629,510937344,28651,8
9319,TRIP13,chr5,F,892853,919072,26089402,26219,510963563,28652,13
9337,CNOT8,chr5,F,154857974,154876792,26108220,18818,510982381,28653,9
9366,RAB9BP1,chr5,F,105099473,105100098,26108845,625,510983006,28654,0
9421,HAND1,chr5,R,154474971,154478264,26112138,3293,510986299,28655,1
9443,MED7,chr5,R,157138439,157142910,26116609,4471,510990770,28656,2
9456,HOMER1,chr5,R,79373823,79513836,26256622,140013,511130783,28657,8
9499,MYOT,chr5,F,137867855,137887851,26276618,19996,511150779,28658,9
9509,ADAMTS2,chr5,R,179110850,179345430,26511198,234580,511385359,28659,22
9522,SCAMP1,chr5,F,78360502,78480739,26631435,120237,511505596,28660,8
9542,NRG2,chr5,R,139846778,140043437,26828094,196659,511702255,28661,16
9547,CXCL14,chr5,R,135570678,135579279,26836695,8601,511710856,28662,3
9555,H2AFY,chr5,R,135334380,135400147,26902462,65767,511776623,28663,13
9597,SMAD5-AS1,chr5,R,136129512,136134890,26907840,5378,511782001,28664,1
9604,RNF14,chr5,F,141966836,141990291,26931295,23455,511805456,28665,11
9607,CARTPT,chr5,F,71719162,71721048,26933181,1886,511807342,28666,2
9627,SNCAIP,chr5,F,122311348,122464099,27085932,152751,511960093,28667,18
9631,NUP155,chr5,R,37291632,37371455,27165755,79823,512039916,28668,35
9652,TTC37,chr5,R,95463894,95555005,27256866,91111,512131027,28669,42
9685,CLINT1,chr5,R,157785742,157859175,27330299,73433,512204460,28670,13
9708,PCDHGA8,chr5,F,141391915,141512979,27451363,121064,512325524,28671,3
9752,PCDHA9,chr5,F,140847771,141012344,27615936,164573,512490097,28672,3
9765,ZFYVE16,chr5,F,80407591,80480520,27688865,72929,512563026,28673,22
9782,MATR3,chr5,F,139273751,139331677,27746791,57926,512620952,28674,18
9794,MAML1,chr5,F,179732849,179777286,27791228,44437,512665389,28675,4
9812,KIAA0141,chr5,F,141923784,141951465,27818909,27681,512693070,28676,15
9832,JAKMIP2,chr5,R,147585438,147782848,28016319,197410,512890480,28677,21
9867,PJA2,chr5,R,109334708,109409974,28091585,75266,512965746,28678,9
9879,DDX46,chr5,F,134758733,134831138,28163990,72405,513038151,28679,25
9945,GFPT2,chr5,R,180300697,180353336,28216629,52639,513090790,28680,19
9963,SLC23A1,chr5,R,139367195,139384553,28233987,17358,513108148,28681,16
10007,GNPDA1,chr5,R,142000668,142013055,28246374,12387,513120535,28682,7
10011,SRA1,chr5,R,140550066,140558093,28254401,8027,513128562,28683,3
10016,PDCD6,chr5,F,271620,314974,28297755,43354,513171916,28684,6
10085,EDIL3,chr5,R,83940594,84384867,28742028,444273,513616189,28685,12
10087,COL4A3BP,chr5,R,75368485,75511981,28885524,143496,513759685,28686,19
10111,RAD50,chr5,F,132556923,132644621,28973222,87698,513847383,28687,24
10112,KIF20A,chr5,F,138178727,138187715,28982210,8988,513856371,28688,18
10146,G3BP1,chr5,F,151771914,151811356,29021652,39442,513895813,28689,11
10184,LHFPL2,chr5,R,78485214,78648895,29185333,163681,514059494,28690,7
10283,CWC27,chr5,F,64768917,65018763,29435179,249846,514309340,28691,17
10299,MARCH6,chr5,F,10353638,10440388,29521929,86750,514396090,28692,29
10307,APBB3,chr5,R,140558267,140564604,29528266,6337,514402427,28693,12
10309,CCNO,chr5,R,55231151,55233717,29530832,2566,514404993,28694,1
10318,TNIP1,chr5,R,151029942,151087660,29588550,57718,514462711,28695,20
10399,GNB2L1,chr5,R,181236927,181243906,29595529,6979,514469690,28696,7
10409,BASP1,chr5,F,17216822,17276845,29655552,60023,514529713,28697,2
10412,NSA2,chr5,F,74765428,74776912,29667036,11484,514541197,28698,7
10468,FST,chr5,F,53480340,53487134,29673830,6794,514547991,28699,6
10569,SLU7,chr5,R,160401640,160419161,29691351,17521,514565512,28700,16
10605,PAIP1,chr5,R,43526266,43557419,29722504,31153,514596665,28701,12
10622,POLR3G,chr5,F,90474228,90514677,29762953,40449,514637114,28702,11
10636,RGS14,chr5,F,177357710,177372601,29777844,14891,514652005,28703,14
10723,SLC12A7,chr5,R,1050373,1155747,29883218,105374,514757379,28704,29
10769,PLK2,chr5,R,58453981,58460139,29889376,6158,514763537,28705,13
10788,IQGAP2,chr5,F,76403254,76708132,30194254,304878,515068415,28706,38
10802,SEC24A,chr5,F,134648784,134727911,30273381,79127,515147542,28707,23
10814,CPLX2,chr5,F,175796538,175884021,30360864,87483,515235025,28708,6
10826,FAXDC2,chr5,R,154817033,154850653,30394484,33620,515268645,28709,9
10827,FAM114A2,chr5,R,153991598,154038937,30441823,47339,515315984,28710,16
10884,MRPS30,chr5,F,44808924,44815514,30448413,6590,515322574,28711,4
10902,BRD8,chr5,R,138139765,138178669,30487317,38904,515361478,28712,29
10915,TCERG1,chr5,F,146447309,146511508,30551516,64199,515425677,28713,26
10917,BTNL3,chr5,F,180988844,181006727,30569399,17883,515443560,28714,7
10923,SUB1,chr5,F,32585498,32604079,30587980,18581,515462141,28715,5
10949,HNRNPA0,chr5,R,137751383,137754350,30590947,2967,515465108,28716,0
10960,LMAN2,chr5,R,177331561,177351884,30611270,20323,515485431,28717,7
11005,SPINK5,chr5,F,148025687,148137366,30722949,111679,515597110,28718,34
11039,SMA4,chr5,R,70127461,70290177,30885665,162716,515759826,28719,11
11042,SMA5,chr5,R,70481042,70585722,30990345,104680,515864506,28720,10
11044,PAPD7,chr5,F,6713952,6757048,31033441,43096,515907602,28721,12
11063,SOX30,chr5,R,157624795,157672756,31081402,47961,515955563,28722,7
11076,TPPP,chr5,R,659861,693395,31114936,33534,515989097,28723,4
11082,ESM1,chr5,R,54977866,54985586,31122656,7720,515996817,28724,2
11127,KIF3A,chr5,R,132689160,132737633,31171129,48473,516045290,28725,19
11174,ADAMTS6,chr5,R,65148735,65482027,31504421,333292,516378582,28726,33
11282,MGAT4B,chr5,R,179797596,179806952,31513777,9356,516387938,28727,14
11285,B4GALT7,chr5,F,177600117,177610347,31524007,10230,516398168,28728,7
11336,EXOC3,chr5,F,443208,467305,31548104,24097,516422265,28729,13
11346,SYNPO,chr5,F,150586036,150659230,31621298,73194,516495459,28730,9
22836,RHOBTB3,chr5,F,95731065,95796367,31686600,65302,516560761,28731,11
22838,RNF44,chr5,R,176526698,176543413,31703315,16715,516577476,28732,13
22885,ABLIM3,chr5,F,149141482,149260439,31822272,118957,516696433,28733,24
22936,ELL2,chr5,R,95885097,95962071,31899246,76974,516773407,28734,12
22948,CCT5,chr5,F,10250169,10266389,31915466,16220,516789627,28735,11
22987,SV2C,chr5,F,76083413,76353939,32185992,270526,517060153,28736,14
22993,HMGXB3,chr5,F,150000605,150053143,32238530,52538,517112691,28737,19
23037,PDZD2,chr5,F,31639362,32110932,32710100,471570,517584261,28738,29
23061,TBC1D9B,chr5,R,179862070,179907856,32755886,45786,517630047,28739,21
23092,ARHGAP26,chr5,F,142770379,143229007,33214514,458628,518088675,28740,36
23105,FSTL4,chr5,R,133194826,133842066,33861754,647240,518735915,28741,19
23107,MRPS27,chr5,R,72219408,72320257,33962603,100849,518836764,28742,11
23120,ATP10B,chr5,R,160563119,160929368,34328852,366249,519203013,28743,27
23138,N4BP3,chr5,F,178113505,178127034,34342381,13529,519216542,28744,4
23176,SEPT8,chr5,R,132750816,132778284,34369849,27468,519244010,28745,12
23194,FBXL7,chr5,F,15500164,15939796,34809481,439632,519683642,28746,6
23197,FAF2,chr5,F,176448305,176510074,34871250,61769,519745411,28747,10
23262,PPIP5K2,chr5,F,103120253,103203523,34954520,83270,519828681,28748,33
23286,WWC1,chr5,F,168292059,168472303,35134764,180244,520008925,28749,24
23291,FBXW11,chr5,R,171861548,172006873,35280089,145325,520154250,28750,16
23305,ACSL6,chr5,R,131949972,132012068,35342185,62096,520216346,28751,22
23338,JADE2,chr5,F,134524161,134583230,35401254,59069,520275415,28752,15
23367,LARP1,chr5,F,154682662,154817607,35536199,134945,520410360,28753,26
23379,ICE1,chr5,F,5422672,5490234,35603761,67562,520477922,28754,20
23398,PPWD1,chr5,F,65563235,65587549,35628075,24314,520502236,28755,12
23438,HARS2,chr5,F,140691425,140699318,35635968,7893,520510129,28756,12
23440,OTP,chr5,R,77628711,77638697,35645954,9986,520520115,28757,3
23517,SKIV2L2,chr5,F,55307747,55425581,35763788,117834,520637949,28758,26
23530,NNT,chr5,F,43602688,43705566,35866666,102878,520740827,28759,25
23548,TTC33,chr5,R,40711575,40755970,35911061,44395,520785222,28760,5
23567,ZNF346,chr5,F,177022679,177081188,35969570,58509,520843731,28761,9
23600,AMACR,chr5,R,33986985,34008115,35990700,21130,520864861,28762,4
23635,SSBP2,chr5,R,81417359,81751253,36324594,333894,521198755,28763,16
23743,BHMT2,chr5,F,79069723,79090074,36344945,20351,521219106,28764,7
25816,TNFAIP8,chr5,F,119268691,119394604,36470858,125913,521345019,28765,5
25836,NIPBL,chr5,F,36876758,37065819,36659919,189061,521534080,28766,46
25845,PP7080,chr5,R,470509,472965,36662375,2456,521536536,28767,1
25859,PART1,chr5,F,60487712,60547657,36722320,59945,521596481,28768,5
25929,GEMIN5,chr5,R,154887415,154938216,36773121,50801,521647282,28769,27
26025,PCDHGA12,chr5,F,141430590,141512979,36855510,82389,521729671,28770,3
26045,LRRTM2,chr5,R,138869345,138875368,36861533,6023,521735694,28771,1
26049,FAM169A,chr5,R,74777573,74866838,36950798,89265,521824959,28772,14
26064,RAI14,chr5,F,34656327,34832612,37127083,176285,522001244,28773,27
26112,CCDC69,chr5,R,151181051,151224093,37170125,43042,522044286,28774,8
26167,PCDHB5,chr5,F,141135205,141138127,37173047,2922,522047208,28775,0
26223,FBXL21,chr5,F,135930316,135941678,37184409,11362,522058570,28776,7
26249,KLHL3,chr5,R,137617499,137736090,37303000,118591,522177161,28777,16
26262,TSPAN17,chr5,F,176647386,176659058,37314672,11672,522188833,28778,8
26272,FBXO4,chr5,F,41925251,42040228,37429649,114977,522303810,28779,8
26683,OR4F3,chr5,F,181367286,181368225,37430588,939,522304749,28780,0
26693,OR2V1,chr5,R,181124356,181125304,37431536,948,522305697,28781,0
26762,HAVCR1,chr5,R,156979479,157069527,37521584,90048,522395745,28782,16
26785,SNORD63,chr5,R,138561042,138561110,37521652,68,522395813,28783,0
26821,SNORA74A,chr5,F,139278779,139278979,37521852,200,522396013,28784,0
26999,CYFIP2,chr5,F,157266079,157395598,37651371,129519,522525532,28785,34
27039,PKD2L2,chr5,F,137889210,137942747,37704908,53537,522579069,28786,17
27089,UQCRQ,chr5,F,132866626,132868844,37707126,2218,522581287,28787,2
27125,AFF4,chr5,R,132875378,132963662,37795410,88284,522669571,28788,22
27166,PRELID1,chr5,F,177303761,177306959,37798608,3198,522672769,28789,4
27190,IL17B,chr5,R,149374266,149404244,37828586,29978,522702747,28790,6
27292,DIMT1,chr5,R,62388523,62403901,37843964,15378,522718125,28791,11
27430,MAT2B,chr5,F,163503063,163519353,37860254,16290,522734415,28792,7
28965,SLC27A6,chr5,F,128965474,129033642,37928422,68168,522802583,28793,10
28966,SNX24,chr5,F,122845464,123029276,38112234,183812,522986395,28794,10
29093,MRPL22,chr5,F,154941072,154969411,38140573,28339,523014734,28795,6
29102,DROSHA,chr5,R,31400493,31532175,38272255,131682,523146416,28796,36
29930,PCDHB1,chr5,F,141051375,141053962,38274842,2587,523149003,28797,0
29958,DMGDH,chr5,R,78997563,79069674,38346953,72111,523221114,28798,18
30012,TLX3,chr5,F,171309283,171312134,38349804,2851,523223965,28799,2
30820,KCNIP1,chr5,F,170353486,170736632,38732950,383146,523607111,28800,13
30832,ZNF354C,chr5,F,179060605,179086298,38758643,25693,523632804,28801,5
50805,IRX4,chr5,R,1877426,1887179,38768396,9753,523642557,28802,7
50834,TAS2R1,chr5,R,9628996,9630351,38769751,1355,523643912,28803,0
51014,TMED7,chr5,R,115613207,115626179,38782723,12972,523656884,28804,3
51015,ISOC1,chr5,F,129094748,129114028,38802003,19280,523676164,28805,4
51121,RPL26L1,chr5,F,172954293,172969771,38817481,15478,523691642,28806,5
51128,SAR1B,chr5,R,134601148,134632843,38849176,31695,523723337,28807,7
51149,C5orf45,chr5,R,179837265,179858840,38870751,21575,523744912,28808,6
51151,SLC45A2,chr5,R,33944615,33985144,38911280,40529,523785441,28809,9
51164,DCTN4,chr5,R,150708746,150759095,38961629,50349,523835790,28810,17
51194,IPO11,chr5,F,62412745,62628589,39177473,215844,524051634,28811,3
51237,MZB1,chr5,R,139387567,139389916,39179822,2349,524053983,28812,3
51247,PAIP2,chr5,F,139341831,139369720,39207711,27889,524081872,28813,5
51265,CDKL3,chr5,R,134236119,134371469,39343061,135350,524217222,28814,22
51289,RXFP3,chr5,F,33936385,33938918,39345594,2533,524219755,28815,0
51294,PCDH12,chr5,R,141943584,141959062,39361072,15478,524235233,28816,3
51301,GCNT4,chr5,R,75027463,75030899,39364508,3436,524238669,28817,0
51306,FAM13B,chr5,R,137937948,138051961,39478521,114013,524352682,28818,28
51307,FAM53C,chr5,F,138337534,138349729,39490716,12195,524364877,28819,5
51308,REEP2,chr5,F,138439000,138446969,39498685,7969,524372846,28820,7
51334,PRR16,chr5,F,120464277,120687332,39721740,223055,524595901,28821,9
51397,COMMD10,chr5,F,116083644,116412683,40050779,329039,524924940,28822,18
51426,POLK,chr5,F,75511042,75599823,40139560,88781,525013721,28823,20
51428,DDX41,chr5,R,177511576,177516966,40144950,5390,525019111,28824,16
51491,NOP16,chr5,R,176383936,176388762,40149776,4826,525023937,28825,5
51520,LARS,chr5,R,146113025,146182787,40219538,69762,525093699,28826,31
51523,CXXC5,chr5,F,139648715,139683882,40254705,35167,525128866,28827,5
51617,HMP19,chr5,F,174045603,174109179,40318281,63576,525192442,28828,4
51663,ZFR,chr5,R,32354349,32444761,40408693,90412,525282854,28829,19
51720,UIMC1,chr5,R,176905004,177022571,40526260,117567,525400421,28830,19
51735,RAPGEF6,chr5,R,131423920,131635236,40737576,211316,525611737,28831,30
51752,ERAP1,chr5,R,96760809,96935924,40912691,175115,525786852,28832,26
51780,KDM3B,chr5,F,138352595,138437027,40997123,84432,525871284,28833,25
51808,PHAX,chr5,F,126600914,126627252,41023461,26338,525897622,28834,4
53917,RAB24,chr5,R,177301189,177303744,41026016,2555,525900177,28835,6
53918,PELO,chr5,F,52787939,52802617,41040694,14678,525914855,28836,2
54439,RBM27,chr5,F,146203549,146289223,41126368,85674,526000529,28837,20
54463,FAM134B,chr5,R,16472815,16617058,41270611,144243,526144772,28838,11
54491,FAM105A,chr5,F,14581781,14616180,41305010,34399,526179171,28839,7
54492,NEURL1B,chr5,F,172641246,172691540,41355304,50294,526229465,28840,4
54505,DHX29,chr5,R,55256244,55307693,41406753,51449,526280914,28841,26
54508,EPB41L4A-AS2,chr5,F,112419582,112420978,41408149,1396,526282310,28842,0
54514,DDX4,chr5,F,55737994,55817147,41487302,79153,526361463,28843,22
54540,FAM193B,chr5,R,177519788,177554547,41522061,34759,526396222,28844,14
54545,MTMR12,chr5,R,32227006,32313008,41608063,86002,526482224,28845,17
54557,SGTB,chr5,R,65665927,65722821,41664957,56894,526539118,28846,11
54622,ARL15,chr5,R,53884747,54310586,42090796,425839,526964957,28847,7
54660,PCDHB18P,chr5,F,141234332,141237529,42093993,3197,526968154,28848,0
54661,PCDHB17P,chr5,F,141155998,141158409,42096404,2411,526970565,28849,0
54732,TMED9,chr5,F,177592211,177596107,42100300,3896,526974461,28850,4
54819,ZCCHC10,chr5,R,132996984,133026617,42129933,29633,527004094,28851,5
54825,CDHR2,chr5,F,176542510,176595768,42183191,53258,527057352,28852,33
54826,GIN1,chr5,R,103085999,103120169,42217361,34170,527091522,28853,7
54853,WDR55,chr5,F,140664798,140672345,42224908,7547,527099069,28854,8
54882,ANKHD1,chr5,F,140401813,140539856,42362951,138043,527237112,28855,34
54888,NSUN2,chr5,R,6599238,6633360,42397073,34122,527271234,28856,18
54908,SPDL1,chr5,F,169583633,169604778,42418218,21145,527292379,28857,14
54974,THG1L,chr5,F,157731314,157739818,42426722,8504,527300883,28858,8
55100,WDR70,chr5,F,37379288,37752674,42800108,373386,527674269,28859,18
55109,AGGF1,chr5,F,77030384,77065234,42834958,34850,527709119,28860,13
55255,WDR41,chr5,R,77430932,77620611,43024637,189679,527898798,28861,15
55299,BRIX1,chr5,F,34915714,34925682,43034605,9968,527908766,28862,9
55322,C5orf22,chr5,F,31532265,31555058,43057398,22793,527931559,28863,9
55338,LOC55338,chr5,R,87215734,87239201,43080865,23467,527955026,28864,2
55374,TMCO6,chr5,F,140596539,140647248,43131574,50709,528005735,28865,14
55521,TRIM36,chr5,R,115124761,115180546,43187359,55785,528061520,28866,13
55568,GALNT10,chr5,F,154190734,154420984,43417609,230250,528291770,28867,11
55651,NHP2,chr5,R,178149462,178153960,43422107,4498,528296268,28868,3
55696,RBM22,chr5,R,150690789,150701107,43432425,10318,528306586,28869,10
55722,CEP72,chr5,F,612289,663500,43483636,51211,528357797,28870,18
55781,RIOK2,chr5,R,97160866,97183301,43506071,22435,528380232,28871,9
55789,DEPDC1B,chr5,R,60596911,60700166,43609326,103255,528483487,28872,13
55814,BDP1,chr5,F,71455382,71581062,43735006,125680,528609167,28873,42
55819,RNF130,chr5,R,179920269,180072130,43886867,151861,528761028,28874,9
55914,ERBB2IP,chr5,F,65926464,66081023,44041426,154559,528915587,28875,28
56097,PCDHGC5,chr5,F,141489240,141512979,44065165,23739,528939326,28876,3
56098,PCDHGC4,chr5,F,141485173,141512979,44092971,27806,528967132,28877,3
56099,PCDHGB7,chr5,F,141417646,141512981,44188306,95335,529062467,28878,3
56100,PCDHGB6,chr5,F,141408202,141512979,44293083,104777,529167244,28879,3
56101,PCDHGB5,chr5,F,141398127,141512979,44407935,114852,529282096,28880,3
56102,PCDHGB3,chr5,F,141370263,141512979,44550651,142716,529424812,28881,3
56103,PCDHGB2,chr5,F,141360135,141512979,44703495,152844,529577656,28882,3
56104,PCDHGB1,chr5,F,141350260,141512979,44866214,162719,529740375,28883,3
56105,PCDHGA11,chr5,F,141420969,141512979,44958224,92010,529832385,28884,3
56106,PCDHGA10,chr5,F,141413175,141512979,45058028,99804,529932189,28885,3
56107,PCDHGA9,chr5,F,141402952,141512979,45168055,110027,530042216,28886,3
56108,PCDHGA7,chr5,F,141382738,141512979,45298296,130241,530172457,28887,3
56109,PCDHGA6,chr5,F,141374083,141512979,45437192,138896,530311353,28888,3
56110,PCDHGA5,chr5,F,141364330,141512979,45585841,148649,530460002,28889,3
56111,PCDHGA4,chr5,F,141355024,141512979,45743796,157955,530617957,28890,3
56112,PCDHGA3,chr5,F,141344033,141512979,45912742,168946,530786903,28891,3
56113,PCDHGA2,chr5,F,141338759,141512979,46086962,174220,530961123,28892,3
56114,PCDHGA1,chr5,F,141330684,141512979,46269257,182295,531143418,28893,3
56120,PCDHGB8P,chr5,F,141426285,141428258,46271230,1973,531145391,28894,0
56121,PCDHB15,chr5,F,141245348,141248234,46274116,2886,531148277,28895,0
56122,PCDHB14,chr5,F,141222325,141226288,46278079,3963,531152240,28896,0
56123,PCDHB13,chr5,F,141213918,141217421,46281582,3503,531155743,28897,0
56124,PCDHB12,chr5,F,141208718,141212126,46284990,3408,531159151,28898,0
56125,PCDHB11,chr5,F,141199774,141203045,46288261,3271,531162422,28899,0
56126,PCDHB10,chr5,F,141192378,141195640,46291523,3262,531165684,28900,0
56127,PCDHB9,chr5,F,141187126,141191538,46295935,4412,531170096,28901,0
56128,PCDHB8,chr5,F,141177789,141180500,46298646,2711,531172807,28902,0
56129,PCDHB7,chr5,F,141172620,141176376,46302402,3756,531176563,28903,0
56130,PCDHB6,chr5,F,141150021,141153287,46305668,3266,531179829,28904,0
56131,PCDHB4,chr5,F,141121749,141125623,46309542,3874,531183703,28905,0
56132,PCDHB3,chr5,F,141100241,141103827,46313128,3586,531187289,28906,0
56133,PCDHB2,chr5,F,141094606,141097380,46315902,2774,531190063,28907,0
56134,PCDHAC2,chr5,F,140966161,141012344,46362085,46183,531236246,28908,3
56135,PCDHAC1,chr5,F,140926716,141012344,46447713,85628,531321874,28909,3
56136,PCDHA13,chr5,F,140882268,141012344,46577789,130076,531451950,28910,3
56137,PCDHA12,chr5,F,140875301,141012344,46714832,137043,531588993,28911,3
56138,PCDHA11,chr5,F,140867512,141012344,46859664,144832,531733825,28912,3
56139,PCDHA10,chr5,F,140855882,141012344,47016126,156462,531890287,28913,3
56140,PCDHA8,chr5,F,140841321,141012344,47187149,171023,532061310,28914,3
56141,PCDHA7,chr5,F,140834383,141012344,47365110,177961,532239271,28915,3
56142,PCDHA6,chr5,F,140827921,141012344,47549533,184423,532423694,28916,3
56143,PCDHA5,chr5,F,140821775,141012344,47740102,190569,532614263,28917,3
56144,PCDHA4,chr5,F,140807073,141012344,47945373,205271,532819534,28918,3
56145,PCDHA3,chr5,F,140801197,141012344,48156520,211147,533030681,28919,3
56146,PCDHA2,chr5,F,140794858,141012344,48374006,217486,533248167,28920,3
56147,PCDHA1,chr5,F,140786135,141012344,48600215,226209,533474376,28921,3
56172,ANKH,chr5,R,14704799,14871778,48767194,166979,533641355,28922,12
56477,CCL28,chr5,R,43356971,43412391,48822614,55420,533696775,28923,6
56662,VTRNA1-3,chr5,F,140726158,140726246,48822702,88,533696863,28924,0
56663,VTRNA1-2,chr5,F,140718925,140719013,48822790,88,533696951,28925,0
56664,VTRNA1-1,chr5,F,140711275,140711373,48822888,98,533697049,28926,0
56923,NMUR2,chr5,R,152391540,152405281,48836629,13741,533710790,28927,3
56929,FEM1C,chr5,R,115520907,115544894,48860616,23987,533734777,28928,4
56951,C5orf15,chr5,R,133955506,133968715,48873825,13209,533747986,28929,2
56979,PRDM9,chr5,F,23507614,23528597,48894808,20983,533768969,28930,10
56990,CDC42SE2,chr5,F,131264008,131394690,49025490,130682,533899651,28931,5
57113,TRPC7,chr5,R,136212764,136365476,49178202,152712,534052363,28932,11
57179,KIAA1191,chr5,R,176346060,176361807,49193949,15747,534068110,28933,8
57222,ERGIC1,chr5,F,172834219,172952685,49312415,118466,534186576,28934,14
57396,CLK4,chr5,R,178602663,178630639,49340391,27976,534214552,28935,16
57451,TENM2,chr5,F,166979077,168264157,50625471,1285080,535499632,28936,32
57472,CNOT6,chr5,F,180494372,180578405,50709504,84033,535583665,28937,13
57486,NLN,chr5,F,65722195,65829283,50816592,107088,535690753,28938,14
57491,AHRR,chr5,F,304175,438291,50950708,134116,535824869,28939,11
57507,ZNF608,chr5,R,124636912,124748824,51062620,111912,535936781,28940,14
57528,KCTD16,chr5,F,144170759,144485686,51377547,314927,536251708,28941,7
57556,SEMA6A,chr5,R,116443554,116574926,51508919,131372,536383080,28942,20
57561,ARRDC3,chr5,R,91368723,91383359,51523555,14636,536397716,28943,7
57688,ZSWIM6,chr5,F,61332272,61546172,51737455,213900,536611616,28944,13
57717,PCDHB16,chr5,F,141181689,141186221,51741987,4532,536616148,28945,0
57763,ANKRA2,chr5,R,73552199,73565705,51755493,13506,536629654,28946,8
57824,HMHB1,chr5,F,143812160,143820719,51764052,8559,536638213,28947,1
63920,ZBED8,chr5,R,160393147,160400097,51771002,6950,536645163,28948,2
64083,GOLPH3,chr5,R,32124717,32174319,51820604,49602,536694765,28949,3
64087,MCCC2,chr5,F,71587287,71658706,51892023,71419,536766184,28950,18
64097,EPB41L4A,chr5,R,112142318,112419490,52169195,277172,537043356,28951,25
64105,CENPK,chr5,R,65508066,65563189,52224318,55123,537098479,28952,15
64167,ERAP2,chr5,F,96875939,96919703,52268082,43764,537142243,28953,18
64283,ARHGEF28,chr5,F,73626157,73941993,52583918,315836,537458079,28954,43
64324,NSD1,chr5,F,177133024,177300213,52751107,167189,537625268,28955,28
64374,SIL1,chr5,R,138946719,139198376,53002764,251657,537876925,28956,11
64396,GMCL1P1,chr5,R,178184509,178187432,53005687,2923,537879848,28957,0
64411,ARAP3,chr5,R,141653400,141682233,53034520,28833,537908681,28958,34
64417,C5orf28,chr5,R,43444251,43485178,53075447,40927,537949608,28959,7
64777,RMND5B,chr5,F,178130531,178148570,53093486,18039,537967647,28960,11
64839,FBXL17,chr5,R,107859032,108382098,53616552,523066,538490713,28961,16
64848,YTHDC2,chr5,F,113513682,113595287,53698157,81605,538572318,28962,31
64901,RANBP17,chr5,F,170861881,171300450,54136726,438569,539010887,28963,37
64902,AGXT2,chr5,R,34998100,35048188,54186814,50088,539060975,28964,13
64924,SLC30A5,chr5,F,69093948,69131072,54223938,37124,539098099,28965,15
64946,CENPH,chr5,F,69189547,69210357,54244748,20810,539118909,28966,8
64979,MRPL36,chr5,R,1798384,1801423,54247787,3039,539121948,28967,3
65056,GPBP1,chr5,F,57173848,57264679,54338618,90831,539212779,28968,14
65250,C5orf42,chr5,R,37065170,37249428,54522876,184258,539397037,28969,57
65980,BRD9,chr5,R,863734,892824,54551966,29090,539426127,28970,20
65983,GRAMD3,chr5,F,126360095,126494364,54686235,134269,539560396,28971,18
78991,PCYOX1L,chr5,F,149358006,149369658,54697887,11652,539572048,28972,6
79072,FASTKD3,chr5,R,7859158,7869037,54707766,9879,539581927,28973,6
79192,IRX1,chr5,F,3596053,3601403,54713116,5350,539587277,28974,3
79616,CCNJL,chr5,R,160251658,160313703,54775161,62045,539649322,28975,12
79628,SH3TC2,chr5,R,148982149,149063174,54856186,81025,539730347,28976,16
79646,PANK3,chr5,R,168555622,168579609,54880173,23987,539754334,28977,6
79668,PARP8,chr5,F,50665898,50846522,55060797,180624,539934958,28978,31
79685,SAP30L,chr5,F,154445956,154461053,55075894,15097,539950055,28979,4
79722,ANKRD55,chr5,R,56099679,56233359,55209574,133680,540083735,28980,12
79770,TXNDC15,chr5,F,134873769,134901633,55237438,27864,540111599,28981,4
79772,MCTP1,chr5,R,94703689,95284575,55818324,580886,540692485,28982,27
79810,PTCD2,chr5,F,72320366,72368397,55866355,48031,540740516,28983,10
79844,ZDHHC11,chr5,R,795604,858973,55929724,63369,540803885,28984,19
79888,LPCAT1,chr5,R,1461426,1525730,55994028,64304,540868189,28985,17
79908,BTNL8,chr5,F,180899076,180952166,56047118,53090,540921279,28986,11
79925,SPEF2,chr5,F,35617778,35814611,56243951,196833,541118112,28987,45
79930,DOK3,chr5,R,177501903,177510522,56252570,8619,541126731,28988,7
79993,ELOVL7,chr5,R,60751788,60844283,56345065,92495,541219226,28989,12
80006,TRAPPC13,chr5,F,65624716,65666127,56386476,41411,541260637,28990,13
80108,ZFP2,chr5,F,178895914,178933209,56423771,37295,541297932,28991,4
80230,RUFY1,chr5,F,179550560,179610026,56483237,59466,541357398,28992,22
80315,CPEB4,chr5,F,173888327,173960310,56555220,71983,541429381,28993,10
80758,PRR7,chr5,F,177446343,177456701,56565578,10358,541439739,28994,4
80762,NDFIP1,chr5,F,142108758,142154443,56611263,45685,541485424,28995,7
81037,CLPTM1L,chr5,R,1317754,1345065,56638574,27311,541512735,28996,16
81545,FBXO38,chr5,F,148383934,148442836,56697476,58902,541571637,28997,23
81555,YIPF5,chr5,R,144158158,144170714,56710032,12556,541584193,28998,5
81786,TRIM7,chr5,R,181193923,181205293,56721402,11370,541595563,28999,7
81789,TIGD6,chr5,R,149993122,150001167,56729447,8045,541603608,29000,1
81792,ADAMTS12,chr5,R,33523534,33892194,57098107,368660,541972268,29001,27
81848,SPRY4,chr5,R,142310426,142325055,57112736,14629,541986897,29002,4
83463,MXD3,chr5,R,177305499,177312291,57119528,6792,541993689,29003,6
83594,NUDT12,chr5,R,103548854,103562804,57133478,13950,542007639,29004,6
83697,SLC4A9,chr5,F,140358558,140375137,57150057,16579,542024218,29005,23
83734,ATG10,chr5,F,81972024,82258502,57436535,286478,542310696,29006,12
83853,ROPN1L,chr5,F,10441861,10482298,57476972,40437,542351133,29007,6
83884,SLC25A2,chr5,R,141302628,141304063,57478407,1435,542352568,29008,0
83890,SPATA9,chr5,R,95652180,95683010,57509237,30830,542383398,29009,11
83942,TSSK1B,chr5,R,113432553,113435031,57511715,2478,542385876,29010,0
83989,FAM172A,chr5,R,93617724,94111699,58005690,493975,542879851,29011,21
84054,PCDHB19P,chr5,F,141240120,141244752,58010322,4632,542884483,29012,0
84059,ADGRV1,chr5,F,90558799,91164223,58615746,605424,543489907,29013,90
84105,PCBD2,chr5,F,134905119,134962646,58673273,57527,543547434,29014,3
84135,UTP15,chr5,F,73565740,73583377,58690910,17637,543565071,29015,12
84240,ZCCHC9,chr5,F,81301582,81313344,58702672,11762,543576833,29016,6
84246,MED10,chr5,R,6371925,6378526,58709273,6601,543583434,29017,3
84249,PSD2,chr5,F,139721902,139844466,58831837,122564,543705998,29018,16
84250,ANKRD32,chr5,F,94615857,94714918,58930898,99061,543805059,29019,26
84321,THOC3,chr5,R,175938809,175968537,58960626,29728,543834787,29020,9
84327,ZBED3,chr5,R,77076706,77087205,58971125,10499,543845286,29021,2
84340,GFM2,chr5,R,74721203,74767371,59017293,46168,543891454,29022,23
84418,CYSTM1,chr5,F,140175067,140243789,59086015,68722,543960176,29023,2
84466,MEGF10,chr5,F,127228946,127461222,59318291,232276,544192452,29024,29
84651,SPINK7,chr5,F,148312426,148315919,59321784,3493,544195945,29025,3
84654,SPZ1,chr5,F,80319970,80321842,59323656,1872,544197817,29026,0
84674,CARD6,chr5,F,40841307,40855354,59337703,14047,544211864,29027,2
84851,TRIM52,chr5,R,181256326,181261160,59342537,4834,544216698,29028,1
84868,HAVCR2,chr5,R,157085831,157109237,59365943,23406,544240104,29029,6
85007,PHYKPL,chr5,R,178208473,178232822,59390292,24349,544264453,29030,14
85027,SMIM3,chr5,F,150777945,150796736,59409083,18791,544283244,29031,1
85409,NKD2,chr5,F,1008819,1038812,59439076,29993,544313237,29032,10
85480,TSLP,chr5,F,111070079,111078024,59447021,7945,544321182,29033,4
89848,FCHSD1,chr5,R,141639301,141651428,59459148,12127,544333309,29034,19
90249,UNC5A,chr5,F,176810558,176880898,59529488,70340,544403649,29035,16
90268,OTULIN,chr5,F,14664673,14712867,59577682,48194,544451843,29036,10
90355,C5orf30,chr5,F,103258740,103278660,59597602,19920,544471763,29037,5
90441,ZNF622,chr5,R,16451518,16470327,59616411,18809,544490572,29038,6
90624,LYRM7,chr5,F,131170913,131205426,59650924,34513,544525085,29039,4
90933,TRIM41,chr5,F,181223262,181235808,59663470,12546,544537631,29040,5
91137,SLC25A46,chr5,F,110738135,110765161,59690496,27026,544564657,29041,9
91272,BOD1,chr5,R,173607144,173617077,59700429,9933,544574590,29042,4
91368,CDKN2AIPNL,chr5,R,134402064,134414603,59712968,12539,544587129,29043,3
91522,COL23A1,chr5,R,178237615,178590555,60065908,352940,544940069,29044,30
91937,TIMD4,chr5,R,156919281,156972310,60118937,53029,544993098,29045,10
91942,NDUFAF2,chr5,F,60945128,61153037,60326846,207909,545201007,29046,3
91975,ZNF300,chr5,R,150894382,150904983,60337447,10601,545211608,29047,6
91977,MYOZ3,chr5,F,150660840,150679700,60356307,18860,545230468,29048,6
92181,UBTD2,chr5,R,172209644,172283791,60430454,74147,545304615,29049,3
92255,LMBRD2,chr5,R,36098418,36151913,60483949,53495,545358110,29050,18
92259,MRPS36,chr5,F,69217745,69230158,60496362,12413,545370523,29051,3
92270,ATP6AP1L,chr5,F,82278664,82344260,60561958,65596,545436119,29052,14
92304,SCGB3A1,chr5,R,180590104,180591487,60563341,1383,545437502,29053,2
93166,PRDM6,chr5,F,123035984,123194266,60721623,158282,545595784,29054,12
94033,FTMT,chr5,F,121851954,121852833,60722502,879,545596663,29055,0
94081,SFXN1,chr5,F,175478510,175529742,60773734,51232,545647895,29056,10
96459,FNIP1,chr5,R,131641713,131797063,60929084,155350,545803245,29057,17
112574,SNX18,chr5,F,54517758,54546586,60957912,28828,545832073,29058,1
113829,SLC35A4,chr5,F,140564564,140569104,60962452,4540,545836613,29059,2
114787,GPRIN1,chr5,R,176595801,176617338,60983989,21537,545858150,29060,2
114825,PWWP2A,chr5,R,160043561,160120808,61061236,77247,545935397,29061,12
114898,C1QTNF2,chr5,R,160347753,160370652,61084135,22899,545958296,29062,3
114899,C1QTNF3,chr5,R,34017857,34043266,61109544,25409,545983705,29063,5
114915,EPB41L4A-AS1,chr5,F,112160525,112162501,61111520,1976,545985681,29064,2
115123,MARCH3,chr5,R,126867713,127032402,61276209,164689,546150370,29065,10
115548,FCHO2,chr5,F,72955980,73090522,61410751,134542,546284912,29066,25
115827,RAB3C,chr5,F,58582126,58859394,61688019,277268,546562180,29067,6
116068,LYSMD3,chr5,R,90515625,90529584,61701978,13959,546576139,29068,3
116349,EXOC3-AS1,chr5,R,441834,443160,61703304,1326,546577465,29069,0
116842,LEAP2,chr5,F,132873665,132874890,61704529,1225,546578690,29070,2
117156,SCGB3A2,chr5,F,147878710,147882193,61708012,3483,546582173,29071,2
117608,ZNF354B,chr5,F,178859952,178884434,61732494,24482,546606655,29072,6
133383,SETD9,chr5,F,56909258,56925532,61748768,16274,546622929,29073,9
133396,IL31RA,chr5,F,55840333,55922854,61831289,82521,546705450,29074,20
133418,EMB,chr5,R,50396191,50443307,61878405,47116,546752566,29075,10
133482,SLCO6A1,chr5,R,102371781,102499656,62006280,127875,546880441,29076,13
133491,C5orf47,chr5,F,173989158,174006140,62023262,16982,546897423,29077,4
133522,PPARGC1B,chr5,F,149730251,149857874,62150885,127623,547025046,29078,15
133558,MROH2B,chr5,R,40998019,41071342,62224208,73323,547098369,29079,42
133584,EGFLAM,chr5,F,38258408,38465480,62431280,207072,547305441,29080,23
133619,PRRC1,chr5,F,127517608,127555089,62468761,37481,547342922,29081,8
133686,NADK2,chr5,R,36192588,36242279,62518452,49691,547392613,29082,14
133688,UGT3A1,chr5,R,35953088,36001045,62566409,47957,547440570,29083,10
133690,CAPSL,chr5,R,35904294,35938779,62600894,34485,547475055,29084,5
133746,JMY,chr5,F,79236101,79327215,62692008,91114,547566169,29085,10
133874,C5orf58,chr5,F,170232551,170246231,62705688,13680,547579849,29086,3
133923,ZNF474,chr5,F,122129512,122153571,62729747,24059,547603908,29087,1
133957,CCDC127,chr5,R,204759,218182,62743170,13423,547617331,29088,2
134083,OR2Y1,chr5,R,180739122,180740058,62744106,936,547618267,29089,0
134111,UBE2QL1,chr5,F,6437346,6496721,62803481,59375,547677642,29090,2
134121,C5orf49,chr5,R,7830377,7851490,62824594,21113,547698755,29091,3
134145,FAM173B,chr5,R,10225506,10250036,62849124,24530,547723285,29092,7
134147,CMBL,chr5,R,10277594,10308056,62879586,30462,547753747,29093,5
134187,POU5F2,chr5,R,93740308,93741603,62880881,1295,547755042,29094,0
134218,DNAJC21,chr5,F,34929592,34958964,62910253,29372,547784414,29095,13
134265,AFAP1L1,chr5,F,149271837,149343637,62982053,71800,547856214,29096,19
134266,GRPEL2,chr5,F,149345413,149354583,62991223,9170,547865384,29097,3
134285,TMEM171,chr5,F,73120560,73131817,63002480,11257,547876641,29098,4
134288,TMEM174,chr5,F,73173195,73175143,63004428,1948,547878589,29099,1
134353,LSM11,chr5,F,157743694,157760709,63021443,17015,547895604,29100,3
134359,POC5,chr5,R,75674197,75717488,63064734,43291,547938895,29101,14
134391,GPR151,chr5,R,146514853,146516113,63065994,1260,547940155,29102,0
134429,STARD4,chr5,R,111496032,111512536,63082498,16504,547956659,29103,5
134430,WDR36,chr5,F,111092171,111130502,63120829,38331,547994990,29104,22
134466,ZNF300P1,chr5,R,150930435,150946584,63136978,16149,548011139,29105,4
134492,NUDCD2,chr5,R,163453487,163460137,63143628,6650,548017789,29106,4
134510,UBLCP1,chr5,F,159263080,159286040,63166588,22960,548040749,29107,10
134526,ACOT12,chr5,R,81329990,81394169,63230767,64179,548104928,29108,15
134548,SOWAHA,chr5,F,132813323,132816797,63234241,3474,548108402,29109,0
134549,SHROOM1,chr5,R,132822140,132831621,63243722,9481,548117883,29110,8
134553,C5orf24,chr5,F,134845679,134859735,63257778,14056,548131939,29111,3
140890,SREK1,chr5,F,66144217,66183616,63297177,39399,548171338,29112,14
140947,DCANP1,chr5,R,135444213,135447348,63300312,3135,548174473,29113,0
153129,SLC38A9,chr5,R,55625844,55712335,63386803,86491,548260964,29114,20
153163,MGC32805,chr5,R,122436496,122479087,63429394,42591,548303555,29115,5
153201,SLC36A2,chr5,R,151314977,151347590,63462007,32613,548336168,29116,11
153218,SPINK13,chr5,F,148268859,148286210,63479358,17351,548353519,29117,4
153222,CREBRF,chr5,F,173056348,173139293,63562303,82945,548436464,29118,9
153241,CEP120,chr5,R,123344884,123423592,63641011,78708,548515172,29119,22
153328,SLC25A48,chr5,F,135834675,135888637,63694973,53962,548569134,29120,13
153339,TMEM167A,chr5,R,83052845,83077453,63719581,24608,548593742,29121,3
153364,MBLAC2,chr5,R,90458202,90474768,63736147,16566,548610308,29122,1
153396,TMEM161B,chr5,R,88185574,88268879,63819452,83305,548693613,29123,17
153443,SRFBP1,chr5,F,121961960,122028600,63886092,66640,548760253,29124,7
153469,JAKMIP2-AS1,chr5,F,147559993,147662009,63988108,102016,548862269,29125,3
153478,PLEKHG4B,chr5,F,54014,189972,64124066,135958,548998227,29126,20
153527,ZMAT2,chr5,F,140698742,140706663,64131987,7921,549006148,29127,6
153562,MARVELD2,chr5,F,69415111,69442063,64158939,26952,549033100,29128,8
153571,C5orf38,chr5,F,2751942,2755397,64162394,3455,549036555,29129,3
153572,IRX2,chr5,R,2741862,2751655,64172187,9793,549046348,29130,4
153579,BTNL9,chr5,F,181040224,181061523,64193486,21299,549067647,29131,12
153642,ARSK,chr5,F,95555110,95605102,64243478,49992,549117639,29132,8
153643,FAM81B,chr5,F,95384801,95450441,64309118,65640,549183279,29133,15
153657,TTC23L,chr5,F,34839163,34899650,64369605,60487,549243766,29134,16
153684,LOC153684,chr5,F,43042133,43045268,64372740,3135,549246901,29135,1
153733,CCDC112,chr5,R,115267187,115296761,64402314,29574,549276475,29136,11
153743,PPP1R2P3,chr5,F,156850537,156852528,64404305,1991,549278466,29137,0
153745,FAM71B,chr5,R,157162331,157166268,64408242,3937,549282403,29138,1
153768,PRELID2,chr5,R,145337931,145835383,64905694,497452,549779855,29139,13
153769,SH3RF2,chr5,F,145936562,146081773,65050905,145211,549925066,29140,11
153770,PLAC8L1,chr5,R,146084148,146104383,65071140,20235,549945301,29141,5
153830,RNF145,chr5,R,159157408,159210053,65123785,52645,549997946,29142,14
166968,MIER3,chr5,R,56919601,56952130,65156314,32529,550030475,29143,13
166979,CDC20B,chr5,R,55112970,55173177,65216521,60207,550090682,29144,12
167127,UGT3A2,chr5,R,36035016,36066921,65248426,31905,550122587,29145,7
167153,PAPD4,chr5,F,79612415,79686648,65322659,74233,550196820,29146,18
167227,DCP2,chr5,F,112976701,113022195,65368153,45494,550242314,29147,10
167359,NIM1K,chr5,F,43192053,43280850,65456950,88797,550331111,29148,5
167410,LIX1,chr5,R,97091869,97142816,65507897,50947,550382058,29149,5
167465,ZNF366,chr5,R,72439898,72507422,65575421,67524,550449582,29150,4
167555,FAM151B,chr5,F,80487980,80542563,65630004,54583,550504165,29151,12
170591,S100Z,chr5,F,76850000,76952882,65732886,102882,550607047,29152,10
170690,ADAMTS16,chr5,F,5140329,5320299,65912856,179970,550787017,29153,22
171019,ADAMTS19,chr5,F,129460398,129738763,66191221,278365,551065382,29154,23
192286,HIGD2A,chr5,F,176388782,176389750,66192189,968,551066350,29155,1
202051,SPATA24,chr5,R,139395939,139404155,66200405,8216,551074566,29156,7
202052,DNAJC18,chr5,R,139410202,139439525,66229728,29323,551103889,29157,7
202134,FAM153B,chr5,F,176063708,176114798,66280818,51090,551154979,29158,19
202151,RANBP3L,chr5,R,36247873,36301926,66334871,54053,551209032,29159,15
202181,LOC202181,chr5,R,177618499,177672277,66388649,53778,551262810,29160,5
202243,CCDC125,chr5,R,69273100,69332852,66448401,59752,551322562,29161,15
202299,LINC01554,chr5,F,95852231,95860133,66456303,7902,551330464,29162,2
202309,GAPT,chr5,F,58491434,58496358,66461227,4924,551335388,29163,2
202333,CMYA5,chr5,F,79689835,79800226,66571618,110391,551445779,29164,12
202374,STK32A,chr5,F,147234962,147401533,66738189,166571,551612350,29165,17
206338,LVRN,chr5,F,115954902,116027606,66810893,72704,551685054,29166,25
206358,SLC36A1,chr5,F,151411343,151561961,66961511,150618,551835672,29167,26
253260,RICTOR,chr5,R,38937919,39074419,67098011,136500,551972172,29168,39
253314,EIF4E1B,chr5,F,176630639,176646641,67114013,16002,551988174,29169,9
255167,LINC01018,chr5,F,6582135,6588500,67120378,6365,551994539,29170,4
255187,LOC255187,chr5,F,149063316,149109787,67166849,46471,552041010,29171,2
255426,RASGEF1C,chr5,R,180100794,180209130,67275185,108336,552149346,29172,15
256006,ANKRD31,chr5,R,75068296,75236887,67443776,168591,552317937,29173,27
256987,SERINC5,chr5,R,80111226,80256082,67588632,144856,552462793,29174,15
257358,LINC01366,chr5,F,170331392,170335100,67592340,3708,552466501,29175,2
257396,LOC257396,chr5,F,53109841,53115126,67597625,5285,552471786,29176,2
285577,LINC01019,chr5,R,3417151,3536094,67716568,118943,552590729,29177,4
285588,EFCAB9,chr5,F,172188429,172203454,67731593,15025,552605754,29178,5
285590,SH3PXD2B,chr5,R,172325180,172454523,67860936,129343,552735097,29179,13
285593,LOC285593,chr5,F,173579633,173585068,67866371,5435,552740532,29180,3
285596,FAM153A,chr5,R,177722379,177783398,67927390,61019,552801551,29181,28
285598,ARL10,chr5,F,176365473,176415463,67977380,49990,552851541,29182,4
285600,KIAA0825,chr5,R,94150850,94618604,68445134,467754,553319295,29183,32
285601,GPR150,chr5,F,95618295,95621672,68448511,3377,553322672,29184,0
285605,DTWD2,chr5,R,118836073,118988545,68600983,152472,553475144,29185,8
285613,RELL2,chr5,F,141636945,141641064,68605102,4119,553479263,29186,4
285622,NBPF22P,chr5,F,86282443,86297547,68620206,15104,553494367,29187,7
285626,LOC285626,chr5,F,159331517,159362834,68651523,31317,553525684,29188,4
285627,LOC285627,chr5,R,159448555,159466276,68669244,17721,553543405,29189,6
285629,LOC285629,chr5,R,160931777,160938626,68676093,6849,553550254,29190,2
285636,C5orf51,chr5,F,41904288,41921636,68693441,17348,553567602,29191,6
285638,LOC285638,chr5,R,109237133,109330452,68786760,93319,553660921,29192,3
285641,SLC36A3,chr5,R,151276364,151312981,68823377,36617,553697538,29193,11
285643,KIF4B,chr5,F,155013699,155018125,68827803,4426,553701964,29194,0
285659,OR2V2,chr5,F,181154942,181155890,68828751,948,553702912,29195,0
285668,C5orf64,chr5,F,61637780,61730997,68921968,93217,553796129,29196,4
285671,RNF180,chr5,F,64165310,64374375,69131033,209065,554005194,29197,11
285672,SREK1IP1,chr5,R,64718147,64768731,69181617,50584,554055778,29198,4
285676,ZNF454,chr5,F,178941192,178966218,69206643,25026,554080804,29199,6
285679,C5orf60,chr5,R,179641541,179645167,69210269,3626,554084430,29200,5
285692,LOC285692,chr5,R,9641314,9903824,69472779,262510,554346940,29201,12
285696,LOC285696,chr5,R,17130027,17217422,69560174,87395,554434335,29202,2
285704,RGMB,chr5,F,98769294,98796494,69587374,27200,554461535,29203,6
285708,LINC00491,chr5,R,102608491,102671464,69650347,62973,554524508,29204,4
317671,RFESD,chr5,F,95646740,95658082,69661689,11342,554535850,29205,7
337876,CHSY3,chr5,F,129903407,130186678,69944960,283271,554819121,29206,7
340024,SLC6A19,chr5,F,1201594,1225117,69968483,23523,554842644,29207,11
340037,PRR7-AS1,chr5,R,177437888,177447944,69978539,10056,554852700,29208,3
340061,TMEM173,chr5,R,139475527,139482790,69985802,7263,554859963,29209,8
340069,FAM170A,chr5,F,119629558,119635822,69992066,6264,554866227,29210,4
340073,C5orf66-AS2,chr5,R,135236233,135248177,70004010,11944,554878171,29211,3
340074,LOC340074,chr5,R,135648682,135653935,70009263,5253,554883424,29212,2
340075,ARSI,chr5,R,150296345,150302962,70015880,6617,554890041,29213,1
340090,LOC340090,chr5,R,73194774,73201969,70023075,7195,554897236,29214,2
340094,LINC01020,chr5,F,5034358,5070004,70058721,35646,554932882,29215,6
340107,LOC340107,chr5,R,24835279,24840583,70064025,5304,554938186,29216,2
340113,LOC340113,chr5,F,32947442,32962467,70079050,15025,554953211,29217,5
340120,ANKRD34B,chr5,R,80556754,80572753,70095049,15999,554969210,29218,6
345456,PFN3,chr5,R,177400106,177400636,70095579,530,554969740,29219,0
345462,ZNF879,chr5,F,179023731,179034387,70106235,10656,554980396,29220,6
345557,PLCXD3,chr5,R,41306945,41510628,70309918,203683,555184079,29221,2
345611,IRGM,chr5,F,150846522,150902400,70365796,55878,555239957,29222,4
345630,FBLL1,chr5,F,168529576,168530634,70366854,1058,555241015,29223,0
345643,MCIDAS,chr5,R,55219596,55227315,70374573,7719,555248734,29224,6
345651,ACTBL2,chr5,R,57480015,57482809,70377367,2794,555251528,29225,0
345757,FAM174A,chr5,F,100535304,100586741,70428804,51437,555302965,29226,3
345778,MTX3,chr5,R,79976715,79991265,70443354,14550,555317515,29227,8
347732,CATSPER3,chr5,F,134967905,135011707,70487156,43802,555361317,29228,7
348932,SLC6A18,chr5,F,1225354,1246189,70507991,20835,555382152,29229,11
348938,NIPAL4,chr5,F,157460018,157474722,70522695,14704,555396856,29230,5
348980,HCN1,chr5,R,45254949,45696118,70963864,441169,555838025,29231,7
353189,SLCO4C1,chr5,R,102233985,102296549,71026428,62564,555900589,29232,15
353376,TICAM2,chr5,R,115578495,115602479,71050412,23984,555924573,29233,1
373863,DND1,chr5,R,140670795,140673586,71053203,2791,555927364,29234,3
375444,C5orf34,chr5,R,43486700,43515171,71081674,28471,555955835,29235,13
375449,MAST4,chr5,F,66596347,67169598,71654925,573251,556529086,29236,40
375484,SIMC1,chr5,F,176238366,176345989,71762548,107623,556636709,29237,13
379013,RNF138P1,chr5,R,55528841,55534542,71768249,5701,556642410,29238,0
386627,SAP30L-AS1,chr5,R,154389768,154445822,71824303,56054,556698464,29239,2
389257,LRRC14B,chr5,F,191510,195353,71828146,3843,556702307,29240,1
389273,LOC389273,chr5,R,10504995,10509256,71832407,4261,556706568,29241,2
389289,ANXA2R,chr5,R,43039079,43040345,71833673,1266,556707834,29242,0
389320,TEX43,chr5,F,126631721,126636282,71838234,4561,556712395,29243,2
389332,LOC389332,chr5,R,136191467,136193163,71839930,1696,556714091,29244,0
389333,PROB1,chr5,R,139391945,139395196,71843181,3251,556717342,29245,0
389336,C5orf46,chr5,R,147885907,147906589,71863863,20682,556738024,29246,4
389337,ARHGEF37,chr5,F,149551631,149634968,71947200,83337,556821361,29247,15
401172,FLJ33360,chr5,R,6310440,6337292,71974052,26852,556848213,29248,1
401176,LOC401176,chr5,F,16180491,16187064,71980625,6573,556854786,29249,2
401177,LOC401177,chr5,R,17378905,17387310,71989030,8405,556863191,29250,2
401190,RGS7BP,chr5,F,64505538,64614657,72098149,109119,556972310,29251,6
401191,LOC401191,chr5,F,66298388,66537775,72337536,239387,557211697,29252,7
401207,C5orf63,chr5,R,127035665,127073539,72375410,37874,557249571,29253,9
404203,SPINK6,chr5,F,148202793,148215137,72387754,12344,557261915,29254,3
404663,LINC01194,chr5,F,12574856,12805183,72618081,230327,557492242,29255,3
404734,ANKHD1-EIF4EBP3,chr5,F,140401813,140549578,72765846,147765,557640007,29256,2
406895,MIR103A1,chr5,R,168560895,168560973,72765924,78,557640085,29257,0
406935,MIR143,chr5,F,149428917,149429023,72766030,106,557640191,29258,0
406937,MIR145,chr5,F,149430645,149430733,72766118,88,557640279,29259,0
406938,MIR146A,chr5,F,160485351,160485450,72766217,99,557640378,29260,0
407001,MIR218-2,chr5,R,168768145,168768255,72766327,110,557640488,29261,0
407047,MIR9-2,chr5,R,88666852,88666939,72766414,87,557640575,29262,0
408187,SPINK14,chr5,F,148168545,148175619,72773488,7074,557647649,29263,4
408263,FNDC9,chr5,R,157341598,157345721,72777611,4123,557651772,29264,1
439936,C5orf17,chr5,F,23951772,24201313,73027152,249541,557901313,29265,6
441061,MARCH11,chr5,R,16067364,16179788,73139576,112424,558013737,29266,3
441072,FLJ31104,chr5,F,55995166,56003649,73148059,8483,558022220,29267,1
441081,LOC441081,chr5,F,70486500,70491787,73153346,5287,558027507,29268,0
441086,LOC441086,chr5,F,74866170,74867275,73154451,1105,558028612,29269,0
441087,LOC441087,chr5,F,75717505,75733324,73170270,15819,558044431,29270,5
441089,CRSP8P,chr5,R,80350604,80351966,73171632,1362,558045793,29271,0
441094,NR2F1-AS1,chr5,R,93409355,93581320,73343597,171965,558217758,29272,11
441098,LOC441098,chr5,F,100388303,100392932,73348226,4629,558222387,29273,0
441108,C5orf56,chr5,F,132410772,132476044,73413498,65272,558287659,29274,3
441116,FLJ16171,chr5,R,174919081,174995731,73490148,76650,558364309,29275,2
442132,LOC442132,chr5,R,7299373,7306714,73497489,7341,558371650,29276,9
442908,MIR340,chr5,R,180015302,180015397,73497584,95,558371745,29277,0
492311,IGIP,chr5,F,140125935,140128806,73500455,2871,558374616,29278,0
493869,GPX8,chr5,F,55160155,55167301,73507601,7146,558381762,29279,2
494327,MIR378A,chr5,F,149732824,149732890,73507667,66,558381828,29280,0
497189,TIFAB,chr5,R,135448867,135452399,73511199,3532,558385360,29281,1
503569,RGMB-AS1,chr5,R,98769617,98773084,73514666,3467,558388827,29282,1
553103,LOC553103,chr5,R,132311275,132369916,73573307,58641,558447468,29283,7
554213,MIR449A,chr5,R,55170531,55170622,73573398,91,558447559,29284,0
613212,CTXN3,chr5,F,127649020,127658630,73583008,9610,558457169,29285,3
619564,SNORD72,chr5,R,40832655,40832735,73583088,80,558457249,29286,0
619570,SNORD95,chr5,R,181243313,181243376,73583151,63,558457312,29287,0
619571,SNORD96A,chr5,R,181241817,181241889,73583223,72,558457384,29288,0
641700,ECSCR,chr5,R,139448553,139449174,73583844,621,558458005,29289,1
641700,ECSCR,chr5,R,139454601,139462743,73591986,8142,558466147,29290,8
642366,LOC642366,chr5,R,51372735,51383332,73602583,10597,558476744,29291,1
642987,TMEM232,chr5,R,110387272,110738921,73954232,351649,558828393,29292,30
643155,SMIM15,chr5,R,61157708,61162475,73958999,4767,558833160,29293,2
643201,LOC643201,chr5,R,176143084,176199295,74015210,56211,558889371,29294,25
643226,GRXCR2,chr5,R,145858386,145937176,74094000,78790,558968161,29295,5
643394,SPINK9,chr5,F,148335558,148339849,74098291,4291,558972452,29296,3
643401,LINC01021,chr5,F,27472291,27496401,74122401,24110,558996562,29297,4
643836,ZFP62,chr5,R,180845337,180861286,74138350,15949,559012511,29298,4
643977,FLJ32255,chr5,R,42985397,42993333,74146286,7936,559020447,29299,1
644100,ARL14EPL,chr5,F,116050392,116059426,74155320,9034,559029481,29300,4
644285,LOC644285,chr5,R,87318414,87323628,74160534,5214,559034695,29301,0
644762,LOC644762,chr5,R,149931357,149932977,74162154,1620,559036315,29302,0
644873,LINC01184,chr5,R,128021550,128083074,74223678,61524,559097839,29303,2
644936,LOC644936,chr5,R,80299084,80300478,74225072,1394,559099233,29304,0
644994,SMIM23,chr5,F,171772641,171791136,74243567,18495,559117728,29305,5
645121,CCNI2,chr5,F,132747410,132756255,74252412,8845,559126573,29306,6
645261,LOC645261,chr5,R,87050925,87056013,74257500,5088,559131661,29307,2
645323,LINC00461,chr5,R,88540778,88684803,74401525,144025,559275686,29308,6
646019,CBY3,chr5,R,179678557,179680974,74403942,2417,559278103,29309,1
646241,LOC646241,chr5,F,17807276,17930489,74527155,123213,559401316,29310,10
646652,LOC646652,chr5,F,34189520,34193736,74531371,4216,559405532,29311,1
646719,NIPBL-AS1,chr5,R,36871360,36876694,74536705,5334,559410866,29312,0
647859,LOC647859,chr5,R,71074202,71093070,74555573,18868,559429734,29313,4
648987,LOC648987,chr5,R,43014728,43067439,74608284,52711,559482445,29314,4
651746,ANKRD33B,chr5,F,10564322,10657816,74701778,93494,559575939,29315,4
653082,ZDHHC11B,chr5,R,710354,784749,74776173,74395,559650334,29316,19
653188,GUSBP3,chr5,R,69639462,69710527,74847238,71065,559721399,29317,5
653238,GTF2H2B,chr5,F,70415369,70450362,74882231,34993,559756392,29318,14
653316,FAM153C,chr5,F,178006965,178049087,74924353,42122,559798514,29319,11
654322,SNORA13,chr5,F,112161484,112161617,74924486,133,559798647,29320,0
677765,SCARNA18,chr5,R,83064203,83064337,74924620,134,559798781,29321,0
677828,SNORA47,chr5,R,77080433,77080571,74924758,138,559798919,29322,0
677841,SNORA74B,chr5,F,173020725,173020929,74924962,204,559799123,29323,0
693123,MIR449B,chr5,R,55170645,55170742,74925059,97,559799220,29324,0
693164,MIR579,chr5,R,32394377,32394475,74925157,98,559799318,29325,0
693165,MIR580,chr5,R,36147891,36147988,74925254,97,559799415,29326,0
693166,MIR581,chr5,R,53951503,53951599,74925350,96,559799511,29327,0
693167,MIR582,chr5,R,59703605,59703703,74925448,98,559799609,29328,0
693168,MIR583,chr5,F,96079137,96079212,74925523,75,559799684,29329,0
693169,MIR584,chr5,R,149062312,149062409,74925620,97,559799781,29330,0
693170,MIR585,chr5,R,169263600,169263694,74925714,94,559799875,29331,0
724102,SNHG4,chr5,F,139273751,139283184,74935147,9433,559809308,29332,4
728093,LOC728093,chr5,F,69631755,69636953,74940345,5198,559814506,29333,0
728095,LOC728095,chr5,F,169013226,169037998,74965117,24772,559839278,29334,4
728264,MIR143HG,chr5,F,149406844,149432836,74991109,25992,559865270,29335,5
728340,GTF2H2C,chr5,F,69560142,69592903,75023870,32761,559898031,29336,16
728342,LINC00992,chr5,F,117415511,117579744,75188103,164233,560062264,29337,5
728411,GUSBP1,chr5,F,21459479,21589372,75317996,129893,560192157,29338,10
728492,SERF1B,chr5,F,70025250,70043108,75335854,17858,560210015,29339,3
728554,LOC728554,chr5,F,177875260,177884268,75344862,9008,560219023,29340,5
728586,LINC01183,chr5,F,127702215,128000995,75643642,298780,560517803,29341,25
728609,SDHAP3,chr5,R,1571956,1594531,75666217,22575,560540378,29342,6
728613,LOC728613,chr5,R,1597556,1634005,75702666,36449,560576827,29343,3
728637,MEIKIN,chr5,R,131806989,131945698,75841375,138709,560715536,29344,12
728723,ZBED3-AS1,chr5,F,77086797,77148351,75902929,61554,560777090,29345,3
728769,SCAMP1-AS1,chr5,R,78358763,78360541,75904707,1778,560778868,29346,1
728780,ANKDD1B,chr5,F,75611217,75671846,75965336,60629,560839497,29347,16
729040,LOC729040,chr5,R,91279992,91283183,75968527,3191,560842688,29348,0
729080,LOC729080,chr5,R,141895625,141896695,75969597,1070,560843758,29349,0
729506,LOC729506,chr5,R,8333482,8457564,76093679,124082,560967840,29350,5
729522,AACSP1,chr5,R,178764860,178776276,76105095,11416,560979256,29351,6
729678,LINC00847,chr5,F,180830956,180835726,76109865,4770,560984026,29352,3
729862,LSP1P3,chr5,F,28926869,28927313,76110309,444,560984470,29353,0
731157,LOC731157,chr5,F,90409999,90410669,76110979,670,560985140,29354,1
790966,TRK-CTT2-4,chr5,R,181221978,181222051,76111052,73,560985213,29355,0
791232,TRV-CAC1-3,chr5,R,181102252,181102325,76111125,73,560985286,29356,0
100049076,GUSBP9,chr5,R,71220225,71259295,76150195,39070,561024356,29357,3
100049614,TRV-CAC1-5,chr5,R,181222394,181222467,76150268,73,561024429,29358,0
100113384,SNORD123,chr5,F,9548826,9548914,76150356,88,561024517,29359,0
100126299,VTRNA2-1,chr5,R,136080497,136080597,76150456,100,561024617,29360,0
100126343,MIR874,chr5,R,137647571,137647649,76150534,78,561024695,29361,0
100126347,MIR887,chr5,F,15935181,15935260,76150613,79,561024774,29362,0
100127206,KIAA1024L,chr5,F,129748190,129765063,76167486,16873,561041647,29363,2
100128340,LOC100128340,chr5,F,177883543,177957757,76241700,74214,561115861,29364,8
100128966,LOC100128966,chr5,F,138332054,138336085,76245731,4031,561119892,29365,2
100129716,ARRDC3-AS1,chr5,F,91380346,91420715,76286100,40369,561160261,29366,2
100129792,CCDC152,chr5,F,42756817,42802437,76331720,45620,561205881,29367,9
100130172,LOC100130172,chr5,F,138032792,138037066,76335994,4274,561210155,29368,1
100130733,LRRC70,chr5,F,62578734,62581448,76338708,2714,561212869,29369,1
100130744,LOC100130744,chr5,F,14712693,14716529,76342544,3836,561216705,29370,1
100130798,LOC100130798,chr5,F,178968224,178990116,76364436,21892,561238597,29371,1
100131067,CKMT2-AS1,chr5,R,81237564,81301569,76428441,64005,561302602,29372,4
100131897,FAM196B,chr5,R,169861290,169980740,76547891,119450,561422052,29373,3
100132062,LOC100132062,chr5,F,181323505,181328195,76552581,4690,561426742,29374,2
100132356,LOC100132356,chr5,R,43065186,43066971,76554366,1785,561428527,29375,0
100132916,FAM159B,chr5,F,64690307,64718190,76582249,27883,561456410,29376,2
100133050,LOC100133050,chr5,R,100379504,100388254,76590999,8750,561465160,29377,3
100188990,TRV-AAC1-2,chr5,F,181164153,181164226,76591072,73,561465233,29378,0
100188992,TRV-AAC2-1,chr5,R,181188415,181188488,76591145,73,561465306,29379,0
100189004,TRL-AAG1-3,chr5,R,181174043,181174125,76591227,82,561465388,29380,0
100189273,TRL-AAG1-2,chr5,F,181101839,181101921,76591309,82,561465470,29381,0
100189280,TRA-TGC3-2,chr5,F,181206867,181206939,76591381,72,561465542,29382,0
100189328,TRL-AAG2-3,chr5,F,181187700,181187782,76591463,82,561465624,29383,0
100189362,TRL-AAG1-1,chr5,R,181097473,181097555,76591545,82,561465706,29384,0
100189399,TRK-CTT2-3,chr5,F,181207754,181207827,76591618,73,561465779,29385,0
100189541,TRV-CAC1-4,chr5,F,181173649,181173722,76591691,73,561465852,29386,0
100190949,C5orf52,chr5,F,157671236,157680176,76600631,8940,561474792,29387,3
100268168,LOC100268168,chr5,R,172954781,172959368,76605218,4587,561479379,29388,4
100272216,LOC100272216,chr5,R,69631152,69633201,76607267,2049,561481428,29389,0
100287592,LOC100287592,chr5,R,50969216,50970187,76608238,971,561482399,29390,1
100288152,LOC100288152,chr5,F,473235,480892,76615895,7657,561490056,29391,6
100288254,LOC100288254,chr5,F,172285596,172298376,76628675,12780,561502836,29392,1
100289230,LOC100289230,chr5,F,98929133,98931009,76630551,1876,561504712,29393,0
100289673,LOC100289673,chr5,F,109883181,109885499,76632869,2318,561507030,29394,2
100302134,MIR1289-2,chr5,R,133427595,133427706,76632980,111,561507141,29395,0
100302156,MIR1229,chr5,R,179798277,179798346,76633049,69,561507210,29396,0
100302159,MIR548F3,chr5,R,110513828,110513915,76633136,87,561507297,29397,0
100302181,MIR1294,chr5,F,154347105,154347247,76633278,142,561507439,29398,0
100302203,MIR1271,chr5,F,176367945,176368031,76633364,86,561507525,29399,0
100302238,MIR103B1,chr5,F,168560903,168560965,76633426,62,561507587,29400,0
100302284,MIR1303,chr5,F,154685775,154685861,76633512,86,561507673,29401,0
100302288,MIR548P,chr5,R,100816481,100816565,76633596,84,561507757,29402,0
100302736,TMED7-TICAM2,chr5,R,115578495,115626179,76681280,47684,561555441,29403,3
100302746,NCRUPAR,chr5,F,76712402,76712888,76681766,486,561555927,29404,0
100303749,LOC100303749,chr5,R,65944804,65945573,76682535,769,561556696,29405,0
100313887,MIR2277,chr5,R,93620695,93620788,76682628,93,561556789,29406,0
100313923,MIR449C,chr5,R,55172261,55172353,76682720,92,561556881,29407,0
100422874,MIR4279,chr5,R,31936101,31936159,76682778,58,561556939,29408,0
100422885,MIR1244-2,chr5,F,118974585,118974670,76682863,85,561557024,29409,0
100422887,MIR4280,chr5,R,87114878,87114954,76682939,76,561557100,29410,0
100422938,MIR3142,chr5,F,160474443,160474525,76683021,82,561557182,29411,0
100422950,MIR3141,chr5,R,154596011,154596072,76683082,61,561557243,29412,0
100422962,MIR4281,chr5,R,176629438,176629500,76683144,62,561557305,29413,0
100422966,MIR4277,chr5,R,1708784,1708868,76683228,84,561557389,29414,0
100422999,MIR4278,chr5,R,6827852,6827921,76683297,69,561557458,29415,0
100462981,MTRNR2L2,chr5,R,80649999,80651035,76684333,1036,561558494,29416,0
100500805,MIR3607,chr5,F,86620496,86620575,76684412,79,561558573,29417,0
100500820,MIR3655,chr5,F,140647843,140647926,76684495,83,561558656,29418,0
100500824,MIR3650,chr5,R,38557501,38557561,76684555,60,561558716,29419,0
100500825,MIR3660,chr5,R,90016620,90016720,76684655,100,561558816,29420,0
100500831,MIR3912,chr5,R,171386655,171386760,76684760,105,561558921,29421,0
100500865,MIR3936,chr5,R,132365489,132365599,76684870,110,561559031,29422,0
100500905,MIR3661,chr5,F,134225756,134225852,76684966,96,561559127,29423,0
100505625,LOC100505625,chr5,R,6686324,6707711,76706353,21387,561580514,29424,2
100505636,LINC01024,chr5,R,140102921,140108012,76711444,5091,561585605,29425,2
100505658,LOC100505658,chr5,F,141558310,141565260,76718394,6950,561592555,29426,2
100505678,STARD4-AS1,chr5,F,111512225,111739726,76945895,227501,561820056,29427,6
100505738,MIR4458HG,chr5,F,8457686,8463096,76951305,5410,561825466,29428,1
100505798,LOC100505798,chr5,R,140574987,140594956,76971274,19969,561845435,29429,9
100505806,SNHG18,chr5,F,9546199,9550298,76975373,4099,561849534,29430,2
100505811,LOC100505811,chr5,F,118282573,118284777,76977577,2204,561851738,29431,1
100505841,LOC100505841,chr5,F,122129545,122182663,77030695,53118,561904856,29432,8
100505845,ROPN1L-AS1,chr5,R,10440734,10441851,77031812,1117,561905973,29433,1
100505878,LOC100505878,chr5,F,86746817,86749772,77034767,2955,561908928,29434,2
100505894,TMEM161B-AS1,chr5,F,88268881,88436674,77202560,167793,562076721,29435,8
100505994,LUCAT1,chr5,R,91302985,91314402,77213977,11417,562088138,29436,5
100506217,LOC100506217,chr5,R,21481306,21484694,77217365,3388,562091526,29437,1
100506406,LOC100506406,chr5,F,35938800,35939993,77218558,1193,562092719,29438,1
100506475,EGFLAM-AS2,chr5,R,38399813,38403471,77222216,3658,562096377,29439,2
100506495,LIFR-AS1,chr5,F,38556785,38671216,77336647,114431,562210808,29440,9
100506526,LOC100506526,chr5,R,61732789,61735698,77339556,2909,562213717,29441,2
100506548,LOC100506548,chr5,R,40825261,40829142,77343437,3881,562217598,29442,0
100506639,LOC100506639,chr5,F,43067022,43093558,77369973,26536,562244134,29443,2
100506658,OCLN,chr5,F,69492291,69558104,77435786,65813,562309947,29444,9
100506674,LOC100506674,chr5,R,44744327,44808793,77500252,64466,562374413,29445,3
100506688,LOC100506688,chr5,R,987176,997340,77510416,10164,562384577,29446,1
100506791,LINC01511,chr5,R,1363581,1380073,77526908,16492,562401069,29447,1
100506858,LOC100506858,chr5,R,2303719,2312201,77535390,8482,562409551,29448,2
100507267,LINC01187,chr5,R,170191646,170199141,77542885,7495,562417046,29449,4
100507387,LOC100507387,chr5,F,176119548,176125165,77548502,5617,562422663,29450,6
100507602,TRIM52-AS1,chr5,F,181261211,181272307,77559598,11096,562433759,29451,3
100534612,C1QTNF3-AMACR,chr5,R,33986985,34124528,77697141,137543,562571302,29452,8
100616142,MIR4458,chr5,F,8460924,8460999,77697216,75,562571377,29453,0
100616152,MIR4804,chr5,F,72878590,72878663,77697289,73,562571450,29454,0
100616175,MIR4633,chr5,F,129097687,129097766,77697368,79,562571529,29455,0
100616202,MIR4634,chr5,F,174751733,174751787,77697422,54,562571583,29456,0
100616209,MIR4461,chr5,F,134928038,134928112,77697496,74,562571657,29457,0
100616233,MIR4459,chr5,R,54075517,54075583,77697562,66,562571723,29458,0
100616235,MIR4457,chr5,R,1309309,1309377,77697630,68,562571791,29459,0
100616271,MIR4637,chr5,R,14825928,14826012,77697714,84,562571875,29460,0
100616297,MIR3977,chr5,F,82840154,82840224,77697784,70,562571945,29461,0
100616306,MIR378H,chr5,F,154829457,154829540,77697867,83,562572028,29462,0
100616325,MIR4460,chr5,R,129397061,129397147,77697953,86,562572114,29463,0
100616326,MIR4636,chr5,R,9053815,9053895,77698033,80,562572194,29464,0
100616339,MIR548AE2,chr5,R,58530042,58530109,77698100,67,562572261,29465,0
100616342,MIR4638,chr5,R,181222565,181222633,77698168,68,562572329,29466,0
100616377,MIR4803,chr5,F,72169466,72169540,77698242,74,562572403,29467,0
100616381,MIR4456,chr5,R,535839,535882,77698285,43,562572446,29468,0
100616479,MIR4635,chr5,R,1062895,1062974,77698364,79,562572525,29469,0
100616498,MIR378E,chr5,F,170028487,170028566,77698443,79,562572604,29470,0
100652758,LOC100652758,chr5,R,151769792,151771508,77700159,1716,562574320,29471,1
100652772,NNT-AS1,chr5,R,43573184,43603230,77730205,30046,562604366,29472,2
100652833,LOC100652833,chr5,R,99522013,99526049,77734241,4036,562608402,29473,0
100652853,LINC01023,chr5,R,108727824,108728261,77734678,437,562608839,29474,0
100846991,MIR5197,chr5,F,143679859,143679971,77734790,112,562608951,29475,0
100847019,MIR5687,chr5,R,55508849,55508926,77734867,77,562609028,29476,0
100847029,MIR5003,chr5,F,172662164,172662263,77734966,99,562609127,29477,0
100847082,MIR5692C1,chr5,R,135802984,135803075,77735057,91,562609218,29478,0
100847085,MIR5706,chr5,F,119154636,119154716,77735137,80,562609298,29479,0
100852408,EGFLAM-AS4,chr5,R,38282268,38290986,77743855,8718,562618016,29480,3
100859930,HEIH,chr5,R,180829953,180831618,77745520,1665,562619681,29481,0
100861468,LINC00492,chr5,F,102581367,102617589,77781742,36222,562655903,29482,1
100861518,P4HA2-AS1,chr5,F,132184875,132192805,77789672,7930,562663833,29483,2
100861519,GDNF-AS1,chr5,F,37840437,37875799,77825034,35362,562699195,29484,7
100873948,NREP-AS1,chr5,F,111912507,112017306,77929833,104799,562803994,29485,3
100874002,OXCT1-AS1,chr5,F,41870029,41872241,77932045,2212,562806206,29486,2
100874239,ARHGAP26-AS1,chr5,R,142859603,142868910,77941352,9307,562815513,29487,5
100874361,PPP2R2B-IT1,chr5,R,146914206,146919506,77946652,5300,562820813,29488,3
100874372,ARHGAP26-IT1,chr5,F,143192499,143194166,77948319,1667,562822480,29489,1
100996325,LOC100996325,chr5,R,602168,612210,77958361,10042,562832522,29490,2
100996385,LOC100996385,chr5,R,176049677,176062055,77970739,12378,562844900,29491,2
100996419,LOC100996419,chr5,F,179858903,179861283,77973119,2380,562847280,29492,1
100996485,C5orf66,chr5,F,135033279,135344680,78284520,311401,563158681,29493,5
100996645,LINCR-0003,chr5,F,57570341,57617430,78331609,47089,563205770,29494,5
101060024,LOC101060024,chr5,R,134081430,134082822,78333001,1392,563207162,29495,0
101180901,IPO11-LRRC70,chr5,F,62578734,62628589,78382856,49855,563257017,29496,3
101926893,LOC101926893,chr5,F,97073743,97183118,78492231,109375,563366392,29497,13
101926904,LINC01265,chr5,R,38710366,38720273,78502138,9907,563376299,29498,4
101926905,LOC101926905,chr5,R,141046204,141078031,78533965,31827,563408126,29499,3
101926940,LOC101926940,chr5,F,39520430,39524708,78538243,4278,563412404,29500,2
101926941,LOC101926941,chr5,F,142325292,142464054,78677005,138762,563551166,29501,3
101926960,LOC101926960,chr5,R,42155832,42175345,78696518,19513,563570679,29502,4
101926975,LOC101926975,chr5,F,142745599,142760993,78711912,15394,563586073,29503,3
101926985,LOC101926985,chr5,R,42569855,42579544,78721601,9689,563595762,29504,2
101927012,LOC101927012,chr5,F,147666597,147694809,78749813,28212,563623974,29505,6
101927023,LOC101927023,chr5,F,112228282,112257309,78778840,29027,563653001,29506,3
101927030,LOC101927030,chr5,F,43024400,43034635,78789075,10235,563663236,29507,2
101927046,LOC101927046,chr5,F,149382060,149384359,78791374,2299,563665535,29508,2
101927059,LOC101927059,chr5,F,114576040,114579970,78795304,3930,563669465,29509,1
101927075,FGF10-AS1,chr5,F,44388731,44413989,78820562,25258,563694723,29510,2
101927078,LOC101927078,chr5,R,114447417,114773413,79146558,325996,564020719,29511,12
101927096,CTB-113P19.1,chr5,F,151676944,151687910,79157524,10966,564031685,29512,4
101927100,LOC101927100,chr5,F,115602154,115620419,79175789,18265,564049950,29513,3
101927115,LOC101927115,chr5,F,151958897,152270449,79487341,311552,564361502,29514,2
101927134,LINC01470,chr5,R,152618964,152972349,79840726,353385,564714887,29515,4
101927190,LOC101927190,chr5,R,116367415,116374570,79847881,7155,564722042,29516,2
101927233,SEMA6A-AS1,chr5,F,116447497,116471673,79872057,24176,564746218,29517,2
101927280,LOC101927280,chr5,R,118350965,118562117,80083209,211152,564957370,29518,9
101927328,LOC101927328,chr5,R,122316954,122323362,80089617,6408,564963778,29519,1
101927357,LOC101927357,chr5,R,122581498,122584611,80092730,3113,564966891,29520,1
101927379,LOC101927379,chr5,R,122628951,122730560,80194339,101609,565068500,29521,11
101927397,LOC101927397,chr5,R,124131193,124137316,80200462,6123,565074623,29522,3
101927421,LOC101927421,chr5,F,125036830,125367734,80531366,330904,565405527,29523,5
101927460,LOC101927460,chr5,F,125493260,125602227,80640333,108967,565514494,29524,3
101927488,LOC101927488,chr5,R,126272516,126285175,80652992,12659,565527153,29525,2
101927514,LOC101927514,chr5,R,126385572,126395097,80662517,9525,565536678,29526,4
101927670,LOC101927670,chr5,F,131450054,131466441,80678904,16387,565553065,29527,2
101927693,LOC101927693,chr5,F,132002039,132007022,80683887,4983,565558048,29528,1
101927697,LOC101927697,chr5,R,158320682,158409773,80772978,89091,565647139,29529,6
101927740,LOC101927740,chr5,F,159100482,159117478,80789974,16996,565664135,29530,2
101927761,LOC101927761,chr5,R,132638157,132642171,80793988,4014,565668149,29531,1
101927766,LOC101927766,chr5,R,159776771,159871384,80888601,94613,565762762,29532,2
101927790,LOC101927790,chr5,R,159935816,159937492,80890277,1676,565764438,29533,2
101927813,HMMR-AS1,chr5,R,163482603,163494058,80901732,11455,565775893,29534,3
101927835,LOC101927835,chr5,R,164448421,164467402,80920713,18981,565794874,29535,3
101927862,CTB-178M22.2,chr5,R,168229582,168232372,80923503,2790,565797664,29536,2
101927885,LOC101927885,chr5,F,167573495,167729424,81079432,155929,565953593,29537,2
101927908,LOC101927908,chr5,R,167164933,167168401,81082900,3468,565957061,29538,1
101927934,LOC101927934,chr5,F,134506551,134509230,81085579,2679,565959740,29539,1
101927953,C5orf66-AS1,chr5,R,135038830,135040047,81086796,1217,565960957,29540,1
101927969,LOC101927969,chr5,F,168706926,168720884,81100754,13958,565974915,29541,6
101928005,LOC101928005,chr5,R,137858441,137889236,81131549,30795,566005710,29542,3
101928033,CTD-2270F17.1,chr5,F,170389492,170422844,81164901,33352,566039062,29543,2
101928093,LOC101928093,chr5,F,172755502,172762565,81171964,7063,566046125,29544,4
101928136,LINC01484,chr5,R,173707598,173746209,81210575,38611,566084736,29545,2
101928154,LINC01485,chr5,R,173786789,173790942,81214728,4153,566088889,29546,3
101928176,LINC01411,chr5,F,174336353,174527139,81405514,190786,566279675,29547,5
101928419,LOC101928419,chr5,F,56124144,56127275,81408645,3131,566282806,29548,1
101928445,LOC101928445,chr5,R,179595903,179603741,81416483,7838,566290644,29549,8
101928448,LOC101928448,chr5,R,56511393,56606232,81511322,94839,566385483,29550,5
101928505,LOC101928505,chr5,F,57650659,57670989,81531652,20330,566405813,29551,2
101928539,LOC101928539,chr5,R,57890330,57899162,81540484,8832,566414645,29552,2
101928569,LOC101928569,chr5,R,58107631,58122341,81555194,14710,566429355,29553,4
101928600,LOC101928600,chr5,R,58541566,58558243,81571871,16677,566446032,29554,3
101928630,CTC-436P18.1,chr5,F,61162315,61232080,81641636,69765,566515797,29555,3
101928649,CTC-338M12.4,chr5,F,181246540,181257586,81652682,11046,566526843,29556,2
101928651,LOC101928651,chr5,R,61663156,61698432,81687958,35276,566562119,29557,7
101928726,LOC101928726,chr5,R,177108797,177121834,81700995,13037,566575156,29558,4
101928741,LOC101928741,chr5,R,66205122,66209906,81705779,4784,566579940,29559,1
101928768,LOC101928768,chr5,F,784847,787141,81708073,2294,566582234,29560,1
101928769,LOC101928769,chr5,R,66507543,66511604,81712134,4061,566586295,29561,2
101928793,LOC101928793,chr5,F,1081750,1083738,81714122,1988,566588283,29562,1
101928794,LOC101928794,chr5,R,67001617,67004154,81716659,2537,566590820,29563,1
101928819,LOC101928819,chr5,R,67463081,67492538,81746116,29457,566620277,29564,5
101928857,CTD-3080P12.3,chr5,R,1173095,1178605,81751626,5510,566625787,29565,4
101928858,LOC101928858,chr5,F,67793212,67801058,81759472,7846,566633633,29566,2
101928885,LOC101928885,chr5,R,68967740,69029927,81821659,62187,566695820,29567,3
101928924,LOC101928924,chr5,R,69477483,69485612,81829788,8129,566703949,29568,1
101928993,LOC101928993,chr5,F,69844636,69879530,81864682,34894,566738843,29569,4
101929003,LOC101929003,chr5,F,1792576,1798622,81870728,6046,566744889,29570,1
101929034,LOC101929034,chr5,R,1855969,1856568,81871327,599,566745488,29571,1
101929056,LOC101929056,chr5,F,1883382,1884649,81872594,1267,566746755,29572,1
101929081,CTD-2194D22.4,chr5,F,1887330,1900493,81885757,13163,566759918,29573,3
101929082,LINC01333,chr5,F,74322485,74328357,81891629,5872,566765790,29574,2
101929109,LOC101929109,chr5,R,76606607,76609016,81894038,2409,566768199,29575,1
101929153,LOC101929153,chr5,F,4773480,4774865,81895423,1385,566769584,29576,1
101929154,LOC101929154,chr5,F,77884655,77959096,81969864,74441,566844025,29577,2
101929176,CTD-2297D10.2,chr5,R,5132084,5140054,81977834,7970,566851995,29578,3
101929200,LOC101929200,chr5,R,5390102,5422123,82009855,32021,566884016,29579,6
101929201,LOC101929201,chr5,R,79349352,79371475,82031978,22123,566906139,29580,5
101929214,LOC101929214,chr5,R,5932075,5932884,82032787,809,566906948,29581,2
101929215,CTD-2201I18.1,chr5,R,80066348,80083665,82050104,17317,566924265,29582,7
101929232,LOC101929232,chr5,F,7289756,7348955,82109303,59199,566983464,29583,13
101929261,LOC101929261,chr5,R,7346985,7347977,82110295,992,566984456,29584,1
101929284,LOC101929284,chr5,F,8839731,8881525,82152089,41794,567026250,29585,2
101929307,LOC101929307,chr5,R,8758079,8840527,82234537,82448,567108698,29586,5
101929321,LOC101929321,chr5,R,85291404,85304187,82247320,12783,567121481,29587,2
101929338,CTD-2201E9.1,chr5,F,9511332,9518086,82254074,6754,567128235,29588,2
101929359,LOC101929359,chr5,R,9594747,9600782,82260109,6035,567134270,29589,4
101929380,LOC101929380,chr5,F,87120147,87248021,82387983,127874,567262144,29590,3
101929412,LOC101929412,chr5,R,10493526,10502728,82397185,9202,567271346,29591,2
101929423,MEF2C-AS1,chr5,F,88883329,89032379,82546235,149050,567420396,29592,7
101929454,LOC101929454,chr5,R,15191645,15266560,82621150,74915,567495311,29593,2
101929472,CTD-2350J17.1,chr5,R,15602188,15615002,82633964,12814,567508125,29594,2
101929495,LINC01339,chr5,R,90158338,90290071,82765697,131733,567639858,29595,5
101929505,LOC101929505,chr5,R,16373360,16441102,82833439,67742,567707600,29596,8
101929524,LOC101929524,chr5,F,16615925,16629969,82847483,14044,567721644,29597,3
101929544,LOC101929544,chr5,F,17404095,17441674,82885062,37579,567759223,29598,2
101929573,LOC101929573,chr5,R,69898214,69903409,82890257,5195,567764418,29599,0
101929599,LOC101929599,chr5,R,70774096,70778812,82894973,4716,567769134,29600,1
101929617,LOC101929617,chr5,F,22754447,22760403,82900929,5956,567775090,29601,3
101929645,LOC101929645,chr5,F,29065243,29073223,82908909,7980,567783070,29602,3
101929660,LOC101929660,chr5,F,29143502,29172975,82938382,29473,567812543,29603,8
101929681,LOC101929681,chr5,R,29380069,29395976,82954289,15907,567828450,29604,4
101929696,LOC101929696,chr5,R,139741346,139746223,82959166,4877,567833327,29605,2
101929704,LOC101929704,chr5,R,34837713,34839275,82960728,1562,567834889,29606,1
101929710,LOC101929710,chr5,F,95962000,96631085,83629813,669085,568503974,29607,4
101929719,LOC101929719,chr5,F,140157318,140168785,83641280,11467,568515441,29608,4
101929745,LOC101929745,chr5,F,38148479,38153715,83646516,5236,568520677,29609,1
101929747,LOC101929747,chr5,R,96934079,96936094,83648531,2015,568522692,29610,0
101929768,OSMR-AS1,chr5,R,38693212,38845829,83801148,152617,568675309,29611,3
101929895,LOC101929895,chr5,F,665243,668743,83804648,3500,568678809,29612,1
101929898,LOC101929898,chr5,F,693526,695809,83806931,2283,568681092,29613,1
101929964,LOC101929964,chr5,R,128002345,128004112,83808698,1767,568682859,29614,1
101929977,LOC101929977,chr5,R,10342764,10354085,83820019,11321,568694180,29615,5
101930276,LOC101930276,chr5,R,103880660,103891392,83830751,10732,568704912,29616,5
102157402,AK6,chr5,R,69351725,69370013,83849039,18288,568723200,29617,5
102465138,MIR6131,chr5,F,10478036,10478145,83849148,109,568723309,29618,0
102465246,MIR6499,chr5,R,151522086,151522148,83849210,62,568723371,29619,0
102465498,MIR6830,chr5,R,132217848,132217918,83849280,70,568723441,29620,0
102465499,MIR6831,chr5,R,140563670,140563751,83849361,81,568723522,29621,0
102465862,MIR8056,chr5,F,173347454,173347536,83849443,82,568723604,29622,0
102465882,MIR8089,chr5,R,181043402,181043484,83849525,82,568723686,29623,0
102466103,MIR6075,chr5,R,1510761,1510856,83849620,95,568723781,29624,0
102467073,LOC102467073,chr5,R,269555,271524,83851589,1969,568725750,29625,1
102467074,LINC01377,chr5,F,3177834,3181232,83854987,3398,568729148,29626,1
102467075,LINC01017,chr5,R,3496371,3504004,83862620,7633,568736781,29627,2
102467077,LINC00603,chr5,F,40052290,40053324,83863654,1034,568737815,29628,1
102467080,LOC102467080,chr5,R,54660157,54744258,83947755,84101,568821916,29629,3
102467081,LOC102467081,chr5,R,55021298,55024169,83950626,2871,568824787,29630,2
102467147,LOC102467147,chr5,R,56457794,56481769,83974601,23975,568848762,29631,4
102467212,LOC102467212,chr5,R,103528433,103541985,83988153,13552,568862314,29632,4
102467213,LOC102467213,chr5,R,106815196,107011014,84183971,195818,569058132,29633,3
102467214,LOC102467214,chr5,F,112628435,112630921,84186457,2486,569060618,29634,2
102467216,LOC102467216,chr5,R,112656427,112682888,84212918,26461,569087079,29635,2
102467217,LOC102467217,chr5,R,115642124,115672652,84243446,30528,569117607,29636,4
102467223,LOC102467223,chr5,R,116743301,116762209,84262354,18908,569136515,29637,3
102467224,LOC102467224,chr5,F,117730360,118266062,84798056,535702,569672217,29638,2
102467225,LOC102467225,chr5,F,118596187,118628092,84829961,31905,569704122,29639,4
102467226,LOC102467226,chr5,F,121322549,121325837,84833249,3288,569707410,29640,2
102467655,LOC102467655,chr5,F,68189875,68198407,84841781,8532,569715942,29641,2
102477328,LOC102477328,chr5,R,72574074,72660669,84928376,86595,569802537,29642,2
102503427,LOC102503427,chr5,F,72557076,72571743,84943043,14667,569817204,29643,3
102503429,LINC01335,chr5,R,74306409,74308325,84944959,1916,569819120,29644,2
102524628,RASGRF2-AS1,chr5,R,80947692,80960907,84958174,13215,569832335,29645,3
102546175,LINC01338,chr5,R,82850863,82859836,84967147,8973,569841308,29646,3
102546226,LOC102546226,chr5,R,88408981,88439090,84997256,30109,569871417,29647,5
102546227,LINC01340,chr5,F,97504695,97671051,85163612,166356,570037773,29648,3
102546228,LOC102546228,chr5,F,126179576,126193850,85177886,14274,570052047,29649,3
102546229,LOC102546229,chr5,R,134429050,134435047,85183883,5997,570058044,29650,2
102546294,LOC102546294,chr5,R,148268306,148383850,85299427,115544,570173588,29651,4
102546298,LOC102546298,chr5,R,150475515,150485992,85309904,10477,570184065,29652,2
102546299,LOC102546299,chr5,F,164470278,164542984,85382610,72706,570256771,29653,3
102557615,CTB-7E3.1,chr5,R,166905221,166926370,85403759,21149,570277920,29654,2
102577424,LINC01574,chr5,F,176743204,176743921,85404476,717,570278637,29655,1
102577426,LOC102577426,chr5,R,181191045,181191908,85405339,863,570279500,29656,1
102723339,LOC102723339,chr5,F,8066943,8071825,85410221,4882,570284382,29657,2
102723365,LOC102723365,chr5,R,115185951,115196416,85420686,10465,570294847,29658,2
102723441,CTD-2154B17.1,chr5,R,10774933,10787035,85432788,12102,570306949,29659,3
102723444,LOC102723444,chr5,R,119345855,119355805,85442738,9950,570316899,29660,4
102723526,LOC102723526,chr5,F,17444056,17445928,85444610,1872,570318771,29661,1
102723557,LOC102723557,chr5,R,126752001,126777046,85469655,25045,570343816,29662,4
102723637,LOC102723637,chr5,F,30459085,30472313,85482883,13228,570357044,29663,2
102723638,LOC102723638,chr5,F,129034885,129088184,85536182,53299,570410343,29664,8
102723654,LOC102723654,chr5,F,129152889,129393969,85777262,241080,570651423,29665,7
102723740,LOC102723740,chr5,R,41284749,41294928,85787441,10179,570661602,29666,1
102723741,LOC102723741,chr5,R,132422663,132432102,85796880,9439,570671041,29667,1
102723752,LOC102723752,chr5,F,41868670,41880167,85808377,11497,570682538,29668,2
102723768,LOC102723768,chr5,R,42314896,42374443,85867924,59547,570742085,29669,2
102723839,LOC102723839,chr5,R,44495143,44687182,86059963,192039,570934124,29670,4
102723915,LOC102723915,chr5,F,141618259,141625965,86067669,7706,570941830,29671,1
102724122,LOC102724122,chr5,F,57483016,57512753,86097406,29737,570971567,29672,7
102724275,LOC102724275,chr5,F,70852087,70872555,86117874,20468,570992035,29673,5
102724292,LOC102724292,chr5,F,70719771,70755443,86153546,35672,571027707,29674,4
102724356,LOC102724356,chr5,F,69979016,70473520,86648050,494504,571522211,29675,4
102724392,LOC102724392,chr5,R,71313575,71448004,86782479,134429,571656640,29676,4
102724404,LOC102724404,chr5,R,157361615,157460056,86880920,98441,571755081,29677,8
102724458,LOC102724458,chr5,F,163709169,163731614,86903365,22445,571777526,29678,8
102724530,LOC102724530,chr5,R,79317008,79348008,86934365,31000,571808526,29679,3
102724551,LOC102724551,chr5,R,174075177,174086601,86945789,11424,571819950,29680,5
102724557,LOC102724557,chr5,F,79801383,79846392,86990798,45009,571864959,29681,6
102724637,LOC102724637,chr5,F,89900663,89963978,87054113,63315,571928274,29682,8
102724657,LOC102724657,chr5,R,178691533,178708586,87071166,17053,571945327,29683,10
102724720,LOC102724720,chr5,F,95841752,95849274,87078688,7522,571952849,29684,2
102724748,LOC102724748,chr5,F,96776557,96785791,87087922,9234,571962083,29685,2
102724810,LOC102724810,chr5,F,98969474,99003936,87122384,34462,571996545,29686,5
102724855,CTD-2151A2.1,chr5,F,99533989,99577954,87166349,43965,572040510,29687,3
102724885,LOC102724885,chr5,R,100450911,100535277,87250715,84366,572124876,29688,4
102724943,LOC102724943,chr5,F,6765909,6777775,87262581,11866,572136742,29689,4
102725105,LOC102725105,chr5,F,20305550,20332446,87289477,26896,572163638,29690,1
102725145,LOC102725145,chr5,R,73777600,73787032,87298909,9432,572173070,29691,2
102725231,LOC102725231,chr5,F,180466988,180493801,87325722,26813,572199883,29692,5
103689846,ADAMTS19-AS1,chr5,R,129459558,129460689,87326853,1131,572201014,29693,1
103689917,LINC01337,chr5,R,80608619,80622524,87340758,13905,572214919,29694,1
103724389,LINC01170,chr5,R,124059793,124438520,87719485,378727,572593646,29695,5
104310351,LINC01331,chr5,R,74369375,74536976,87887086,167601,572761247,29696,2
104326188,LINC01202,chr5,R,161910461,162001196,87977821,90735,572851982,29697,2
104326191,LINC01336,chr5,R,75047718,75052643,87982746,4925,572856907,29698,1
104355136,LINC01033,chr5,F,54320943,54415125,88076928,94182,572951089,29699,4
104355294,LINC01386,chr5,R,73454189,73472966,88095705,18777,572969866,29700,4
105369144,LOC105369144,chr5,R,34064448,34115521,88146778,51073,573020939,29701,2
105369177,LOC105369177,chr5,F,111517641,111525432,88154569,7791,573028730,29702,3
105369178,LOC105369178,chr5,R,125980473,126368825,88542921,388352,573417082,29703,6
105369214,LOC105369214,chr5,F,10462872,10464841,88544890,1969,573419051,29704,0
105369228,LOC105369228,chr5,F,69975858,69978635,88547667,2777,573421828,29705,2
105374602,LOC105374602,chr5,R,24542,51010,88574135,26468,573448296,29706,4
105374604,LOC105374604,chr5,F,299835,303312,88577612,3477,573451773,29707,1
105374605,LOC105374605,chr5,F,292511,297463,88582564,4952,573456725,29708,1
105374606,LOC105374606,chr5,R,555060,555868,88583372,808,573457533,29709,2
105374607,LOC105374607,chr5,R,571043,577073,88589402,6030,573463563,29710,2
105374608,LOC105374608,chr5,F,600500,610822,88599724,10322,573473885,29711,6
105374609,LOC105374609,chr5,R,900500,912593,88611817,12093,573485978,29712,2
105374612,LOC105374612,chr5,F,1110732,1117428,88618513,6696,573492674,29713,2
105374613,LOC105374613,chr5,F,1252007,1255382,88621888,3375,573496049,29714,2
105374614,LOC105374614,chr5,R,1704252,1725328,88642964,21076,573517125,29715,3
105374616,LOC105374616,chr5,F,1991980,1993420,88644404,1440,573518565,29716,1
105374617,LOC105374617,chr5,F,2066841,2071611,88649174,4770,573523335,29717,2
105374618,LOC105374618,chr5,F,2093661,2119386,88674899,25725,573549060,29718,7
105374619,LOC105374619,chr5,F,2840561,2850913,88685251,10352,573559412,29719,2
105374620,LOC105374620,chr5,F,2917837,2965527,88732941,47690,573607102,29720,12
105374621,LOC105374621,chr5,F,3035624,3043011,88740328,7387,573614489,29721,3
105374622,LOC105374622,chr5,F,3160157,3161379,88741550,1222,573615711,29722,2
105374623,LOC105374623,chr5,F,3344009,3346863,88744404,2854,573618565,29723,3
105374624,LOC105374624,chr5,F,3452815,3462314,88753903,9499,573628064,29724,3
105374625,LOC105374625,chr5,F,3778346,3788064,88763621,9718,573637782,29725,5
105374626,LOC105374626,chr5,F,3961157,3964006,88766470,2849,573640631,29726,1
105374627,LOC105374627,chr5,F,4135681,4154136,88784925,18455,573659086,29727,4
105374628,LOC105374628,chr5,R,4486705,4487963,88786183,1258,573660344,29728,2
105374629,LOC105374629,chr5,F,4866489,4868215,88787909,1726,573662070,29729,1
105374630,LOC105374630,chr5,R,4967771,4975243,88795381,7472,573669542,29730,4
105374631,LOC105374631,chr5,R,5069191,5078410,88804600,9219,573678761,29731,1
105374633,LOC105374633,chr5,R,5584187,5595078,88815491,10891,573689652,29732,2
105374634,LOC105374634,chr5,F,5688423,5699846,88826914,11423,573701075,29733,4
105374635,LOC105374635,chr5,F,5781119,5789183,88834978,8064,573709139,29734,3
105374636,LOC105374636,chr5,F,5789464,5796226,88841740,6762,573715901,29735,2
105374637,LOC105374637,chr5,F,5843991,5850465,88848214,6474,573722375,29736,2
105374638,LOC105374638,chr5,R,6339487,6369751,88878478,30264,573752639,29737,4
105374639,LOC105374639,chr5,F,6454464,6459317,88883331,4853,573757492,29738,1
105374641,LOC105374641,chr5,F,6829726,6833157,88886762,3431,573760923,29739,2
105374642,LOC105374642,chr5,F,6870742,6888120,88904140,17378,573778301,29740,1
105374643,LOC105374643,chr5,F,7272808,7277788,88909120,4980,573783281,29741,3
105374644,LOC105374644,chr5,F,7373398,7391983,88927705,18585,573801866,29742,4
105374645,LOC105374645,chr5,R,7362935,7373142,88937912,10207,573812073,29743,7
105374646,LOC105374646,chr5,F,7417773,7419472,88939611,1699,573813772,29744,1
105374647,LOC105374647,chr5,F,8525154,8563160,88977617,38006,573851778,29745,8
105374648,LOC105374648,chr5,F,9854395,9891237,89014459,36842,573888620,29746,4
105374649,LOC105374649,chr5,F,9751413,9776840,89039886,25427,573914047,29747,2
105374650,LOC105374650,chr5,R,10207377,10223999,89056508,16622,573930669,29748,2
105374651,LOC105374651,chr5,F,10316099,10332129,89072538,16030,573946699,29749,5
105374652,LOC105374652,chr5,F,10767737,10770295,89075096,2558,573949257,29750,2
105374654,LOC105374654,chr5,F,10964704,10987571,89097963,22867,573972124,29751,3
105374655,LOC105374655,chr5,R,12362201,12574539,89310301,212338,574184462,29752,4
105374656,LOC105374656,chr5,F,12354683,12368765,89324383,14082,574198544,29753,2
105374657,LOC105374657,chr5,R,12739662,12862122,89446843,122460,574321004,29754,3
105374658,LOC105374658,chr5,R,12888000,13032890,89591733,144890,574465894,29755,5
105374659,LOC105374659,chr5,F,13144041,13175981,89623673,31940,574497834,29756,3
105374660,LOC105374660,chr5,R,13516342,13578394,89685725,62052,574559886,29757,3
105374661,LOC105374661,chr5,F,14883561,14892660,89694824,9099,574568985,29758,3
105374663,LOC105374663,chr5,F,16441946,16446524,89699402,4578,574573563,29759,2
105374664,LOC105374664,chr5,F,17164722,17185213,89719893,20491,574594054,29760,4
105374665,LOC105374665,chr5,F,17491581,17495538,89723850,3957,574598011,29761,2
105374666,LOC105374666,chr5,F,17743833,17785733,89765750,41900,574639911,29762,2
105374668,LOC105374668,chr5,R,17810770,17820745,89775725,9975,574649886,29763,2
105374669,LOC105374669,chr5,F,18972407,18990438,89793756,18031,574667917,29764,4
105374670,LOC105374670,chr5,R,19035491,19038790,89797055,3299,574671216,29765,2
105374671,LOC105374671,chr5,F,20290976,20293079,89799158,2103,574673319,29766,2
105374672,LOC105374672,chr5,F,19771366,19778750,89806542,7384,574680703,29767,2
105374673,LOC105374673,chr5,R,20849716,20875809,89832635,26093,574706796,29768,2
105374675,LOC105374675,chr5,F,20751699,20752543,89833479,844,574707640,29769,1
105374676,LOC105374676,chr5,F,20611816,20937711,90159374,325895,575033535,29770,13
105374677,LOC105374677,chr5,R,20607454,20616320,90168240,8866,575042401,29771,5
105374678,LOC105374678,chr5,R,21031932,21116540,90252848,84608,575127009,29772,5
105374680,LOC105374680,chr5,F,21275671,21282672,90259849,7001,575134010,29773,2
105374681,LOC105374681,chr5,F,22574913,22589298,90274234,14385,575148395,29774,2
105374682,LOC105374682,chr5,F,22212448,22216197,90277983,3749,575152144,29775,1
105374683,LOC105374683,chr5,F,21823362,21826613,90281234,3251,575155395,29776,2
105374684,LOC105374684,chr5,F,21741573,21802252,90341913,60679,575216074,29777,2
105374685,LOC105374685,chr5,F,21616246,21676412,90402079,60166,575276240,29778,2
105374686,LOC105374686,chr5,F,23039053,23093949,90456975,54896,575331136,29779,3
105374687,LOC105374687,chr5,R,23159843,23171595,90468727,11752,575342888,29780,3
105374688,LOC105374688,chr5,R,23344657,23349272,90473342,4615,575347503,29781,4
105374689,LOC105374689,chr5,F,24291915,24323113,90504540,31198,575378701,29782,3
105374691,LOC105374691,chr5,F,24840761,24851023,90514802,10262,575388963,29783,2
105374692,LOC105374692,chr5,F,24877923,24880474,90517353,2551,575391514,29784,3
105374693,LOC105374693,chr5,F,25190595,25520991,90847749,330396,575721910,29785,17
105374694,LOC105374694,chr5,R,25088081,25190522,90950190,102441,575824351,29786,6
105374695,LOC105374695,chr5,R,27406529,27413642,90957303,7113,575831464,29787,3
105374696,LOC105374696,chr5,F,27772330,27775475,90960448,3145,575834609,29788,3
105374698,LOC105374698,chr5,R,28285978,28287763,90962233,1785,575836394,29789,2
105374699,LOC105374699,chr5,R,29077275,29143424,91028382,66149,575902543,29790,6
105374700,LOC105374700,chr5,F,28809034,28898807,91118155,89773,575992316,29791,1
105374701,LOC105374701,chr5,R,28548405,28809029,91378779,260624,576252940,29792,6
105374702,LOC105374702,chr5,R,29472718,29485424,91391485,12706,576265646,29793,2
105374703,LOC105374703,chr5,F,29793720,29814358,91412123,20638,576286284,29794,4
105374704,LOC105374704,chr5,F,29880525,29882103,91413701,1578,576287862,29795,1
105374705,LOC105374705,chr5,R,29931555,29964943,91447089,33388,576321250,29796,4
105374706,LOC105374706,chr5,R,29989130,30002215,91460174,13085,576334335,29797,4
105374707,LOC105374707,chr5,R,30099012,30102387,91463549,3375,576337710,29798,2
105374708,LOC105374708,chr5,R,31164033,31175969,91475485,11936,576349646,29799,2
105374709,LOC105374709,chr5,R,31201504,31213922,91487903,12418,576362064,29800,4
105374710,LOC105374710,chr5,R,32106148,32122020,91503775,15872,576377936,29801,3
105374711,LOC105374711,chr5,R,32097670,32098396,91504501,726,576378662,29802,1
105374712,LOC105374712,chr5,R,31846411,31855024,91513114,8613,576387275,29803,2
105374713,LOC105374713,chr5,F,32505639,32571326,91578801,65687,576452962,29804,3
105374714,LOC105374714,chr5,R,32634207,32652024,91596618,17817,576470779,29805,2
105374715,LOC105374715,chr5,R,33010864,33023321,91609075,12457,576483236,29806,3
105374716,LOC105374716,chr5,F,33229223,33258419,91638271,29196,576512432,29807,5
105374717,LOC105374717,chr5,R,33516018,33522505,91644758,6487,576518919,29808,2
105374718,LOC105374718,chr5,R,34156875,34169120,91657003,12245,576531164,29809,3
105374719,LOC105374719,chr5,R,34264916,34269419,91661506,4503,576535667,29810,4
105374720,LOC105374720,chr5,F,34329893,34465090,91796703,135197,576670864,29811,3
105374721,LOC105374721,chr5,F,34585801,34590317,91801219,4516,576675380,29812,2
105374722,LOC105374722,chr5,R,34798346,34814576,91817449,16230,576691610,29813,1
105374723,LOC105374723,chr5,R,34651467,34656253,91822235,4786,576696396,29814,2
105374724,LOC105374724,chr5,R,35676735,35686311,91831811,9576,576705972,29815,2
105374725,LOC105374725,chr5,F,36324526,36338168,91845453,13642,576719614,29816,2
105374727,LOC105374727,chr5,F,37249050,37250644,91847047,1594,576721208,29817,1
105374728,LOC105374728,chr5,R,37916468,37920929,91851508,4461,576725669,29818,3
105374729,LOC105374729,chr5,F,37948304,37951055,91854259,2751,576728420,29819,2
105374730,LOC105374730,chr5,R,38074800,38084348,91863807,9548,576737968,29820,3
105374731,LOC105374731,chr5,F,38024190,38183932,92023549,159742,576897710,29821,6
105374732,LOC105374732,chr5,R,38460777,38462817,92025589,2040,576899750,29822,1
105374733,LOC105374733,chr5,R,38812098,38813637,92027128,1539,576901289,29823,2
105374734,LOC105374734,chr5,R,38604653,38608420,92030895,3767,576905056,29824,2
105374735,LOC105374735,chr5,F,38576090,38579594,92034399,3504,576908560,29825,1
105374736,LOC105374736,chr5,R,40307686,40346555,92073268,38869,576947429,29826,6
105374737,LOC105374737,chr5,F,40599879,40631723,92105112,31844,576979273,29827,2
105374738,LOC105374738,chr5,R,40678775,40679489,92105826,714,576979987,29828,1
105374739,LOC105374739,chr5,F,41071431,41201549,92235944,130118,577110105,29829,9
105374740,LOC105374740,chr5,F,41385122,41409162,92259984,24040,577134145,29830,2
105374741,LOC105374741,chr5,F,41281221,41350070,92328833,68849,577202994,29831,1
105374742,LOC105374742,chr5,F,41733478,41737454,92332809,3976,577206970,29832,1
105374743,LOC105374743,chr5,F,42889624,42892218,92335403,2594,577209564,29833,2
105374745,LOC105374745,chr5,F,42957578,42965053,92342878,7475,577217039,29834,2
105374746,LOC105374746,chr5,F,42996583,43000906,92347201,4323,577221362,29835,1
105374747,LOC105374747,chr5,R,42974416,42975949,92348734,1533,577222895,29836,1
105374748,LOC105374748,chr5,F,43018856,43024240,92354118,5384,577228279,29837,3
105374749,LOC105374749,chr5,F,43511263,43529468,92372323,18205,577246484,29838,3
105374750,LOC105374750,chr5,F,43483915,43509815,92398223,25900,577272384,29839,5
105374751,LOC105374751,chr5,F,45226523,45228894,92400594,2371,577274755,29840,2
105374752,LOC105374752,chr5,R,51193,57883,92407284,6690,577281445,29841,7
105374753,LOC105374753,chr5,R,34656305,34658489,92409468,2184,577283629,29842,1
105377673,LOC105377673,chr5,R,156703577,156742880,92448771,39303,577322932,29843,6
105377674,LOC105377674,chr5,R,156290510,156376289,92534550,85779,577408711,29844,2
105377675,LOC105377675,chr5,F,157652244,157659054,92541360,6810,577415521,29845,3
105377676,LOC105377676,chr5,F,157696215,157711208,92556353,14993,577430514,29846,2
105377677,LOC105377677,chr5,R,158045315,158051280,92562318,5965,577436479,29847,4
105377678,LOC105377678,chr5,F,158226020,158251077,92587375,25057,577461536,29848,3
105377679,LOC105377679,chr5,R,158387400,158396126,92596101,8726,577470262,29849,2
105377680,LOC105377680,chr5,F,158317268,158323197,92602030,5929,577476191,29850,2
105377681,LOC105377681,chr5,R,158470883,158515080,92646227,44197,577520388,29851,4
105377682,LOC105377682,chr5,F,159227714,159245157,92663670,17443,577537831,29852,2
105377683,LOC105377683,chr5,F,159310858,159315252,92668064,4394,577542225,29853,2
105377684,LOC105377684,chr5,F,159515730,159629601,92781935,113871,577656096,29854,20
105377685,LOC105377685,chr5,R,159512507,159520471,92789899,7964,577664060,29855,3
105377686,LOC105377686,chr5,R,159504781,159511892,92797010,7111,577671171,29856,1
105377687,LOC105377687,chr5,R,159698587,159705348,92803771,6761,577677932,29857,2
105377688,LOC105377688,chr5,R,159708084,159761045,92856732,52961,577730893,29858,5
105377689,LOC105377689,chr5,F,159865079,159906757,92898410,41678,577772571,29859,2
105377690,LOC105377690,chr5,R,160195695,160210577,92913292,14882,577787453,29860,3
105377691,LOC105377691,chr5,F,160263527,160271065,92920830,7538,577794991,29861,3
105377692,LOC105377692,chr5,F,160685309,160692005,92927526,6696,577801687,29862,2
105377693,LOC105377693,chr5,F,161059771,161085376,92953131,25605,577827292,29863,4
105377694,LOC105377694,chr5,F,161369997,161407224,92990358,37227,577864519,29864,4
105377695,LOC105377695,chr5,F,161735746,161766913,93021525,31167,577895686,29865,2
105377696,LOC105377696,chr5,R,161809045,161819517,93031997,10472,577906158,29866,2
105377697,LOC105377697,chr5,R,162534935,162558535,93055597,23600,577929758,29867,7
105377698,LOC105377698,chr5,R,162623347,162624440,93056690,1093,577930851,29868,2
105377699,LOC105377699,chr5,R,162795810,163012064,93272944,216254,578147105,29869,3
105377700,LOC105377700,chr5,R,163397142,163437228,93313030,40086,578187191,29870,3
105377701,LOC105377701,chr5,R,165219919,165243358,93336469,23439,578210630,29871,9
105377702,LOC105377702,chr5,R,165140172,165160126,93356423,19954,578230584,29872,2
105377703,LOC105377703,chr5,F,164973248,165171593,93554768,198345,578428929,29873,2
105377704,LOC105377704,chr5,F,165843234,165847804,93559338,4570,578433499,29874,2
105377705,LOC105377705,chr5,R,166230128,166233375,93562585,3247,578436746,29875,2
105377706,LOC105377706,chr5,R,166845620,166895725,93612690,50105,578486851,29876,2
105377707,LOC105377707,chr5,R,168226522,168227960,93614128,1438,578488289,29877,2
105377708,LOC105377708,chr5,R,168181376,168186178,93618930,4802,578493091,29878,2
105377709,LOC105377709,chr5,R,167937076,167953560,93635414,16484,578509575,29879,2
105377710,LOC105377710,chr5,F,167411154,167418869,93643129,7715,578517290,29880,3
105377711,LOC105377711,chr5,R,168350143,168352132,93645118,1989,578519279,29881,2
105377712,LOC105377712,chr5,F,169079895,169091143,93656366,11248,578530527,29882,3
105377713,LOC105377713,chr5,F,168886581,168892251,93662036,5670,578536197,29883,2
105377714,LOC105377714,chr5,R,169458435,169583608,93787209,125173,578661370,29884,6
105377715,LOC105377715,chr5,F,169460335,169561759,93888633,101424,578762794,29885,4
105377716,LOC105377716,chr5,R,170642232,170681437,93927838,39205,578801999,29886,8
105377717,LOC105377717,chr5,R,171139431,171143752,93932159,4321,578806320,29887,2
105377718,LOC105377718,chr5,R,170911169,170936355,93957345,25186,578831506,29888,5
105377719,LOC105377719,chr5,R,171443608,171451889,93965626,8281,578839787,29889,2
105377720,LOC105377720,chr5,F,171494921,171502737,93973442,7816,578847603,29890,2
105377721,LOC105377721,chr5,R,171469834,171495642,93999250,25808,578873411,29891,2
105377722,LOC105377722,chr5,R,171566902,171582890,94015238,15988,578889399,29892,2
105377723,LOC105377723,chr5,F,171738384,171742789,94019643,4405,578893804,29893,1
105377724,LOC105377724,chr5,R,171718776,171742482,94043349,23706,578917510,29894,8
105377725,LOC105377725,chr5,R,171794051,171848089,94097387,54038,578971548,29895,7
105377726,LOC105377726,chr5,F,171792592,171796883,94101678,4291,578975839,29896,2
105377727,LOC105377727,chr5,F,172479228,172535787,94158237,56559,579032398,29897,5
105377728,LOC105377728,chr5,R,172556724,172559153,94160666,2429,579034827,29898,2
105377729,LOC105377729,chr5,R,172605445,172616842,94172063,11397,579046224,29899,2
105377730,LOC105377730,chr5,F,172771408,172783198,94183853,11790,579058014,29900,4
105377731,LOC105377731,chr5,F,173269430,173280929,94195352,11499,579069513,29901,2
105377732,LOC105377732,chr5,F,173385051,173524433,94334734,139382,579208895,29902,18
105377733,LOC105377733,chr5,F,173543293,173555535,94346976,12242,579221137,29903,3
105377734,LOC105377734,chr5,F,173561469,173574123,94359630,12654,579233791,29904,3
105377735,LOC105377735,chr5,R,173581541,173585551,94363640,4010,579237801,29905,1
105377736,LOC105377736,chr5,F,173689216,173708197,94382621,18981,579256782,29906,3
105377737,LOC105377737,chr5,F,174237914,174243501,94388208,5587,579262369,29907,1
105377738,LOC105377738,chr5,F,174530844,174532457,94389821,1613,579263982,29908,1
105377739,LOC105377739,chr5,R,174522565,174548113,94415369,25548,579289530,29909,3
105377740,LOC105377740,chr5,F,174615580,174621838,94421627,6258,579295788,29910,3
105377741,LOC105377741,chr5,F,174721320,174724123,94424430,2803,579298591,29911,2
105377742,LOC105377742,chr5,F,174804969,174826714,94446175,21745,579320336,29912,4
105377743,LOC105377743,chr5,R,175691854,175697196,94451517,5342,579325678,29913,2
105377744,LOC105377744,chr5,R,175824371,175827049,94454195,2678,579328356,29914,2
105377745,LOC105377745,chr5,F,175972269,175979402,94461328,7133,579335489,29915,1
105377746,LOC105377746,chr5,F,176031324,176035274,94465278,3950,579339439,29916,2
105377747,LOC105377747,chr5,F,176040325,176042971,94467924,2646,579342085,29917,2
105377748,LOC105377748,chr5,F,176135101,176171585,94504408,36484,579378569,29918,5
105377749,LOC105377749,chr5,F,177085846,177086638,94505200,792,579379361,29919,2
105377750,LOC105377750,chr5,F,177554627,177575299,94525872,20672,579400033,29920,3
105377751,LOC105377751,chr5,R,177707965,177722358,94540265,14393,579414426,29921,10
105377752,LOC105377752,chr5,R,177801110,177807458,94546613,6348,579420774,29922,2
105377753,LOC105377753,chr5,R,177864398,177871742,94553957,7344,579428118,29923,1
105377754,LOC105377754,chr5,R,178088665,178093386,94558678,4721,579432839,29924,2
105377755,LOC105377755,chr5,F,178232836,178237077,94562919,4241,579437080,29925,1
105377756,LOC105377756,chr5,F,178477749,178480563,94565733,2814,579439894,29926,1
105377757,LOC105377757,chr5,F,178365832,178369499,94569400,3667,579443561,29927,3
105377758,LOC105377758,chr5,F,178302269,178315869,94583000,13600,579457161,29928,2
105377759,LOC105377759,chr5,R,179346587,179349065,94585478,2478,579459639,29929,2
105377760,LOC105377760,chr5,F,179373430,179375753,94587801,2323,579461962,29930,2
105377761,LOC105377761,chr5,F,179456227,179457903,94589477,1676,579463638,29931,2
105377762,LOC105377762,chr5,R,179534544,179550505,94605438,15961,579479599,29932,3
105377763,LOC105377763,chr5,F,179657783,179674052,94621707,16269,579495868,29933,4
105377764,LOC105377764,chr5,R,180349441,180352353,94624619,2912,579498780,29934,1
105377765,LOC105377765,chr5,F,180684095,180687502,94628026,3407,579502187,29935,1
105377766,LOC105377766,chr5,F,180822810,180826497,94631713,3687,579505874,29936,1
105377767,LOC105377767,chr5,R,181045681,181046131,94632163,450,579506324,29937,1
105377768,LOC105377768,chr5,R,180951073,181040099,94721189,89026,579595350,29938,2
105377769,LOC105377769,chr5,F,181192022,181194247,94723414,2225,579597575,29939,2
105377770,LOC105377770,chr5,R,181454359,181460306,94729361,5947,579603522,29940,1
105377771,LOC105377771,chr5,F,181295346,181318407,94752422,23061,579626583,29941,4
105377772,LOC105377772,chr5,R,178006272,178007707,94753857,1435,579628018,29942,1
105378195,LOC105378195,chr5,R,139667823,139672147,94758181,4324,579632342,29943,1
105378196,LOC105378196,chr5,F,139741654,139745010,94761537,3356,579635698,29944,2
105378197,LOC105378197,chr5,R,140149613,140157785,94769709,8172,579643870,29945,3
105378198,LOC105378198,chr5,F,140711459,140733719,94791969,22260,579666130,29946,2
105378199,LOC105378199,chr5,R,141260223,141263663,94795409,3440,579669570,29947,1
105378200,LOC105378200,chr5,F,141576240,141583212,94802381,6972,579676542,29948,2
105378201,LOC105378201,chr5,F,141705511,141717470,94814340,11959,579688501,29949,2
105378202,LOC105378202,chr5,R,141822049,141828787,94821078,6738,579695239,29950,1
105378203,LOC105378203,chr5,F,141951596,141955721,94825203,4125,579699364,29951,2
105378204,LOC105378204,chr5,R,142088383,142103124,94839944,14741,579714105,29952,2
105378205,LOC105378205,chr5,F,142810779,142821323,94850488,10544,579724649,29953,2
105378206,LOC105378206,chr5,F,143258638,143285987,94877837,27349,579751998,29954,1
105378207,LOC105378207,chr5,F,143462112,143494009,94909734,31897,579783895,29955,2
105378208,LOC105378208,chr5,F,143531377,143560079,94938436,28702,579812597,29956,5
105378209,LOC105378209,chr5,F,143561312,143598434,94975558,37122,579849719,29957,3
105378210,LOC105378210,chr5,F,143662892,143672726,94985392,9834,579859553,29958,2
105378211,LOC105378211,chr5,F,145429603,145480465,95036254,50862,579910415,29959,2
105378212,LOC105378212,chr5,F,146098323,146104568,95042499,6245,579916660,29960,2
105378213,LOC105378213,chr5,R,146370384,146376959,95049074,6575,579923235,29961,4
105378214,LOC105378214,chr5,F,146917930,146923541,95054685,5611,579928846,29962,2
105378215,LOC105378215,chr5,F,146563160,146621829,95113354,58669,579987515,29963,4
105378216,LOC105378216,chr5,F,147432427,147438455,95119382,6028,579993543,29964,2
105378217,LOC105378217,chr5,R,147174509,147234960,95179833,60451,580053994,29965,7
105378218,LOC105378218,chr5,F,147721489,147725809,95184153,4320,580058314,29966,2
105378219,LOC105378219,chr5,F,148147522,148152080,95188711,4558,580062872,29967,4
105378220,LOC105378220,chr5,F,148238564,148244034,95194181,5470,580068342,29968,1
105378221,LOC105378221,chr5,F,148550231,148559987,95203937,9756,580078098,29969,1
105378222,LOC105378222,chr5,F,149060563,149061324,95204698,761,580078859,29970,2
105378223,LOC105378223,chr5,F,149371300,149375112,95208510,3812,580082671,29971,2
105378224,LOC105378224,chr5,F,149703276,149721636,95226870,18360,580101031,29972,2
105378225,LOC105378225,chr5,R,150334875,150340649,95232644,5774,580106805,29973,2
105378226,LOC105378226,chr5,R,150353281,150355670,95235033,2389,580109194,29974,2
105378227,LOC105378227,chr5,R,150666002,150672340,95241371,6338,580115532,29975,2
105378228,LOC105378228,chr5,R,150985575,151020483,95276279,34908,580150440,29976,2
105378229,LOC105378229,chr5,R,151173629,151175458,95278108,1829,580152269,29977,1
105378230,LOC105378230,chr5,F,151211767,151223916,95290257,12149,580164418,29978,2
105378231,LOC105378231,chr5,F,151637914,151655449,95307792,17535,580181953,29979,2
105378232,LOC105378232,chr5,F,151626345,151628832,95310279,2487,580184440,29980,2
105378233,LOC105378233,chr5,F,151567253,151583152,95326178,15899,580200339,29981,2
105378234,LOC105378234,chr5,R,151352582,151436929,95410525,84347,580284686,29982,8
105378235,LOC105378235,chr5,F,151752499,151758528,95416554,6029,580290715,29983,2
105378236,LOC105378236,chr5,R,152294644,152329868,95451778,35224,580325939,29984,3
105378237,LOC105378237,chr5,F,152337667,152378423,95492534,40756,580366695,29985,2
105378238,LOC105378238,chr5,R,153861918,153977134,95607750,115216,580481911,29986,4
105378239,LOC105378239,chr5,F,155115725,155119567,95611592,3842,580485753,29987,3
105378959,LOC105378959,chr5,R,51937690,51964435,95638337,26745,580512498,29988,2
105378960,LOC105378960,chr5,F,52004239,52009849,95643947,5610,580518108,29989,2
105378961,LOC105378961,chr5,F,52107477,52137582,95674052,30105,580548213,29990,4
105378962,LOC105378962,chr5,F,52289022,52339234,95724264,50212,580598425,29991,5
105378963,LOC105378963,chr5,R,52674688,52689973,95739549,15285,580613710,29992,2
105378964,LOC105378964,chr5,R,52710152,52751776,95781173,41624,580655334,29993,2
105378965,LOC105378965,chr5,R,53299658,53326543,95808058,26885,580682219,29994,4
105378966,LOC105378966,chr5,R,53776835,53819684,95850907,42849,580725068,29995,5
105378967,LOC105378967,chr5,F,54617770,54648022,95881159,30252,580755320,29996,2
105378968,LOC105378968,chr5,R,54633026,54642207,95890340,9181,580764501,29997,2
105378969,LOC105378969,chr5,F,54691904,54737635,95936071,45731,580810232,29998,3
105378970,LOC105378970,chr5,R,54957869,54964041,95942243,6172,580816404,29999,2
105378971,LOC105378971,chr5,R,55039613,55042380,95945010,2767,580819171,30000,2
105378972,LOC105378972,chr5,F,55212254,55214911,95947667,2657,580821828,30001,2
105378973,LOC105378973,chr5,F,55279605,55295302,95963364,15697,580837525,30002,4
105378974,LOC105378974,chr5,R,55599921,55605059,95968502,5138,580842663,30003,2
105378975,LOC105378975,chr5,R,55613393,55620559,95975668,7166,580849829,30004,3
105378976,LOC105378976,chr5,F,56059037,56111111,96027742,52074,580901903,30005,2
105378977,LOC105378977,chr5,F,56296695,56350724,96081771,54029,580955932,30006,2
105378978,LOC105378978,chr5,R,56536582,56555886,96101075,19304,580975236,30007,6
105378979,LOC105378979,chr5,R,56770326,56773143,96103892,2817,580978053,30008,2
105378980,LOC105378980,chr5,R,56896283,56909861,96117470,13578,580991631,30009,3
105378981,LOC105378981,chr5,R,57251030,57252444,96118884,1414,580993045,30010,1
105378982,LOC105378982,chr5,F,57803864,57810349,96125369,6485,580999530,30011,2
105378983,LOC105378983,chr5,R,58188295,58218900,96155974,30605,581030135,30012,3
105378984,LOC105378984,chr5,R,58390280,58400829,96166523,10549,581040684,30013,3
105378985,LOC105378985,chr5,F,58503119,58507784,96171188,4665,581045349,30014,2
105378986,LOC105378986,chr5,R,58814666,58817121,96173643,2455,581047804,30015,2
105378987,LOC105378987,chr5,F,60021287,60032848,96185204,11561,581059365,30016,2
105378988,LOC105378988,chr5,F,59768392,59817023,96233835,48631,581107996,30017,3
105378989,LOC105378989,chr5,F,59618801,59649084,96264118,30283,581138279,30018,2
105378990,LOC105378990,chr5,F,59034280,59065051,96294889,30771,581169050,30019,2
105378991,LOC105378991,chr5,F,60914862,60919573,96299600,4711,581173761,30020,2
105378992,LOC105378992,chr5,R,61201308,61305062,96403354,103754,581277515,30021,3
105378993,LOC105378993,chr5,R,61305915,61309317,96406756,3402,581280917,30022,2
105378994,LOC105378994,chr5,R,61321489,61332216,96417483,10727,581291644,30023,4
105378995,LOC105378995,chr5,R,61775229,61784726,96426980,9497,581301141,30024,4
105378996,LOC105378996,chr5,F,61744226,61759165,96441919,14939,581316080,30025,4
105378997,LOC105378997,chr5,R,61624357,61631575,96449137,7218,581323298,30026,2
105378998,LOC105378998,chr5,R,61902625,61916275,96462787,13650,581336948,30027,3
105378999,LOC105378999,chr5,R,63883500,63887417,96466704,3917,581340865,30028,2
105379000,LOC105379000,chr5,R,64151279,64165343,96480768,14064,581354929,30029,2
105379001,LOC105379001,chr5,R,64831773,64884195,96533190,52422,581407351,30030,2
105379002,LOC105379002,chr5,F,66504151,66511835,96540874,7684,581415035,30031,2
105379003,LOC105379003,chr5,R,66346432,66440488,96634930,94056,581509091,30032,2
105379004,LOC105379004,chr5,R,66280648,66298081,96652363,17433,581526524,30033,2
105379005,LOC105379005,chr5,R,67692565,67800939,96760737,108374,581634898,30034,3
105379006,LOC105379006,chr5,R,67632675,67646787,96774849,14112,581649010,30035,3
105379007,LOC105379007,chr5,F,67910870,67950678,96814657,39808,581688818,30036,3
105379008,LOC105379008,chr5,F,68239377,68243345,96818625,3968,581692786,30037,2
105379009,LOC105379009,chr5,R,68373029,68374710,96820306,1681,581694467,30038,1
105379010,LOC105379010,chr5,F,68648616,68662370,96834060,13754,581708221,30039,7
105379011,LOC105379011,chr5,R,68508244,68759670,97085486,251426,581959647,30040,10
105379012,LOC105379012,chr5,F,68483649,68512736,97114573,29087,581988734,30041,3
105379013,LOC105379013,chr5,R,68429585,68444977,97129965,15392,582004126,30042,3
105379014,LOC105379014,chr5,R,68792665,68832704,97170004,40039,582044165,30043,2
105379015,LOC105379015,chr5,F,68941949,68951328,97179383,9379,582053544,30044,2
105379016,LOC105379016,chr5,R,71259354,71289856,97209885,30502,582084046,30045,3
105379017,LOC105379017,chr5,F,70926381,70930090,97213594,3709,582087755,30046,1
105379018,LOC105379018,chr5,F,70798132,70804737,97220199,6605,582094360,30047,2
105379019,LOC105379019,chr5,R,70738920,70741927,97223206,3007,582097367,30048,2
105379020,LOC105379020,chr5,F,70585909,70598722,97236019,12813,582110180,30049,2
105379021,LOC105379021,chr5,R,70382240,70401369,97255148,19129,582129309,30050,3
105379022,LOC105379022,chr5,F,70050963,70054666,97258851,3703,582133012,30051,1
105379023,LOC105379023,chr5,F,69923083,69924616,97260384,1533,582134545,30052,2
105379024,LOC105379024,chr5,F,69640365,69647466,97267485,7101,582141646,30053,1
105379025,LOC105379025,chr5,R,71372547,71375763,97270701,3216,582144862,30054,2
105379026,LOC105379026,chr5,R,71337348,71346915,97280268,9567,582154429,30055,2
105379027,LOC105379027,chr5,F,71750034,71886003,97416237,135969,582290398,30056,3
105379028,LOC105379028,chr5,R,72074583,72108954,97450608,34371,582324769,30057,8
105379029,LOC105379029,chr5,R,73114871,73120456,97456193,5585,582330354,30058,2
105379030,LOC105379030,chr5,R,73132006,73150691,97474878,18685,582349039,30059,1
105379031,LOC105379031,chr5,R,73246493,73274998,97503383,28505,582377544,30060,1
105379032,LOC105379032,chr5,F,73287646,73290488,97506225,2842,582380386,30061,2
105379033,LOC105379033,chr5,F,73337789,73338765,97507201,976,582381362,30062,1
105379034,LOC105379034,chr5,F,73967618,73985925,97525508,18307,582399669,30063,4
105379035,LOC105379035,chr5,F,74039886,74054359,97539981,14473,582414142,30064,2
105379036,LOC105379036,chr5,R,74034265,74103216,97608932,68951,582483093,30065,2
105379037,LOC105379037,chr5,R,74258784,74321276,97671424,62492,582545585,30066,4
105379038,LOC105379038,chr5,R,74682890,74685097,97673631,2207,582547792,30067,1
105379039,LOC105379039,chr5,R,74883140,74898113,97688604,14973,582562765,30068,4
105379040,LOC105379040,chr5,F,74948165,74975758,97716197,27593,582590358,30069,1
105379041,LOC105379041,chr5,R,76081411,76082986,97717772,1575,582591933,30070,1
105379042,LOC105379042,chr5,R,76294994,76311454,97734232,16460,582608393,30071,3
105379043,LOC105379043,chr5,R,76975739,76981882,97740375,6143,582614536,30072,2
105379044,LOC105379044,chr5,R,77127579,77131128,97743924,3549,582618085,30073,2
105379045,LOC105379045,chr5,R,77772648,77776194,97747470,3546,582621631,30074,0
105379046,LOC105379046,chr5,F,79513677,79515303,97749096,1626,582623257,30075,1
105379047,LOC105379047,chr5,F,79547572,79579305,97780829,31733,582654990,30076,4
105379048,LOC105379048,chr5,F,79859860,79975850,97896819,115990,582770980,30077,2
105379049,LOC105379049,chr5,R,80483119,80487966,97901666,4847,582775827,30078,2
105379050,LOC105379050,chr5,F,82730530,82735046,97906182,4516,582780343,30079,3
105379051,LOC105379051,chr5,R,82913366,82924327,97917143,10961,582791304,30080,4
105379052,LOC105379052,chr5,R,83011440,83023190,97928893,11750,582803054,30081,2
105379053,LOC105379053,chr5,F,83388267,83398262,97938888,9995,582813049,30082,2
105379054,LOC105379054,chr5,R,83507039,83562372,97994221,55333,582868382,30083,9
105379055,LOC105379055,chr5,F,83710382,83714595,97998434,4213,582872595,30084,3
105379056,LOC105379056,chr5,F,84492163,84496472,98002743,4309,582876904,30085,2
105379057,LOC105379057,chr5,F,84384789,84538785,98156739,153996,583030900,30086,6
105379058,LOC105379058,chr5,F,84161457,84176489,98171771,15032,583045932,30087,2
105379059,LOC105379059,chr5,F,84566750,84590484,98195505,23734,583069666,30088,3
105379060,LOC105379060,chr5,F,84590535,84605813,98210783,15278,583084944,30089,2
105379061,LOC105379061,chr5,R,85629705,85647805,98228883,18100,583103044,30090,3
105379062,LOC105379062,chr5,F,85805312,85856116,98279687,50804,583153848,30091,2
105379063,LOC105379063,chr5,R,86010708,86031103,98300082,20395,583174243,30092,2
105379064,LOC105379064,chr5,R,86355017,86429992,98375057,74975,583249218,30093,6
105379065,LOC105379065,chr5,R,87066564,87075365,98383858,8801,583258019,30094,3
105379066,LOC105379066,chr5,F,87412981,87483172,98454049,70191,583328210,30095,3
105379067,LOC105379067,chr5,R,87372741,87376386,98457694,3645,583331855,30096,1
105379068,LOC105379068,chr5,R,87364305,87366801,98460190,2496,583334351,30097,1
105379069,LOC105379069,chr5,R,87680559,87715578,98495209,35019,583369370,30098,2
105379070,LOC105379070,chr5,F,88100276,88111441,98506374,11165,583380535,30099,2
105379071,LOC105379071,chr5,R,88691760,88693863,98508477,2103,583382638,30100,1
105379072,LOC105379072,chr5,F,89003916,89468238,98972799,464322,583846960,30101,10
105379073,LOC105379073,chr5,R,89401003,89430351,99002147,29348,583876308,30102,6
105379074,LOC105379074,chr5,R,89362921,89394360,99033586,31439,583907747,30103,3
105379075,LOC105379075,chr5,R,89349252,89360723,99045057,11471,583919218,30104,2
105379076,LOC105379076,chr5,F,89581217,89794279,99258119,213062,584132280,30105,3
105379077,LOC105379077,chr5,R,90712376,90741177,99286920,28801,584161081,30106,3
105379078,LOC105379078,chr5,F,91687475,91721364,99320809,33889,584194970,30107,6
105379079,LOC105379079,chr5,F,91794227,91797824,99324406,3597,584198567,30108,2
105379080,LOC105379080,chr5,F,92329172,92334443,99329677,5271,584203838,30109,2
105379081,LOC105379081,chr5,F,92082506,92416514,99663685,334008,584537846,30110,2
105379082,LOC105379082,chr5,R,92556654,92939630,100046661,382976,584920822,30111,5
105379083,LOC105379083,chr5,R,93135839,93162489,100073311,26650,584947472,30112,2
105379084,LOC105379084,chr5,F,93571681,93574817,100076447,3136,584950608,30113,4
105379085,LOC105379085,chr5,F,95138563,95259834,100197718,121271,585071879,30114,10
105379086,LOC105379086,chr5,F,94577868,94580575,100200425,2707,585074586,30115,2
105379087,LOC105379087,chr5,F,94111694,94251844,100340575,140150,585214736,30116,8
105379088,LOC105379088,chr5,F,93621368,93675492,100394699,54124,585268860,30117,3
105379089,LOC105379089,chr5,R,95366376,95391172,100419495,24796,585293656,30118,3
105379090,LOC105379090,chr5,F,95667344,95684773,100436924,17429,585311085,30119,1
105379091,LOC105379091,chr5,F,95861893,95876809,100451840,14916,585326001,30120,3
105379092,LOC105379092,chr5,F,96808233,96814158,100457765,5925,585331926,30121,2
105379093,LOC105379093,chr5,F,96803951,96806105,100459919,2154,585334080,30122,1
105379094,LOC105379094,chr5,R,96748620,96752513,100463812,3893,585337973,30123,2
105379095,LOC105379095,chr5,F,96142655,96165500,100486657,22845,585360818,30124,3
105379096,LOC105379096,chr5,R,95985888,96072467,100573236,86579,585447397,30125,3
105379097,LOC105379097,chr5,R,95964870,95980527,100588893,15657,585463054,30126,2
105379098,LOC105379098,chr5,R,98066788,98161239,100683344,94451,585557505,30127,8
105379099,LOC105379099,chr5,R,98841081,98841928,100684191,847,585558352,30128,2
105379100,LOC105379100,chr5,F,100397557,100443717,100730351,46160,585604512,30129,9
105379101,LOC105379101,chr5,R,100246890,100248331,100731792,1441,585605953,30130,1
105379102,LOC105379102,chr5,R,101591654,101815736,100955874,224082,585830035,30131,3
105379103,LOC105379103,chr5,F,102669567,102671059,100957366,1492,585831527,30132,1
105379104,LOC105379104,chr5,F,102664251,102726614,101019729,62363,585893890,30133,5
105379105,LOC105379105,chr5,R,103045691,103071029,101045067,25338,585919228,30134,3
105379106,LOC105379106,chr5,F,102974442,102983479,101054104,9037,585928265,30135,1
105379107,LOC105379107,chr5,F,103670788,103819228,101202544,148440,586076705,30136,2
105379108,LOC105379108,chr5,F,103913403,103915424,101204565,2021,586078726,30137,1
105379109,LOC105379109,chr5,R,104540193,104773817,101438189,233624,586312350,30138,11
105379110,LOC105379110,chr5,R,105243270,105393540,101588459,150270,586462620,30139,3
105379111,LOC105379111,chr5,R,104972973,104979775,101595261,6802,586469422,30140,2
105379112,LOC105379112,chr5,F,106247369,106250451,101598343,3082,586472504,30141,2
105379113,LOC105379113,chr5,F,107126695,107153491,101625139,26796,586499300,30142,2
105379114,LOC105379114,chr5,F,108467401,108486103,101643841,18702,586518002,30143,3
105379115,LOC105379115,chr5,R,109163662,109186235,101666414,22573,586540575,30144,2
105379116,LOC105379116,chr5,F,109451510,109466180,101681084,14670,586555245,30145,2
105379117,LOC105379117,chr5,F,109469054,109573827,101785857,104773,586660018,30146,7
105379118,LOC105379118,chr5,F,109666063,109677749,101797543,11686,586671704,30147,2
105379119,LOC105379119,chr5,F,109907503,109912259,101802299,4756,586676460,30148,2
105379120,LOC105379120,chr5,R,110289247,110323455,101836507,34208,586710668,30149,2
105379121,LOC105379121,chr5,R,111008932,111014620,101842195,5688,586716356,30150,3
105379122,LOC105379122,chr5,F,111826783,111845362,101860774,18579,586734935,30151,2
105379123,LOC105379123,chr5,F,112922442,112934261,101872593,11819,586746754,30152,3
105379124,LOC105379124,chr5,F,113294859,113336545,101914279,41686,586788440,30153,2
105379125,LOC105379125,chr5,F,112981128,112984656,101917807,3528,586791968,30154,1
105379126,LOC105379126,chr5,R,112971852,112976618,101922573,4766,586796734,30155,2
105379127,LOC105379127,chr5,R,113776432,113777286,101923427,854,586797588,30156,2
105379128,LOC105379128,chr5,F,115172693,115175456,101926190,2763,586800351,30157,1
105379129,LOC105379129,chr5,F,115296927,115338873,101968136,41946,586842297,30158,5
105379130,LOC105379130,chr5,R,115364201,115370216,101974151,6015,586848312,30159,1
105379131,LOC105379131,chr5,R,115813619,115816111,101976643,2492,586850804,30160,1
105379132,LOC105379132,chr5,F,116574915,116632174,102033902,57259,586908063,30161,6
105379133,LOC105379133,chr5,F,116764470,116810049,102079481,45579,586953642,30162,3
105379134,LOC105379134,chr5,F,116917239,116919948,102082190,2709,586956351,30163,2
105379135,LOC105379135,chr5,R,116899712,116917909,102100387,18197,586974548,30164,3
105379136,LOC105379136,chr5,F,116899355,116913594,102114626,14239,586988787,30165,2
105379137,LOC105379137,chr5,R,116921244,116953427,102146809,32183,587020970,30166,3
105379138,LOC105379138,chr5,F,117271933,117280286,102155162,8353,587029323,30167,2
105379139,LOC105379139,chr5,F,117356981,117370388,102168569,13407,587042730,30168,2
105379140,LOC105379140,chr5,F,117986397,118001124,102183296,14727,587057457,30169,2
105379141,LOC105379141,chr5,F,118577112,118581581,102187765,4469,587061926,30170,3
105379142,LOC105379142,chr5,R,118696908,118737666,102228523,40758,587102684,30171,3
105379143,LOC105379143,chr5,R,118996311,119070865,102303077,74554,587177238,30172,9
105379144,LOC105379144,chr5,F,119835265,119977972,102445784,142707,587319945,30173,3
105379145,LOC105379145,chr5,F,120433120,120451857,102464521,18737,587338682,30174,1
105379146,LOC105379146,chr5,F,120781224,120792869,102476166,11645,587350327,30175,2
105379147,LOC105379147,chr5,F,120868487,120873008,102480687,4521,587354848,30176,2
105379148,LOC105379148,chr5,R,121865087,121872394,102487994,7307,587362155,30177,3
105379149,LOC105379149,chr5,F,121829422,121878798,102537370,49376,587411531,30178,3
105379150,LOC105379150,chr5,R,121821695,121847689,102563364,25994,587437525,30179,2
105379151,LOC105379151,chr5,F,122545299,122567141,102585206,21842,587459367,30180,2
105379152,LOC105379152,chr5,R,123086230,123090149,102589125,3919,587463286,30181,2
105379153,LOC105379153,chr5,F,123075762,123083927,102597290,8165,587471451,30182,1
105379154,LOC105379154,chr5,R,122787494,122844943,102654739,57449,587528900,30183,2
105379155,LOC105379155,chr5,F,124403547,124409975,102661167,6428,587535328,30184,2
105379156,LOC105379156,chr5,F,124796865,124801928,102666230,5063,587540391,30185,3
105379157,LOC105379157,chr5,R,124869170,124876110,102673170,6940,587547331,30186,1
105379158,LOC105379158,chr5,R,124986601,124996103,102682672,9502,587556833,30187,7
105379159,LOC105379159,chr5,F,125388080,125391260,102685852,3180,587560013,30188,2
105379160,LOC105379160,chr5,R,125804199,125828076,102709729,23877,587583890,30189,3
105379161,LOC105379161,chr5,R,126432174,126491786,102769341,59612,587643502,30190,3
105379162,LOC105379162,chr5,R,126664370,126674976,102779947,10606,587654108,30191,2
105379163,LOC105379163,chr5,F,127032112,127036662,102784497,4550,587658658,30192,2
105379164,LOC105379164,chr5,R,127651742,127663762,102796517,12020,587670678,30193,2
105379165,LOC105379165,chr5,R,127940233,127978690,102834974,38457,587709135,30194,4
105379166,LOC105379166,chr5,R,127826776,127858418,102866616,31642,587740777,30195,2
105379167,LOC105379167,chr5,R,128640361,128659185,102885440,18824,587759601,30196,3
105379168,LOC105379168,chr5,F,128537971,128845694,103193163,307723,588067324,30197,4
105379169,LOC105379169,chr5,R,129345428,129352457,103200192,7029,588074353,30198,2
105379170,LOC105379170,chr5,R,130120167,130124343,103204368,4176,588078529,30199,3
105379171,LOC105379171,chr5,F,130337421,130379839,103246786,42418,588120947,30200,5
105379172,LOC105379172,chr5,F,131019892,131068547,103295441,48655,588169602,30201,5
105379173,LOC105379173,chr5,R,131393808,131417924,103319557,24116,588193718,30202,3
105379174,LOC105379174,chr5,R,132048495,132062721,103333783,14226,588207944,30203,5
105379175,LOC105379175,chr5,R,132468862,132472685,103337606,3823,588211767,30204,1
105379176,LOC105379176,chr5,R,132679216,132682629,103341019,3413,588215180,30205,1
105379177,LOC105379177,chr5,R,132958512,132962693,103345200,4181,588219361,30206,0
105379178,LOC105379178,chr5,R,133111067,133124476,103358609,13409,588232770,30207,2
105379179,LOC105379179,chr5,F,133799394,133802808,103362023,3414,588236184,30208,2
105379180,LOC105379180,chr5,F,133387522,133395362,103369863,7840,588244024,30209,2
105379181,LOC105379181,chr5,F,133207886,133225143,103387120,17257,588261281,30210,4
105379182,LOC105379182,chr5,R,133927733,133954074,103413461,26341,588287622,30211,4
105379183,LOC105379183,chr5,F,133968688,133970223,103414996,1535,588289157,30212,1
105379184,LOC105379184,chr5,R,134111613,134114629,103418012,3016,588292173,30213,1
105379185,LOC105379185,chr5,R,134074365,134106400,103450047,32035,588324208,30214,2
105379186,LOC105379186,chr5,F,134412005,134439793,103477835,27788,588351996,30215,5
105379187,LOC105379187,chr5,R,134874905,134875546,103478476,641,588352637,30216,1
105379188,LOC105379188,chr5,R,135122066,135131322,103487732,9256,588361893,30217,1
105379189,LOC105379189,chr5,R,136021580,136025893,103492045,4313,588366206,30218,3
105379190,LOC105379190,chr5,R,136144376,136157399,103505068,13023,588379229,30219,2
105379191,LOC105379191,chr5,F,136753933,136755619,103506754,1686,588380915,30220,1
105379192,LOC105379192,chr5,F,137128135,137130969,103509588,2834,588383749,30221,1
105379193,LOC105379193,chr5,F,138543330,138587034,103553292,43704,588427453,30222,5
105379194,LOC105379194,chr5,R,138744428,138754097,103562961,9669,588437122,30223,2
105379195,LOC105379195,chr5,F,138960690,138970365,103572636,9675,588446797,30224,2
105379197,LOC105379197,chr5,R,103432458,103503988,103644166,71530,588518327,30225,6
105379198,LOC105379198,chr5,R,127218520,127229743,103655389,11223,588529550,30226,3
105379199,LOC105379199,chr5,R,127264452,127291123,103682060,26671,588556221,30227,2
105379200,LOC105379200,chr5,R,132495145,132497253,103684168,2108,588558329,30228,1
23,ABCF1,chr6,F,30571392,30591532,20140,20140,588578469,30229,24
39,ACAT2,chr6,F,159761956,159779112,37296,17156,588595625,30230,9
167,CRISP1,chr6,R,49834256,49877096,80136,42840,588638465,30231,9
177,AGER,chr6,R,32180967,32184322,83491,3355,588641820,30232,9
199,AIF1,chr6,F,31615191,31617021,85321,1830,588643650,30233,2
202,AIM1,chr6,F,106360807,106570451,294965,209644,588853294,30234,21
262,AMD1,chr6,F,110814620,110895713,376058,81093,588934387,30235,9
383,ARG1,chr6,F,131573202,131584332,387188,11130,588945517,30236,7
534,ATP6V1G2,chr6,R,31544450,31546848,389586,2398,588947915,30237,2
577,ADGRB3,chr6,F,68635281,69389511,1143816,754230,589702145,30238,34
578,BAK1,chr6,R,33572545,33580299,1151570,7754,589709899,30239,6
594,BCKDHB,chr6,F,80106626,80346270,1391214,239644,589949543,30240,15
629,CFB,chr6,F,31945943,31952084,1397355,6141,589955684,30241,17
639,PRDM1,chr6,F,106086319,106109939,1420975,23620,589979304,30242,9
653,BMP5,chr6,R,55753652,55875593,1542916,121941,590101245,30243,7
654,BMP6,chr6,F,7726777,7881728,1697867,154951,590256196,30244,6
667,DST,chr6,R,56457986,56954628,2194509,496642,590752838,30245,110
670,BPHL,chr6,F,3118375,3153198,2229332,34823,590787661,30246,8
696,BTN1A1,chr6,F,26499305,26510425,2240452,11120,590798781,30247,7
705,BYSL,chr6,F,41907846,41933046,2265652,25200,590823981,30248,7
717,C2,chr6,F,31897784,31945674,2313542,47890,590871871,30249,19
720,C4A,chr6,F,31982056,32002680,2334166,20624,590892495,30250,40
721,C4B,chr6,F,32014794,32035418,2354790,20624,590913119,30251,40
780,DDR1,chr6,F,30880908,30900156,2374038,19248,590932367,30252,22
860,RUNX2,chr6,F,45327799,45664032,2710271,336233,591268600,30253,15
892,CCNC,chr6,R,99542386,99568973,2736858,26587,591295187,30254,13
896,CCND3,chr6,R,41934932,42048894,2850820,113962,591409149,30255,6
988,CDC5L,chr6,F,44387513,44450424,2913731,62911,591472060,30256,17
1026,CDKN1A,chr6,F,36676459,36687339,2924611,10880,591482940,30257,5
1041,CDSN,chr6,R,31115087,31120475,2929999,5388,591488328,30258,1
1081,CGA,chr6,R,87085497,87095147,2939649,9650,591497978,30259,4
1192,CLIC1,chr6,R,31730580,31737318,2946387,6738,591504716,30260,6
1208,CLPS,chr6,R,35794981,35797344,2948750,2363,591507079,30261,3
1235,CCR6,chr6,F,167111806,167139141,2976085,27335,591534414,30262,3
1268,CNR1,chr6,R,88139863,88166745,3002967,26882,591561296,30263,5
1297,COL9A1,chr6,R,70215060,70303083,3090990,88023,591649319,30264,40
1300,COL10A1,chr6,R,116118908,116218169,3190251,99261,591748580,30265,5
1302,COL11A2,chr6,R,33162691,33193152,3220712,30461,591779041,30266,68
1303,COL12A1,chr6,R,75084325,75206202,3342589,121877,591900918,30267,65
1310,COL19A1,chr6,F,69866555,70212454,3688488,345899,592246817,30268,52
1347,COX7A2,chr6,R,75237674,75254885,3705699,17211,592264028,30269,4
1388,ATF6B,chr6,R,32115267,32128240,3718672,12973,592277001,30270,17
1432,MAPK14,chr6,F,36027634,36111236,3802274,83602,592360603,30271,18
1460,CSNK2B,chr6,F,31665879,31670070,3806465,4191,592364794,30272,6
1490,CTGF,chr6,R,131948175,131951378,3809668,3203,592367997,30273,4
1589,CYP21A2,chr6,F,32038315,32041670,3813023,3355,592371352,30274,9
1590,CYP21A1P,chr6,F,32005635,32008909,3816297,3274,592374626,30275,7
1616,DAXX,chr6,R,33318557,33323016,3820756,4459,592379085,30276,7
1769,DNAH8,chr6,F,38715331,39030798,4136223,315467,592694552,30277,94
1797,DXO,chr6,R,31969810,31972290,4138703,2480,592697032,30278,5
1832,DSP,chr6,F,7541574,7586713,4183842,45139,592742171,30279,23
1871,E2F3,chr6,F,20401905,20493714,4275651,91809,592833980,30280,10
1906,EDN1,chr6,F,12261213,12297194,4311632,35981,592869961,30281,6
1915,EEF1A1,chr6,R,73515749,73521032,4316915,5283,592875244,30282,8
1992,SERPINB1,chr6,R,2832331,2842049,4326633,9718,592884962,30283,8
2030,SLC29A1,chr6,F,44219504,44234151,4341280,14647,592899609,30284,16
2037,EPB41L2,chr6,R,130828172,131063322,4576430,235150,593134759,30285,29
2045,EPHA7,chr6,R,93240019,93419584,4755995,179565,593314324,30286,17
2070,EYA4,chr6,F,133241334,133532120,5046781,290786,593605110,30287,21
2099,ESR1,chr6,F,151690495,152103274,5459560,412779,594017889,30288,17
2162,F13A1,chr6,R,6144077,6321013,5636496,176936,594194825,30289,16
2173,FABP7,chr6,F,122779500,122784074,5641070,4574,594199399,30290,3
2178,FANCE,chr6,F,35452338,35467106,5655838,14768,594214167,30291,10
2289,FKBP5,chr6,R,35573584,35728583,5810837,154999,594369166,30292,12
2295,FOXF2,chr6,F,1389833,1395597,5816601,5764,594374930,30293,1
2296,FOXC1,chr6,F,1610445,1613897,5820053,3452,594378382,30294,0
2309,FOXO3,chr6,F,108559822,108684769,5945000,124947,594503329,30295,8
2444,FRK,chr6,R,115941527,116100728,6104201,159201,594662530,30296,9
2519,FUCA2,chr6,R,143494811,143511883,6121273,17072,594679602,30297,6
2534,FYN,chr6,R,111660331,111873452,6334394,213121,594892723,30298,18
2550,GABBR1,chr6,R,29602227,29633185,6365352,30958,594923681,30299,24
2569,GABRR1,chr6,R,89177503,89231288,6419137,53785,594977466,30300,12
2570,GABRR2,chr6,R,89256060,89315299,6478376,59239,595036705,30301,8
2651,GCNT2,chr6,F,10521282,10629368,6586462,108086,595144791,30302,12
2697,GJA1,chr6,F,121435576,121449744,6600630,14168,595158959,30303,1
2729,GCLC,chr6,R,53497340,53545129,6648419,47789,595206748,30304,15
2739,GLO1,chr6,R,38675924,38703176,6675671,27252,595234000,30305,5
2740,GLP1R,chr6,F,39048780,39091303,6718194,42523,595276523,30306,12
2762,GMDS,chr6,R,1623799,2245634,7340029,621835,595898358,30307,19
2766,GMPR,chr6,F,16238579,16295549,7396999,56970,595955328,30308,9
2794,GNL1,chr6,R,30541376,30557594,7413217,16218,595971546,30309,11
2822,GPLD1,chr6,R,24425831,24495043,7482429,69212,596040758,30310,25
2830,GPR6,chr6,F,109978255,109980720,7484894,2465,596043223,30311,2
2853,GPR31,chr6,R,167156871,167157831,7485854,960,596044183,30312,0
2880,GPX5,chr6,F,28526011,28534951,7494794,8940,596053123,30313,6
2898,GRIK2,chr6,F,101393707,102070083,8171170,676376,596729499,30314,20
2911,GRM1,chr6,F,145964768,146437598,8644000,472830,597202329,30315,10
2914,GRM4,chr6,R,34018642,34155622,8780980,136980,597339309,30316,15
2938,GSTA1,chr6,R,52791379,52803866,8793467,12487,597351796,30317,6
2939,GSTA2,chr6,R,52750086,52763563,8806944,13477,597365273,30318,7
2940,GSTA3,chr6,R,52896638,52909798,8820104,13160,597378433,30319,8
2941,GSTA4,chr6,R,52977947,52995380,8837537,17433,597395866,30320,6
2968,GTF2H4,chr6,F,30908199,30914103,8843441,5904,597401770,30321,13
2978,GUCA1A,chr6,F,42155385,42180056,8868112,24671,597426441,30322,6
2979,GUCA1B,chr6,R,42183283,42206551,8891380,23268,597449709,30323,4
3006,HIST1H1C,chr6,R,26055739,26056471,8892112,732,597450441,30324,0
3007,HIST1H1D,chr6,R,26234211,26234988,8892889,777,597451218,30325,0
3008,HIST1H1E,chr6,F,26156330,26157115,8893674,785,597452003,30326,0
3009,HIST1H1B,chr6,R,27866791,27867581,8894464,790,597452793,30327,0
3010,HIST1H1T,chr6,R,26107411,26108136,8895189,725,597453518,30328,0
3012,HIST1H2AE,chr6,F,26216919,26217483,8895753,564,597454082,30329,0
3013,HIST1H2AD,chr6,R,26198783,26199293,8896263,510,597454592,30330,0
3017,HIST1H2BD,chr6,F,26157842,26171349,8909770,13507,597468099,30331,2
3018,HIST1H2BB,chr6,R,26043226,26043657,8910201,431,597468530,30332,0
3024,HIST1H1A,chr6,R,26017031,26017812,8910982,781,597469311,30333,0
3062,HCRTR2,chr6,F,55174272,55282620,9019330,108348,597577659,30334,7
3066,HDAC2,chr6,R,113936155,113971195,9054370,35040,597612699,30335,16
3077,HFE,chr6,F,26087280,26096117,9063207,8837,597621536,30336,6
3096,HIVEP1,chr6,F,12007652,12164999,9220554,157347,597778883,30337,16
3097,HIVEP2,chr6,R,142751466,142945201,9414289,193735,597972618,30338,9
3105,HLA-A,chr6,F,29942469,29945884,9417704,3415,597976033,30339,7
3106,HLA-B,chr6,R,31353867,31357212,9421049,3345,597979378,30340,7
3107,HLA-C,chr6,R,31268748,31272136,9424437,3388,597982766,30341,7
3108,HLA-DMA,chr6,R,32948613,32953122,9428946,4509,597987275,30342,4
3109,HLA-DMB,chr6,R,32934628,32941070,9435388,6442,597993717,30343,5
3111,HLA-DOA,chr6,R,33004181,33009612,9440819,5431,597999148,30344,4
3112,HLA-DOB,chr6,R,32812762,32817048,9445105,4286,598003434,30345,5
3113,HLA-DPA1,chr6,R,33064568,33080778,9461315,16210,598019644,30346,5
3115,HLA-DPB1,chr6,F,33075925,33089696,9475086,13771,598033415,30347,6
3116,HLA-DPB2,chr6,F,33112515,33129113,9491684,16598,598050013,30348,4
3117,HLA-DQA1,chr6,F,32637395,32654774,9509063,17379,598067392,30349,5
3118,HLA-DQA2,chr6,F,32741385,32746887,9514565,5502,598072894,30350,4
3119,HLA-DQB1,chr6,R,32659463,32666689,9521791,7226,598080120,30351,5
3120,HLA-DQB2,chr6,R,32756093,32763553,9529251,7460,598087580,30352,5
3122,HLA-DRA,chr6,F,32439841,32445046,9534456,5205,598092785,30353,4
3123,HLA-DRB1,chr6,R,32578768,32589836,9545524,11068,598103853,30354,5
3127,HLA-DRB5,chr6,R,32517373,32530316,9558467,12943,598116796,30355,6
3128,HLA-DRB6,chr6,R,32552712,32560002,9565757,7290,598124086,30356,5
3133,HLA-E,chr6,F,30489405,30494205,9570557,4800,598128886,30357,7
3134,HLA-F,chr6,F,29723339,29740355,9587573,17016,598145902,30358,8
3135,HLA-G,chr6,F,29826978,29831122,9591717,4144,598150046,30359,7
3136,HLA-H,chr6,F,29887759,29891080,9595038,3321,598153367,30360,7
3137,HLA-J,chr6,F,30005970,30009956,9599024,3986,598157353,30361,6
3139,HLA-L,chr6,F,30259561,30266951,9606414,7390,598164743,30362,6
3159,HMGA1,chr6,F,34236799,34246231,9615846,9432,598174175,30363,6
3298,HSF2,chr6,F,122399550,122433119,9649415,33569,598207744,30364,12
3303,HSPA1A,chr6,F,31815513,31817942,9651844,2429,598210173,30365,0
3304,HSPA1B,chr6,F,31827734,31830254,9654364,2520,598212693,30366,0
3305,HSPA1L,chr6,R,31809618,31821999,9666745,12381,598225074,30367,4
3326,HSP90AB1,chr6,F,44246165,44253888,9674468,7723,598232797,30368,12
3351,HTR1B,chr6,R,77462230,77463403,9675641,1173,598233970,30369,0
3354,HTR1E,chr6,F,86937305,87016679,9755015,79374,598313344,30370,2
3400,ID4,chr6,F,19837369,19842200,9759846,4831,598318175,30371,2
3459,IFNGR1,chr6,R,137197483,137219844,9782207,22361,598340536,30372,8
3482,IGF2R,chr6,F,159969098,160106551,9919660,137453,598477989,30373,47
3605,IL17A,chr6,F,52186386,52190638,9923912,4252,598482241,30374,2
3617,IMPG1,chr6,R,75921113,76072678,10075477,151565,598633806,30375,16
3662,IRF4,chr6,F,391738,411443,10095182,19705,598653511,30376,9
3710,ITPR3,chr6,F,33621378,33696574,10170378,75196,598728707,30377,60
3720,JARID2,chr6,F,15245974,15522042,10446446,276068,599004775,30378,22
3833,KIFC1,chr6,F,33391523,33410226,10465149,18703,599023478,30379,11
3834,KIF25,chr6,F,168002542,168045089,10507696,42547,599066025,30380,10
3841,KPNA5,chr6,F,116681085,116741867,10568478,60782,599126807,30381,16
3908,LAMA2,chr6,F,128883140,129516569,11201907,633429,599760236,30382,65
3910,LAMA4,chr6,R,112107930,112254722,11348699,146792,599907028,30383,38
4018,LPA,chr6,R,160531482,160666375,11483592,134893,600041921,30384,39
4049,LTA,chr6,F,31560549,31574324,11497367,13775,600055696,30385,6
4050,LTB,chr6,R,31580557,31582425,11499235,1868,600057564,30386,3
4082,MARCKS,chr6,F,113857334,113863475,11505376,6141,600063705,30387,1
4117,MAK,chr6,R,10762722,10838605,11581259,75883,600139588,30388,19
4121,MAN1A1,chr6,R,119177200,119351633,11755692,174433,600314021,30389,15
4142,MAS1,chr6,F,159906941,159908076,11756827,1135,600315156,30390,0
4172,MCM3,chr6,R,52264013,52284881,11777695,20868,600336024,30391,16
4188,MDFI,chr6,F,41637036,41654246,11794905,17210,600353234,30392,6
4199,ME1,chr6,R,83210388,83431741,12016258,221353,600574587,30393,13
4201,MEA1,chr6,R,42980343,43017087,12053002,36744,600611331,30394,7
4216,MAP3K4,chr6,F,160991726,161117385,12178661,125659,600736990,30395,28
4217,MAP3K5,chr6,R,136557045,136793051,12414667,236006,600972996,30396,30
4224,MEP1A,chr6,F,46793356,46845987,12467298,52631,601025627,30397,13
4277,MICB,chr6,F,31494276,31511124,12484146,16848,601042475,30398,7
4295,MLN,chr6,R,33794671,33804016,12493491,9345,601051820,30399,4
4301,MLLT4,chr6,F,167826921,167972023,12638593,145102,601196922,30400,36
4337,MOCS1,chr6,R,39903704,39934551,12669440,30847,601227769,30401,10
4340,MOG,chr6,F,29656980,29672372,12684832,15392,601243161,30402,9
4439,MSH5,chr6,F,31739947,31762678,12707563,22731,601265892,30403,24
4594,MUT,chr6,R,49430359,49463328,12740532,32969,601298861,30404,12
4602,MYB,chr6,F,135180980,135219173,12778725,38193,601337054,30405,17
4646,MYO6,chr6,F,75749175,75919537,12949087,170362,601507416,30406,35
4736,RPL10A,chr6,F,35468400,35470781,12951468,2381,601509797,30407,5
4739,NEDD9,chr6,R,11183297,11382348,13150519,199051,601708848,30408,10
4758,NEU1,chr6,R,31859051,31862932,13154400,3881,601712729,30409,5
4794,NFKBIE,chr6,R,44258165,44265788,13162023,7623,601720352,30410,5
4795,NFKBIL1,chr6,F,31546850,31558829,13174002,11979,601732331,30411,4
4800,NFYA,chr6,F,41072967,41102407,13203442,29440,601761771,30412,9
4829,NMBR,chr6,R,142074483,142147118,13276077,72635,601834406,30413,5
4835,NQO2,chr6,F,2988639,3019876,13307314,31237,601865643,30414,14
4855,NOTCH4,chr6,R,32194842,32224067,13336539,29225,601894868,30415,29
4907,NT5E,chr6,F,85449583,85495791,13382747,46208,601941076,30416,8
4988,OPRM1,chr6,F,154010495,154246867,13619119,236372,602177448,30417,16
5071,PARK2,chr6,R,161347416,162727802,14999505,1380386,603557834,30418,15
5089,PBX2,chr6,R,32184732,32190186,15004959,5454,603563288,30419,8
5110,PCMT1,chr6,F,149749694,149811421,15066686,61727,603625015,30420,8
5134,PDCD2,chr6,R,170575571,170584774,15075889,9203,603634218,30421,6
5167,ENPP1,chr6,F,131808015,131895155,15163029,87140,603721358,30422,24
5169,ENPP3,chr6,F,131637234,131747413,15273208,110179,603831537,30423,24
5190,PEX6,chr6,R,42963872,42979243,15288579,15371,603846908,30424,16
5191,PEX7,chr6,F,136822219,136913934,15380294,91715,603938623,30425,10
5225,PGC,chr6,R,41736710,41747401,15390985,10691,603949314,30426,10
5232,PGK2,chr6,R,49785650,49787340,15392675,1690,603951004,30427,0
5238,PGM3,chr6,R,83151971,83193936,15434640,41965,603992969,30428,17
5252,PHF1,chr6,F,33410411,33416453,15440682,6042,603999011,30429,17
5269,SERPINB6,chr6,R,2948158,2972165,15464689,24007,604023018,30430,11
5272,SERPINB9,chr6,R,2887264,2903312,15480737,16048,604039066,30431,8
5292,PIM1,chr6,F,37170145,37175428,15486020,5283,604044349,30432,5
5314,PKHD1,chr6,R,51614684,52087625,15958961,472941,604517290,30433,73
5325,PLAGL1,chr6,R,143940299,144064599,16083261,124300,604641590,30434,9
5340,PLG,chr6,F,160702192,160754054,16135123,51862,604693452,30435,18
5350,PLN,chr6,F,118548278,118560424,16147269,12146,604705598,30436,1
5429,POLH,chr6,F,43576140,43620523,16191652,44383,604749981,30437,10
5454,POU3F2,chr6,F,98834703,98838790,16195739,4087,604754068,30438,0
5460,POU5F1,chr6,R,31164336,31170693,16202096,6357,604760425,30439,3
5467,PPARD,chr6,F,35342557,35428191,16287730,85634,604846059,30440,10
5514,PPP1R10,chr6,R,30600399,30618607,16305938,18208,604864267,30441,21
5528,PPP2R5D,chr6,F,42984498,43012345,16333785,27847,604892114,30442,15
5550,PREP,chr6,R,105277566,105403124,16459343,125558,605017672,30443,16
5558,PRIM2,chr6,F,57314804,57646850,16791389,332046,605349718,30444,18
5570,PKIB,chr6,F,122471916,122726373,17045846,254457,605604175,30445,17
5603,MAPK13,chr6,F,36130483,36144524,17059887,14041,605618216,30446,11
5617,PRL,chr6,R,22287243,22302883,17075527,15640,605633856,30447,6
5689,PSMB1,chr6,R,170535115,170553329,17093741,18214,605652070,30448,5
5696,PSMB8,chr6,R,32840716,32844935,17097960,4219,605656289,30449,6
5698,PSMB9,chr6,F,32854160,32859851,17103651,5691,605661980,30450,5
5754,PTK7,chr6,F,43076267,43161720,17189104,85453,605747433,30451,20
5796,PTPRK,chr6,R,127968778,128520847,17741173,552069,606299502,30452,40
5863,RGL2,chr6,R,33291653,33299452,17748972,7799,606307301,30453,19
5961,PRPH2,chr6,R,42696594,42722989,17775367,26395,606333696,30454,4
5980,REV3L,chr6,R,111299030,111483715,17960052,184685,606518381,30455,39
5987,TRIM27,chr6,R,28903001,28923991,17981042,20990,606539371,30456,7
6005,RHAG,chr6,R,49605174,49636874,18012742,31700,606571071,30457,10
6015,RING1,chr6,F,33208508,33212722,18016956,4214,606575285,30458,6
6046,BRD2,chr6,F,32968659,32981505,18029802,12846,606588131,30459,16
6048,RNF5,chr6,F,32178384,32180793,18032211,2409,606590540,30460,5
6098,ROS1,chr6,R,117287917,117425922,18170216,138005,606728545,30461,46
6196,RPS6KA2,chr6,R,166409365,166862550,18623401,453185,607181730,30462,25
6204,RPS10,chr6,R,34417453,34426125,18632073,8672,607190402,30463,8
6206,RPS12,chr6,F,132814568,132817564,18635069,2996,607193398,30464,5
6222,RPS18,chr6,F,33272074,33276504,18639499,4430,607197828,30465,5
6239,RREB1,chr6,F,7107596,7251980,18783883,144384,607342212,30466,18
6257,RXRB,chr6,R,33193584,33200853,18791152,7269,607349481,30467,10
6293,VPS52,chr6,R,33250271,33271965,18812846,21694,607371175,30468,19
6310,ATXN1,chr6,R,16299111,16761490,19275225,462379,607833554,30469,8
6428,SRSF3,chr6,F,36594312,36604467,19285380,10155,607843709,30470,6
6446,SGK1,chr6,R,134169245,134318112,19434247,148867,607992576,30471,16
6492,SIM1,chr6,R,100385008,100464929,19514168,79921,608072497,30472,11
6499,SKIV2L,chr6,F,31958803,31969755,19525120,10952,608083449,30473,27
6568,SLC17A1,chr6,R,25781453,25832070,19575737,50617,608134066,30474,12
6580,SLC22A1,chr6,F,160121788,160159198,19613147,37410,608171476,30475,14
6581,SLC22A3,chr6,F,160348372,160452581,19717356,104209,608275685,30476,17
6582,SLC22A2,chr6,R,160216761,160258931,19759526,42170,608317855,30477,10
6610,SMPD2,chr6,F,109440645,109443922,19762803,3277,608321132,30478,9
6631,SNRPC,chr6,F,34757093,34773857,19779567,16764,608337896,30479,5
6648,SOD2,chr6,R,159679115,159693321,19793773,14206,608352102,30480,5
6659,SOX4,chr6,F,21593740,21598619,19798652,4879,608356981,30481,0
6722,SRF,chr6,F,43171294,43181506,19808864,10212,608367193,30482,7
6732,SRPK1,chr6,R,35833033,35921180,19897011,88147,608455340,30483,15
6745,SSR1,chr6,R,7281142,7313314,19929183,32172,608487512,30484,7
6785,ELOVL4,chr6,R,79914811,79947598,19961970,32787,608520299,30485,5
6862,T,chr6,R,166157655,166168669,19972984,11014,608531313,30486,8
6882,TAF11,chr6,R,34877777,34888071,19983278,10294,608541607,30487,5
6885,MAP3K7,chr6,R,90513572,90587301,20057007,73729,608615336,30488,16
6890,TAP1,chr6,R,32845208,32853971,20065770,8763,608624099,30489,11
6891,TAP2,chr6,R,32821832,32838823,20082761,16991,608641090,30490,12
6892,TAPBP,chr6,R,33299693,33314387,20097455,14694,608655784,30491,7
6903,TBCC,chr6,R,42744495,42746146,20099106,1651,608657435,30492,0
6908,TBP,chr6,F,170554332,170572870,20117644,18538,608675973,30493,7
6941,TCF19,chr6,F,31158525,31164215,20123334,5690,608681663,30494,2
6943,TCF21,chr6,F,133889120,133895537,20129751,6417,608688080,30495,2
6950,TCP1,chr6,R,159778497,159789703,20140957,11206,608699286,30496,11
6953,TCP10,chr6,R,167372378,167384552,20153131,12174,608711460,30497,11
6954,TCP11,chr6,R,35118070,35141642,20176703,23572,608735032,30498,10
6991,TCTE3,chr6,R,169725089,169751549,20203163,26460,608761492,30499,4
6992,PPP1R11,chr6,F,30066879,30070333,20206617,3454,608764946,30500,3
6993,DYNLT1,chr6,R,158636473,158644786,20214930,8313,608773259,30501,4
7005,TEAD3,chr6,R,35473596,35497084,20238418,23488,608796747,30502,12
7020,TFAP2A,chr6,R,10396676,10419624,20261366,22948,608819695,30503,10
7021,TFAP2B,chr6,F,50817709,50847619,20291276,29910,608849605,30504,9
7058,THBS2,chr6,R,169215779,169254114,20329611,38335,608887940,30505,22
7101,NR2E1,chr6,F,108158114,108188809,20360306,30695,608918635,30506,10
7124,TNF,chr6,F,31575566,31578336,20363076,2770,608921405,30507,3
7128,TNFAIP3,chr6,F,137866316,137883314,20380074,16998,608938403,30508,11
7146,TNXA,chr6,R,32008419,32013023,20384678,4604,608943007,30509,12
7148,TNXB,chr6,R,32041154,32109374,20452898,68220,609011227,30510,43
7154,TRA-TGC7-1,chr6,R,28802799,28802870,20452969,71,609011298,30511,0
7162,TPBG,chr6,F,82363205,82367417,20457181,4212,609015510,30512,3
7164,TPD52L1,chr6,F,125153728,125263498,20566951,109770,609125280,30513,10
7172,TPMT,chr6,R,18128310,18155165,20593806,26855,609152135,30514,8
7180,CRISP2,chr6,R,49676658,49714198,20631346,37540,609189675,30515,13
7202,TRI-AAT9-1,chr6,F,27273959,27274033,20631420,74,609189749,30516,0
7210,TRX-CAT1-3,chr6,F,26286525,26286597,20631492,72,609189821,30517,0
7212,TRX-CAT2-1,chr6,F,27777884,27777956,20631564,72,609189893,30518,0
7231,TRR-ACG1-3,chr6,F,26537497,26537570,20631637,73,609189966,30519,0
7232,TRR-TCG4-1,chr6,F,26299676,26299749,20631710,73,609190039,30520,0
7259,TSPYL1,chr6,R,116274858,116280117,20636969,5259,609195298,30521,0
7272,TTK,chr6,F,80004604,80042527,20674892,37923,609233221,30522,21
7280,TUBB2A,chr6,R,3153665,3157549,20678776,3884,609237105,30523,3
7287,TULP1,chr6,R,35497873,35512902,20693805,15029,609252134,30524,14
7402,UTRN,chr6,F,144285297,144853034,21261542,567737,609819871,30525,83
7407,VARS,chr6,R,31777517,31795935,21279960,18418,609838289,30526,29
7422,VEGFA,chr6,F,43770208,43786487,21296239,16279,609854568,30527,8
7430,EZR,chr6,R,158765740,158819424,21349923,53684,609908252,30528,13
7432,VIP,chr6,F,152747922,152759765,21361766,11843,609920095,30529,6
7629,ZNF76,chr6,F,35259487,35295987,21398266,36500,609956595,30530,14
7718,ZNF165,chr6,F,28080703,28089563,21407126,8860,609965455,30531,3
7726,TRIM26,chr6,R,30184452,30213494,21436168,29042,609994497,30532,9
7738,ZNF184,chr6,R,27450741,27473118,21458545,22377,610016874,30533,5
7741,ZSCAN26,chr6,F,28267009,28278224,21469760,11215,610028089,30534,2
7745,ZKSCAN8,chr6,F,28136742,28159472,21492490,22730,610050819,30535,9
7746,ZSCAN9,chr6,F,28212664,28233487,21513313,20823,610071642,30536,6
7754,ZNF204P,chr6,R,27357822,27375374,21530865,17552,610089194,30537,4
7803,PTP4A1,chr6,F,63572011,63583588,21542442,11577,610100771,30538,6
7913,DEK,chr6,R,18224168,18264568,21582842,40400,610141171,30539,11
7915,ALDH5A1,chr6,F,24494968,24537207,21625081,42239,610183410,30540,10
7916,PRRC2A,chr6,F,31620672,31637777,21642186,17105,610200515,30541,30
7917,BAG6,chr6,R,31639027,31660767,21663926,21740,610222255,30542,28
7918,GPANK1,chr6,R,31661228,31666283,21668981,5055,610227310,30543,3
7919,DDX39B,chr6,R,31530218,31542475,21681238,12257,610239567,30544,10
7920,ABHD16A,chr6,R,31686948,31703360,21697650,16412,610255979,30545,20
7922,SLC39A7,chr6,F,33200825,33204437,21701262,3612,610259591,30546,6
7923,HSD17B8,chr6,F,33204636,33206831,21703457,2195,610261786,30547,8
7932,OR2H2,chr6,F,29587377,29591012,21707092,3635,610265421,30548,0
7936,NELFE,chr6,R,31952086,31959087,21714093,7001,610272422,30549,10
7940,LST1,chr6,F,31586178,31588909,21716824,2731,610275153,30550,5
7941,PLA2G7,chr6,R,46704315,46735701,21748210,31386,610306539,30551,12
7942,TFEB,chr6,R,41683977,41736259,21800492,52282,610358821,30552,15
7955,RNF217-AS1,chr6,R,124908242,124963027,21855277,54785,610413606,30553,6
7957,EPM2A,chr6,R,145500776,145736303,22090804,235527,610649133,30554,8
8294,HIST1H4I,chr6,F,27139308,27139678,22091174,370,610649503,30555,0
8329,HIST1H2AI,chr6,F,27808198,27808667,22091643,469,610649972,30556,0
8330,HIST1H2AK,chr6,R,27837879,27838339,22092103,460,610650432,30557,0
8331,HIST1H2AJ,chr6,R,27814301,27814740,22092542,439,610650871,30558,0
8332,HIST1H2AL,chr6,F,27865328,27865798,22093012,470,610651341,30559,0
8334,HIST1H2AC,chr6,F,26124144,26124690,22093558,546,610651887,30560,0
8335,HIST1H2AB,chr6,R,26033091,26033568,22094035,477,610652364,30561,0
8336,HIST1H2AM,chr6,R,27892698,27893185,22094522,487,610652851,30562,0
8339,HIST1H2BG,chr6,R,26216199,26216644,22094967,445,610653296,30563,0
8340,HIST1H2BL,chr6,R,27807478,27807931,22095420,453,610653749,30564,0
8341,HIST1H2BN,chr6,F,27838661,27839110,22095869,449,610654198,30565,0
8342,HIST1H2BM,chr6,F,27815043,27815489,22096315,446,610654644,30566,0
8343,HIST1H2BF,chr6,F,26199558,26199988,22096745,430,610655074,30567,0
8344,HIST1H2BE,chr6,F,26183795,26184230,22097180,435,610655509,30568,0
8345,HIST1H2BH,chr6,F,26251650,26252075,22097605,425,610655934,30569,0
8346,HIST1H2BI,chr6,F,26272975,26273412,22098042,437,610656371,30570,0
8347,HIST1H2BC,chr6,R,26123466,26123904,22098480,438,610656809,30571,0
8348,HIST1H2BO,chr6,F,27893424,27893891,22098947,467,610657276,30572,0
8350,HIST1H3A,chr6,F,26020489,26020958,22099416,469,610657745,30573,0
8351,HIST1H3D,chr6,R,26196783,26199293,22101926,2510,610660255,30574,0
8352,HIST1H3C,chr6,F,26045410,26045869,22102385,459,610660714,30575,0
8353,HIST1H3E,chr6,F,26225154,26225616,22102847,462,610661176,30576,0
8354,HIST1H3I,chr6,R,27871844,27872321,22103324,477,610661653,30577,0
8355,HIST1H3G,chr6,R,26270917,26271384,22103791,467,610662120,30578,0
8356,HIST1H3J,chr6,R,27890314,27890792,22104269,478,610662598,30579,0
8357,HIST1H3H,chr6,F,27810063,27810536,22104742,473,610663071,30580,0
8358,HIST1H3B,chr6,R,26031588,26032060,22105214,472,610663543,30581,0
8359,HIST1H4A,chr6,F,26021678,26022050,22105586,372,610663915,30582,0
8360,HIST1H4D,chr6,R,26188709,26189076,22105953,367,610664282,30583,0
8361,HIST1H4F,chr6,F,26240425,26240793,22106321,368,610664650,30584,0
8362,HIST1H4K,chr6,R,27831173,27831527,22106675,354,610665004,30585,0
8363,HIST1H4J,chr6,F,27824124,27824480,22107031,356,610665360,30586,0
8364,HIST1H4C,chr6,F,26103947,26104337,22107421,390,610665750,30587,0
8365,HIST1H4H,chr6,R,26285125,26285499,22107795,374,610666124,30588,0
8366,HIST1H4B,chr6,R,26026895,26027252,22108152,357,610666481,30589,0
8367,HIST1H4E,chr6,F,26204644,26205021,22108529,377,610666858,30590,0
8368,HIST1H4L,chr6,R,27873147,27873511,22108893,364,610667222,30591,0
8369,HIST1H4G,chr6,R,26246610,26246977,22109260,367,610667589,30592,0
8417,STX7,chr6,R,132457523,132513198,22164935,55675,610723264,30593,10
8418,CMAHP,chr6,R,25081066,25138392,22222261,57326,610780590,30594,13
8449,DHX16,chr6,R,30653118,30673053,22242196,19935,610800525,30595,23
8464,SUPT3H,chr6,R,44807498,45378051,22812749,570553,611371078,30596,19
8504,PEX3,chr6,F,143450780,143490616,22852585,39836,611410914,30597,11
8521,GCM1,chr6,R,53126960,53148826,22874451,21866,611432780,30598,5
8528,DDO,chr6,R,110392179,110415550,22897822,23371,611456151,30599,4
8635,RNASET2,chr6,R,166929515,166956589,22924896,27074,611483225,30600,8
8645,KCNK5,chr6,R,39188970,39229475,22965401,40505,611523730,30601,4
8676,STX11,chr6,F,144140050,144191939,23017290,51889,611575619,30602,8
8705,B3GALT4,chr6,F,33277139,33278825,23018976,1686,611577305,30603,0
8724,SNX3,chr6,R,108211216,108261260,23069020,50044,611627349,30604,3
8732,RNGTT,chr6,R,88609896,88963716,23422840,353820,611981169,30605,17
8737,RIPK1,chr6,F,3063966,3115187,23474061,51221,612032390,30606,12
8763,CD164,chr6,R,109366513,109382559,23490107,16046,612048436,30607,5
8831,SYNGAP1,chr6,F,33420069,33453689,23523727,33620,612082056,30608,18
8838,WISP3,chr6,F,112053515,112069686,23539898,16171,612098227,30609,9
8859,STK19,chr6,F,31971174,31981446,23550170,10272,612108499,30610,7
8870,IER3,chr6,R,30743198,30744550,23551522,1352,612109851,30611,1
8871,SYNJ2,chr6,F,157981855,158099176,23668843,117321,612227172,30612,32
8875,VNN2,chr6,R,132743869,132763459,23688433,19590,612246762,30613,10
8876,VNN1,chr6,R,132680857,132714055,23721631,33198,612279960,30614,6
8899,PRPF4B,chr6,F,4021328,4064983,23765286,43655,612323615,30615,16
8936,WASF1,chr6,R,110099816,110189874,23855344,90058,612413673,30616,12
8968,HIST1H3F,chr6,R,26250141,26250607,23855810,466,612414139,30617,0
8969,HIST1H2AG,chr6,F,27133037,27133535,23856308,498,612414637,30618,0
8970,HIST1H2BJ,chr6,R,27132315,27132796,23856789,481,612415118,30619,0
9025,RNF8,chr6,F,37353971,37394738,23897556,40767,612455885,30620,8
9038,TAAR5,chr6,R,132588591,132589738,23898703,1147,612457032,30621,0
9053,MAP7,chr6,R,136342280,136550819,24107242,208539,612665571,30622,19
9096,TBX18,chr6,R,84687350,84764730,24184622,77380,612742951,30623,10
9113,LATS1,chr6,R,149658152,149718256,24244726,60104,612803055,30624,12
9247,GCM2,chr6,R,10872723,10886430,24258433,13707,612816762,30625,5
9277,WDR46,chr6,R,33279102,33289527,24268858,10425,612827187,30626,15
9278,ZBTB22,chr6,R,33314404,33317942,24272396,3538,612830725,30627,2
9287,TAAR2,chr6,R,132599626,132624358,24297128,24732,612855457,30628,3
9288,TAAR3,chr6,R,132608224,132609302,24298206,1078,612856535,30629,0
9308,CD83,chr6,F,14117255,14136918,24317869,19663,612876198,30630,5
9324,HMGN3,chr6,R,79201244,79234738,24351363,33494,612909692,30631,4
9374,PPT2,chr6,F,32153451,32163681,24361593,10230,612919922,30632,9
9425,CDYL,chr6,F,4706158,4955544,24610979,249386,613169308,30633,11
9436,NCR2,chr6,F,41335789,41350887,24626077,15098,613184406,30634,5
9439,MED23,chr6,R,131573965,131628239,24680351,54274,613238680,30635,31
9444,QKI,chr6,F,163414642,163578596,24844305,163954,613402634,30636,6
9450,LY86,chr6,F,6588700,6654983,24910588,66283,613468917,30637,4
9457,FHL5,chr6,F,96562547,96618620,24966661,56073,613524990,30638,7
9465,AKAP7,chr6,F,131135685,131283535,25114511,147850,613672840,30639,13
9474,ATG5,chr6,R,106184475,106325820,25255856,141345,613814185,30640,9
9477,MED20,chr6,R,41905353,41921139,25271642,15786,613829971,30641,3
9481,SLC25A27,chr6,F,46652914,46678190,25296918,25276,613855247,30642,8
9519,TBPL1,chr6,F,133952169,133987500,25332249,35331,613890578,30643,7
9521,EEF1E1,chr6,R,8073359,8102595,25361485,29236,613919814,30644,4
9532,BAG2,chr6,F,57172305,57185215,25374395,12910,613932724,30645,4
9533,POLR1C,chr6,F,43517038,43550984,25408341,33946,613966670,30646,10
9587,MAD2L1BP,chr6,F,43629541,43640952,25419752,11411,613978081,30647,4
9589,WTAP,chr6,F,159726997,159756319,25449074,29322,614007403,30648,9
9590,AKAP12,chr6,F,151239998,151358559,25567635,118561,614125964,30649,6
9656,MDC1,chr6,R,30699806,30717966,25585795,18160,614144124,30650,15
9697,TRAM2,chr6,R,52497401,52577064,25665458,79663,614223787,30651,11
9729,KIAA0408,chr6,R,127438405,127459390,25686443,20985,614244772,30652,5
9749,PHACTR2,chr6,F,143608179,143831185,25909449,223006,614467778,30653,13
9750,FAM65B,chr6,R,24804280,25042288,26147457,238008,614705786,30654,30
9753,ZSCAN12,chr6,R,28378820,28399767,26168404,20947,614726733,30655,5
9774,BCLAF1,chr6,R,136256862,136290645,26202187,33783,614760516,30656,15
9820,CUL7,chr6,R,43037616,43053950,26218521,16334,614776850,30657,26
9841,ZBTB24,chr6,R,109462515,109483237,26239243,20722,614797572,30658,6
9856,KIAA0319,chr6,R,24544103,24646172,26341312,102069,614899641,30659,24
9892,SNAP91,chr6,R,83552884,83709408,26497836,156524,615056165,30660,34
9896,FIG4,chr6,F,109691220,109825431,26632047,134211,615190376,30661,23
9972,NUP153,chr6,R,17615034,17706834,26723847,91800,615282176,30662,23
9994,CASP8AP2,chr6,F,89829899,89874436,26768384,44537,615326713,30663,9
10048,RANBP9,chr6,R,13621497,13711580,26858467,90083,615416796,30664,14
10050,SLC17A4,chr6,F,25753358,25781175,26886284,27817,615444613,30665,14
10090,UST,chr6,F,148746961,149076990,27216313,330029,615774642,30666,11
10107,TRIM10,chr6,R,30151938,30163440,27227815,11502,615786144,30667,9
10211,FLOT1,chr6,R,30727733,30742685,27242767,14952,615801096,30668,13
10231,RCAN2,chr6,R,46220729,46492067,27514105,271338,616072434,30669,7
10246,SLC17A2,chr6,R,25912753,25930726,27532078,17973,616090407,30670,11
10255,HCG9,chr6,F,29975114,29978403,27535367,3289,616093696,30671,2
10279,PRSS16,chr6,F,27247722,27256620,27544265,8898,616102594,30672,11
10321,CRISP3,chr6,R,49727375,49744455,27561345,17080,616119674,30673,7
10345,TRDN,chr6,R,123216338,123637283,27982290,420945,616540619,30674,41
10370,CITED2,chr6,R,139372254,139374650,27984686,2396,616543015,30675,3
10384,BTN3A3,chr6,F,26440471,26453415,27997630,12944,616555959,30676,10
10385,BTN2A2,chr6,F,26382885,26394874,28009619,11989,616567948,30677,7
10455,ECI2,chr6,R,4115692,4135597,28029524,19905,616587853,30678,11
10471,PFDN6,chr6,F,33289596,33290934,28030862,1338,616589191,30679,4
10473,HMGN4,chr6,F,26538343,26546937,28039456,8594,616597785,30680,1
10475,TRIM38,chr6,F,25962688,25987329,28064097,24641,616622426,30681,8
10486,CAP2,chr6,F,17393215,17557792,28228674,164577,616787003,30682,12
10492,SYNCRIP,chr6,R,85607783,85643850,28264741,36067,616823070,30683,12
10537,UBD,chr6,R,29555611,29559925,28269055,4314,616827384,30684,1
10554,AGPAT1,chr6,R,32168205,32178111,28278961,9906,616837290,30685,10
10559,SLC35A1,chr6,F,87472924,87512339,28318376,39415,616876705,30686,7
10590,SCGN,chr6,F,25652200,25701783,28367959,49583,616926288,30687,10
10591,DNPH1,chr6,R,43225628,43229473,28371804,3845,616930133,30688,2
10665,C6orf10,chr6,R,32288540,32372114,28455378,83574,617013707,30689,30
10667,FARS2,chr6,F,5261017,5771583,28965944,510566,617524273,30690,15
10690,FUT9,chr6,F,96015968,96215612,29165588,199644,617723917,30691,5
10695,CNPY3,chr6,F,42929121,42939270,29175737,10149,617734066,30692,7
10758,TRAF3IP2,chr6,R,111555377,111606874,29227234,51497,617785563,30693,11
10767,HBS1L,chr6,R,134960377,135054898,29321755,94521,617880084,30694,19
10786,SLC17A3,chr6,R,25845099,25874243,29350899,29144,617909228,30695,12
10799,RPP40,chr6,R,4992413,5004063,29362549,11650,617920878,30696,8
10817,FRS3,chr6,R,41770175,41779905,29372279,9730,617930608,30697,7
10846,PDE10A,chr6,R,165327286,165711153,29756146,383867,618314475,30698,29
10864,SLC22A7,chr6,F,43295709,43305538,29765975,9829,618324304,30699,13
10866,HCP5,chr6,F,31463179,31465809,29768605,2630,618326934,30700,1
10919,EHMT2,chr6,R,31879758,31897707,29786554,17949,618344883,30701,27
10924,SMPDL3A,chr6,F,122788455,122809720,29807819,21265,618366148,30702,8
10930,APOBEC2,chr6,F,41053200,41064891,29819510,11691,618377839,30703,2
10957,PNRC1,chr6,F,89080709,89085160,29823961,4451,618382290,30704,1
10973,ASCC3,chr6,R,100508193,100881372,30197140,373179,618755469,30705,42
10981,RAB32,chr6,F,146543691,146554950,30208399,11259,618766728,30706,2
11074,TRIM31,chr6,R,30102891,30113090,30218598,10199,618776927,30707,8
11104,KATNA1,chr6,R,149594872,149649018,30272744,54146,618831073,30708,12
11116,FGFR1OP,chr6,F,166999316,167042418,30315846,43102,618874175,30709,12
11118,BTN3A2,chr6,F,26365158,26451653,30402341,86495,618960670,30710,11
11119,BTN3A1,chr6,F,26402236,26415216,30415321,12980,618973650,30711,10
11120,BTN2A1,chr6,F,26457903,26476621,30434039,18718,618992368,30712,8
11131,CAPN11,chr6,F,44158810,44184402,30459631,25592,619017960,30713,23
11149,BVES,chr6,R,105096821,105137174,30499984,40353,619058313,30714,10
11165,NUDT3,chr6,R,34287193,34392680,30605471,105487,619163800,30715,4
11231,SEC63,chr6,R,107867755,107958278,30695994,90523,619254323,30716,21
11270,NRM,chr6,R,30688046,30691420,30699368,3374,619257697,30717,5
11329,STK38,chr6,R,36493888,36547479,30752959,53591,619311288,30718,14
22828,SCAF8,chr6,F,154733377,154834244,30853826,100867,619412155,30719,20
22832,CEP162,chr6,R,84124240,84227890,30957476,103650,619515805,30720,31
22858,ICK,chr6,R,53001298,53061833,31018011,60535,619576340,30721,15
22875,ENPP4,chr6,F,46129963,46146699,31034747,16736,619593076,30722,3
22881,ANKRD6,chr6,F,89433177,89633834,31235404,200657,619793733,30723,20
22999,RIMS1,chr6,F,71886702,72403143,31751845,516441,620310174,30724,39
23033,DOPEY1,chr6,F,83067659,83168471,31852657,100812,620410986,30725,40
23036,ZNF292,chr6,F,87155550,87263690,31960797,108140,620519126,30726,9
23070,CMTR1,chr6,F,37433130,37482827,32010494,49697,620568823,30727,24
23097,CDK19,chr6,R,110609977,110816516,32217033,206539,620775362,30728,17
23113,CUL9,chr6,F,43182173,43224587,32259447,42414,620817776,30729,41
23118,TAB2,chr6,F,149217923,149411613,32453137,193690,621011466,30730,14
23195,MDN1,chr6,R,89642774,89827961,32638324,185187,621196653,30731,104
23270,TSPYL4,chr6,R,116249963,116254098,32642459,4135,621200788,30732,0
23294,ANKS1A,chr6,F,34889260,35098010,32851209,208750,621409538,30733,27
23304,UBR2,chr6,F,42563951,42693505,32980763,129554,621539092,30734,51
23328,SASH1,chr6,F,148193439,148552049,33339373,358610,621897702,30735,24
23345,SYNE1,chr6,R,152121683,152637399,33855089,515716,622413418,30736,151
23376,UFL1,chr6,F,96521825,96555276,33888540,33451,622446869,30737,18
23408,SIRT5,chr6,F,13574273,13615158,33929425,40885,622487754,30738,14
23437,TRS-AGA2-4,chr6,F,27495813,27495895,33929507,82,622487836,30739,0
23469,PHF3,chr6,F,63635801,63715522,34009228,79721,622567557,30740,17
23493,HEY2,chr6,F,125749585,125761271,34020914,11686,622579243,30741,7
23500,DAAM2,chr6,F,39792365,39904877,34133426,112512,622691755,30742,31
23506,GLTSCR1L,chr6,F,42782051,42868560,34219935,86509,622778264,30743,13
23540,TRS-TGA4-1,chr6,R,27505827,27505909,34220017,82,622778346,30744,0
23564,DDAH2,chr6,R,31727036,31730265,34223246,3229,622781575,30745,5
23593,HEBP2,chr6,F,138404198,138421545,34240593,17347,622798922,30746,4
23595,ORC3,chr6,F,87590066,87667454,34317981,77388,622876310,30747,22
23607,CD2AP,chr6,F,47477745,47627263,34467499,149518,623025828,30748,18
23629,BRD7P3,chr6,F,118501372,118503846,34469973,2474,623028302,30749,0
23787,MTCH1,chr6,R,36968134,36986551,34488390,18417,623046719,30750,10
24149,ZNF318,chr6,R,43327164,43369459,34530685,42295,623089014,30751,12
25803,SPDEF,chr6,R,34537801,34556333,34549217,18532,623107546,30752,7
25821,MTO1,chr6,F,73461730,73501456,34588943,39726,623147272,30753,14
25842,ASF1A,chr6,F,118894076,118909171,34604038,15095,623162367,30754,3
25844,YIPF3,chr6,R,43511826,43516990,34609202,5164,623167531,30755,9
25862,USP49,chr6,R,41789895,41895361,34714668,105466,623272997,30756,7
25901,CCDC28A,chr6,F,138773519,138808327,34749476,34808,623307805,30757,8
25902,MTHFD1L,chr6,F,150865678,151101887,34985685,236209,623544014,30758,37
25957,PNISR,chr6,R,99398654,99425342,35012373,26688,623570702,30759,11
25998,IBTK,chr6,R,82169986,82247754,35090141,77768,623648470,30760,29
26002,MOXD1,chr6,R,132296054,132401534,35195621,105480,623753950,30761,11
26034,IPCEF1,chr6,R,154154482,154356802,35397941,202320,623956270,30762,19
26036,ZNF451,chr6,F,57090009,57170305,35478237,80296,624036566,30763,17
26054,SENP6,chr6,F,75601508,75718285,35595014,116777,624153343,30764,25
26212,OR2B6,chr6,F,27957240,27958182,35595956,942,624154285,30765,0
26230,TIAM2,chr6,F,155090288,155257723,35763391,167435,624321720,30766,26
26235,FBXL4,chr6,R,98873724,98948006,35837673,74282,624396002,30767,10
26238,LINC01558,chr6,R,167784536,167796859,35849996,12323,624408325,30768,3
26240,FAM50B,chr6,F,3849397,3851317,35851916,1920,624410245,30769,1
26268,FBXO9,chr6,F,53057782,53100873,35895007,43091,624453336,30770,16
26271,FBXO5,chr6,R,152970518,152983605,35908094,13087,624466423,30771,6
26503,SLC17A5,chr6,R,73593378,73654014,35968730,60636,624527059,30772,13
26529,OR12D2,chr6,F,29396638,29397671,35969763,1033,624528092,30773,0
26531,OR11A1,chr6,R,29425503,29427732,35971992,2229,624530321,30774,0
26575,RGS17,chr6,R,153010822,153131254,36092424,120432,624650753,30775,7
26692,OR2W1,chr6,R,29044212,29045175,36093387,963,624651716,30776,0
26707,OR2J2,chr6,F,29173533,29174574,36094428,1041,624652757,30777,0
26716,OR2H1,chr6,F,29457132,29464322,36101618,7190,624659947,30778,6
26797,SNORD52,chr6,F,31837075,31837139,36101682,64,624660011,30779,0
26799,SNORD50A,chr6,R,85677293,85677368,36101757,75,624660086,30780,0
26801,SNORD48,chr6,F,31835262,31835326,36101821,64,624660150,30781,0
27115,PDE7B,chr6,F,135808751,136195571,36488641,386820,625046970,30782,15
27145,FILIP1,chr6,R,75294947,75493829,36687523,198882,625245852,30783,9
27154,BRPF3,chr6,F,36196772,36232790,36723541,36018,625281870,30784,14
27232,GNMT,chr6,F,42939414,42963880,36748007,24466,625306336,30785,8
27242,TNFRSF21,chr6,R,47231526,47309976,36826457,78450,625384786,30786,6
27244,SESN1,chr6,R,108986436,109094505,36934526,108069,625492855,30787,11
27283,TINAG,chr6,F,54307791,54390152,37016887,82361,625575216,30788,12
28514,DLL1,chr6,R,170282199,170306555,37041243,24356,625599572,30789,11
28962,OSTM1,chr6,R,108041408,108074737,37074572,33329,625632901,30790,7
28973,MRPS18B,chr6,F,30617319,30626397,37083650,9078,625641979,30791,6
28978,TMEM14A,chr6,F,52671085,52686588,37099153,15503,625657482,30792,4
29074,MRPL18,chr6,F,159790459,159798429,37107123,7970,625665452,30793,3
29078,NDUFAF4,chr6,R,96889310,96897891,37115704,8581,625674033,30794,2
29113,C6orf15,chr6,R,31111222,31112555,37117037,1333,625675366,30795,1
29116,MYLIP,chr6,F,16129085,16148248,37136200,19163,625694529,30796,6
29777,ABT1,chr6,F,26596942,26600050,37139308,3108,625697637,30797,2
29940,DSE,chr6,F,116280119,116443475,37302664,163356,625860993,30798,6
29964,PRICKLE4,chr6,F,41780761,41787372,37309275,6611,625867604,30799,7
29993,PACSIN1,chr6,F,34466060,34536262,37379477,70202,625937806,30800,11
30834,ZNRD1,chr6,F,30061239,30064909,37383147,3670,625941476,30801,3
49861,CLDN20,chr6,F,155264012,155276548,37395683,12536,625954012,30802,2
50508,NOX3,chr6,R,155395367,155455903,37456219,60536,626014548,30803,13
50619,DEF6,chr6,F,35297817,35321771,37480173,23954,626038502,30804,10
50854,C6orf48,chr6,F,31834914,31839766,37485025,4852,626043354,30805,4
51000,SLC35B3,chr6,R,8413066,8435567,37507526,22501,626065855,30806,12
51020,HDDC2,chr6,R,125275349,125302141,37534318,26792,626092647,30807,5
51053,GMNN,chr6,F,24774930,24786099,37545487,11169,626103816,30808,8
51069,MRPL2,chr6,R,43054028,43060186,37551645,6158,626109974,30809,7
51106,TFB1M,chr6,R,155247237,155314497,37618905,67260,626177234,30810,11
51167,CYB5R4,chr6,F,83859650,83960427,37719682,100777,626278011,30811,15
51175,TUBE1,chr6,R,112070656,112087548,37736574,16892,626294903,30812,12
51250,C6orf203,chr6,F,107028171,107051586,37759989,23415,626318318,30813,5
51256,TBC1D7,chr6,R,13304950,13328583,37783622,23633,626341951,30814,7
51299,NRN1,chr6,R,5997998,6007605,37793229,9607,626351558,30815,6
51302,CYP39A1,chr6,R,46549579,46652847,37896497,103268,626454826,30816,13
51362,CDC40,chr6,F,110180420,110232232,37948309,51812,626506638,30817,15
51389,RWDD1,chr6,F,116571366,116593601,37970544,22235,626528873,30818,8
51390,AIG1,chr6,F,143059362,143340343,38251525,280981,626809854,30819,10
51406,NOL7,chr6,F,13615326,13632524,38268723,17198,626827052,30820,8
51429,SNX9,chr6,F,157716045,157945077,38497755,229032,627056084,30821,21
51439,FAM8A1,chr6,F,17600286,17611719,38509188,11433,627067517,30822,4
51465,UBE2J1,chr6,R,89326624,89352900,38535464,26276,627093793,30823,7
51473,DCDC2,chr6,R,24171754,24383292,38747002,211538,627305331,30824,10
51513,ETV7,chr6,R,36354220,36387800,38780582,33580,627338911,30825,9
51522,TMEM14C,chr6,F,10722914,10731129,38788797,8215,627347126,30826,5
51534,VTA1,chr6,F,142147161,142220948,38862584,73787,627420913,30827,7
51557,LGSN,chr6,R,63275950,63567921,39154555,291971,627712884,30828,13
51567,TDP2,chr6,R,24649976,24666989,39171568,17013,627729897,30829,7
51596,CUTA,chr6,R,33416541,33418288,39173315,1747,627731644,30830,4
51645,PPIL1,chr6,R,36854828,36875024,39193511,20196,627751840,30831,3
51660,MPC1,chr6,R,166364918,166383013,39211606,18095,627769935,30832,6
51696,HECA,chr6,F,139135111,139180809,39257304,45698,627815633,30833,3
51715,RAB23,chr6,R,57186991,57222314,39292627,35323,627850956,30834,7
51805,COQ3,chr6,R,99369400,99394218,39317445,24818,627875774,30835,7
53405,CLIC5,chr6,R,45898450,46080348,39499343,181898,628057672,30836,13
53832,IL20RA,chr6,R,136999970,137045366,39544739,45396,628103068,30837,7
54209,TREM2,chr6,R,41158505,41163198,39549432,4693,628107761,30838,4
54210,TREM1,chr6,R,41267384,41286719,39568767,19335,628127096,30839,5
54346,UNC93A,chr6,F,167271173,167316029,39613623,44856,628171952,30840,11
54435,HCG4,chr6,R,29791030,29793073,39615666,2043,628173995,30841,0
54438,GFOD1,chr6,R,13357829,13487637,39745474,129808,628303803,30842,6
54511,HMGCLL1,chr6,R,55434372,55679668,39990770,245296,628549099,30843,12
54516,MTRF1L,chr6,R,152987365,153002815,40006220,15450,628564549,30844,6
54535,CCHCR1,chr6,R,31142438,31158238,40022020,15800,628580349,30845,19
54676,GTPBP2,chr6,R,43620480,43629246,40030786,8766,628589115,30846,12
54718,BTN2A3P,chr6,F,26421390,26430588,40039984,9198,628598313,30847,6
54806,AHI1,chr6,R,135283971,135497765,40253778,213794,628812107,30848,34
54887,UHRF1BP1,chr6,F,34792016,34877514,40339276,85498,628897605,30849,22
54898,ELOVL2,chr6,R,10980758,11044391,40402909,63633,628961238,30850,9
54901,CDKAL1,chr6,F,20534456,21232404,41100857,697948,629659186,30851,18
55003,PAK1IP1,chr6,F,10690864,10709782,41119775,18918,629678104,30852,12
55005,RMND1,chr6,R,151404760,151452181,41167196,47421,629725525,30853,12
55023,PHIP,chr6,R,78934418,79078294,41311072,143876,629869401,30854,41
55084,SOBP,chr6,F,107490097,107661309,41482284,171212,630040613,30855,10
55122,AKIRIN2,chr6,R,87674859,87702267,41509692,27408,630068021,30856,4
55166,CENPQ,chr6,F,49463340,49493107,41539459,29767,630097788,30857,8
55168,MRPS18A,chr6,R,43671196,43687812,41556075,16616,630114404,30858,4
55173,MRPS10,chr6,R,42206800,42217907,41567182,11107,630125511,30859,7
55227,LRRC1,chr6,F,53794496,53924610,41697296,130114,630255625,30860,15
55274,PHF10,chr6,R,169703904,169724010,41717402,20106,630275731,30861,11
55278,QRSL1,chr6,F,106629565,106668417,41756254,38852,630314583,30862,11
55350,VNN3,chr6,R,132722786,132734765,41768233,11979,630326562,30863,6
55362,TMEM63B,chr6,F,44126756,44155519,41796996,28763,630355325,30864,25
55510,DDX43,chr6,F,73394561,73417566,41820001,23005,630378330,30865,17
55603,FAM46A,chr6,R,81745729,81752711,41826983,6982,630385312,30866,2
55604,LRRC16A,chr6,F,25279427,25620530,42168086,341103,630726415,30867,39
55633,TBC1D22B,chr6,F,37257703,37332970,42243353,75267,630801682,30868,13
55754,TMEM30A,chr6,R,75252921,75284916,42275348,31995,630833677,30869,6
55770,EXOC2,chr6,R,485137,693141,42483352,208004,631041681,30870,29
55776,SAYSD1,chr6,R,39104062,39115186,42494476,11124,631052805,30871,3
55780,ERMARD,chr6,F,169751621,169781584,42524439,29963,631082768,30872,19
55788,LMBRD1,chr6,R,69675748,69797157,42645848,121409,631204177,30873,17
55809,TRERF1,chr6,R,42224932,42452205,42873121,227273,631431450,30874,22
55856,ACOT13,chr6,F,24667034,24705069,42911156,38035,631469485,30875,3
55862,ECHDC1,chr6,R,127288711,127344069,42966514,55358,631524843,30876,9
55937,APOM,chr6,F,31652409,31658210,42972315,5801,631530644,30877,6
56244,BTNL2,chr6,R,32393338,32408879,42987856,15541,631546185,30878,6
56479,KCNQ5,chr6,F,72621279,73198851,43565428,577572,632123757,30879,15
56658,TRIM39,chr6,F,30326843,30343729,43582314,16886,632140643,30880,9
56895,AGPAT4,chr6,R,161130019,161274075,43726370,144056,632284699,30881,9
56897,WRNIP1,chr6,F,2765340,2785745,43746775,20405,632305104,30882,7
56940,DUSP22,chr6,F,292056,351355,43806074,59299,632364403,30883,7
56995,TULP4,chr6,F,158232235,158511828,44085667,279593,632643996,30884,15
57038,RARS2,chr6,R,87499346,87590017,44176338,90671,632734667,30885,25
57061,HYMAI,chr6,R,144002885,144008730,44182183,5845,632740512,30886,1
57107,PDSS2,chr6,R,107152556,107459702,44489329,307146,633047658,30887,9
57120,GOPC,chr6,R,117560268,117602542,44531603,42274,633089932,30888,8
57128,LYRM4,chr6,R,5031752,5260950,44760801,229198,633319130,30889,11
57150,SMIM8,chr6,F,87322587,87342328,44780542,19741,633338871,30890,3
57176,VARS2,chr6,F,30914207,30926459,44792794,12252,633351123,30891,29
57211,ADGRG6,chr6,F,142301918,142446266,44937142,144348,633495471,30892,26
57221,ARFGEF3,chr6,F,138161915,138344663,45119890,182748,633678219,30893,33
57224,NHSL1,chr6,R,138422042,138692616,45390464,270574,633948793,30894,16
57226,LYRM2,chr6,R,89632223,89638755,45396996,6532,633955325,30895,3
57231,SNX14,chr6,R,85505495,85594156,45485657,88661,634043986,30896,30
57380,MRS2,chr6,F,24402907,24426194,45508944,23287,634067273,30897,11
57480,PLEKHG1,chr6,F,150599862,150843665,45752747,243803,634311076,30898,21
57492,ARID1B,chr6,F,156777891,157210779,46185635,432888,634743964,30899,25
57497,LRFN2,chr6,R,40391098,40587464,46382001,196366,634940330,30900,10
57505,AARS2,chr6,R,44297825,44313358,46397534,15533,634955863,30901,22
57510,XPO5,chr6,R,43522329,43576075,46451280,53746,635009609,30902,31
57515,SERINC1,chr6,R,122443347,122471807,46479740,28460,635038069,30903,9
57531,HACE1,chr6,R,104682658,104859919,46657001,177261,635215330,30904,29
57579,FAM135A,chr6,F,70413403,70561174,46804772,147771,635363101,30905,24
57583,TMEM181,chr6,F,158536431,158635435,46903776,99004,635462105,30906,19
57621,ZBTB2,chr6,R,151364114,151391700,46931362,27586,635489691,30907,5
57673,BEND3,chr6,R,107065179,107115182,46981365,50003,635539694,30908,7
57691,KIAA1586,chr6,F,57046531,57059326,46994160,12795,635552489,30909,5
57699,CPNE5,chr6,R,36740771,36839444,47092833,98673,635651162,30910,28
57819,LSM2,chr6,R,31797391,31806984,47102426,9593,635660755,30911,4
57827,C6orf47,chr6,R,31658297,31660772,47104901,2475,635663230,30912,0
58496,LY6G5B,chr6,F,31670950,31672450,47106401,1500,635664730,30913,2
58527,ABRACL,chr6,F,139028681,139043302,47121022,14621,635679351,30914,2
58528,RRAGD,chr6,R,89364615,89412276,47168683,47661,635727012,30915,7
58530,LY6G6D,chr6,F,31715355,31717804,47171132,2449,635729461,30916,2
59084,ENPP5,chr6,R,46159181,46171010,47182961,11829,635741290,30917,4
59336,PRDM13,chr6,F,99606773,99615578,47191766,8805,635750095,30918,3
59351,PBOV1,chr6,R,138215985,138218490,47194271,2505,635752600,30919,0
60468,BACH2,chr6,R,89926527,90296908,47564652,370381,636122981,30920,12
60481,ELOVL5,chr6,R,53267397,53349179,47646434,81782,636204763,30921,9
60487,TRMT11,chr6,F,125986429,126039276,47699281,52847,636257610,30922,16
60682,SMAP1,chr6,F,70667770,70862015,47893526,194245,636451855,30923,15
60685,ZFAND3,chr6,F,37819495,38154624,48228655,335129,636786984,30924,6
63027,SLC22A23,chr6,R,3268972,3456587,48416270,187615,636974599,30925,15
63914,LINC01590,chr6,F,87397123,87399741,48418888,2618,636977217,30926,1
63915,BLOC1S5,chr6,R,8013566,8064414,48469736,50848,637028065,30927,5
63933,MCUR1,chr6,R,13786548,13814563,48497751,28015,637056080,30928,8
63940,GPSM3,chr6,R,32190765,32195523,48502509,4758,637060838,30929,7
63943,FKBPL,chr6,R,32128706,32130308,48504111,1602,637062440,30930,1
63971,KIF13A,chr6,R,17759182,17987629,48732558,228447,637290887,30931,46
64065,PERP,chr6,R,138088504,138107523,48751577,19019,637309906,30932,2
64094,SMOC2,chr6,F,168441150,168667994,48978421,226844,637536750,30933,13
64208,POPDC3,chr6,R,105157899,105180009,49000531,22110,637558860,30934,7
64288,ZSCAN31,chr6,R,28312836,28354506,49042201,41670,637600530,30935,11
64577,ALDH8A1,chr6,R,134917389,134950122,49074934,32733,637633263,30936,6
64771,C6orf106,chr6,R,34587279,34696850,49184505,109571,637742834,30937,6
64780,MICAL1,chr6,R,109444061,109465968,49206412,21907,637764741,30938,25
64928,MRPL14,chr6,R,44113634,44127454,49220232,13820,637778561,30939,5
65989,DLK2,chr6,R,43450351,43456632,49226513,6281,637784842,30940,6
79136,LY6G6E,chr6,R,31711975,31714065,49228603,2090,637786932,30941,3
79465,ULBP3,chr6,R,150063263,150069213,49234553,5950,637792882,30942,4
79541,OR2A4,chr6,R,131699643,131701401,49236311,1758,637794640,30943,0
79624,ARMT1,chr6,F,151452257,151470101,49254155,17844,637812484,30944,4
79627,OGFRL1,chr6,F,71288773,71308953,49274335,20180,637832664,30945,8
79632,FAM184A,chr6,R,118959828,119149193,49463700,189365,638022029,30946,18
79683,ZDHHC14,chr6,F,157381524,157678114,49760290,296590,638318619,30947,14
79692,ZNF322,chr6,R,26634382,26659752,49785660,25370,638343989,30948,4
79694,MANEA,chr6,F,95577496,95609452,49817616,31956,638375945,30949,5
79747,ADGB,chr6,F,146598964,146815462,50034114,216498,638592443,30950,41
79865,TREML2,chr6,R,41189748,41201192,50045558,11444,638603887,30951,4
79897,RPP21,chr6,F,30345128,30346858,50047288,1730,638605617,30952,9
79940,LINC00472,chr6,R,71407863,71420745,50060170,12882,638618499,30953,3
79969,ATAT1,chr6,F,30626835,30646823,50080158,19988,638638487,30954,10
79981,FRMD1,chr6,R,168055744,168101514,50125928,45770,638684257,30955,18
79992,AGPAT4-IT1,chr6,R,161160113,161161982,50127797,1869,638686126,30956,0
80069,LINC00574,chr6,F,169790072,169802873,50140598,12801,638698927,30957,2
80078,LOC80078,chr6,R,79307668,79313384,50146314,5716,638704643,30958,2
80129,CCDC170,chr6,F,151494039,151621193,50273468,127154,638831797,30959,11
80177,MYCT1,chr6,F,152697894,152747175,50322749,49281,638881078,30960,5
80317,ZKSCAN3,chr6,F,28349912,28369177,50342014,19265,638900343,30961,7
80328,ULBP2,chr6,F,149941937,149949235,50349312,7298,638907641,30962,4
80329,ULBP1,chr6,F,149964006,149973710,50359016,9704,638917345,30963,4
80345,ZSCAN16,chr6,F,28124555,28130086,50364547,5531,638922876,30964,3
80350,LPAL2,chr6,R,160466554,160511124,50409117,44570,638967446,30965,10
80352,RNF39,chr6,R,30070265,30075851,50414703,5586,638973032,30966,3
80736,SLC44A4,chr6,R,31863191,31879046,50430558,15855,638988887,30967,21
80737,VWA7,chr6,R,31765400,31777331,50442489,11931,639000818,30968,16
80739,C6orf25,chr6,F,31720807,31726710,50448392,5903,639006721,30969,5
80740,LY6G6C,chr6,R,31718647,31721734,50451479,3087,639009808,30970,2
80741,LY6G5C,chr6,R,31676683,31680373,50455169,3690,639013498,30971,2
80742,PRR3,chr6,F,30556708,30564696,50463157,7988,639021486,30972,4
80759,KHDC1,chr6,R,73241313,73310365,50532209,69052,639090538,30973,8
80862,ZNRD1-AS1,chr6,R,30001010,30061184,50592383,60174,639150712,30974,5
80863,PRRT1,chr6,R,32148362,32151943,50595964,3581,639154293,30975,3
80864,EGFL8,chr6,F,32164604,32168285,50599645,3681,639157974,30976,15
80868,HCG4B,chr6,R,29924591,29927215,50602269,2624,639160598,30977,0
81491,GPR63,chr6,R,96794121,96837492,50645640,43371,639203969,30978,8
81567,TXNDC5,chr6,R,7881249,7910814,50675205,29565,639233534,30979,10
81578,COL21A1,chr6,R,56056589,56394122,51012738,337533,639571067,30980,35
81688,C6orf62,chr6,R,24704860,24720836,51028714,15976,639587043,30981,6
81696,OR5V1,chr6,R,29355229,29457067,51130552,101838,639688881,30982,4
81697,OR2B2,chr6,R,27911184,27912396,51131764,1212,639690093,30983,0
81706,PPP1R14C,chr6,F,150143051,150250392,51239105,107341,639797434,30984,4
81797,OR12D3,chr6,R,29373422,29375291,51240974,1869,639799303,30985,0
81833,SPACA1,chr6,F,88047034,88066832,51260772,19798,639819101,30986,7
81847,RNF146,chr6,F,127266339,127288562,51282995,22223,639841324,30987,6
81853,TMEM14B,chr6,F,10747758,10759774,51295011,12016,639853340,30988,6
83443,SF3B5,chr6,R,144094880,144095617,51295748,737,639854077,30989,0
83551,TAAR8,chr6,F,132552692,132553721,51296777,1029,639855106,30990,0
83699,SH3BGRL2,chr6,F,79631282,79703670,51369165,72388,639927494,30991,4
83732,RIOK1,chr6,F,7389418,7418037,51397784,28619,639956113,30992,16
83741,TFAP2D,chr6,F,50713543,50773033,51457274,59490,640015603,30993,7
83795,KCNK16,chr6,R,39314697,39322985,51465562,8288,640023891,30994,7
83861,RSPH3,chr6,R,158976738,159000432,51489256,23694,640047585,30995,7
83887,TTLL2,chr6,F,167325085,167342689,51506860,17604,640065189,30996,2
84062,DTNBP1,chr6,R,15522800,15663058,51647118,140258,640205447,30997,11
84071,ARMC2,chr6,F,108848413,108998506,51797211,150093,640355540,30998,24
84085,FBXO30,chr6,R,145798120,145814786,51813877,16666,640372206,30999,3
84154,RPF2,chr6,F,110982016,111028263,51860124,46247,640418453,31000,9
84300,UQCC2,chr6,R,33696760,33711751,51875115,14991,640433444,31001,3
84456,L3MBTL3,chr6,F,129978803,130141449,52037761,162646,640596090,31002,30
84498,FAM120B,chr6,F,170290702,170407071,52154130,116369,640712459,31003,12
84539,MCHR2,chr6,R,99919909,99994238,52228459,74329,640786788,31004,5
84547,PGBD1,chr6,F,28281536,28302549,52249472,21013,640807801,31005,7
84553,FAXC,chr6,R,99272914,99350122,52326680,77208,640885009,31006,9
84624,FNDC1,chr6,F,159169396,159272108,52429392,102712,640987721,31007,22
84630,TTBK1,chr6,F,43243483,43288259,52474168,44776,641032497,31008,16
84694,GJA10,chr6,F,89894468,89896100,52475800,1632,641034129,31009,0
84816,RTN4IP1,chr6,R,106571027,106630500,52535273,59473,641093602,31010,10
84830,ADTRP,chr6,R,11712894,11779628,52602007,66734,641160336,31011,12
84870,RSPO3,chr6,F,127118902,127199481,52682586,80579,641240915,31012,4
84918,LRP11,chr6,R,149795187,149864348,52751747,69161,641310076,31013,10
84946,LTV1,chr6,F,143843370,143863806,52772183,20436,641330512,31014,10
84947,SERAC1,chr6,R,158109503,158168280,52830960,58777,641389289,31015,18
85015,USP45,chr6,R,99432305,99515777,52914432,83472,641472761,31016,22
85021,REPS1,chr6,R,138904014,138988282,52998700,84268,641557029,31017,20
85235,HIST1H2AH,chr6,F,27147081,27147562,52999181,481,641557510,31018,0
85236,HIST1H2BK,chr6,R,27138292,27146858,53007747,8566,641566076,31019,1
85313,PPIL4,chr6,R,149504494,149546102,53049355,41608,641607684,31020,12
85315,PAQR8,chr6,F,52362127,52407777,53095005,45650,641653334,31021,1
85413,SLC22A16,chr6,R,110424684,110476641,53146962,51957,641705291,31022,10
88745,RRP36,chr6,F,43021635,43029599,53154926,7964,641713255,31023,6
89758,C6orf7,chr6,R,79803581,79878494,53229839,74913,641788168,31024,4
89822,KCNK17,chr6,R,39299000,39314461,53245300,15461,641803629,31025,6
89845,ABCC10,chr6,F,43427545,43451980,53269735,24435,641828064,31026,25
89870,TRIM15,chr6,F,30163205,30172696,53279226,9491,641837555,31027,6
89953,KLC4,chr6,F,43059593,43075099,53294732,15506,641853061,31028,17
90025,UBE3D,chr6,R,82892397,83065841,53468176,173444,642026505,31029,15
90523,MLIP,chr6,F,54010978,54266280,53723478,255302,642281807,31030,20
90632,LINC00473,chr6,R,165924047,165988039,53787470,63992,642345799,31031,2
91749,KIAA1919,chr6,F,111259278,111269060,53797252,9782,642355581,31032,3
93643,TJAP1,chr6,F,43477522,43506556,53826286,29034,642384615,31033,14
93663,ARHGAP18,chr6,R,129576144,129710225,53960367,134081,642518696,31034,15
94017,TRS-TGA2-1,chr6,F,27545688,27545770,53960449,82,642518778,31035,0
94026,POM121L2,chr6,R,27309062,27312232,53963619,3170,642521948,31036,0
94120,SYTL3,chr6,F,158644898,158764876,54083597,119978,642641926,31037,20
94234,FOXQ1,chr6,F,1312439,1314758,54085916,2319,642644245,31038,0
112495,GTF3C6,chr6,F,110958559,110967888,54095245,9329,642653574,31039,5
112609,MRAP2,chr6,F,84024785,84146282,54216742,121497,642775071,31040,11
112611,RWDD2A,chr6,F,83193312,83198932,54222362,5620,642780691,31041,4
112744,IL17F,chr6,R,52236680,52245689,54231371,9009,642789700,31042,3
113115,MTFR2,chr6,R,136231028,136253615,54253958,22587,642812287,31043,8
113402,SFT2D1,chr6,R,166319727,166342606,54276837,22879,642835166,31044,8
114327,EFHC1,chr6,F,52420195,52495785,54352427,75590,642910756,31045,11
114781,BTBD9,chr6,R,38168450,38640547,54824524,472097,643382853,31046,16
114792,KLHL32,chr6,F,96898012,97142614,55069126,244602,643627455,31047,19
114801,TMEM200A,chr6,F,130366280,130443424,55146270,77144,643704599,31048,5
114821,ZBED9,chr6,R,28571337,28616203,55191136,44866,643749465,31049,7
115004,MB21D1,chr6,R,73416257,73452330,55227209,36073,643785538,31050,5
116113,FOXP4,chr6,F,41546425,41602384,55283168,55959,643841497,31051,18
116138,KLHDC3,chr6,F,43014102,43021298,55290364,7196,643848693,31052,10
116150,NUS1,chr6,F,117675453,117710727,55325638,35274,643883967,31053,4
116254,GINM1,chr6,F,149566391,149590931,55350178,24540,643908507,31054,7
116369,SLC26A8,chr6,R,35943513,36024636,55431301,81123,643989630,31055,20
116379,IL22RA2,chr6,R,137143819,137173648,55461130,29829,644019459,31056,6
116511,MAS1L,chr6,R,29486765,29487902,55462267,1137,644020596,31057,0
116843,SLC18B1,chr6,R,132769367,132804931,55497831,35564,644056160,31058,15
117247,SLC16A10,chr6,F,111087502,111223405,55633734,135903,644192063,31059,9
117283,IP6K3,chr6,R,33721636,33746985,55659083,25349,644217412,31060,9
117289,TAGAP,chr6,R,159034467,159045152,55669768,10685,644228097,31061,9
125050,RN7SK,chr6,F,52995619,52995951,55670100,332,644228429,31062,0
129685,TAF8,chr6,F,42050512,42087462,55707050,36950,644265379,31063,10
134637,ADAT2,chr6,R,143422831,143450750,55734969,27919,644293298,31064,10
134701,RIPPLY2,chr6,F,83853265,83857515,55739219,4250,644297548,31065,3
134728,IRAK1BP1,chr6,F,78867084,78936160,55808295,69076,644366624,31066,6
134829,CLVS2,chr6,F,122995970,123072920,55885245,76950,644443574,31067,5
134860,TAAR9,chr6,F,132538287,132539336,55886294,1049,644444623,31068,0
134864,TAAR1,chr6,R,132644983,132646003,55887314,1020,644445643,31069,0
134957,STXBP5,chr6,F,147204357,147390476,56073433,186119,644631762,31070,33
135112,NCOA7,chr6,F,125781130,125932030,56224333,150900,644782662,31071,22
135114,HINT3,chr6,F,125956714,125980244,56247863,23530,644806192,31072,4
135138,PACRG,chr6,F,162727083,163315492,56836272,588409,645394601,31073,26
135152,B3GAT2,chr6,R,70861365,70957189,56932096,95824,645490425,31074,2
135154,SDHAF4,chr6,F,70566921,70588903,56954078,21982,645512407,31075,2
135228,CD109,chr6,F,73672181,73828317,57110214,156136,645668543,31076,35
135250,RAET1E,chr6,R,149864396,149898321,57144139,33925,645702468,31077,8
135293,PM20D2,chr6,F,89096752,89165569,57212956,68817,645771285,31078,12
135295,SRSF12,chr6,R,89095956,89118081,57235081,22125,645793410,31079,6
135398,C6orf141,chr6,F,49550399,49560572,57245254,10173,645803583,31080,3
135458,HUS1B,chr6,R,655938,656964,57246280,1026,645804609,31081,0
135644,TRIM40,chr6,F,30134509,30148773,57260544,14264,645818873,31082,6
135656,DPCR1,chr6,F,30940999,30954221,57273766,13222,645832095,31083,2
140767,NRSN1,chr6,F,24126185,24147529,57295110,21344,645853439,31084,3
153910,LOC153910,chr6,R,142526454,142637889,57406545,111435,645964874,31085,3
153918,ZC2HC1B,chr6,F,143864435,143938346,57480456,73911,646038785,31086,7
154007,SNRNP48,chr6,F,7590198,7611967,57502225,21769,646060554,31087,8
154043,CNKSR3,chr6,R,154405298,154510619,57607546,105321,646165875,31088,13
154064,RAET1L,chr6,R,150018341,150025596,57614801,7255,646173130,31089,4
154075,SAMD3,chr6,R,130133202,130365425,57847024,232223,646405353,31090,16
154089,LINC01312,chr6,F,133821146,133853992,57879870,32846,646438199,31091,2
154091,SLC2A12,chr6,R,133987580,134052668,57944958,65088,646503287,31092,5
154092,LINC01010,chr6,F,134437715,134504020,58011263,66305,646569592,31093,5
154141,MBOAT1,chr6,R,20099683,20212464,58124044,112781,646682373,31094,13
154150,HDGFL1,chr6,F,22569448,22570521,58125117,1073,646683446,31095,0
154197,PNLDC1,chr6,F,159800248,159820704,58145573,20456,646703902,31096,19
154214,RNF217,chr6,F,124962485,125092633,58275721,130148,646834050,31097,19
154215,NKAIN2,chr6,F,123803836,124825640,59297525,1021804,647855854,31098,11
154288,KHDC3L,chr6,F,73362210,73364175,59299490,1965,647857819,31099,3
154313,C6orf165,chr6,F,87407971,87464473,59355992,56502,647914321,31100,12
154386,C6orf195,chr6,R,2622737,2635064,59368319,12327,647926648,31101,2
154442,BVES-AS1,chr6,F,105137686,105169945,59400578,32259,647958907,31102,3
154449,LOC154449,chr6,R,170254333,170262569,59408814,8236,647967143,31103,2
154467,CCDC167,chr6,R,37482919,37499924,59425819,17005,647984148,31104,3
166994,LOC166994,chr6,F,26897222,26900865,59429462,3643,647987791,31105,1
167681,PRSS35,chr6,F,83512474,83525704,59442692,13230,648001021,31106,2
167691,LCA5,chr6,R,79484990,79537430,59495132,52440,648053461,31107,8
167826,OLIG3,chr6,R,137492198,137494394,59497328,2196,648055657,31108,0
167838,TXLNB,chr6,R,139159159,139324011,59662180,164852,648220509,31109,17
168002,DACT2,chr6,R,168292829,168319754,59689105,26925,648247434,31110,8
168090,C6orf118,chr6,R,165279663,165309647,59719089,29984,648277418,31111,12
170679,PSORS1C1,chr6,F,31114830,31140092,59744351,25262,648302680,31112,5
170680,PSORS1C2,chr6,R,31137533,31139350,59746168,1817,648304497,31113,1
170954,PPP1R18,chr6,R,30676388,30687895,59757675,11507,648316004,31114,2
171558,PTCRA,chr6,F,42915806,42925838,59767707,10032,648326036,31115,5
202459,OSTCP1,chr6,R,158841116,158857632,59784223,16516,648342552,31116,2
202500,TCTE1,chr6,R,44280159,44297721,59801785,17562,648360114,31117,6
202559,KHDRBS2,chr6,R,61630483,62286195,60457497,655712,649015826,31118,20
202658,TRIM39-RPP21,chr6,F,30329310,30346858,60475045,17548,649033374,31119,9
203068,TUBB,chr6,F,30720200,30725426,60480271,5226,649038600,31120,4
206412,C6orf163,chr6,F,87343079,87365553,60502745,22474,649061074,31121,5
206426,PIP5K1P1,chr6,F,7986101,7990344,60506988,4243,649065317,31122,0
221262,CCDC162P,chr6,F,109294302,109308220,60520906,13918,649079235,31123,3
221264,AK9,chr6,R,109492854,109691212,60719264,198358,649277593,31124,47
221294,NT5DC1,chr6,F,116100822,116245690,60864132,144868,649422461,31125,12
221301,FAM26D,chr6,F,116528998,116561123,60896257,32125,649454586,31126,6
221302,ZUFSP,chr6,R,116635617,116668810,60929450,33193,649487779,31127,11
221303,FAM162B,chr6,R,116752196,116765723,60942977,13527,649501306,31128,3
221322,TBC1D32,chr6,R,121079493,121334956,61198440,255463,649756769,31129,45
221336,BEND6,chr6,F,56954974,57027652,61271118,72678,649829447,31130,9
221357,GSTA5,chr6,R,52831741,52846095,61285472,14354,649843801,31131,6
221391,OPN5,chr6,F,47780301,47857840,61363011,77539,649921340,31132,18
221393,ADGRF4,chr6,F,47698552,47722021,61386480,23469,649944809,31133,9
221395,ADGRF5,chr6,R,46852504,46954954,61488930,102450,650047259,31134,24
221400,TDRD6,chr6,F,46687874,46704319,61505375,16445,650063704,31135,3
221409,SPATS1,chr6,F,44342659,44377167,61539883,34508,650098212,31136,8
221416,C6orf223,chr6,F,44000596,44005958,61545245,5362,650103574,31137,3
221421,RSPH9,chr6,F,43645029,43671013,61571229,25984,650129558,31138,7
221424,LRRC73,chr6,R,43506964,43510343,61574608,3379,650132937,31139,5
221438,TREML5P,chr6,F,41249376,41249589,61574821,213,650133150,31140,0
221442,ADCY10P1,chr6,F,41101033,41140835,61614623,39802,650172952,31141,22
221443,OARD1,chr6,R,41066791,41072449,61620281,5658,650178610,31142,5
221458,KIF6,chr6,R,39335099,39725472,62010654,390373,650568983,31143,26
221468,TMEM217,chr6,R,37212177,37259005,62057482,46828,650615811,31144,6
221472,FGD2,chr6,F,37005646,37029070,62080906,23424,650639235,31145,17
221476,PI16,chr6,F,36948262,36964837,62097481,16575,650655810,31146,8
221477,C6orf89,chr6,F,36871845,36928964,62154600,57119,650712929,31147,14
221481,ARMC12,chr6,F,35733804,35748913,62169709,15109,650728038,31148,6
221491,C6orf1,chr6,R,34246379,34249108,62172438,2729,650730767,31149,4
221496,LEMD2,chr6,R,33771212,33789163,62190389,17951,650748718,31150,8
221504,ZBTB9,chr6,F,33454578,33457544,62193355,2966,650751684,31151,1
221527,ZBTB12,chr6,R,31899203,31902367,62196519,3164,650754848,31152,2
221545,C6orf136,chr6,F,30647038,30653210,62202691,6172,650761020,31153,5
221584,ZSCAN12P1,chr6,F,28090806,28095715,62207600,4909,650765929,31154,1
221613,HIST1H2AA,chr6,R,25726062,25726562,62208100,500,650766429,31155,0
221656,KDM1B,chr6,F,18155387,18223854,62276567,68467,650834896,31156,21
221662,RBM24,chr6,F,17281491,17293875,62288951,12384,650847280,31157,6
221687,RNF182,chr6,F,13924445,13980009,62344515,55564,650902844,31158,5
221692,PHACTR1,chr6,F,12716605,13290244,62918154,573639,651476483,31159,19
221710,SMIM13,chr6,F,11094032,11138738,62962860,44706,651521189,31160,1
221711,SYCP2L,chr6,F,10886830,10974309,63050339,87479,651608668,31161,29
221718,LINC00518,chr6,R,10427784,10434822,63057377,7038,651615706,31162,2
221749,PXDC1,chr6,R,3722601,3752012,63086788,29411,651645117,31163,7
221756,SERPINB9P1,chr6,R,2854656,2876510,63108642,21854,651666971,31164,1
222537,HS3ST5,chr6,R,114055585,114342433,63395490,286848,651953819,31165,7
222545,GPRC6A,chr6,R,116792084,116829057,63432463,36973,651990792,31166,5
222546,RFX6,chr6,F,116877212,116932163,63487414,54951,652045743,31167,18
222553,SLC35F1,chr6,F,117907230,118317676,63897860,410446,652456189,31168,7
222584,FAM83B,chr6,F,54846642,54945099,63996317,98457,652554646,31169,7
222611,ADGRF2,chr6,F,47656589,47697797,64037525,41208,652595854,31170,10
222642,TSPO2,chr6,F,41041369,41044337,64040493,2968,652598822,31171,4
222643,UNC5CL,chr6,R,41026900,41039199,64052792,12299,652611121,31172,8
222658,KCTD20,chr6,F,36442766,36491143,64101169,48377,652659498,31173,10
222659,PXT1,chr6,R,36390550,36442889,64153508,52339,652711837,31174,4
222662,LHFPL5,chr6,F,35797419,35824075,64180164,26656,652738493,31175,4
222663,SCUBE3,chr6,F,35214046,35253079,64219197,39033,652777526,31176,24
222696,ZSCAN23,chr6,R,28425530,28443974,64237641,18444,652795970,31177,8
222698,NKAPL,chr6,F,28259296,28260958,64239303,1662,652797632,31178,0
222699,TOB2P1,chr6,R,28215337,28218929,64242895,3592,652801224,31179,0
222826,FAM217A,chr6,R,4068351,4087344,64261888,18993,652820217,31180,8
245806,VGLL2,chr6,F,117265557,117273565,64269896,8008,652828225,31181,3
245913,DEFB110,chr6,R,50009137,50021981,64282740,12844,652841069,31182,2
245915,DEFB112,chr6,R,50043574,50048651,64287817,5077,652846146,31183,1
245927,DEFB113,chr6,R,49968676,49969625,64288766,949,652847095,31184,1
245928,DEFB114,chr6,R,49960291,49964105,64292580,3814,652850909,31185,1
246269,LACE1,chr6,F,108294893,108525548,64523235,230655,653081564,31186,18
253018,HCG27,chr6,F,31197759,31203968,64529444,6209,653087773,31187,1
253582,TMEM244,chr6,R,129831243,129861503,64559704,30260,653118033,31188,5
253714,MMS22L,chr6,R,97142160,97283437,64700981,141277,653259310,31189,31
253769,WDR27,chr6,R,169426406,169702063,64976638,275657,653534967,31190,42
254228,FAM26E,chr6,F,116511644,116518546,64983540,6902,653541869,31191,1
254394,MCM9,chr6,R,118813448,118935162,65105254,121714,653663583,31192,12
255488,RNF144B,chr6,F,18277514,18468874,65296614,191360,653854943,31193,8
255626,HIST1H2BA,chr6,F,25726908,25727345,65297051,437,653855380,31194,0
256380,SCML4,chr6,R,107697296,107848659,65448414,151363,654006743,31195,15
257202,GPX6,chr6,R,28503295,28515793,65460912,12498,654019241,31196,4
257218,SHPRH,chr6,R,145862720,145964285,65562477,101565,654120806,31197,35
259197,NCR3,chr6,R,31588882,31593019,65566614,4137,654124943,31198,4
259215,LY6G6F,chr6,F,31706906,31710595,65570303,3689,654128632,31199,5
266553,OFCC1,chr6,R,9702022,9842630,65710911,140608,654269240,31200,9
266727,MDGA1,chr6,R,37632507,37697990,65776394,65483,654334723,31201,18
266977,ADGRF1,chr6,R,46997702,47042363,65821055,44661,654379384,31202,16
282890,ZNF311,chr6,R,28994784,29005628,65831899,10844,654390228,31203,5
285735,LINC00326,chr6,F,133088079,133106578,65850398,18499,654408727,31204,3
285740,LOC285740,chr6,R,143554114,143569339,65865623,15225,654423952,31205,4
285753,CEP57L1,chr6,F,109095152,109163912,65934383,68760,654492712,31206,16
285755,PPIL6,chr6,R,109390214,109441171,65985340,50957,654543669,31207,12
285758,LINC01268,chr6,R,113868012,113873347,65990675,5335,654549004,31208,2
285759,FLJ34503,chr6,F,113904386,113921642,66007931,17256,654566260,31209,3
285761,DCBLD1,chr6,F,117453818,117569858,66123971,116040,654682300,31210,20
285762,LOC285762,chr6,R,119452546,119491302,66162727,38756,654721056,31211,5
285766,LOC285766,chr6,R,181465,205484,66186746,24019,654745075,31212,7
285768,LOC285768,chr6,R,961002,1101332,66327076,140330,654885405,31213,4
285780,LY86-AS1,chr6,R,6346464,6622826,66603438,276362,655161767,31214,7
285782,CAGE1,chr6,R,7326653,7389709,66666494,63056,655224823,31215,14
285796,PACRG-AS1,chr6,R,163309984,163324473,66680983,14489,655239312,31216,5
285800,PRR18,chr6,R,166305679,166308383,66683687,2704,655242016,31217,0
285804,LOC285804,chr6,R,170266668,170276762,66693781,10094,655252110,31218,2
285819,LOC285819,chr6,R,26471943,26482509,66704347,10566,655262676,31219,3
285830,HLA-F-AS1,chr6,R,29726600,29749049,66726796,22449,655285125,31220,5
285834,HCG22,chr6,F,31053449,31059890,66733237,6441,655291566,31221,3
285847,LOC285847,chr6,R,35726761,35736947,66743423,10186,655301752,31222,9
285848,PNPLA1,chr6,F,36239765,36313955,66817613,74190,655375942,31223,12
285852,TREML4,chr6,F,41228323,41238382,66827672,10059,655386001,31224,5
285855,RPL7L1,chr6,F,42879916,42889889,66837645,9973,655395974,31225,6
285857,LOC285857,chr6,R,43845749,43852341,66844237,6592,655402566,31226,6
319100,TAAR6,chr6,F,132570321,132571359,66845275,1038,655403604,31227,0
340146,SLC35D3,chr6,F,136922240,136925660,66848695,3420,655407024,31228,1
340152,ZC3H12D,chr6,R,149447629,149485012,66886078,37383,655444407,31229,5
340156,MYLK4,chr6,R,2663628,2770123,66992573,106495,655550902,31230,17
340168,DPPA5,chr6,R,73353061,73354276,66993788,1215,655552117,31231,2
340184,LOC340184,chr6,F,11690059,11723500,67027229,33441,655585558,31232,3
340198,IFITM4P,chr6,R,29750806,29751148,67027571,342,655585900,31233,0
340204,CLPSL1,chr6,F,35781053,35788064,67034582,7011,655592911,31234,2
340205,TREML1,chr6,R,41149259,41154349,67039672,5090,655598001,31235,5
340206,TREML3P,chr6,R,41208553,41217947,67049066,9394,655607395,31236,4
345895,RSPH4A,chr6,F,116593899,116633051,67088218,39152,655646547,31237,8
345930,ECT2L,chr6,F,138796050,138904070,67196238,108020,655754567,31238,24
346007,EYS,chr6,R,63719979,65707225,69183484,1987246,657741813,31239,45
346157,ZNF391,chr6,F,27374937,27403908,69212455,28971,657770784,31240,5
346171,ZFP57,chr6,R,29672391,29681146,69221210,8755,657779539,31241,4
347733,TUBB2B,chr6,R,3224260,3231665,69228615,7405,657786944,31242,4
347734,SLC35B2,chr6,R,44254100,44257890,69232405,3790,657790734,31243,5
347744,C6orf52,chr6,R,10671417,10694797,69255785,23380,657814114,31244,6
348995,NUP43,chr6,R,149724314,149746572,69278043,22258,657836372,31245,9
352961,HCG26,chr6,F,31471228,31472408,69279223,1180,657837552,31246,0
352999,C6orf58,chr6,F,127577173,127591818,69293868,14645,657852197,31247,5
353091,RAET1G,chr6,R,149916877,149923152,69300143,6275,657858472,31248,4
353219,KAAG1,chr6,F,24356902,24358284,69301525,1382,657859854,31249,0
375513,GUSBP4,chr6,R,57919880,57961446,69343091,41566,657901420,31250,9
375519,GJB7,chr6,R,87282977,87329278,69389392,46301,657947721,31251,3
378884,NHLRC1,chr6,R,18120486,18122620,69391526,2134,657949855,31252,0
387032,ZKSCAN4,chr6,R,28241704,28259271,69409093,17567,657967422,31253,7
387036,GUSBP2,chr6,R,26871486,26956554,69494161,85068,658052490,31254,8
387065,HMGA1P7,chr6,R,134113961,134117680,69497880,3719,658056209,31255,1
387066,SNHG5,chr6,R,85677006,85678733,69499607,1727,658057936,31256,5
387082,SUMO4,chr6,F,149400358,149401046,69500295,688,658058624,31257,0
387103,CENPW,chr6,F,126339788,126483320,69643827,143532,658202156,31258,4
387104,SOGA3,chr6,R,127438405,127519355,69724777,80950,658283106,31259,11
387111,LINC00222,chr6,F,108751653,108769942,69743066,18289,658301395,31260,4
387119,CEP85L,chr6,R,118460771,118710082,69992377,249311,658550706,31261,19
387263,C6orf120,chr6,F,169702160,169706306,69996523,4146,658554852,31262,0
387316,VN1R10P,chr6,F,27324760,27325963,69997726,1203,658556055,31263,0
387319,HIST1H2APS1,chr6,F,25732432,25732861,69998155,429,658556484,31264,0
387357,THEMIS,chr6,R,127708193,127918631,70208593,210438,658766922,31265,9
389362,PSMG4,chr6,F,3254448,3303019,70257164,48571,658815493,31266,5
389376,SFTA2,chr6,R,30931349,30932175,70257990,826,658816319,31267,2
389383,CLPSL2,chr6,F,35776593,35779552,70260949,2959,658819278,31268,3
389384,C6orf222,chr6,R,36315756,36336977,70282170,21221,658840499,31269,12
389396,GLYATL3,chr6,F,49499957,49528064,70310277,28107,658868606,31270,5
389400,GFRAL,chr6,F,55327468,55402493,70385302,75025,658943631,31271,8
389421,LIN28B,chr6,F,104936998,105083332,70531636,146334,659089965,31272,6
389432,SAMD5,chr6,F,147508647,147737541,70760530,228894,659318859,31273,3
389434,IYD,chr6,F,150368860,150404629,70796299,35769,659354628,31274,6
394263,MUC21,chr6,F,30983707,30988637,70801229,4930,659359558,31275,2
401232,LINC01011,chr6,F,2987966,2991171,70804434,3205,659362763,31276,1
401233,HTATSF1P2,chr6,R,3020155,3024771,70809050,4616,659367379,31277,0
401236,STMND1,chr6,F,17102257,17131372,70838165,29115,659396494,31278,4
401237,CASC15,chr6,F,21666443,22194400,71366122,527957,659924451,31279,11
401242,LOC401242,chr6,R,28859624,28863677,71370175,4053,659928504,31280,1
401247,LINC00243,chr6,R,30812865,30830659,71387969,17794,659946298,31281,1
401250,MCCD1,chr6,F,31528961,31530231,71389239,1270,659947568,31282,1
401251,SAPCD1,chr6,F,31762995,31764850,71391094,1855,659949423,31283,4
401253,LINC00336,chr6,R,33586105,33593338,71398327,7233,659956656,31284,1
401258,RAB44,chr6,F,36697826,36733183,71433684,35357,659992013,31285,15
401260,LINC00951,chr6,R,40344344,40356006,71445346,11662,660003675,31286,2
401261,LOC401261,chr6,F,42782926,42785561,71447981,2635,660006310,31287,0
401262,CRIP3,chr6,R,43299740,43309614,71457855,9874,660016184,31288,10
401264,TRAM2-AS1,chr6,F,52577201,52583993,71464647,6792,660022976,31289,2
401265,KLHL31,chr6,R,53647900,53665846,71482593,17946,660040922,31290,2
401281,LOC401281,chr6,R,159588438,159589980,71484135,1542,660042464,31291,0
401282,DKFZp451B082,chr6,R,163338341,163347033,71492827,8692,660051156,31292,3
401285,TCP10L2,chr6,F,167170592,167193779,71516014,23187,660074343,31293,13
401286,LOC401286,chr6,R,167666839,167679223,71528398,12384,660086727,31294,2
401287,LOC401287,chr6,R,169433368,169453720,71548750,20352,660107079,31295,3
401288,LINC00242,chr6,R,169788789,169798825,71558786,10036,660117115,31296,1
401289,FLJ38122,chr6,F,170272473,170279469,71565782,6996,660124111,31297,1
403339,DEFB133,chr6,R,49946100,49949444,71569126,3344,660127455,31298,1
404220,C6orf201,chr6,F,4079205,4130766,71620687,51561,660179016,31299,8
404672,GTF2H5,chr6,F,158168346,158199344,71651685,30998,660210014,31300,2
405754,ERVFRD-1,chr6,R,11102488,11111838,71661035,9350,660219364,31301,1
406989,MIR206,chr6,F,52144348,52144434,71661121,86,660219450,31302,0
407002,MIR219A1,chr6,F,33207834,33207944,71661231,110,660219560,31303,0
407029,MIR30A,chr6,R,71403550,71403621,71661302,71,660219631,31304,0
407032,MIR30C2,chr6,R,71376959,71377031,71661374,72,660219703,31305,0
414760,HCG14,chr6,F,28896529,28897320,71662165,791,660220494,31306,1
414764,HCG23,chr6,F,32390509,32393691,71665347,3182,660223676,31307,2
414765,HCG25,chr6,F,33249535,33254890,71670702,5355,660229031,31308,4
414766,HCG16,chr6,F,28984948,29008251,71694005,23303,660252334,31309,8
414768,HCG24,chr6,F,33143387,33147298,71697916,3911,660256245,31310,2
414777,HCG18,chr6,R,30287396,30327156,71737676,39760,660296005,31311,3
414778,HCG17,chr6,R,30234038,30326134,71829772,92096,660388101,31312,4
441123,LINC00266-3,chr6,R,140263,148159,71837668,7896,660395997,31313,2
441150,C6orf226,chr6,R,42890264,42890816,71838220,552,660396549,31314,0
441151,TMEM151B,chr6,F,44270742,44279445,71846923,8703,660405252,31315,2
441155,LOC441155,chr6,F,65301417,65305613,71851119,4196,660409448,31316,2
441161,OOEP,chr6,R,73368554,73369792,71852357,1238,660410686,31317,2
441168,FAM26F,chr6,F,116461369,116463782,71854770,2413,660413099,31318,2
441172,FLJ46906,chr6,F,138691667,138697288,71860391,5621,660418720,31319,3
441177,LINC00602,chr6,F,165987550,165989615,71862456,2065,660420785,31320,0
441178,LOC441178,chr6,R,167679625,167683787,71866618,4162,660424947,31321,3
441179,LOC441179,chr6,F,167795028,167796598,71868188,1570,660426517,31322,1
442184,OR2B3,chr6,R,29086207,29087313,71869294,1106,660427623,31323,0
442186,OR2J3,chr6,F,29111809,29112884,71870369,1075,660428698,31324,0
442191,OR14J1,chr6,F,29306689,29307655,71871335,966,660429664,31325,0
442194,OR10C1,chr6,F,29439938,29440977,71872374,1039,660430703,31326,0
442211,ATP6V0CP3,chr6,F,42727575,42728194,71872993,619,660431322,31327,0
442213,PTCHD4,chr6,R,47877420,48111132,72106705,233712,660665034,31328,9
442229,SLC25A51P1,chr6,F,65787878,65789483,72108310,1605,660666639,31329,0
442245,GSTM2P1,chr6,R,111046418,111047554,72109446,1136,660667775,31330,0
442247,RFPL4B,chr6,F,112347329,112351296,72113413,3967,660671742,31331,2
442890,MIR133B,chr6,F,52148922,52149041,72113532,119,660671861,31332,0
449520,GGNBP1,chr6,F,33583698,33589026,72118860,5328,660677189,31333,5
493812,HCG11,chr6,F,26521705,26527393,72124548,5688,660682877,31334,0
497048,KU-MEL-3,chr6,F,4610564,4611919,72125903,1355,660684232,31335,1
554223,LOC554223,chr6,F,29791905,29797807,72131805,5902,660690134,31336,2
594837,SNORD101,chr6,F,132815306,132815379,72131878,73,660690207,31337,0
594838,SNORD100,chr6,F,132816801,132816877,72131954,76,660690283,31338,0
594839,SNORA33,chr6,F,132817218,132817351,72132087,133,660690416,31339,0
619208,FAM229B,chr6,F,112087470,112102790,72147407,15320,660705736,31340,3
643327,LOC643327,chr6,F,3458702,3469212,72157917,10510,660716246,31341,2
643432,TSG1,chr6,F,93707082,93776481,72227316,69399,660785645,31342,9
643623,LOC643623,chr6,F,125674352,125720218,72273182,45866,660831511,31343,3
643749,TRAF3IP2-AS1,chr6,F,111483471,111602295,72392006,118824,660950335,31344,6
643854,CTAGE9,chr6,R,131708440,131711017,72394583,2577,660952912,31345,0
643962,LOC643962,chr6,R,86728141,86937522,72603964,209381,661162293,31346,6
644135,LOC644135,chr6,R,136012647,136117169,72708486,104522,661266815,31347,16
645434,LOC645434,chr6,R,139468994,139474596,72714088,5602,661272417,31348,3
645958,RPS18P9,chr6,F,149593615,149594602,72715075,987,661273404,31349,0
645967,LOC645967,chr6,F,149717606,149718896,72716365,1290,661274694,31350,0
646024,RAET1K,chr6,R,149998018,150005144,72723491,7126,661281820,31351,3
647024,C6orf132,chr6,R,42101118,42142977,72765350,41859,661323679,31352,4
647190,RPS16P5,chr6,R,53334459,53337617,72768508,3158,661326837,31353,0
648791,PPP1R3G,chr6,F,5085485,5087221,72770244,1736,661328573,31354,0
651302,ZNF192P1,chr6,F,28161760,28169595,72778079,7835,661336408,31355,4
653483,MLLT4-AS1,chr6,R,167823889,167826796,72780986,2907,661339315,31356,1
677806,SNORA20,chr6,R,159780249,159780381,72781118,132,661339447,31357,0
677812,SNORA29,chr6,R,159785593,159785733,72781258,140,661339587,31358,0
677820,SNORA38,chr6,F,31623078,31623210,72781390,132,661339719,31359,0
692088,SNORD50B,chr6,R,85677588,85677659,72781461,71,661339790,31360,0
692092,SNORD32B,chr6,F,29582251,29582328,72781538,77,661339867,31361,0
692199,SNORD84,chr6,R,31541100,31541178,72781616,78,661339945,31362,0
692233,SNORD117,chr6,R,31536373,31536449,72781692,76,661340021,31363,0
693125,MIR548A1,chr6,F,18571783,18571880,72781789,97,661340118,31364,0
693126,MIR548A2,chr6,F,135239159,135239256,72781886,97,661340215,31365,0
693128,MIR548B,chr6,R,119069046,119069143,72781983,97,661340312,31366,0
693171,MIR586,chr6,R,45197673,45197770,72782080,97,661340409,31367,0
693172,MIR587,chr6,F,106784124,106784220,72782176,96,661340505,31368,0
693173,MIR588,chr6,F,126484630,126484713,72782259,83,661340588,31369,0
727925,LOC727925,chr6,R,68720716,68761467,72823010,40751,661381339,31370,3
728012,MCHR2-AS1,chr6,F,99994037,100076419,72905392,82382,661463721,31371,2
728402,TPI1P3,chr6,F,116038730,116039944,72906606,1214,661464935,31372,0
728464,METTL24,chr6,R,110245945,110358272,73018933,112327,661577262,31373,4
728655,HULC,chr6,F,8652208,8653846,73020571,1638,661578900,31374,1
729176,KATNBL1P6,chr6,R,146801668,146803824,73022727,2156,661581056,31375,0
729177,NBAT1,chr6,R,22134601,22147193,73035319,12592,661593648,31376,2
729178,STXBP5-AS1,chr6,R,146841387,147204614,73398546,363227,661956875,31377,10
729515,TMEM242,chr6,R,157289021,157324259,73433784,35238,661992113,31378,3
729583,LINC01556,chr6,F,28943783,28944538,73434539,755,661992868,31379,0
729603,LOC729603,chr6,F,160093081,160096212,73437670,3131,661995999,31380,0
729658,LOC729658,chr6,R,163181644,163192002,73448028,10358,662006357,31381,3
730101,LOC730101,chr6,F,52664400,52669153,73452781,4753,662011110,31382,1
730152,GSTA7P,chr6,R,52739462,52745159,73458478,5697,662016807,31383,0
732253,TDRG1,chr6,F,40378423,40379892,73459947,1469,662018276,31384,1
790951,TRS-AGA3-1,chr6,F,27532207,27532289,73460029,82,662018358,31385,0
791230,TRV-AAC1-5,chr6,R,27753399,27753472,73460102,73,662018431,31386,0
791231,TRV-AAC3-1,chr6,R,27650927,27651000,73460175,73,662018504,31387,0
100113403,LINC00577,chr6,R,104936293,104940527,73464409,4234,662022738,31388,2
100113407,TMEM170B,chr6,F,11538195,11583524,73509738,45329,662068067,31389,2
100124533,SCARNA27,chr6,R,8086407,8086533,73509864,126,662068193,31390,0
100126314,MIR877,chr6,F,30584331,30584417,73509950,86,662068279,31391,0
100126476,TRNAL-CAA,chr6,R,28896222,28896328,73510056,106,662068385,31392,1
100126481,TRNAI-AAU,chr6,F,26780621,26780695,73510130,74,662068459,31393,0
100126484,TRNAM-CAU,chr6,F,26766233,26766306,73510203,73,662068532,31394,0
100126584,LOC100126584,chr6,R,125154597,125197863,73553469,43266,662111798,31395,3
100128124,HGC6.3,chr6,R,167975923,167976939,73554485,1016,662112814,31396,0
100128176,LOC100128176,chr6,R,148954258,148964684,73564911,10426,662123240,31397,2
100128327,TRAPPC3L,chr6,R,116496482,116545610,73614039,49128,662172368,31398,5
100129128,KHDC1L,chr6,R,73223543,73225452,73615948,1909,662174277,31399,2
100129195,ZSCAN16-AS1,chr6,R,28121794,28137316,73631470,15522,662189799,31400,2
100129461,LOC100129461,chr6,F,5003815,5240496,73868151,236681,662426480,31401,5
100129518,LOC100129518,chr6,R,159760257,159762332,73870226,2075,662428555,31402,1
100129636,LOC100129636,chr6,F,29036020,29076740,73910946,40720,662469275,31403,3
100130275,TFAP2A-AS1,chr6,F,10412317,10416169,73914798,3852,662473127,31404,2
100130357,LOC100130357,chr6,R,13279294,13297297,73932801,18003,662491130,31405,5
100130476,LOC100130476,chr6,R,137823668,137868233,73977366,44565,662535695,31406,3
100130889,PSORS1C3,chr6,R,31173734,31177899,73981531,4165,662539860,31407,2
100130890,TSTD3,chr6,F,99520826,99579288,74039993,58462,662598322,31408,6
100130967,C6orf99,chr6,F,158869854,158918005,74088144,48151,662646473,31409,5
100131047,LOC100131047,chr6,R,38906494,38953107,74134757,46613,662693086,31410,4
100131289,LOC100131289,chr6,F,27761743,27763187,74136201,1444,662694530,31411,2
100131532,LOC100131532,chr6,F,169962622,169967678,74141257,5056,662699586,31412,2
100131814,LINC00271,chr6,F,135497800,135690838,74334295,193038,662892624,31413,3
100132354,LINC01512,chr6,F,43891027,43938207,74381475,47180,662939804,31414,1
100132735,LOC100132735,chr6,F,139771072,139860471,74470874,89399,663029203,31415,2
100133205,LINC00240,chr6,F,26956992,27023974,74537856,66982,663096185,31416,2
100133941,CD24,chr6,R,106969830,106976855,74544881,7025,663103210,31417,5
100188893,TOMM6,chr6,F,41787442,41789896,74547335,2454,663105664,31418,2
100188987,TRH-GTG1-8,chr6,F,27158126,27158198,74547407,72,663105736,31419,0
100189002,TRS-GCT2-1,chr6,F,27297995,27298077,74547489,82,663105818,31420,0
100189012,TRR-TCT5-1,chr6,F,27562183,27562270,74547576,87,663105905,31421,1
100189014,TRV-AAC5-1,chr6,F,27235508,27235581,74547649,73,663105978,31422,0
100189024,TRE-CTC1-6,chr6,F,28982198,28982270,74547721,72,663106050,31423,0
100189028,TRI-TAT2-2,chr6,F,27020345,27020439,74547815,94,663106144,31424,1
100189033,TRA-CGC4-1,chr6,F,28729314,28729386,74547887,72,663106216,31425,0
100189034,TRR-TCG5-1,chr6,R,28543113,28543186,74547960,73,663106289,31426,0
100189035,TRT-CGT1-1,chr6,R,28488992,28489066,74548034,74,663106363,31427,0
100189038,TRL-CAA3-1,chr6,R,27602568,27602675,74548141,107,663106470,31428,1
100189040,TRX-CAT1-5,chr6,R,26330300,26330372,74548213,72,663106542,31429,0
100189041,TRS-CGA2-1,chr6,F,27209848,27209930,74548295,82,663106624,31430,0
100189042,TRA-AGC6-1,chr6,R,28812071,28812143,74548367,72,663106696,31431,0
100189046,TRA-AGC4-1,chr6,R,28658236,28658308,74548439,72,663106768,31432,0
100189047,TRA-AGC5-1,chr6,F,28710588,28710660,74548511,72,663106840,31433,0
100189048,TRW-CCA3-3,chr6,R,26331443,26331515,74548583,72,663106912,31434,0
100189053,TRK-TTT4-1,chr6,R,27591813,27591886,74548656,73,663106985,31435,0
100189066,TRA-TGC5-1,chr6,R,28817234,28817306,74548728,72,663107057,31436,0
100189067,TRL-TAA4-1,chr6,R,27230554,27230637,74548811,83,663107140,31437,0
100189070,TRS-AGA4-1,chr6,R,27553412,27553494,74548893,82,663107222,31438,0
100189071,TRI-AAT2-1,chr6,F,27688187,27688261,74548967,74,663107296,31439,0
100189074,TRQ-TTG3-3,chr6,R,27795860,27795932,74549039,72,663107368,31440,0
100189077,TRS-AGA2-3,chr6,F,27478811,27478893,74549121,82,663107450,31441,0
100189082,TRA-TGC6-1,chr6,R,28758363,28758435,74549193,72,663107522,31442,0
100189084,TRR-CCG1-3,chr6,F,28881387,28881460,74549266,73,663107595,31443,0
100189085,TRM-CAT7-1,chr6,R,57842213,57842286,74549339,73,663107668,31444,0
100189092,TRA-AGC7-1,chr6,F,28719703,28719775,74549411,72,663107740,31445,0
100189093,TRA-AGC2-1,chr6,R,28838443,28838515,74549483,72,663107812,31446,0
100189094,TRX-CAT1-4,chr6,R,26313123,26313195,74549555,72,663107884,31447,0
100189095,TRI-AAT8-1,chr6,F,27668582,27668656,74549629,74,663107958,31448,0
100189099,TRR-ACG2-3,chr6,F,27215172,27215245,74549702,73,663108031,31449,0
100189101,TRV-CAC7-1,chr6,R,27728547,27728620,74549775,73,663108104,31450,0
100189110,TRK-CTT2-5,chr6,F,26556545,26556618,74549848,73,663108177,31451,0
100189111,TRM-CAT3-2,chr6,R,28953264,28953337,74549921,73,663108250,31452,0
100189114,TRA-TGC2-1,chr6,F,28643444,28643516,74549993,72,663108322,31453,0
100189118,TRL-AAG4-1,chr6,R,28478622,28478704,74550075,82,663108404,31454,0
100189121,TRQ-CTG1-5,chr6,R,28941600,28941672,74550147,72,663108476,31455,0
100189131,TRI-TAT2-3,chr6,F,27631420,27631514,74550241,94,663108570,31456,1
100189137,TRF-GAA1-5,chr6,R,28790721,28790794,74550314,73,663108643,31457,0
100189138,TRQ-TTG2-1,chr6,F,28589378,28589450,74550386,72,663108715,31458,0
100189143,TRT-AGT6-1,chr6,F,27162270,27162344,74550460,74,663108789,31459,0
100189145,TRF-GAA5-1,chr6,F,28764386,28764459,74550533,73,663108862,31460,0
100189149,TRA-TGC1-1,chr6,R,28789769,28789841,74550605,72,663108934,31461,0
100189153,TRI-AAT5-3,chr6,F,26554121,26554195,74550679,74,663109008,31462,0
100189157,TRS-GCT1-1,chr6,F,27097305,27097387,74550761,82,663109090,31463,0
100189158,TRD-GTC2-10,chr6,F,27479673,27479745,74550833,72,663109162,31464,0
100189159,TRS-GCT5-1,chr6,F,28213036,28213118,74550915,82,663109244,31465,0
100189161,TRV-AAC4-1,chr6,R,27681105,27681178,74550988,73,663109317,31466,0
100189162,TRY-GTA3-1,chr6,F,26577103,26577192,74551077,89,663109406,31467,1
100189164,TRL-TAA2-1,chr6,R,27721118,27721201,74551160,83,663109489,31468,0
100189167,TRR-ACG2-2,chr6,R,27213843,27213916,74551233,73,663109562,31469,0
100189169,TRL-AAG3-1,chr6,F,28989001,28989083,74551315,82,663109644,31470,0
100189170,TRF-GAA3-1,chr6,R,28807832,28807905,74551388,73,663109717,31471,0
100189172,TRP-CGG2-1,chr6,F,27091741,27091813,74551460,72,663109789,31472,0
100189178,TRV-AAC6-1,chr6,R,28735428,28735500,74551532,72,663109861,31473,0
100189182,TRK-TTT6-1,chr6,R,27334989,27335062,74551605,73,663109934,31474,0
100189185,TRQ-TTG3-2,chr6,R,26311746,26311818,74551677,72,663110006,31475,0
100189189,TRQ-CTG1-4,chr6,F,27519528,27519600,74551749,72,663110078,31476,0
100189196,TRV-CAC9-1,chr6,F,27150242,27150315,74551822,73,663110151,31477,0
100189200,TRD-GTC3-1,chr6,R,27583456,27583528,74551894,72,663110223,31478,0
100189202,TRL-AAG2-4,chr6,R,28943621,28943703,74551976,82,663110305,31479,0
100189205,TRS-CGA3-1,chr6,R,27672449,27672531,74552058,82,663110387,31480,0
100189213,TRI-AAT3-1,chr6,R,27275210,27275284,74552132,74,663110461,31481,0
100189214,TRQ-CTG6-1,chr6,R,27791355,27791427,74552204,72,663110533,31482,0
100189216,TRM-CAT3-1,chr6,F,28944574,28944647,74552277,73,663110606,31483,0
100189218,TRS-GCT6-1,chr6,R,26305489,26305573,74552361,84,663110690,31484,0
100189219,TRY-GTA6-1,chr6,F,26594873,26594962,74552450,89,663110779,31485,1
100189223,TRP-AGG2-7,chr6,F,26555269,26555341,74552522,72,663110851,31486,0
100189225,TRS-GCT4-3,chr6,R,28597339,28597421,74552604,82,663110933,31487,0
100189227,TRV-CAC1-6,chr6,F,26538053,26538126,74552677,73,663111006,31488,0
100189234,TRK-TTT3-5,chr6,F,28951028,28951101,74552750,73,663111079,31489,0
100189237,TRL-CAA1-2,chr6,F,28941052,28941157,74552855,105,663111184,31490,1
100189247,TRS-AGA2-5,chr6,F,27503038,27503120,74552937,82,663111266,31491,0
100189249,TRI-AAT1-1,chr6,F,57800210,57800284,74553011,74,663111340,31492,0
100189254,TRF-GAA1-6,chr6,R,28981671,28981744,74553084,73,663111413,31493,0
100189268,TRQ-CTG2-1,chr6,R,27547751,27547823,74553156,72,663111485,31494,0
100189269,TRE-CTC1-7,chr6,R,125780246,125780318,74553228,72,663111557,31495,0
100189272,TRY-GTA1-1,chr6,F,26568857,26568948,74553319,91,663111648,31496,1
100189287,TRQ-CTG1-3,chr6,F,18836170,18836242,74553391,72,663111720,31497,0
100189288,TRL-CAG1-7,chr6,F,26521207,26521290,74553474,83,663111803,31498,0
100189292,TRD-GTC2-11,chr6,F,27503743,27503815,74553546,72,663111875,31499,0
100189293,TRF-GAA4-1,chr6,R,28823315,28823389,74553620,74,663111949,31500,0
100189295,TRA-AGC2-2,chr6,R,28863684,28863756,74553692,72,663112021,31501,0
100189297,TRX-CAT1-7,chr6,R,27592820,27592892,74553764,72,663112093,31502,0
100189299,TRA-AGC3-1,chr6,F,28607155,28607227,74553836,72,663112165,31503,0
100189300,TRT-CGT5-1,chr6,F,27618355,27618429,74553910,74,663112239,31504,0
100189301,TRL-CAA2-1,chr6,R,27605637,27605745,74554018,108,663112347,31505,1
100189303,TRM-CAT5-1,chr6,F,26701482,26701555,74554091,73,663112420,31506,0
100189303,TRM-CAT5-1,chr6,R,26800112,26800185,74554164,73,663112493,31507,0
100189308,TRA-CGC1-1,chr6,F,26553502,26553574,74554236,72,663112565,31508,0
100189310,TRI-AAT5-5,chr6,R,27237570,27237644,74554310,74,663112639,31509,0
100189313,TRL-TAA1-1,chr6,F,144216546,144216629,74554393,83,663112722,31510,0
100189314,TRG-GCC2-6,chr6,R,27902907,27902978,74554464,71,663112793,31511,0
100189315,TRX-CAT1-8,chr6,R,27902492,27902564,74554536,72,663112865,31512,0
100189319,TRT-AGT2-1,chr6,R,26532916,26532990,74554610,74,663112939,31513,0
100189321,TRQ-TTG3-1,chr6,R,26311195,26311267,74554682,72,663113011,31514,0
100189329,TRQ-CTG5-1,chr6,F,27295432,27295504,74554754,72,663113083,31515,0
100189332,TRK-TTT7-1,chr6,F,28747743,28747816,74554827,73,663113156,31516,0
100189336,TRI-AAT5-4,chr6,R,27177214,27177288,74554901,74,663113230,31517,0
100189337,TRY-GTA8-1,chr6,F,26575569,26575659,74554991,90,663113320,31518,1
100189340,TRT-AGT2-2,chr6,R,27684694,27684768,74555065,74,663113394,31519,0
100189344,TRT-TGT1-1,chr6,R,28474551,28474625,74555139,74,663113468,31520,0
100189345,TRX-CAT1-6,chr6,R,27332984,27333056,74555211,72,663113540,31521,0
100189346,TRA-AGC1-1,chr6,R,28795963,28796035,74555283,72,663113612,31522,0
100189348,TRI-TAT3-1,chr6,F,28537589,28537683,74555377,94,663113706,31523,1
100189352,TRS-AGA1-1,chr6,R,27541774,27541856,74555459,82,663113788,31524,0
100189354,TRM-CAT4-2,chr6,F,26743262,26743335,74555532,73,663113861,31525,0
100189360,TRT-CGT3-1,chr6,R,28648206,28648280,74555606,74,663113935,31526,0
100189363,TRV-CAC2-1,chr6,R,27280269,27280342,74555679,73,663114008,31527,0
100189365,TRR-CCG1-2,chr6,R,28742951,28743024,74555752,73,663114081,31528,0
100189368,TRV-CAC6-1,chr6,R,27206087,27206160,74555825,73,663114154,31529,0
100189372,TRI-AAT6-1,chr6,F,26756551,26756625,74555899,74,663114228,31530,0
100189374,TRT-AGT5-1,chr6,F,27726693,27726767,74555973,74,663114302,31531,0
100189382,TRS-AGA2-2,chr6,F,26327588,26327670,74556055,82,663114384,31532,0
100189390,TRK-TTT9-1,chr6,F,27576066,27576139,74556128,73,663114457,31533,0
100189391,TRM-CAT4-3,chr6,R,26735369,26735442,74556201,73,663114530,31534,0
100189395,TRA-CGC5-1,chr6,R,28695931,28696003,74556273,72,663114602,31535,0
100189396,TRR-ACG1-2,chr6,F,26328139,26328212,74556346,73,663114675,31536,0
100189400,TRA-CGC2-1,chr6,R,28673835,28673907,74556418,72,663114747,31537,0
100189401,TRI-AAT7-2,chr6,F,57822972,57823046,74556492,74,663114821,31538,0
100189401,TRI-AAT7-2,chr6,R,26720991,26721065,74556566,74,663114895,31539,0
100189408,TRV-TAC4-1,chr6,F,27290625,27290698,74556639,73,663114968,31540,0
100189410,TRR-TCG2-1,chr6,F,26322817,26322890,74556712,73,663115041,31541,0
100189422,TRQ-TTG4-1,chr6,F,145182722,145182794,74556784,72,663115113,31542,0
100189428,TRR-ACG2-4,chr6,R,27670564,27670637,74556857,73,663115186,31543,0
100189430,TRS-TGA3-1,chr6,R,26312595,26312677,74556939,82,663115268,31544,0
100189433,TRT-AGT3-1,chr6,F,28726017,28726091,74557013,74,663115342,31545,0
100189436,TRW-CCA3-2,chr6,R,26319101,26319173,74557085,72,663115414,31546,0
100270746,LOC100270746,chr6,R,27019365,27020306,74558026,941,663116355,31547,0
100271873,AIRN,chr6,R,160003290,160007664,74562400,4374,663120729,31548,0
100287329,LOC100287329,chr6,R,31548401,31572698,74586697,24297,663145026,31549,2
100287632,LOC100287632,chr6,F,118782707,118783420,74587410,713,663145739,31550,0
100287718,ANKRD66,chr6,F,46746916,46759218,74599712,12302,663158041,31551,4
100288198,HMGN3-AS1,chr6,F,79233673,79236800,74602839,3127,663161168,31552,1
100289495,LOC100289495,chr6,F,166342630,166351469,74611678,8839,663170007,31553,1
100294145,LOC100294145,chr6,F,32894175,32903758,74621261,9583,663179590,31554,1
100294720,NHEG1,chr6,R,136982158,136993231,74632334,11073,663190663,31555,2
100302123,MIR1275,chr6,R,33999971,34000051,74632414,80,663190743,31556,0
100302141,MIR1913,chr6,R,166509353,166509433,74632494,80,663190823,31557,0
100302164,MIR2113,chr6,F,98024530,98024621,74632585,91,663190914,31558,0
100302242,MIR1236,chr6,R,31956838,31956940,74632687,102,663191016,31559,0
100302259,MIR1202,chr6,F,155946796,155946879,74632770,83,663191099,31560,0
100422737,LOC100422737,chr6,R,106717451,106787425,74702744,69974,663261073,31561,6
100422821,MIR1273C,chr6,F,154853359,154853436,74702821,77,663261150,31562,0
100422884,MIR548U,chr6,F,57390131,57390212,74702902,81,663261231,31563,0
100422934,MIR3143,chr6,F,27147625,27147688,74702965,63,663261294,31564,0
100422951,MIR3144,chr6,F,120015178,120015257,74703044,79,663261373,31565,0
100423001,MIR3145,chr6,R,138435212,138435294,74703126,82,663261455,31566,0
100423005,MIR4282,chr6,R,72967686,72967753,74703193,67,663261522,31567,0
100463487,MTRNR2L9,chr6,F,61574102,61574629,74703720,527,663262049,31568,0
100500851,MIR3918,chr6,R,158764660,158764753,74703813,93,663262142,31569,0
100500857,MIR3939,chr6,R,166997806,166997912,74703919,106,663262248,31570,0
100500873,MIR3934,chr6,F,33698127,33698234,74704026,107,663262355,31571,0
100500879,MIR3668,chr6,F,140205251,140205326,74704101,75,663262430,31572,0
100500880,MIR3662,chr6,R,134979337,134979432,74704196,95,663262525,31573,0
100500885,MIR3925,chr6,R,36622435,36622512,74704273,77,663262602,31574,0
100500899,MIR3692,chr6,F,157529131,157529200,74704342,69,663262671,31575,0
100500900,MIR3691,chr6,R,5148232,5148322,74704432,90,663262761,31576,0
100505475,SYNE1-AS1,chr6,F,152380529,152381713,74705616,1184,663263945,31577,1
100505530,LOC100505530,chr6,F,37507347,37536280,74734549,28933,663292878,31578,3
100505635,LOC100505635,chr6,R,39888789,39897380,74743140,8591,663301469,31579,3
100505711,LOC100505711,chr6,R,41381391,41383128,74744877,1737,663303206,31580,2
100505879,KIF25-AS1,chr6,R,167994186,167997077,74747768,2891,663306097,31581,3
100505985,LOC100505985,chr6,F,50093433,50099283,74753618,5850,663311947,31582,1
100506188,LOC100506188,chr6,R,57260523,57263346,74756441,2823,663314770,31583,2
100506207,LOC100506207,chr6,F,8435622,8785445,75106264,349823,663664593,31584,5
100506409,ELOVL2-AS1,chr6,F,11043757,11079144,75141651,35387,663699980,31585,5
100506681,JARID2-AS1,chr6,R,15247814,15248696,75142533,882,663700862,31586,1
100506804,LOC100506804,chr6,F,75285013,75291864,75149384,6851,663707713,31587,2
100506851,LOC100506851,chr6,F,79419878,79421659,75151165,1781,663709494,31588,2
100506885,LOC100506885,chr6,R,19803705,19804793,75152253,1088,663710582,31589,2
100507173,LINC01012,chr6,F,27694034,27710222,75168441,16188,663726770,31590,3
100507194,LOC100507194,chr6,R,3182816,3195767,75181392,12951,663739721,31591,2
100507203,SMLR1,chr6,F,130827404,130837135,75191123,9731,663749452,31592,1
100507254,LINC01013,chr6,F,132133977,132169374,75226520,35397,663784849,31593,2
100507308,TARID,chr6,R,133502251,133889006,75613275,386755,664171604,31594,8
100507336,LOC100507336,chr6,R,3588983,3720074,75744366,131091,664302695,31595,6
100507362,LINC01015,chr6,F,29529405,29533568,75748529,4163,664306858,31596,2
100507381,KCNQ5-IT1,chr6,F,72630494,72678558,75796593,48064,664354922,31597,3
100507399,HCG8,chr6,R,30012100,30013922,75798415,1822,664356744,31598,0
100507406,LOC100507406,chr6,R,137730169,137739037,75807283,8868,664365612,31599,2
100507436,MICA,chr6,F,31399783,31415315,75822815,15532,664381144,31600,6
100507462,LOC100507462,chr6,R,138725210,138773679,75871284,48469,664429613,31601,3
100507463,PSMB8-AS1,chr6,F,32844085,32846500,75873699,2415,664432028,31602,2
100507477,LOC100507477,chr6,F,139976318,140093721,75991102,117403,664549431,31603,3
100507489,LINC01277,chr6,R,142966420,143037582,76062264,71162,664620593,31604,2
100507506,LOC100507506,chr6,F,4136071,4157385,76083578,21314,664641907,31605,3
100507547,LOC100507547,chr6,R,32152801,32154365,76085142,1564,664643471,31606,2
100507557,LOC100507557,chr6,F,145734868,145886585,76236859,151717,664795188,31607,4
100507584,LINC01016,chr6,R,33889510,33896907,76244256,7397,664802585,31608,2
100507679,MUC22,chr6,F,31005951,31035570,76273875,29619,664832204,31609,4
100508120,GMDS-AS1,chr6,F,2245752,2413591,76441714,167839,665000043,31610,6
100526820,CAHM,chr6,R,163413064,163413950,76442600,886,665000929,31611,0
100526836,BLOC1S5-TXNDC5,chr6,R,7881249,8064414,76625765,183165,665184094,31612,5
100526837,EEF1E1-BLOC1S5,chr6,R,8013566,8102595,76714794,89029,665273123,31613,4
100529239,RPS10-NUDT3,chr6,R,34287193,34426125,76853726,138932,665412055,31614,8
100532732,MSH5-SAPCD1,chr6,F,31739947,31764850,76878629,24903,665436958,31615,4
100532737,ATP6V1G2-DDX39B,chr6,R,31530218,31546848,76895259,16630,665453588,31616,2
100532746,PPT2-EGFL8,chr6,F,32153998,32168285,76909546,14287,665467875,31617,15
100616109,MIR4464,chr6,F,90312741,90312833,76909638,92,665467967,31618,0
100616124,MIR4647,chr6,R,44254205,44254285,76909718,80,665468047,31619,0
100616154,MIR4466,chr6,R,156779677,156779731,76909772,54,665468101,31620,0
100616174,MIR4643,chr6,F,91521659,91521737,76909850,78,665468179,31621,0
100616178,MIR4641,chr6,F,41598722,41598788,76909916,66,665468245,31622,0
100616180,MIR4465,chr6,F,140683813,140683883,76909986,70,665468315,31623,0
100616191,MIR548AJ1,chr6,R,132115191,132115263,76910058,72,665468387,31624,0
100616218,MIR3135B,chr6,R,32749911,32749979,76910126,68,665468455,31625,0
100616230,MIR4646,chr6,R,31701028,31701091,76910189,63,665468518,31626,0
100616237,MIR4640,chr6,F,30890882,30890972,76910279,90,665468608,31627,0
100616269,MIR4639,chr6,F,16141555,16141624,76910348,69,665468677,31628,0
100616285,MIR4645,chr6,R,2854030,2854107,76910425,77,665468754,31629,0
100616347,MIR548AI,chr6,F,99124608,99124696,76910513,88,665468842,31630,0
100616352,MIR4642,chr6,F,44435640,44435722,76910595,82,665468924,31631,0
100616389,MIR4463,chr6,F,75428406,75428473,76910662,67,665468991,31632,0
100616413,MIR4462,chr6,R,37555364,37555422,76910720,58,665469049,31633,0
100616430,MIR4644,chr6,F,170330760,170330844,76910804,84,665469133,31634,0
100616455,MIR548H5,chr6,F,131792171,131792231,76910864,60,665469193,31635,0
100652739,RAET1E-AS1,chr6,F,149863497,149919508,76966875,56011,665525204,31636,3
100846998,MIR5689,chr6,F,10439716,10439794,76966953,78,665525282,31637,0
100847012,MIR5004,chr6,F,33438330,33438437,76967060,107,665525389,31638,0
100847034,MIR5683,chr6,F,6169333,6169409,76967136,76,665525465,31639,0
100847048,MIR5690,chr6,R,35664716,35664789,76967209,73,665525538,31640,0
100847075,MIR5685,chr6,F,53276992,53277071,76967288,79,665525617,31641,0
100861523,RPS6KA2-AS1,chr6,F,166903697,166905069,76968660,1372,665526989,31642,1
100873997,KCNQ5-AS1,chr6,R,73134802,73143514,76977372,8712,665535701,31643,4
100874282,MLIP-IT1,chr6,F,53998889,54007152,76985635,8263,665543964,31644,3
100874300,SYNJ2-IT1,chr6,F,158001106,158002383,76986912,1277,665545241,31645,2
100874353,RPS6KA2-IT1,chr6,R,166460662,166465383,76991633,4721,665549962,31646,3
100874531,LINC00581,chr6,R,21486060,21511892,77017465,25832,665575794,31647,3
100996634,LOC100996634,chr6,F,109217300,109285010,77085175,67710,665643504,31648,17
101060264,FOXP4-AS1,chr6,R,41523894,41548621,77109902,24727,665668231,31649,3
101154753,PANDAR,chr6,R,36673620,36675126,77111408,1506,665669737,31650,0
101409257,EZR-AS1,chr6,F,158817978,158822239,77115669,4261,665673998,31651,2
101926898,LOC101926898,chr6,F,46492051,46533486,77157104,41435,665715433,31652,2
101926915,LOC101926915,chr6,F,46276323,46365508,77246289,89185,665804618,31653,3
101926934,LOC101926934,chr6,R,46670443,46687833,77263679,17390,665822008,31654,1
101926962,LOC101926962,chr6,F,46903470,46910029,77270238,6559,665828567,31655,3
101927020,LOC101927020,chr6,F,49811539,49820503,77279202,8964,665837531,31656,3
101927048,LOC101927048,chr6,R,49815492,49824766,77288476,9274,665846805,31657,4
101927082,LOC101927082,chr6,F,51621869,51622577,77289184,708,665847513,31658,1
101927136,LOC101927136,chr6,R,53561288,53573275,77301171,11987,665859500,31659,3
101927171,LINC01564,chr6,F,53628379,53631394,77304186,3015,665862515,31660,2
101927189,LOC101927189,chr6,F,53929981,53997667,77371872,67686,665930201,31661,3
101927211,LOC101927211,chr6,R,57114910,57172213,77429175,57303,665987504,31662,3
101927268,LOC101927268,chr6,R,57855890,57867101,77440386,11211,665998715,31663,3
101927288,MANEA-AS1,chr6,R,95560095,95577451,77457742,17356,666016071,31664,2
101927293,LOC101927293,chr6,F,57961547,58096528,77592723,134981,666151052,31665,9
101927314,LOC101927314,chr6,F,97305585,97708917,77996055,403332,666554384,31666,4
101927335,LOC101927335,chr6,F,97816604,98398963,78578414,582359,667136743,31667,10
101927353,LOC101927353,chr6,F,906469,915491,78587436,9022,667145765,31668,5
101927365,LOC101927365,chr6,F,99424870,99431315,78593881,6445,667152210,31669,2
101927388,LOC101927388,chr6,R,101452674,101454295,78595502,1621,667153831,31670,1
101927405,LOC101927405,chr6,R,106491102,106502188,78606588,11086,667164917,31671,3
101927538,LOC101927538,chr6,R,109334198,109351724,78624114,17526,667182443,31672,4
101927640,LOC101927640,chr6,F,112236595,112306683,78694202,70088,667252531,31673,2
101927664,LOC101927664,chr6,R,112376287,112396404,78714319,20117,667272648,31674,4
101927686,LOC101927686,chr6,R,113623534,113650075,78740860,26541,667299189,31675,2
101927691,LOC101927691,chr6,F,868497,876613,78748976,8116,667307305,31676,2
101927703,FOXCUT,chr6,F,1605530,1607358,78750804,1828,667309133,31677,1
101927730,LOC101927730,chr6,F,2883987,2900676,78767493,16689,667325822,31678,4
101927759,LOC101927759,chr6,F,3025693,3027434,78769234,1741,667327563,31679,1
101927768,LOC101927768,chr6,F,113969700,114340729,79140263,371029,667698592,31680,9
101927818,LOC101927818,chr6,F,116033675,116055894,79162482,22219,667720811,31681,3
101927888,LOC101927888,chr6,R,4343046,4347168,79166604,4122,667724933,31682,2
101927913,LOC101927913,chr6,R,4774525,4775548,79167627,1023,667725956,31683,1
101927919,LOC101927919,chr6,R,117672812,117675284,79170099,2472,667728428,31684,2
101927950,LOC101927950,chr6,R,5664984,5695272,79200387,30288,667758716,31685,3
101927972,LOC101927972,chr6,R,5452467,5458075,79205995,5608,667764324,31686,2
101927990,LOC101927990,chr6,F,123439603,123471756,79238148,32153,667796477,31687,2
101928004,LOC101928004,chr6,R,6694798,6799335,79342685,104537,667901014,31688,9
101928047,LOC101928047,chr6,F,6710978,6730254,79361961,19276,667920290,31689,5
101928076,LOC101928076,chr6,R,7540113,7543038,79364886,2925,667923215,31690,2
101928096,LOC101928096,chr6,F,126128941,126200587,79436532,71646,667994861,31691,5
101928106,LOC101928106,chr6,R,10465977,10481946,79452501,15969,668010830,31692,5
101928140,LOC101928140,chr6,F,128027864,128086293,79510930,58429,668069259,31693,4
101928146,LOC101928146,chr6,R,10508662,10521255,79523523,12593,668081852,31694,2
101928191,LOC101928191,chr6,R,10932316,10954089,79545296,21773,668103625,31695,2
101928231,LOC101928231,chr6,R,134429029,134478897,79595164,49868,668153493,31696,4
101928249,LOC101928249,chr6,R,134498113,134524516,79621567,26403,668179896,31697,9
101928253,LOC101928253,chr6,R,11990342,12001244,79632469,10902,668190798,31698,2
101928277,LOC101928277,chr6,R,134673917,134904643,79863195,230726,668421524,31699,5
101928280,LOC101928280,chr6,R,68226969,68329899,79966125,102930,668524454,31700,3
101928304,LOC101928304,chr6,R,134525317,134540005,79980813,14688,668539142,31701,3
101928307,LOC101928307,chr6,R,68632662,68634324,79982475,1662,668540804,31702,1
101928309,LOC101928309,chr6,R,12582767,12585590,79985298,2823,668543627,31703,1
101928326,LOC101928326,chr6,R,135807144,135808473,79986627,1329,668544956,31704,1
101928331,LOC101928331,chr6,F,14431939,14516086,80070774,84147,668629103,31705,5
101928353,LOC101928353,chr6,F,70394201,70399417,80075990,5216,668634319,31706,3
101928354,LOC101928354,chr6,R,14597512,14717497,80195975,119985,668754304,31707,6
101928373,LOC101928373,chr6,R,135853866,135922229,80264338,68363,668822667,31708,7
101928394,LOC101928394,chr6,F,71059579,71162147,80366906,102568,668925235,31709,2
101928406,LOC101928406,chr6,F,15994943,16000491,80372454,5548,668930783,31710,1
101928429,LOC101928429,chr6,F,136784115,136786025,80374364,1910,668932693,31711,1
101928433,LOC101928433,chr6,F,16760057,16764994,80379301,4937,668937630,31712,2
101928461,LOC101928461,chr6,F,136629113,136648198,80398386,19085,668956715,31713,2
101928463,LOC101928463,chr6,R,17092942,17107584,80413028,14642,668971357,31714,2
101928489,LOC101928489,chr6,R,73693902,73696131,80415257,2229,668973586,31715,1
101928491,LOC101928491,chr6,R,17501359,17511265,80425163,9906,668983492,31716,3
101928516,LOC101928516,chr6,F,74069450,74690727,81046440,621277,669604769,31717,3
101928519,LOC101928519,chr6,R,19068542,19180480,81158378,111938,669716707,31718,10
101928540,LOC101928540,chr6,F,75383185,75458900,81234093,75715,669792422,31719,8
101928570,LOC101928570,chr6,R,77112750,77316924,81438267,204174,669996596,31720,8
101928573,LOC101928573,chr6,F,20265725,20307258,81479800,41533,670038129,31721,2
101928601,MEI4,chr6,F,77650232,77927045,81756613,276813,670314942,31722,6
101928603,C6orf229,chr6,R,24797320,24798896,81758189,1576,670316518,31723,1
101928661,LOC101928661,chr6,R,146594515,146598931,81762605,4416,670320934,31724,2
101928663,LOC101928663,chr6,R,25244915,25261407,81779097,16492,670337426,31725,3
101928742,LOC101928742,chr6,R,81491438,81513904,81801563,22466,670359892,31726,2
101928743,LOC101928743,chr6,R,26324697,26332124,81808990,7427,670367319,31727,2
101928770,LINC01526,chr6,R,81813285,81814192,81809897,907,670368226,31728,1
101928820,LOC101928820,chr6,R,85387218,85390364,81813043,3146,670371372,31729,1
101928842,LOC101928842,chr6,F,85941209,85998671,81870505,57462,670428834,31730,10
101928868,LOC101928868,chr6,F,154510096,154522300,81882709,12204,670441038,31731,1
101928870,LOC101928870,chr6,F,87152458,87155589,81885840,3131,670444169,31732,2
101928911,LOC101928911,chr6,F,87784859,87911731,82012712,126872,670571041,31733,4
101928923,LOC101928923,chr6,R,155808724,156373758,82577746,565034,671136075,31734,8
101928936,LOC101928936,chr6,R,88525923,88539369,82591192,13446,671149521,31735,2
101928946,LOC101928946,chr6,R,157309726,157313979,82595445,4253,671153774,31736,6
101929004,LOC101929004,chr6,R,89131480,89147723,82611688,16243,671170017,31737,4
101929006,LOC101929006,chr6,F,29223884,29290440,82678244,66556,671236573,31738,3
101929057,LOC101929057,chr6,F,89638531,89689481,82729194,50950,671287523,31739,3
101929072,LOC101929072,chr6,R,31394290,31398485,82733389,4195,671291718,31740,1
101929083,CASC6,chr6,R,91629039,91690428,82794778,61389,671353107,31741,3
101929122,LOC101929122,chr6,R,159165898,159170007,82798887,4109,671357216,31742,3
101929142,LOC101929142,chr6,F,159463279,159468861,82804469,5582,671362798,31743,3
101929163,LOC101929163,chr6,F,32255716,32407822,82956575,152106,671514904,31744,6
101929188,LOC101929188,chr6,R,33631243,33633706,82959038,2463,671517367,31745,1
101929239,LOC101929239,chr6,R,163042979,163054161,82970220,11182,671528549,31746,3
101929243,LOC101929243,chr6,F,34696898,34697471,82970793,573,671529122,31747,1
101929285,LOC101929285,chr6,R,35224648,35259398,83005543,34750,671563872,31748,8
101929297,LOC101929297,chr6,F,166236968,166256947,83025522,19979,671583851,31749,4
101929309,LOC101929309,chr6,F,35543392,35593621,83075751,50229,671634080,31750,3
101929420,LOC101929420,chr6,F,168242937,168262578,83095392,19641,671653721,31751,4
101929425,LOC101929425,chr6,F,38475147,38500230,83120475,25083,671678804,31752,5
101929460,LOC101929460,chr6,R,169034170,169035643,83121948,1473,671680277,31753,1
101929484,LOC101929484,chr6,R,169157118,169163523,83128353,6405,671686682,31754,2
101929504,LOC101929504,chr6,R,169175303,169182740,83135790,7437,671694119,31755,2
101929523,LOC101929523,chr6,F,169213211,169239565,83162144,26354,671720473,31756,2
101929535,LOC101929535,chr6,R,40712820,40715369,83164693,2549,671723022,31757,2
101929555,LOC101929555,chr6,R,40878885,41023280,83309088,144395,671867417,31758,5
101929614,LOC101929614,chr6,F,170147067,170152997,83315018,5930,671873347,31759,2
101929670,LOC101929670,chr6,F,170395610,170400256,83319664,4646,671877993,31760,1
101929692,LOC101929692,chr6,F,170712351,170736419,83343732,24068,671902061,31761,5
101929705,LOC101929705,chr6,R,43995722,44074652,83422662,78930,671980991,31762,5
101929716,ARMC2-AS1,chr6,R,108908139,108924103,83438626,15964,671996955,31763,2
101929726,LOC101929726,chr6,F,44192364,44218236,83464498,25872,672022827,31764,5
101929770,LOC101929770,chr6,F,44728009,44829669,83566158,101660,672124487,31765,3
101930010,LOC101930010,chr6,F,56843985,56864338,83586511,20353,672144840,31766,3
102060414,C2-AS1,chr6,R,31934473,31941724,83593762,7251,672152091,31767,2
102216342,LINC01108,chr6,R,14280126,14285454,83599090,5328,672157419,31768,2
102465500,MIR6833,chr6,F,32179815,32179876,83599151,61,672157480,31769,0
102465501,MIR6834,chr6,F,33290244,33290325,83599232,81,672157561,31770,0
102465502,MIR6835,chr6,F,34240672,34240736,83599296,64,672157625,31771,0
102465537,MIR6891,chr6,R,31355223,31355316,83599389,93,672157718,31772,0
102465668,MIR7111,chr6,F,35470507,35470579,83599461,72,672157790,31773,0
102465694,MIR7161,chr6,F,158609706,158609790,83599545,84,672157874,31774,0
102466190,MIR6721,chr6,R,32170029,32170116,83599632,87,672157961,31775,0
102466720,MIR6720,chr6,R,1390313,1390411,83599730,98,672158059,31776,0
102466745,MIR6832,chr6,F,31633786,31633858,83599802,72,672158131,31777,0
102466746,MIR6780B,chr6,F,43434541,43434620,83599881,79,672158210,31778,0
102466754,MIR6873,chr6,R,33287226,33287289,83599944,63,672158273,31779,0
102466816,MIR7159,chr6,F,33899134,33899200,83600010,66,672158339,31780,0
102466866,MIR7853,chr6,R,6169303,6169435,83600142,132,672158471,31781,0
102723311,LOC102723311,chr6,R,30007303,30010299,83603138,2996,672161467,31782,4
102723341,LOC102723341,chr6,R,125370210,125445210,83678138,75000,672236467,31783,6
102723346,LOC102723346,chr6,R,30952445,30955720,83681413,3275,672239742,31784,2
102723409,LOC102723409,chr6,R,129502708,129552937,83731642,50229,672289971,31785,9
102723445,LOC102723445,chr6,R,131084991,131129831,83776482,44840,672334811,31786,2
102723463,LOC102723463,chr6,F,134398706,134406650,83784426,7944,672342755,31787,2
102723521,LOC102723521,chr6,F,34273201,34282446,83793671,9245,672352000,31788,2
102723633,LOC102723633,chr6,F,137415100,137463779,83842350,48679,672400679,31789,10
102723648,LOC102723648,chr6,R,36146707,36196427,83892070,49720,672450399,31790,8
102723649,LOC102723649,chr6,F,137665645,137674554,83900979,8909,672459308,31791,3
102723690,LOC102723690,chr6,F,139250257,139302539,83953261,52282,672511590,31792,5
102723724,LOC102723724,chr6,R,140845957,140898412,84005716,52455,672564045,31793,2
102723736,LOC102723736,chr6,F,37546154,37550856,84010418,4702,672568747,31794,2
102723789,LOC102723789,chr6,F,39934568,39954301,84030151,19733,672588480,31795,3
102723831,LOC102723831,chr6,R,151196672,151228457,84061936,31785,672620265,31796,2
102723883,LOC102723883,chr6,F,68055350,68060502,84067088,5152,672625417,31797,1
102723922,LOC102723922,chr6,R,266183,292170,84093075,25987,672651404,31798,5
102723944,LOC102723944,chr6,R,1453285,1555226,84195016,101941,672753345,31799,9
102724000,LOC102724000,chr6,F,71421026,71458872,84232862,37846,672791191,31800,7
102724053,LOC102724053,chr6,F,159383530,159396443,84245775,12913,672804104,31801,2
102724087,LOC102724087,chr6,F,160926321,160981614,84301068,55293,672859397,31802,9
102724096,LOC102724096,chr6,R,4186319,4190029,84304778,3710,672863107,31803,2
102724109,LOC102724109,chr6,F,79421983,79489077,84371872,67094,672930201,31804,4
102724152,LOC102724152,chr6,R,163664365,163671533,84379040,7168,672937369,31805,1
102724168,LOC102724168,chr6,R,81843774,82085889,84621155,242115,673179484,31806,10
102724169,LOC102724169,chr6,R,166331775,166341191,84630571,9416,673188900,31807,1
102724201,LOC102724201,chr6,F,84689457,84709534,84650648,20077,673208977,31808,2
102724205,LOC102724205,chr6,F,167183454,167196978,84664172,13524,673222501,31809,4
102724220,LOC102724220,chr6,R,167237517,167241938,84668593,4421,673226922,31810,1
102724234,LOC102724234,chr6,F,7426846,7452752,84694499,25906,673252828,31811,5
102724327,LOC102724327,chr6,F,52201490,52208240,84701249,6750,673259578,31812,2
102724357,LOC102724357,chr6,F,169067785,169069416,84702880,1631,673261209,31813,1
102724379,LOC102724379,chr6,R,11862807,11868586,84708659,5779,673266988,31814,2
102724406,LOC102724406,chr6,F,100393886,100445425,84760198,51539,673318527,31815,3
102724422,LOC102724422,chr6,F,100881407,101167758,85046549,286351,673604878,31816,7
102724443,LOC102724443,chr6,R,104336526,104359776,85069799,23250,673628128,31817,2
102724463,LOC102724463,chr6,F,14661123,14665219,85073895,4096,673632224,31818,2
102724475,LOC102724475,chr6,R,169973374,170023239,85123760,49865,673682089,31819,3
102724490,LOC102724490,chr6,F,15525590,15531616,85129786,6026,673688115,31820,1
102724511,LOC102724511,chr6,F,170160641,170163027,85132172,2386,673690501,31821,2
102724520,LOC102724520,chr6,R,15665457,15758240,85224955,92783,673783284,31822,8
102724586,LOC102724586,chr6,F,110335269,110353143,85242829,17874,673801158,31823,4
102724591,LOC102724591,chr6,R,17585355,17600271,85257745,14916,673816074,31824,9
102724646,LOC102724646,chr6,F,111872731,111877015,85262029,4284,673820358,31825,2
102724654,LOC102724654,chr6,R,21852637,21855921,85265313,3284,673823642,31826,3
102724665,LOC102724665,chr6,R,92644472,92644805,85265646,333,673823975,31827,0
102724736,LOC102724736,chr6,F,22662394,22674065,85277317,11671,673835646,31828,4
102724749,LOC102724749,chr6,F,23337574,23405413,85345156,67839,673903485,31829,16
102724765,LOC102724765,chr6,R,25014970,25036418,85366604,21448,673924933,31830,2
102724851,LOC102724851,chr6,F,26670972,26687841,85383473,16869,673941802,31831,6
102724889,LOC102724889,chr6,R,28078789,28081174,85385858,2385,673944187,31832,1
102724896,LOC102724896,chr6,F,118027413,118045914,85404359,18501,673962688,31833,2
102725019,LOC102725019,chr6,F,32718015,32718827,85405171,812,673963500,31834,1
102725048,LOC102725048,chr6,F,167241621,167247465,85411015,5844,673969344,31835,2
102725068,LOC102725068,chr6,R,31479917,31494794,85425892,14877,673984221,31836,1
102725160,LOC102725160,chr6,R,46096308,46129866,85459450,33558,674017779,31837,4
103106903,LINC01276,chr6,F,41502443,41519852,85476859,17409,674035188,31838,2
103352541,LOC103352541,chr6,R,139978349,139991261,85489771,12912,674048100,31839,2
104355145,NCOA7-AS1,chr6,R,125797860,125818858,85510769,20998,674069098,31840,2
104413891,SAPCD1-AS1,chr6,R,31764134,31765588,85512223,1454,674070552,31841,1
104533120,TRIM31-AS1,chr6,F,30105239,30114724,85521708,9485,674080037,31842,3
105369145,LOC105369145,chr6,R,9845517,10159438,85835629,313921,674393958,31843,10
105369170,LOC105369170,chr6,R,142898657,142926820,85863792,28163,674422121,31844,3
105369171,LOC105369171,chr6,R,162367241,162422268,85918819,55027,674477148,31845,3
105369172,LOC105369172,chr6,R,165906084,165987133,85999868,81049,674558197,31846,2
105369204,LOC105369204,chr6,R,71251238,71328267,86076897,77029,674635226,31847,6
105369208,LOC105369208,chr6,R,68627864,68631657,86080690,3793,674639019,31848,2
105374869,LOC105374869,chr6,F,182308,187745,86086127,5437,674644456,31849,1
105374870,LOC105374870,chr6,F,230929,237089,86092287,6160,674650616,31850,2
105374871,LOC105374871,chr6,F,329768,335021,86097540,5253,674655869,31851,1
105374872,LOC105374872,chr6,F,356607,363395,86104328,6788,674662657,31852,1
105374873,LOC105374873,chr6,R,729073,758947,86134202,29874,674692531,31853,3
105374874,LOC105374874,chr6,F,597630,602734,86139306,5104,674697635,31854,1
105374875,LOC105374875,chr6,F,451011,486528,86174823,35517,674733152,31855,1
105374876,LOC105374876,chr6,R,775544,780628,86179907,5084,674738236,31856,2
105374877,LOC105374877,chr6,R,1026055,1029557,86183409,3502,674741738,31857,2
105374878,LOC105374878,chr6,F,1169642,1172029,86185796,2387,674744125,31858,2
105374879,LOC105374879,chr6,R,1284930,1305966,86206832,21036,674765161,31859,3
105374880,LOC105374880,chr6,R,1383791,1389470,86212511,5679,674770840,31860,1
105374881,LOC105374881,chr6,R,1321235,1335651,86226927,14416,674785256,31861,4
105374882,LOC105374882,chr6,F,1529122,1544090,86241895,14968,674800224,31862,3
105374883,LOC105374883,chr6,F,1489488,1492524,86244931,3036,674803260,31863,3
105374884,LOC105374884,chr6,F,1855238,1858263,86247956,3025,674806285,31864,2
105374885,LOC105374885,chr6,F,2629266,2642796,86261486,13530,674819815,31865,5
105374886,LOC105374886,chr6,R,2790731,2805235,86275990,14504,674834319,31866,2
105374887,LOC105374887,chr6,F,2940397,2941406,86276999,1009,674835328,31867,1
105374888,LOC105374888,chr6,R,2989722,2999292,86286569,9570,674844898,31868,1
105374889,LOC105374889,chr6,F,3157675,3158702,86287596,1027,674845925,31869,1
105374890,LOC105374890,chr6,F,3410718,3417979,86294857,7261,674853186,31870,2
105374891,LOC105374891,chr6,F,3309249,3313646,86299254,4397,674857583,31871,1
105374892,LOC105374892,chr6,R,3662820,3665982,86302416,3162,674860745,31872,2
105374893,LOC105374893,chr6,R,3893035,3895552,86304933,2517,674863262,31873,1
105374894,LOC105374894,chr6,R,4497944,4583834,86390823,85890,674949152,31874,2
105374895,LOC105374895,chr6,F,4488808,4494613,86396628,5805,674954957,31875,2
105374896,LOC105374896,chr6,R,4599287,4602420,86399761,3133,674958090,31876,1
105374897,LOC105374897,chr6,F,4902372,4909245,86406634,6873,674964963,31877,1
105374898,LOC105374898,chr6,F,5993271,5998801,86412164,5530,674970493,31878,1
105374899,LOC105374899,chr6,F,6325200,6326274,86413238,1074,674971567,31879,2
105374900,LOC105374900,chr6,F,6659370,6681179,86435047,21809,674993376,31880,2
105374901,LOC105374901,chr6,R,6752065,6759366,86442348,7301,675000677,31881,1
105374902,LOC105374902,chr6,F,6885675,6898568,86455241,12893,675013570,31882,3
105374903,LOC105374903,chr6,R,6872274,6890466,86473433,18192,675031762,31883,2
105374904,LOC105374904,chr6,F,6994095,6995825,86475163,1730,675033492,31884,2
105374905,LOC105374905,chr6,F,7255404,7276293,86496052,20889,675054381,31885,2
105374906,LOC105374906,chr6,F,7672677,7699197,86522572,26520,675080901,31886,2
105374907,LOC105374907,chr6,F,7727626,7731870,86526816,4244,675085145,31887,1
105374908,LOC105374908,chr6,F,7912480,7916025,86530361,3545,675088690,31888,1
105374909,LOC105374909,chr6,F,8102696,8153333,86580998,50637,675139327,31889,2
105374910,LOC105374910,chr6,F,8158178,8260628,86683448,102450,675241777,31890,5
105374911,LOC105374911,chr6,F,8283202,8307516,86707762,24314,675266091,31891,3
105374912,LOC105374912,chr6,F,8307530,8326285,86726517,18755,675284846,31892,2
105374913,LOC105374913,chr6,F,8925896,8939632,86740253,13736,675298582,31893,3
105374914,LOC105374914,chr6,F,8965318,9051657,86826592,86339,675384921,31894,7
105374915,LOC105374915,chr6,F,9188907,9227648,86865333,38741,675423662,31895,2
105374916,LOC105374916,chr6,F,9335915,9344588,86874006,8673,675432335,31896,2
105374917,LOC105374917,chr6,F,9697234,9698141,86874913,907,675433242,31897,1
105374918,LOC105374918,chr6,F,10140700,10144465,86878678,3765,675437007,31898,2
105374919,LOC105374919,chr6,F,10041204,10062391,86899865,21187,675458194,31899,2
105374920,LOC105374920,chr6,R,10325209,10329501,86904157,4292,675462486,31900,2
105374921,LOC105374921,chr6,R,10347962,10352022,86908217,4060,675466546,31901,2
105374922,LOC105374922,chr6,R,10570209,10581238,86919246,11029,675477575,31902,2
105374923,LOC105374923,chr6,F,10684211,10686111,86921146,1900,675479475,31903,2
105374924,LOC105374924,chr6,F,10659563,10684185,86945768,24622,675504097,31904,3
105374925,LOC105374925,chr6,F,11291534,11336978,86991212,45444,675549541,31905,9
105374926,LOC105374926,chr6,R,11219860,11232127,87003479,12267,675561808,31906,1
105374927,LOC105374927,chr6,R,11391874,11394860,87006465,2986,675564794,31907,1
105374928,LOC105374928,chr6,F,11417400,11535327,87124392,117927,675682721,31908,9
105374929,LOC105374929,chr6,F,11417611,11429540,87136321,11929,675694650,31909,2
105374930,LOC105374930,chr6,F,11727245,11731247,87140323,4002,675698652,31910,1
105374931,LOC105374931,chr6,F,12395473,12407661,87152511,12188,675710840,31911,2
105374932,LOC105374932,chr6,R,13273186,13276683,87156008,3497,675714337,31912,2
105374933,LOC105374933,chr6,R,13223048,13230030,87162990,6982,675721319,31913,3
105374934,LOC105374934,chr6,R,12828523,12834796,87169263,6273,675727592,31914,4
105374935,LOC105374935,chr6,R,12695220,12747458,87221501,52238,675779830,31915,6
105374936,LOC105374936,chr6,F,13351082,13354188,87224607,3106,675782936,31916,2
105374937,LOC105374937,chr6,R,13572071,13574137,87226673,2066,675785002,31917,1
105374938,LOC105374938,chr6,R,13599161,13611819,87239331,12658,675797660,31918,3
105374939,LOC105374939,chr6,F,14098682,14107284,87247933,8602,675806262,31919,2
105374940,LOC105374940,chr6,R,14194448,14201140,87254625,6692,675812954,31920,1
105374941,LOC105374941,chr6,R,14460480,14463522,87257667,3042,675815996,31921,2
105374942,LOC105374942,chr6,R,14424256,14460449,87293860,36193,675852189,31922,7
105374943,LOC105374943,chr6,R,14389890,14394068,87298038,4178,675856367,31923,3
105374944,LOC105374944,chr6,R,14860415,14865591,87303214,5176,675861543,31924,2
105374945,LOC105374945,chr6,R,14876138,15009028,87436104,132890,675994433,31925,2
105374946,LOC105374946,chr6,R,15143784,15176913,87469233,33129,676027562,31926,2
105374947,LOC105374947,chr6,F,15533403,15560573,87496403,27170,676054732,31927,5
105374948,LOC105374948,chr6,R,15829646,15834463,87501220,4817,676059549,31928,2
105374949,LOC105374949,chr6,R,15956415,15980976,87525781,24561,676084110,31929,3
105374950,LOC105374950,chr6,R,16901789,16953272,87577264,51483,676135593,31930,2
105374951,LOC105374951,chr6,F,17015794,17034225,87595695,18431,676154024,31931,2
105374952,LOC105374952,chr6,F,17706526,17711027,87600196,4501,676158525,31932,3
105374953,LOC105374953,chr6,F,17850433,17853690,87603453,3257,676161782,31933,2
105374954,LOC105374954,chr6,F,17754041,17760051,87609463,6010,676167792,31934,1
105374955,LOC105374955,chr6,F,18496635,18517420,87630248,20785,676188577,31935,3
105374956,LOC105374956,chr6,F,18522796,18723964,87831416,201168,676389745,31936,12
105374957,LOC105374957,chr6,R,18746781,18757290,87841925,10509,676400254,31937,2
105374958,LOC105374958,chr6,F,18977112,19129915,87994728,152803,676553057,31938,7
105374959,LOC105374959,chr6,R,19639211,19691070,88046587,51859,676604916,31939,4
105374960,LOC105374960,chr6,F,19449710,19459348,88056225,9638,676614554,31940,1
105374961,LOC105374961,chr6,R,19317176,19322245,88061294,5069,676619623,31941,2
105374962,LOC105374962,chr6,R,19729426,19750457,88082325,21031,676640654,31942,3
105374963,LOC105374963,chr6,F,19807729,19814175,88088771,6446,676647100,31943,4
105374964,LOC105374964,chr6,R,20048825,20055559,88095505,6734,676653834,31944,2
105374965,LOC105374965,chr6,R,20069575,20074664,88100594,5089,676658923,31945,2
105374966,LOC105374966,chr6,R,21136036,21140935,88105493,4899,676663822,31946,2
105374967,LOC105374967,chr6,R,20974074,20999650,88131069,25576,676689398,31947,2
105374968,LOC105374968,chr6,F,20597731,20600617,88133955,2886,676692284,31948,1
105374969,LOC105374969,chr6,F,22147033,22149137,88136059,2104,676694388,31949,1
105374970,LOC105374970,chr6,R,21825748,21828652,88138963,2904,676697292,31950,2
105374971,LOC105374971,chr6,F,22349225,22590129,88379867,240904,676938196,31951,6
105374972,LOC105374972,chr6,R,22654159,22717922,88443630,63763,677001959,31952,1
105374973,LOC105374973,chr6,F,22644190,22662205,88461645,18015,677019974,31953,5
105374974,LOC105374974,chr6,R,23016750,23177072,88621967,160322,677180296,31954,4
105374975,LOC105374975,chr6,F,23415989,23455137,88661115,39148,677219444,31955,3
105374976,LOC105374976,chr6,R,23337812,23584381,88907684,246569,677466013,31956,4
105374977,LOC105374977,chr6,R,23605948,23626334,88928070,20386,677486399,31957,2
105374978,LOC105374978,chr6,F,24742301,24751646,88937415,9345,677495744,31958,2
105374979,LOC105374979,chr6,R,24792908,24796298,88940805,3390,677499134,31959,2
105374980,LOC105374980,chr6,F,24796742,24797435,88941498,693,677499827,31960,2
105374981,LOC105374981,chr6,F,24933920,24950491,88958069,16571,677516398,31961,1
105374982,LOC105374982,chr6,F,25121715,25135311,88971665,13596,677529994,31962,2
105374983,LOC105374983,chr6,R,25682023,25703140,88992782,21117,677551111,31963,3
105374984,LOC105374984,chr6,F,26226479,26227473,88993776,994,677552105,31964,1
105374985,LOC105374985,chr6,R,26280353,26285027,88998450,4674,677556779,31965,1
105374986,LOC105374986,chr6,F,26257023,26262753,89004180,5730,677562509,31966,2
105374987,LOC105374987,chr6,F,26331843,26340273,89012610,8430,677570939,31967,2
105374988,LOC105374988,chr6,F,26569077,26574698,89018231,5621,677576560,31968,1
105374989,LOC105374989,chr6,F,26602049,26606661,89022843,4612,677581172,31969,1
105374990,LOC105374990,chr6,F,26706840,26730118,89046121,23278,677604450,31970,5
105374991,LOC105374991,chr6,R,26698074,26722150,89070197,24076,677628526,31971,3
105374992,LOC105374992,chr6,F,26779536,26803593,89094254,24057,677652583,31972,3
105374993,LOC105374993,chr6,R,26771567,26794817,89117504,23250,677675833,31973,5
105374994,LOC105374994,chr6,R,26813826,26827989,89131667,14163,677689996,31974,4
105374995,LOC105374995,chr6,R,27125896,27130449,89136220,4553,677694549,31975,3
105374996,LOC105374996,chr6,F,28638793,28653234,89150661,14441,677708990,31976,3
105374997,LOC105374997,chr6,R,28421574,28424819,89153906,3245,677712235,31977,1
105374998,LOC105374998,chr6,F,28399818,28403595,89157683,3777,677716012,31978,1
105374999,LOC105374999,chr6,R,28039342,28062955,89181296,23613,677739625,31979,4
105375000,LOC105375000,chr6,F,27791720,27796867,89186443,5147,677744772,31980,2
105375001,LOC105375001,chr6,F,27473190,27480803,89194056,7613,677752385,31981,1
105375002,LOC105375002,chr6,R,29022006,29035914,89207964,13908,677766293,31982,3
105375003,LOC105375003,chr6,F,29108629,29114417,89213752,5788,677772081,31983,2
105375004,LOC105375004,chr6,F,29123979,29128974,89218747,4995,677777076,31984,1
105375005,LOC105375005,chr6,R,29284071,29334443,89269119,50372,677827448,31985,2
105375006,LOC105375006,chr6,R,29205062,29232329,89296386,27267,677854715,31986,2
105375007,LOC105375007,chr6,R,29490319,29494236,89300303,3917,677858632,31987,2
105375008,LOC105375008,chr6,F,29473742,29490405,89316966,16663,677875295,31988,5
105375009,LOC105375009,chr6,F,29497499,29510558,89330025,13059,677888354,31989,4
105375010,LOC105375010,chr6,R,29848016,29857386,89339395,9370,677897724,31990,3
105375011,LOC105375011,chr6,R,29876072,29887324,89350647,11252,677908976,31991,4
105375012,LOC105375012,chr6,R,30460913,30463663,89353397,2750,677911726,31992,2
105375013,LOC105375013,chr6,F,30744490,30791578,89400485,47088,677958814,31993,4
105375014,LOC105375014,chr6,R,30839528,30848150,89409107,8622,677967436,31994,2
105375015,LOC105375015,chr6,R,31296817,31308579,89420869,11762,677979198,31995,4
105375016,LOC105375016,chr6,R,31357275,31358155,89421749,880,677980078,31996,2
105375017,LOC105375017,chr6,R,31439082,31440913,89423580,1831,677981909,31997,1
105375018,LOC105375018,chr6,F,31689710,31691316,89425186,1606,677983515,31998,1
105375019,LOC105375019,chr6,F,31682894,31687124,89429416,4230,677987745,31999,2
105375020,LOC105375020,chr6,R,31737431,31739943,89431928,2512,677990257,32000,2
105375021,LOC105375021,chr6,R,33131013,33143300,89444215,12287,678002544,32001,4
105375022,LOC105375022,chr6,R,33246074,33247086,89445227,1012,678003556,32002,1
105375023,LOC105375023,chr6,F,33633875,33635421,89446773,1546,678005102,32003,1
105375024,LOC105375024,chr6,F,33789171,33803004,89460606,13833,678018935,32004,3
105375025,LOC105375025,chr6,R,33820299,33822132,89462439,1833,678020768,32005,2
105375026,LOC105375026,chr6,F,33893106,33914794,89484127,21688,678042456,32006,7
105375027,LOC105375027,chr6,F,33856201,33877132,89505058,20931,678063387,32007,2
105375028,LOC105375028,chr6,R,34687098,34688874,89506834,1776,678065163,32008,1
105375029,LOC105375029,chr6,R,34713142,34720142,89513834,7000,678072163,32009,2
105375030,LOC105375030,chr6,F,34880062,34885341,89519113,5279,678077442,32010,1
105375031,LOC105375031,chr6,R,35192546,35213648,89540215,21102,678098544,32011,4
105375032,LOC105375032,chr6,F,35633533,35653116,89559798,19583,678118127,32012,3
105375033,LOC105375033,chr6,F,35600387,35618431,89577842,18044,678136171,32013,2
105375034,LOC105375034,chr6,F,35997883,36012225,89592184,14342,678150513,32014,3
105375035,LOC105375035,chr6,F,35968942,35992503,89615745,23561,678174074,32015,6
105375036,LOC105375036,chr6,R,36241390,36248340,89622695,6950,678181024,32016,3
105375037,LOC105375037,chr6,F,36386394,36391823,89628124,5429,678186453,32017,1
105375038,LOC105375038,chr6,F,36639110,36642010,89631024,2900,678189353,32018,2
105375039,LOC105375039,chr6,F,36678945,36681307,89633386,2362,678191715,32019,1
105375040,LOC105375040,chr6,R,37334127,37354004,89653263,19877,678211592,32020,3
105375041,LOC105375041,chr6,R,37547623,37548601,89654241,978,678212570,32021,2
105375042,LOC105375042,chr6,R,37543552,37546762,89657451,3210,678215780,32022,2
105375043,LOC105375043,chr6,F,38133755,38139938,89663634,6183,678221963,32023,1
105375044,LOC105375044,chr6,F,38640394,38664180,89687420,23786,678245749,32024,2
105375045,LOC105375045,chr6,F,38242879,38246616,89691157,3737,678249486,32025,1
105375046,LOC105375046,chr6,R,39077292,39078956,89692821,1664,678251150,32026,2
105375047,LOC105375047,chr6,F,39314152,39342752,89721421,28600,678279750,32027,2
105375048,LOC105375048,chr6,R,39807844,39819734,89733311,11890,678291640,32028,2
105375049,LOC105375049,chr6,F,40164685,40171667,89740293,6982,678298622,32029,5
105375050,LOC105375050,chr6,R,40271605,40276310,89744998,4705,678303327,32030,1
105375051,LOC105375051,chr6,F,40524040,40529389,89750347,5349,678308676,32031,2
105375052,LOC105375052,chr6,F,40715539,40726072,89760880,10533,678319209,32032,4
105375053,LOC105375053,chr6,R,40794740,40825326,89791466,30586,678349795,32033,2
105375054,LOC105375054,chr6,R,40858545,40868551,89801472,10006,678359801,32034,3
105375055,LOC105375055,chr6,F,41221274,41225181,89805379,3907,678363708,32035,2
105375056,LOC105375056,chr6,F,41140893,41178551,89843037,37658,678401366,32036,4
105375057,LOC105375057,chr6,F,41250076,41253515,89846476,3439,678404805,32037,2
105375058,LOC105375058,chr6,R,41452888,41487130,89880718,34242,678439047,32038,1
105375059,LOC105375059,chr6,F,42013859,42017799,89884658,3940,678442987,32039,1
105375060,LOC105375060,chr6,F,41996901,42013865,89901622,16964,678459951,32040,5
105375061,LOC105375061,chr6,F,42234457,42240949,89908114,6492,678466443,32041,3
105375062,LOC105375062,chr6,F,42746420,42781996,89943690,35576,678502019,32042,3
105375063,LOC105375063,chr6,R,42894449,42903035,89952276,8586,678510605,32043,2
105375064,LOC105375064,chr6,R,43281416,43283628,89954488,2212,678512817,32044,2
105375065,LOC105375065,chr6,F,43391334,43424729,89987883,33395,678546212,32045,5
105375066,LOC105375066,chr6,R,43722547,43737945,90003281,15398,678561610,32046,2
105375067,LOC105375067,chr6,R,43899878,43902490,90005893,2612,678564222,32047,1
105375068,LOC105375068,chr6,R,43862666,43870149,90013376,7483,678571705,32048,3
105375069,LOC105375069,chr6,R,43836931,43838732,90015177,1801,678573506,32049,3
105375070,LOC105375070,chr6,F,43797120,43821702,90039759,24582,678598088,32050,2
105375071,LOC105375071,chr6,R,44010453,44048929,90078235,38476,678636564,32051,2
105375072,LOC105375072,chr6,F,44185988,44189941,90082188,3953,678640517,32052,2
105375073,LOC105375073,chr6,F,44306942,44308325,90083571,1383,678641900,32053,2
105375074,LOC105375074,chr6,F,44510222,44527546,90100895,17324,678659224,32054,2
105375075,LOC105375075,chr6,R,44546165,44551972,90106702,5807,678665031,32055,1
105375076,LOC105375076,chr6,F,45574452,45578085,90110335,3633,678668664,32056,2
105375077,LOC105375077,chr6,R,45555180,45576785,90131940,21605,678690269,32057,9
105375078,LOC105375078,chr6,F,45911966,45930080,90150054,18114,678708383,32058,1
105375079,LOC105375079,chr6,F,46214660,46267419,90202813,52759,678761142,32059,7
105375080,LOC105375080,chr6,F,46931864,46937165,90208114,5301,678766443,32060,3
105375081,LOC105375081,chr6,R,47129171,47138637,90217580,9466,678775909,32061,4
105375082,LOC105375082,chr6,R,47377367,47397171,90237384,19804,678795713,32062,2
105375083,LOC105375083,chr6,R,49773366,49782499,90246517,9133,678804846,32063,2
105375084,LOC105375084,chr6,F,50797932,50802822,90251407,4890,678809736,32064,2
105375085,LOC105375085,chr6,R,51398320,51408679,90261766,10359,678820095,32065,2
105375086,LOC105375086,chr6,F,52068807,52073134,90266093,4327,678824422,32066,4
105375087,LOC105375087,chr6,F,51651838,51685413,90299668,33575,678857997,32067,2
105375088,LOC105375088,chr6,F,52237113,52238823,90301378,1710,678859707,32068,2
105375089,LOC105375089,chr6,F,52522988,52531140,90309530,8152,678867859,32069,2
105375090,LOC105375090,chr6,R,52780883,52787690,90316337,6807,678874666,32070,2
105375091,LOC105375091,chr6,F,52882075,52905737,90339999,23662,678898328,32071,4
105375092,LOC105375092,chr6,R,53064692,53065792,90341099,1100,678899428,32072,0
105375093,LOC105375093,chr6,F,53101118,53102749,90342730,1631,678901059,32073,2
105375094,LOC105375094,chr6,R,53193542,53262771,90411959,69229,678970288,32074,11
105375095,LOC105375095,chr6,F,53474101,53506911,90444769,32810,679003098,32075,4
105375096,LOC105375096,chr6,R,53848295,53850799,90447273,2504,679005602,32076,2
105375097,LOC105375097,chr6,R,54146385,54190432,90491320,44047,679049649,32077,4
105375098,LOC105375098,chr6,R,54301167,54302708,90492861,1541,679051190,32078,2
105375099,LOC105375099,chr6,F,55862874,55869546,90499533,6672,679057862,32079,2
105375100,LOC105375100,chr6,F,56012807,56019173,90505899,6366,679064228,32080,2
105375101,LOC105375101,chr6,F,57821240,57846232,90530891,24992,679089220,32081,4
105375102,LOC105375102,chr6,R,57811148,57822628,90542371,11480,679100700,32082,5
105375103,LOC105375103,chr6,R,57792089,57798702,90548984,6613,679107313,32083,2
105375104,LOC105375104,chr6,R,364142,380671,90565513,16529,679123842,32084,4
105375105,LOC105375105,chr6,R,20400747,20402772,90567538,2025,679125867,32085,2
105375106,LOC105375106,chr6,F,25273477,25279431,90573492,5954,679131821,32086,2
105375107,LOC105375107,chr6,F,27312168,27314612,90575936,2444,679134265,32087,2
105375108,LOC105375108,chr6,R,30464492,30467855,90579299,3363,679137628,32088,2
105375109,LOC105375109,chr6,F,32966704,32972249,90584844,5545,679143173,32089,2
105375110,LOC105375110,chr6,R,35684466,35689106,90589484,4640,679147813,32090,2
105377835,LOC105377835,chr6,R,60784950,60789765,90594299,4815,679152628,32091,1
105377836,LOC105377836,chr6,F,63926491,63930763,90598571,4272,679156900,32092,2
105377837,LOC105377837,chr6,F,64979059,64994288,90613800,15229,679172129,32093,2
105377838,LOC105377838,chr6,R,65989470,65998637,90622967,9167,679181296,32094,3
105377839,LOC105377839,chr6,F,66054411,66055177,90623733,766,679182062,32095,2
105377840,LOC105377840,chr6,R,66050907,66060428,90633254,9521,679191583,32096,4
105377841,LOC105377841,chr6,F,66134950,66176338,90674642,41388,679232971,32097,4
105377842,LOC105377842,chr6,F,67300674,67352437,90726405,51763,679284734,32098,5
105377843,LOC105377843,chr6,R,67282676,67301037,90744766,18361,679303095,32099,2
105377844,LOC105377844,chr6,F,67995805,67998743,90747704,2938,679306033,32100,2
105377845,LOC105377845,chr6,F,67886973,67932198,90792929,45225,679351258,32101,2
105377846,LOC105377846,chr6,F,68091853,68113612,90814688,21759,679373017,32102,2
105377847,LOC105377847,chr6,R,70384174,70399208,90829722,15034,679388051,32103,6
105377848,LOC105377848,chr6,R,70348120,70381447,90863049,33327,679421378,32104,5
105377849,LOC105377849,chr6,R,70412827,70414036,90864258,1209,679422587,32105,1
105377850,LOC105377850,chr6,F,70882100,70905324,90887482,23224,679445811,32106,6
105377851,LOC105377851,chr6,R,71224922,71234722,90897282,9800,679455611,32107,2
105377852,LOC105377852,chr6,F,71293617,71295464,90899129,1847,679457458,32108,1
105377853,LOC105377853,chr6,F,71469803,71479480,90908806,9677,679467135,32109,3
105377854,LOC105377854,chr6,R,73003920,73005994,90910880,2074,679469209,32110,2
105377855,LOC105377855,chr6,R,72945825,72994626,90959681,48801,679518010,32111,5
105377856,LOC105377856,chr6,R,72614329,72621869,90967221,7540,679525550,32112,2
105377857,LOC105377857,chr6,F,73523617,73571599,91015203,47982,679573532,32113,4
105377858,LOC105377858,chr6,R,74594252,74734294,91155245,140042,679713574,32114,2
105377859,LOC105377859,chr6,F,75357118,75362418,91160545,5300,679718874,32115,2
105377860,LOC105377860,chr6,R,76522373,76593800,91231972,71427,679790301,32116,3
105377861,LOC105377861,chr6,R,76724216,76726450,91234206,2234,679792535,32117,2
105377862,LOC105377862,chr6,F,76774935,77137973,91597244,363038,680155573,32118,9
105377863,LOC105377863,chr6,R,77427883,77433654,91603015,5771,680161344,32119,2
105377864,LOC105377864,chr6,F,77403603,77503988,91703400,100385,680261729,32120,14
105377865,LOC105377865,chr6,R,77925901,78300807,92078306,374906,680636635,32121,5
105377866,LOC105377866,chr6,F,79537644,79631131,92171793,93487,680730122,32122,3
105377867,LOC105377867,chr6,R,79444036,79447068,92174825,3032,680733154,32123,2
105377868,LOC105377868,chr6,F,80259695,80262907,92178037,3212,680736366,32124,2
105377869,LOC105377869,chr6,R,80530626,80548624,92196035,17998,680754364,32125,2
105377870,LOC105377870,chr6,R,80904607,80924038,92215466,19431,680773795,32126,2
105377871,LOC105377871,chr6,R,81526711,81544045,92232800,17334,680791129,32127,2
105377872,LOC105377872,chr6,R,81692566,81740179,92280413,47613,680838742,32128,7
105377873,LOC105377873,chr6,R,81760294,81768415,92288534,8121,680846863,32129,2
105377874,LOC105377874,chr6,F,82271425,82272641,92289750,1216,680848079,32130,2
105377875,LOC105377875,chr6,R,82352778,82363656,92300628,10878,680858957,32131,2
105377876,LOC105377876,chr6,R,82598013,82688414,92391029,90401,680949358,32132,4
105377877,LOC105377877,chr6,R,82819564,82836480,92407945,16916,680966274,32133,3
105377878,LOC105377878,chr6,R,82880832,82882194,92409307,1362,680967636,32134,3
105377879,LOC105377879,chr6,F,83722330,83727629,92414606,5299,680972935,32135,2
105377880,LOC105377880,chr6,R,84421042,84458249,92451813,37207,681010142,32136,2
105377881,LOC105377881,chr6,R,84961734,84967809,92457888,6075,681016217,32137,2
105377882,LOC105377882,chr6,F,87930923,87942511,92469476,11588,681027805,32138,4
105377883,LOC105377883,chr6,R,88217317,88249176,92501335,31859,681059664,32139,2
105377884,LOC105377884,chr6,R,88277590,88299584,92523329,21994,681081658,32140,3
105377885,LOC105377885,chr6,R,88299738,88442913,92666504,143175,681224833,32141,5
105377887,LOC105377887,chr6,R,89621402,89624577,92669679,3175,681228008,32142,1
105377888,LOC105377888,chr6,R,89537817,89566972,92698834,29155,681257163,32143,5
105377889,LOC105377889,chr6,R,89508177,89515600,92706257,7423,681264586,32144,3
105377890,LOC105377890,chr6,F,90183914,90185520,92707863,1606,681266192,32145,2
105377891,LOC105377891,chr6,F,90331359,90357265,92733769,25906,681292098,32146,5
105377892,LOC105377892,chr6,F,90587210,90590736,92737295,3526,681295624,32147,2
105377893,LOC105377893,chr6,F,90641748,90642684,92738231,936,681296560,32148,2
105377894,LOC105377894,chr6,F,91719751,91729795,92748275,10044,681306604,32149,2
105377895,LOC105377895,chr6,F,92208755,92246265,92785785,37510,681344114,32150,2
105377896,LOC105377896,chr6,R,92584903,92590151,92791033,5248,681349362,32151,1
105377897,LOC105377897,chr6,F,92979598,92986870,92798305,7272,681356634,32152,4
105377898,LOC105377898,chr6,R,93030893,93069761,92837173,38868,681395502,32153,2
105377899,LOC105377899,chr6,F,93418647,93503360,92921886,84713,681480215,32154,4
105377900,LOC105377900,chr6,F,93674394,93702017,92949509,27623,681507838,32155,4
105377901,LOC105377901,chr6,R,94546224,94573259,92976544,27035,681534873,32156,4
105377902,LOC105377902,chr6,R,94607877,94627356,92996023,19479,681554352,32157,2
105377903,LOC105377903,chr6,R,95487906,95519565,93027682,31659,681586011,32158,2
105377904,LOC105377904,chr6,R,96200342,96399031,93226371,198689,681784700,32159,6
105377905,LOC105377905,chr6,R,96052967,96056660,93230064,3693,681788393,32160,2
105377906,LOC105377906,chr6,R,96526040,96531033,93235057,4993,681793386,32161,3
105377907,LOC105377907,chr6,R,96499956,96517331,93252432,17375,681810761,32162,3
105377908,LOC105377908,chr6,R,96717621,96721365,93256176,3744,681814505,32163,2
105377909,LOC105377909,chr6,R,97456570,97456979,93256585,409,681814914,32164,1
105377910,LOC105377910,chr6,F,98517893,98519842,93258534,1949,681816863,32165,2
105377911,LOC105377911,chr6,R,100149638,100156113,93265009,6475,681823338,32166,2
105377912,LOC105377912,chr6,F,101454358,101463831,93274482,9473,681832811,32167,2
105377913,LOC105377913,chr6,F,102160998,102225366,93338850,64368,681897179,32168,7
105377914,LOC105377914,chr6,F,103000963,103162055,93499942,161092,682058271,32169,3
105377915,LOC105377915,chr6,R,103463680,103534905,93571167,71225,682129496,32170,3
105377916,LOC105377916,chr6,F,103535037,103540791,93576921,5754,682135250,32171,2
105377917,LOC105377917,chr6,F,104275486,104286853,93588288,11367,682146617,32172,3
105377918,LOC105377918,chr6,R,104500830,104527391,93614849,26561,682173178,32173,4
105377919,LOC105377919,chr6,F,105309551,105328856,93634154,19305,682192483,32174,2
105377920,LOC105377920,chr6,F,105275771,105277981,93636364,2210,682194693,32175,1
105377921,LOC105377921,chr6,F,105453667,105479087,93661784,25420,682220113,32176,2
105377922,LOC105377922,chr6,R,105611546,105632271,93682509,20725,682240838,32177,5
105377923,LOC105377923,chr6,R,105637104,105893062,93938467,255958,682496796,32178,4
105377924,LOC105377924,chr6,R,106451495,106457267,93944239,5772,682502568,32179,1
105377925,LOC105377925,chr6,F,106587887,106588771,93945123,884,682503452,32180,1
105377926,LOC105377926,chr6,F,106686981,106699946,93958088,12965,682516417,32181,2
105377927,LOC105377927,chr6,F,106702867,106716503,93971724,13636,682530053,32182,2
105377928,LOC105377928,chr6,F,106881937,106884664,93974451,2727,682532780,32183,2
105377929,LOC105377929,chr6,R,108030249,108040387,93984589,10138,682542918,32184,1
105377930,LOC105377930,chr6,R,108120199,108122489,93986879,2290,682545208,32185,2
105377931,LOC105377931,chr6,R,108468772,108492382,94010489,23610,682568818,32186,2
105377932,LOC105377932,chr6,R,108359370,108407461,94058580,48091,682616909,32187,1
105377933,LOC105377933,chr6,R,109265439,109266428,94059569,989,682617898,32188,1
105377934,LOC105377934,chr6,F,109183929,109203797,94079437,19868,682637766,32189,8
105377935,LOC105377935,chr6,F,109482767,109495331,94092001,12564,682650330,32190,3
105377936,LOC105377936,chr6,F,110415699,110420130,94096432,4431,682654761,32191,1
105377937,LOC105377937,chr6,F,110241040,110254214,94109606,13174,682667935,32192,2
105377938,LOC105377938,chr6,F,110475351,110479436,94113691,4085,682672020,32193,1
105377939,LOC105377939,chr6,F,110549562,110555691,94119820,6129,682678149,32194,3
105377940,LOC105377940,chr6,R,110530698,110549402,94138524,18704,682696853,32195,7
105377941,LOC105377941,chr6,F,110575410,110589420,94152534,14010,682710863,32196,5
105377942,LOC105377942,chr6,R,110943459,110958478,94167553,15019,682725882,32197,2
105377943,LOC105377943,chr6,F,111276113,111343553,94234993,67440,682793322,32198,4
105377944,LOC105377944,chr6,R,111642802,111655549,94247740,12747,682806069,32199,2
105377945,LOC105377945,chr6,F,111681397,111694367,94260710,12970,682819039,32200,3
105377946,LOC105377946,chr6,R,111900304,111909477,94269883,9173,682828212,32201,3
105377947,LOC105377947,chr6,F,111980870,111986954,94275967,6084,682834296,32202,3
105377948,LOC105377948,chr6,F,111996860,112012253,94291360,15393,682849689,32203,2
105377949,LOC105377949,chr6,F,112689899,112771666,94373127,81767,682931456,32204,8
105377950,LOC105377950,chr6,F,112880152,112904294,94397269,24142,682955598,32205,3
105377951,LOC105377951,chr6,F,112983719,112997698,94411248,13979,682969577,32206,2
105377952,LOC105377952,chr6,R,113094281,113111755,94428722,17474,682987051,32207,4
105377953,LOC105377953,chr6,F,113174910,113197540,94451352,22630,683009681,32208,4
105377954,LOC105377954,chr6,F,113172040,113173547,94452859,1507,683011188,32209,1
105377955,LOC105377955,chr6,R,113168494,113194877,94479242,26383,683037571,32210,3
105377956,LOC105377956,chr6,R,113122121,113131546,94488667,9425,683046996,32211,3
105377957,LOC105377957,chr6,R,113424361,113441493,94505799,17132,683064128,32212,7
105377958,LOC105377958,chr6,F,113871441,113880812,94515170,9371,683073499,32213,2
105377959,LOC105377959,chr6,R,114477349,114545331,94583152,67982,683141481,32214,7
105377960,LOC105377960,chr6,F,115046773,115053480,94589859,6707,683148188,32215,2
105377961,LOC105377961,chr6,F,115472501,115486379,94603737,13878,683162066,32216,2
105377962,LOC105377962,chr6,R,115633585,115643898,94614050,10313,683172379,32217,4
105377963,LOC105377963,chr6,F,116766353,116768033,94615730,1680,683174059,32218,2
105377964,LOC105377964,chr6,R,117261488,117264784,94619026,3296,683177355,32219,1
105377965,LOC105377965,chr6,R,117526821,117537178,94629383,10357,683187712,32220,1
105377966,LOC105377966,chr6,R,118290416,118325365,94664332,34949,683222661,32221,2
105377967,LOC105377967,chr6,F,118085902,118095452,94673882,9550,683232211,32222,2
105377968,LOC105377968,chr6,R,118335359,118448439,94786962,113080,683345291,32223,3
105377969,LOC105377969,chr6,F,118664514,118687766,94810214,23252,683368543,32224,5
105377970,LOC105377970,chr6,F,118496602,118540443,94854055,43841,683412384,32225,5
105377971,LOC105377971,chr6,F,118466477,118489030,94876608,22553,683434937,32226,4
105377972,LOC105377972,chr6,F,119654067,119703623,94926164,49556,683484493,32227,2
105377973,LOC105377973,chr6,R,119473411,119478658,94931411,5247,683489740,32228,1
105377974,LOC105377974,chr6,F,119209089,119219345,94941667,10256,683499996,32229,2
105377975,LOC105377975,chr6,F,119843065,119845084,94943686,2019,683502015,32230,1
105377976,LOC105377976,chr6,F,119877929,119880655,94946412,2726,683504741,32231,2
105377977,LOC105377977,chr6,R,120970993,121004252,94979671,33259,683538000,32232,2
105377978,LOC105377978,chr6,R,121865958,121884715,94998428,18757,683556757,32233,2
105377979,LOC105377979,chr6,F,121767375,122055650,95286703,288275,683845032,32234,9
105377980,LOC105377980,chr6,F,123105909,123107312,95288106,1403,683846435,32235,2
105377981,LOC105377981,chr6,F,123610433,123668971,95346644,58538,683904973,32236,3
105377982,LOC105377982,chr6,F,123519438,123570916,95398122,51478,683956451,32237,6
105377983,LOC105377983,chr6,F,123506594,123509746,95401274,3152,683959603,32238,1
105377984,LOC105377984,chr6,F,123309151,123336000,95428123,26849,683986452,32239,3
105377985,LOC105377985,chr6,F,125267734,125276098,95436487,8364,683994816,32240,1
105377986,LOC105377986,chr6,R,125645672,125749208,95540023,103536,684098352,32241,4
105377987,LOC105377987,chr6,R,125916319,125919121,95542825,2802,684101154,32242,2
105377988,LOC105377988,chr6,R,127119974,127180309,95603160,60335,684161489,32243,2
105377989,LOC105377989,chr6,R,126998849,127119967,95724278,121118,684282607,32244,5
105377990,LOC105377990,chr6,R,126877675,126943596,95790199,65921,684348528,32245,4
105377991,LOC105377991,chr6,F,126874057,126882804,95798946,8747,684357275,32246,4
105377992,LOC105377992,chr6,F,126705139,126706594,95800401,1455,684358730,32247,2
105377993,LOC105377993,chr6,R,126692610,126696228,95804019,3618,684362348,32248,1
105377994,LOC105377994,chr6,F,127296986,127341875,95848908,44889,684407237,32249,5
105377995,LOC105377995,chr6,R,127599425,127608188,95857671,8763,684416000,32250,3
105377996,LOC105377996,chr6,F,127608337,127632311,95881645,23974,684439974,32251,3
105377997,LOC105377997,chr6,F,127663886,127684761,95902520,20875,684460849,32252,5
105377998,LOC105377998,chr6,F,128648537,128702758,95956741,54221,684515070,32253,4
105377999,LOC105377999,chr6,F,129855627,129947895,96049009,92268,684607338,32254,7
105378000,LOC105378000,chr6,R,130120121,130121326,96050214,1205,684608543,32255,1
105378001,LOC105378001,chr6,F,130687612,130697583,96060185,9971,684618514,32256,2
105378002,LOC105378002,chr6,R,130719229,130723221,96064177,3992,684622506,32257,3
105378003,LOC105378003,chr6,R,130741372,130770750,96093555,29378,684651884,32258,3
105378004,LOC105378004,chr6,F,131063419,131074841,96104977,11422,684663306,32259,2
105378005,LOC105378005,chr6,R,131439986,131443792,96108783,3806,684667112,32260,2
105378006,LOC105378006,chr6,F,132074858,132077657,96111582,2799,684669911,32261,1
105378007,LOC105378007,chr6,F,132876631,132920124,96155075,43493,684713404,32262,3
105378008,LOC105378008,chr6,F,132936566,132941103,96159612,4537,684717941,32263,3
105378009,LOC105378009,chr6,R,134335845,134351644,96175411,15799,684733740,32264,2
105378010,LOC105378010,chr6,F,135106844,135110423,96178990,3579,684737319,32265,2
105378011,LOC105378011,chr6,R,135195913,135236190,96219267,40277,684777596,32266,5
105378012,LOC105378012,chr6,R,135796398,135805073,96227942,8675,684786271,32267,2
105378013,LOC105378013,chr6,R,135628896,135634680,96233726,5784,684792055,32268,3
105378014,LOC105378014,chr6,F,136294985,136306064,96244805,11079,684803134,32269,3
105378015,LOC105378015,chr6,F,136550420,136552602,96246987,2182,684805316,32270,1
105378016,LOC105378016,chr6,F,136756568,136765538,96255957,8970,684814286,32271,2
105378017,LOC105378017,chr6,R,137305771,137314115,96264301,8344,684822630,32272,2
105378018,LOC105378018,chr6,R,137664065,137673295,96273531,9230,684831860,32273,2
105378019,LOC105378019,chr6,F,137824574,137860852,96309809,36278,684868138,32274,2
105378020,LOC105378020,chr6,R,137945041,137957661,96322429,12620,684880758,32275,3
105378021,LOC105378021,chr6,R,138015542,138034865,96341752,19323,684900081,32276,2
105378022,LOC105378022,chr6,R,138830569,138833614,96344797,3045,684903126,32277,2
105378023,LOC105378023,chr6,F,139525503,139527587,96346881,2084,684905210,32278,2
105378024,LOC105378024,chr6,F,139546270,139547690,96348301,1420,684906630,32279,1
105378025,LOC105378025,chr6,R,140140611,140148171,96355861,7560,684914190,32280,2
105378026,LOC105378026,chr6,R,140610365,140663992,96409488,53627,684967817,32281,2
105378027,LOC105378027,chr6,F,140539232,140785751,96656007,246519,685214336,32282,10
105378028,LOC105378028,chr6,F,140866465,140880595,96670137,14130,685228466,32283,2
105378029,LOC105378029,chr6,F,141403267,141451006,96717876,47739,685276205,32284,2
105378030,LOC105378030,chr6,R,141752984,141798153,96763045,45169,685321374,32285,3
105378031,LOC105378031,chr6,R,141850130,142030422,96943337,180292,685501666,32286,3
105378032,LOC105378032,chr6,R,142242313,142259717,96960741,17404,685519070,32287,2
105378033,LOC105378033,chr6,R,143115212,143165071,97010600,49859,685568929,32288,3
105378034,LOC105378034,chr6,F,143505415,143506213,97011398,798,685569727,32289,1
105378035,LOC105378035,chr6,F,143513091,143534580,97032887,21489,685591216,32290,5
105378036,LOC105378036,chr6,F,144110170,144125408,97048125,15238,685606454,32291,3
105378037,LOC105378037,chr6,F,145138118,145154520,97064527,16402,685622856,32292,2
105378038,LOC105378038,chr6,F,145744805,145750461,97070183,5656,685628512,32293,2
105378039,LOC105378039,chr6,R,145753805,145767491,97083869,13686,685642198,32294,2
105378040,LOC105378040,chr6,R,146731003,146771347,97124213,40344,685682542,32295,3
105378041,LOC105378041,chr6,R,146720750,146730759,97134222,10009,685692551,32296,2
105378042,LOC105378042,chr6,F,146857696,146863335,97139861,5639,685698190,32297,3
105378043,LOC105378043,chr6,F,147431728,147440077,97148210,8349,685706539,32298,2
105378044,LOC105378044,chr6,R,147740974,147743297,97150533,2323,685708862,32299,1
105378045,LOC105378045,chr6,R,148267748,148272345,97155130,4597,685713459,32300,2
105378046,LOC105378046,chr6,F,149049947,149053415,97158598,3468,685716927,32301,1
105378047,LOC105378047,chr6,R,149027228,149032754,97164124,5526,685722453,32302,1
105378048,LOC105378048,chr6,R,148926276,148937730,97175578,11454,685733907,32303,2
105378049,LOC105378049,chr6,R,149243281,149257567,97189864,14286,685748193,32304,6
105378050,LOC105378050,chr6,F,149685682,149691408,97195590,5726,685753919,32305,1
105378052,LOC105378052,chr6,F,149934489,149936324,97197425,1835,685755754,32306,1
105378053,LOC105378053,chr6,F,150079412,150119617,97237630,40205,685795959,32307,2
105378054,LOC105378054,chr6,F,150269743,150306111,97273998,36368,685832327,32308,3
105378055,LOC105378055,chr6,F,150336270,150345620,97283348,9350,685841677,32309,2
105378056,LOC105378056,chr6,F,150600271,150601061,97284138,790,685842467,32310,0
105378057,LOC105378057,chr6,R,151088102,151151137,97347173,63035,685905502,32311,3
105378058,LOC105378058,chr6,F,151626574,151662953,97383552,36379,685941881,32312,4
105378059,LOC105378059,chr6,R,152061130,152088443,97410865,27313,685969194,32313,2
105378060,LOC105378060,chr6,R,151747958,151764293,97427200,16335,685985529,32314,3
105378061,LOC105378061,chr6,F,152657975,152687915,97457140,29940,686015469,32315,3
105378062,LOC105378062,chr6,F,152863578,152871493,97465055,7915,686023384,32316,2
105378063,LOC105378063,chr6,R,152838746,152867545,97493854,28799,686052183,32317,2
105378064,LOC105378064,chr6,F,152838425,152845806,97501235,7381,686059564,32318,2
105378065,LOC105378065,chr6,R,152806225,152875814,97570824,69589,686129153,32319,3
105378066,LOC105378066,chr6,R,153304631,153427337,97693530,122706,686251859,32320,10
105378067,LOC105378067,chr6,R,154360786,154362977,97695721,2191,686254050,32321,2
105378068,LOC105378068,chr6,F,155514861,155526018,97706878,11157,686265207,32322,3
105378069,LOC105378069,chr6,R,155689641,155697834,97715071,8193,686273400,32323,2
105378070,LOC105378070,chr6,F,156352746,156371021,97733346,18275,686291675,32324,2
105378071,LOC105378071,chr6,F,156310940,156352705,97775111,41765,686333440,32325,3
105378072,LOC105378072,chr6,F,155793340,155915268,97897039,121928,686455368,32326,6
105378073,LOC105378073,chr6,R,156498847,156501135,97899327,2288,686457656,32327,2
105378074,LOC105378074,chr6,R,156776113,156778422,97901636,2309,686459965,32328,1
105378075,LOC105378075,chr6,F,157240566,157253516,97914586,12950,686472915,32329,3
105378076,LOC105378076,chr6,F,157326564,157332523,97920545,5959,686478874,32330,2
105378077,LOC105378077,chr6,F,157558230,157561455,97923770,3225,686482099,32331,1
105378078,LOC105378078,chr6,R,157885113,157893132,97931789,8019,686490118,32332,1
105378079,LOC105378079,chr6,F,158071800,158074119,97934108,2319,686492437,32333,1
105378080,LOC105378080,chr6,F,158858079,158864498,97940527,6419,686498856,32334,2
105378081,LOC105378081,chr6,R,159051765,159121467,98010229,69702,686568558,32335,6
105378082,LOC105378082,chr6,F,159042251,159046703,98014681,4452,686573010,32336,1
105378083,LOC105378083,chr6,F,159000328,159042223,98056576,41895,686614905,32337,5
105378084,LOC105378084,chr6,R,159375330,159383327,98064573,7997,686622902,32338,2
105378085,LOC105378085,chr6,R,159586952,159595202,98072823,8250,686631152,32339,2
105378086,LOC105378086,chr6,R,159615417,159618776,98076182,3359,686634511,32340,2
105378087,LOC105378087,chr6,F,159917040,159919259,98078401,2219,686636730,32341,2
105378088,LOC105378088,chr6,F,160263287,160276240,98091354,12953,686649683,32342,1
105378089,LOC105378089,chr6,F,160485909,160506798,98112243,20889,686670572,32343,7
105378090,LOC105378090,chr6,R,160369744,160391996,98134495,22252,686692824,32344,2
105378091,LOC105378091,chr6,R,160776299,160807169,98165365,30870,686723694,32345,2
105378092,LOC105378092,chr6,R,160872887,160895704,98188182,22817,686746511,32346,1
105378093,LOC105378093,chr6,R,160899972,160926209,98214419,26237,686772748,32347,3
105378094,LOC105378094,chr6,F,161336249,161338180,98216350,1931,686774679,32348,2
105378095,LOC105378095,chr6,F,163209278,163211640,98218712,2362,686777041,32349,1
105378096,LOC105378096,chr6,F,162900284,162901279,98219707,995,686778036,32350,2
105378097,LOC105378097,chr6,F,162234815,162239913,98224805,5098,686783134,32351,1
105378098,LOC105378098,chr6,F,161470976,161484045,98237874,13069,686796203,32352,3
105378099,LOC105378099,chr6,R,163368305,163371187,98240756,2882,686799085,32353,1
105378100,LOC105378100,chr6,R,163387585,163393639,98246810,6054,686805139,32354,4
105378101,LOC105378101,chr6,F,163411036,163414279,98250053,3243,686808382,32355,1
105378102,LOC105378102,chr6,F,163919542,164058966,98389477,139424,686947806,32356,3
105378103,LOC105378103,chr6,F,163903536,163919119,98405060,15583,686963389,32357,2
105378104,LOC105378104,chr6,R,163715105,163720235,98410190,5130,686968519,32358,1
105378105,LOC105378105,chr6,R,163711975,163714377,98412592,2402,686970921,32359,4
105378106,LOC105378106,chr6,F,164083986,164088302,98416908,4316,686975237,32360,1
105378107,LOC105378107,chr6,F,164184365,164337805,98570348,153440,687128677,32361,2
105378108,LOC105378108,chr6,R,164305346,164337800,98602802,32454,687161131,32362,4
105378109,LOC105378109,chr6,R,164293407,164300747,98610142,7340,687168471,32363,4
105378110,LOC105378110,chr6,R,164184276,164190941,98616807,6665,687175136,32364,2
105378111,LOC105378111,chr6,R,164792574,164827657,98651890,35083,687210219,32365,4
105378112,LOC105378112,chr6,F,164927834,164928940,98652996,1106,687211325,32366,1
105378113,LOC105378113,chr6,F,165309662,165316728,98660062,7066,687218391,32367,6
105378114,LOC105378114,chr6,R,165773200,165775945,98662807,2745,687221136,32368,1
105378115,LOC105378115,chr6,F,165668729,165676224,98670302,7495,687228631,32369,3
105378116,LOC105378116,chr6,F,165408844,165413654,98675112,4810,687233441,32370,4
105378117,LOC105378117,chr6,F,166025365,166042646,98692393,17281,687250722,32371,3
105378118,LOC105378118,chr6,R,166275586,166277085,98693892,1499,687252221,32372,2
105378120,LOC105378120,chr6,R,166968039,166974440,98700293,6401,687258622,32373,2
105378121,LOC105378121,chr6,R,166982650,166988392,98706035,5742,687264364,32374,2
105378122,LOC105378122,chr6,R,167112398,167122594,98716231,10196,687274560,32375,1
105378123,LOC105378123,chr6,R,167165524,167170007,98720714,4483,687279043,32376,2
105378124,LOC105378124,chr6,F,167146413,167169128,98743429,22715,687301758,32377,6
105378125,LOC105378125,chr6,F,167385108,167404984,98763305,19876,687321634,32378,2
105378126,LOC105378126,chr6,F,167423234,167436372,98776443,13138,687334772,32379,4
105378127,LOC105378127,chr6,R,167459261,167463531,98780713,4270,687339042,32380,2
105378128,LOC105378128,chr6,F,167481677,167489224,98788260,7547,687346589,32381,2
105378129,LOC105378129,chr6,F,167544445,167551392,98795207,6947,687353536,32382,3
105378130,LOC105378130,chr6,F,167565509,167573780,98803478,8271,687361807,32383,1
105378131,LOC105378131,chr6,F,167574833,167588832,98817477,13999,687375806,32384,7
105378132,LOC105378132,chr6,R,167686991,167696379,98826865,9388,687385194,32385,3
105378133,LOC105378133,chr6,F,167677262,167679526,98829129,2264,687387458,32386,1
105378134,LOC105378134,chr6,F,167815893,167823247,98836483,7354,687394812,32387,2
105378135,LOC105378135,chr6,R,168045104,168046162,98837541,1058,687395870,32388,2
105378136,LOC105378136,chr6,F,168229764,168231364,98839141,1600,687397470,32389,1
105378137,LOC105378137,chr6,R,168225279,168227074,98840936,1795,687399265,32390,2
105378138,LOC105378138,chr6,R,168298072,168302153,98845017,4081,687403346,32391,1
105378139,LOC105378139,chr6,R,168333250,168334523,98846290,1273,687404619,32392,2
105378140,LOC105378140,chr6,R,168410451,168413100,98848939,2649,687407268,32393,1
105378141,LOC105378141,chr6,F,168413353,168421325,98856911,7972,687415240,32394,1
105378142,LOC105378142,chr6,F,168694999,168697957,98859869,2958,687418198,32395,2
105378143,LOC105378143,chr6,F,168711147,168716888,98865610,5741,687423939,32396,2
105378144,LOC105378144,chr6,F,168860821,168862366,98867155,1545,687425484,32397,1
105378145,LOC105378145,chr6,F,168964399,169063791,98966547,99392,687524876,32398,6
105378146,LOC105378146,chr6,R,168919701,168964340,99011186,44639,687569515,32399,7
105378147,LOC105378147,chr6,R,169355735,169396423,99051874,40688,687610203,32400,6
105378148,LOC105378148,chr6,R,169330543,169340581,99061912,10038,687620241,32401,2
105378149,LOC105378149,chr6,F,169899160,169904735,99067487,5575,687625816,32402,1
105378150,LOC105378150,chr6,F,170023726,170028797,99072558,5071,687630887,32403,2
105378151,LOC105378151,chr6,R,170081099,170126847,99118306,45748,687676635,32404,3
105378152,LOC105378152,chr6,R,170130196,170142348,99130458,12152,687688787,32405,0
105378153,LOC105378153,chr6,R,170153578,170165670,99142550,12092,687700879,32406,2
105378154,LOC105378154,chr6,R,170404830,170412183,99149903,7353,687708232,32407,1
105378155,LOC105378155,chr6,R,170370494,170394115,99173524,23621,687731853,32408,5
105378156,LOC105378156,chr6,F,170358325,170388280,99203479,29955,687761808,32409,3
105378157,LOC105378157,chr6,R,170469030,170497372,99231821,28342,687790150,32410,4
105378158,LOC105378158,chr6,F,83708511,83736441,99259751,27930,687818080,32411,2
105378159,LOC105378159,chr6,R,130287920,130383090,99354921,95170,687913250,32412,5
105378160,LOC105378160,chr6,R,167357355,167371630,99369196,14275,687927525,32413,4
105378161,LOC105378161,chr6,R,170461021,170463114,99371289,2093,687929618,32414,2
26,AOC1,chr7,F,150826392,150861291,34899,34899,687964517,32415,8
43,ACHE,chr7,R,100889993,100896686,41592,6693,687971210,32416,6
60,ACTB,chr7,R,5527147,5530601,45046,3454,687974664,32417,5
107,ADCY1,chr7,F,45574139,45723116,194023,148977,688123641,32418,21
117,ADCYAP1R1,chr7,F,31052340,31111479,253162,59139,688182780,32419,17
165,AEBP1,chr7,F,44104319,44114565,263408,10246,688193026,32420,20
196,AHR,chr7,F,17298651,17346151,310908,47500,688240526,32421,10
231,AKR1B1,chr7,R,134442350,134459136,327694,16786,688257312,32422,9
273,AMPH,chr7,R,38383693,38631567,575568,247874,688505186,32423,22
313,AOAH,chr7,R,36512940,36724549,787177,211609,688716795,32424,28
358,AQP1,chr7,F,30911799,30925516,800894,13717,688730512,32425,5
381,ARF5,chr7,F,127588351,127591705,804248,3354,688733866,32426,5
435,ASL,chr7,F,66075788,66093343,821803,17555,688751421,32427,15
440,ASNS,chr7,R,97852116,97872542,842229,20426,688771847,32428,13
563,AZGP1,chr7,R,99966726,99976112,851615,9386,688781233,32429,3
611,OPN1SW,chr7,R,128772488,128775790,854917,3302,688784535,32430,4
644,BLVRA,chr7,F,43758191,43807342,904068,49151,688833686,32431,9
669,BPGM,chr7,F,134646778,134679816,937106,33038,688866724,32432,5
673,BRAF,chr7,R,140715950,140924764,1145920,208814,689075538,32433,21
781,CACNA2D1,chr7,R,81946443,82443806,1643283,497363,689572901,32434,46
799,CALCR,chr7,R,93424486,93574730,1793527,150244,689723145,32435,16
800,CALD1,chr7,F,134779412,134970729,1984844,191317,689914462,32436,17
813,CALU,chr7,F,128739291,128773423,2018976,34132,689948594,32437,8
816,CAMK2B,chr7,R,44217149,44325994,2127821,108845,690057439,32438,27
830,CAPZA2,chr7,F,116862508,116919259,2184572,56751,690114190,32439,9
835,CASP2,chr7,F,143288214,143307696,2204054,19482,690133672,32440,12
857,CAV1,chr7,F,116524784,116561185,2240455,36401,690170073,32441,2
858,CAV2,chr7,F,116499600,116508541,2249396,8941,690179014,32442,2
889,KRIT1,chr7,R,92198968,92246128,2296556,47160,690226174,32443,18
908,CCT6A,chr7,F,56051684,56063989,2308861,12305,690238479,32444,13
948,CD36,chr7,F,80602187,80679277,2385951,77090,690315569,32445,17
989,SEPT7,chr7,F,35800985,35915763,2500729,114778,690430347,32446,18
1020,CDK5,chr7,R,151053811,151057965,2504883,4154,690434501,32447,11
1021,CDK6,chr7,R,92604920,92836627,2736590,231707,690666208,32448,9
1080,CFTR,chr7,F,117478339,117668665,2926916,190326,690856534,32449,32
1124,CHN2,chr7,F,29146546,29514335,3294705,367789,691224323,32450,20
1129,CHRM2,chr7,F,136868651,137020255,3446309,151604,691375927,32451,8
1174,AP1S1,chr7,F,101154404,101161276,3453181,6872,691382799,32452,4
1180,CLCN1,chr7,F,143316125,143353862,3490918,37737,691420536,32453,23
1197,CLK2P1,chr7,R,23584715,23586527,3492730,1812,691422348,32454,0
1278,COL1A2,chr7,F,94394560,94431232,3529402,36672,691459020,32455,51
1357,CPA1,chr7,F,130380370,130388108,3537140,7738,691466758,32456,9
1358,CPA2,chr7,F,130266862,130289798,3560076,22936,691489694,32457,10
1364,CLDN4,chr7,F,73830862,73832693,3561907,1831,691491525,32458,0
1365,CLDN3,chr7,R,73768996,73770270,3563181,1274,691492799,32459,0
1395,CRHR2,chr7,R,30651842,30700103,3611442,48261,691541060,32460,14
1523,CUX1,chr7,F,101815903,102283958,4079497,468055,692009115,32461,33
1551,CYP3A7,chr7,R,99705036,99735200,4109661,30164,692039279,32462,12
1576,CYP3A4,chr7,R,99756959,99784188,4136890,27229,692066508,32463,13
1577,CYP3A5,chr7,R,99648188,99680026,4168728,31838,692098346,32464,15
1595,CYP51A1,chr7,R,92112148,92134745,4191325,22597,692120943,32465,10
1607,DGKB,chr7,R,14145048,14974777,5021054,829729,692950672,32466,30
1644,DDC,chr7,R,50458435,50565457,5128076,107022,693057694,32467,17
1687,DFNA5,chr7,R,24698354,24758020,5187742,59666,693117360,32468,10
1738,DLD,chr7,F,107891106,107921198,5217834,30092,693147452,32469,13
1749,DLX5,chr7,R,97020389,97024831,5222276,4442,693151894,32470,3
1750,DLX6,chr7,F,97005977,97011040,5227339,5063,693156957,32471,2
1780,DYNC1I1,chr7,F,95772505,96110322,5565156,337817,693494774,32472,20
1804,DPP6,chr7,F,153887096,154894290,6572350,1007194,694501968,32473,29
1811,SLC26A3,chr7,R,107765466,107803233,6610117,37767,694539735,32474,20
1956,EGFR,chr7,F,55019031,55207338,6798424,188307,694728042,32475,29
2006,ELN,chr7,F,74027771,74069907,6840560,42136,694770178,32476,33
2020,EN2,chr7,F,155458128,155464831,6847263,6703,694776881,32477,1
2041,EPHA1,chr7,R,143390781,143408892,6865374,18111,694794992,32478,18
2050,EPHB4,chr7,R,100802564,100827521,6890331,24957,694819949,32479,16
2051,EPHB6,chr7,F,142854642,142871093,6906782,16451,694836400,32480,20
2056,EPO,chr7,F,100720799,100723700,6909683,2901,694839301,32481,4
2086,ERV3-1,chr7,R,64990354,65006746,6926075,16392,694855693,32482,1
2115,ETV1,chr7,R,13891228,13991425,7026272,100197,694955890,32483,20
2128,EVX1,chr7,F,27242544,27247819,7031547,5275,694961165,32484,4
2146,EZH2,chr7,R,148807371,148884349,7108525,76978,695038143,32485,24
2318,FLNC,chr7,F,128830428,128859274,7137371,28846,695066989,32486,47
2617,GARS,chr7,F,30594564,30634033,7176840,39469,695106458,32487,17
2631,GBAS,chr7,F,55964576,56000182,7212446,35606,695142064,32488,9
2636,GBX1,chr7,R,151146737,151167548,7233257,20811,695162875,32489,3
2645,GCK,chr7,R,44144270,44189423,7278410,45153,695208028,32490,11
2692,GHRHR,chr7,F,30964020,30979531,7293921,15511,695223539,32491,12
2737,GLI3,chr7,R,41960948,42264112,7597085,303164,695526703,32492,19
2768,GNA12,chr7,R,2728104,2870656,7739637,142552,695669255,32493,7
2770,GNAI1,chr7,F,80134823,80219409,7824223,84586,695753841,32494,8
2783,GNB2,chr7,F,100673739,100679169,7829653,5430,695759271,32495,9
2791,GNG11,chr7,F,93921703,93926514,7834464,4811,695764082,32496,1
2792,GNGT1,chr7,F,93906507,93911173,7839130,4666,695768748,32497,2
2845,GPR22,chr7,F,107470056,107476212,7845286,6156,695774904,32498,3
2852,GPER1,chr7,F,1086806,1093815,7852295,7009,695781913,32499,2
2861,GPR37,chr7,R,124745600,124766025,7872720,20425,695802338,32500,1
2887,GRB10,chr7,R,50590062,50793462,8076120,203400,696005738,32501,34
2913,GRM3,chr7,F,86643913,86864879,8297086,220966,696226704,32502,7
2918,GRM8,chr7,R,126438597,127253294,9111783,814697,697041401,32503,26
2969,GTF2I,chr7,F,74657664,74760692,9214811,103028,697144429,32504,35
2970,GTF2IP1,chr7,R,75185382,75237705,9267134,52323,697196752,32505,23
2990,GUSB,chr7,R,65960683,65982314,9288765,21631,697218383,32506,11
3082,HGF,chr7,R,81699005,81770438,9360198,71433,697289816,32507,19
3092,HIP1,chr7,R,75533297,75738972,9565873,205675,697495491,32508,32
3110,MNX1,chr7,R,157004852,157010653,9571674,5801,697501292,32509,3
3181,HNRNPA2B1,chr7,R,26189926,26200793,9582541,10867,697512159,32510,11
3198,HOXA1,chr7,R,27092992,27096006,9585555,3014,697515173,32511,1
3199,HOXA2,chr7,R,27100353,27102775,9587977,2422,697517595,32512,1
3200,HOXA3,chr7,R,27106189,27152581,9634369,46392,697563987,32513,9
3201,HOXA4,chr7,R,27128506,27130780,9636643,2274,697566261,32514,1
3202,HOXA5,chr7,R,27141051,27143668,9639260,2617,697568878,32515,1
3203,HOXA6,chr7,R,27145582,27147774,9641452,2192,697571070,32516,1
3204,HOXA7,chr7,R,27153715,27156677,9644414,2962,697574032,32517,1
3205,HOXA9,chr7,R,27162437,27165530,9647507,3093,697577125,32518,1
3206,HOXA10,chr7,R,27170590,27180261,9657178,9671,697586796,32519,2
3207,HOXA11,chr7,R,27181156,27185216,9661238,4060,697590856,32520,1
3209,HOXA13,chr7,R,27193418,27200266,9668086,6848,697597704,32521,2
3262,HPVC1,chr7,R,54201223,54202421,9669284,1198,697598902,32522,0
3268,AGFG2,chr7,F,100539210,100568220,9698294,29010,697627912,32523,12
3315,HSPB1,chr7,F,76302557,76304297,9700034,1740,697629652,32524,2
3361,HTR5A,chr7,F,155070323,155087392,9717103,17069,697646721,32525,1
3364,HUS1,chr7,R,47963287,47979625,9733441,16338,697663059,32526,7
3382,ICA1,chr7,R,8113183,8262687,9882945,149504,697812563,32527,21
3475,IFRD1,chr7,F,112423143,112477203,9937005,54060,697866623,32528,16
3484,IGFBP1,chr7,F,45888359,45893668,9942314,5309,697871932,32529,3
3486,IGFBP3,chr7,R,45912244,45921272,9951342,9028,697880960,32530,4
3569,IL6,chr7,F,22725441,22732002,9957903,6561,697887521,32531,4
3614,IMPDH1,chr7,R,128392276,128409987,9975614,17711,697905232,32532,17
3624,INHBA,chr7,R,41689002,41703108,9989720,14106,697919338,32533,2
3638,INSIG1,chr7,F,155297775,155310235,10002180,12460,697931798,32534,6
3663,IRF5,chr7,F,128937736,128950042,10014486,12306,697944104,32535,12
3696,ITGB8,chr7,F,20329802,20415759,10100443,85957,698030061,32536,17
3751,KCND2,chr7,F,120273640,120750333,10577136,476693,698506754,32537,9
3757,KCNH2,chr7,R,150944955,150978314,10610495,33359,698540113,32538,16
3792,KEL,chr7,R,142941113,142962416,10631798,21303,698561416,32539,19
3912,LAMB1,chr7,R,107923800,108003359,10711357,79559,698640975,32540,34
3952,LEP,chr7,F,128241201,128257629,10727785,16428,698657403,32541,2
3955,LFNG,chr7,F,2512528,2529177,10744434,16649,698674052,32542,12
3984,LIMK1,chr7,F,74083776,74122525,10783183,38749,698712801,32543,16
4034,LRCH4,chr7,R,100574010,100586188,10795361,12178,698724979,32544,17
4176,MCM7,chr7,R,100092727,100101940,10804574,9213,698734192,32545,14
4189,DNAJB9,chr7,F,108569744,108574850,10809680,5106,698739298,32546,2
4191,MDH2,chr7,F,76048018,76067508,10829170,19490,698758788,32547,9
4223,MEOX2,chr7,R,15611211,15686683,10904642,75472,698834260,32548,2
4232,MEST,chr7,F,130486174,130506297,10924765,20123,698854383,32549,13
4233,MET,chr7,F,116672404,116798386,11050747,125982,698980365,32550,23
4289,MKLN1,chr7,F,131110095,131496639,11437291,386544,699366909,32551,19
4521,NUDT1,chr7,F,2242221,2251145,11446215,8924,699375833,32552,5
4584,MUC3A,chr7,F,100949116,100968347,11465446,19231,699395064,32553,11
4697,NDUFA4,chr7,R,10931952,10940186,11473680,8234,699403298,32554,3
4698,NDUFA5,chr7,R,123536996,123601651,11538335,64655,699467953,32555,12
4708,NDUFB2,chr7,F,140696680,140706646,11548301,9966,699477919,32556,3
4846,NOS3,chr7,F,150991055,151014599,11571845,23544,699501463,32557,28
4850,CNOT4,chr7,R,135361794,135510127,11720178,148333,699649796,32558,14
4852,NPY,chr7,F,24284187,24291865,11727856,7678,699657474,32559,3
4885,NPTX2,chr7,F,98617284,98629869,11740441,12585,699670059,32560,4
4897,NRCAM,chr7,R,108147625,108456397,12049213,308772,699978831,32561,36
4899,NRF1,chr7,F,129611701,129757082,12194594,145381,700124212,32562,12
4951,OCM2,chr7,R,97984699,97990104,12199999,5405,700129617,32563,3
4967,OGDH,chr7,F,44606521,44709070,12302548,102549,700232166,32564,25
5001,ORC5,chr7,R,104126340,104208047,12384255,81707,700313873,32565,14
5054,SERPINE1,chr7,F,101127088,101139266,12396433,12178,700326051,32566,8
5078,PAX4,chr7,R,127610291,127618192,12404334,7901,700333952,32567,11
5118,PCOLCE,chr7,F,100602258,100608175,12410251,5917,700339869,32568,8
5137,PDE1C,chr7,R,31616776,32299404,13092879,682628,701022497,32569,27
5154,PDGFA,chr7,R,497257,520668,13116290,23411,701045908,32570,8
5166,PDK4,chr7,R,95583496,95596613,13129407,13117,701059025,32571,10
5172,SLC26A4,chr7,F,107660634,107717809,13186582,57175,701116200,32572,22
5189,PEX1,chr7,R,92487022,92528531,13228091,41509,701157709,32573,23
5218,CDK14,chr7,F,90596361,91210590,13842320,614229,701771938,32574,22
5224,PGAM2,chr7,R,44062726,44065972,13845566,3246,701775184,32575,2
5243,ABCB1,chr7,R,87503862,87713323,14055027,209461,701984645,32576,28
5244,ABCB4,chr7,R,87402043,87477523,14130507,75480,702060125,32577,29
5260,PHKG1,chr7,R,56080282,56093396,14143621,13114,702073239,32578,10
5294,PIK3CG,chr7,F,106865277,106908978,14187322,43701,702116940,32579,13
5304,PIP,chr7,F,143132080,143139741,14194983,7661,702124601,32580,3
5379,PMS2P1,chr7,R,100320639,100336307,14210651,15668,702140269,32581,6
5380,PMS2P2,chr7,R,75343936,75358997,14225712,15061,702155330,32582,4
5382,PMS2P4,chr7,R,67276130,67302442,14252024,26312,702181642,32583,6
5383,PMS2P5,chr7,F,74890767,74921138,14282395,30371,702212013,32584,7
5387,PMS2P3,chr7,R,75507746,75528123,14302772,20377,702232390,32585,8
5395,PMS2,chr7,R,5970924,6009106,14340954,38182,702270572,32586,17
5420,PODXL,chr7,R,131500261,131556617,14397310,56356,702326928,32587,8
5425,POLD2,chr7,R,44114679,44123668,14406299,8989,702335917,32588,12
5439,POLR2J,chr7,R,102473099,102478999,14412199,5900,702341817,32589,3
5444,PON1,chr7,R,95298356,95324572,14438415,26216,702368033,32590,8
5445,PON2,chr7,R,95404861,95435072,14468626,30211,702398244,32591,8
5446,PON3,chr7,R,95359871,95396375,14505130,36504,702434748,32592,8
5447,POR,chr7,F,75915101,75986855,14576884,71754,702506502,32593,15
5478,PPIA,chr7,F,44796635,44803123,14583372,6488,702512990,32594,5
5506,PPP1R3A,chr7,R,113876826,113919027,14625573,42201,702555191,32595,3
5575,PRKAR1B,chr7,R,549195,727676,14804054,178481,702733672,32596,17
5577,PRKAR2B,chr7,F,107044727,107161811,14921138,117084,702850756,32597,11
5644,PRSS1,chr7,F,142740234,142753076,14933980,12842,702863598,32598,6
5645,PRSS2,chr7,F,142770942,142774564,14937602,3622,702867220,32599,5
5649,RELN,chr7,R,103471783,103989516,15455335,517733,703384953,32600,64
5683,PSMA2,chr7,R,42916860,42932206,15470681,15346,703400299,32601,7
5701,PSMC2,chr7,F,103344404,103369395,15495672,24991,703425290,32602,12
5723,PSPH,chr7,R,56010362,56051604,15536914,41242,703466532,32603,11
5726,TAS2R38,chr7,R,141972630,141973773,15538057,1143,703467675,32604,0
5764,PTN,chr7,R,137227340,137343860,15654577,116520,703584195,32605,5
5782,PTPN12,chr7,F,77537455,77640071,15757193,102616,703686811,32606,18
5799,PTPRN2,chr7,R,157539055,158587796,16805934,1048741,704735552,32607,26
5803,PTPRZ1,chr7,F,121873104,122062036,16994866,188932,704924484,32608,29
5814,PURB,chr7,R,44876292,44885385,17003959,9093,704933577,32609,0
5879,RAC1,chr7,F,6374494,6403967,17033432,29473,704963050,32610,6
5898,RALA,chr7,F,39622954,39708124,17118602,85170,705048220,32611,7
5919,RARRES2,chr7,R,150338317,150341674,17121959,3357,705051577,32612,5
5982,RFC2,chr7,R,74231484,74254458,17144933,22974,705074551,32613,10
6009,RHEB,chr7,R,151466011,151519924,17198846,53913,705128464,32614,8
6084,RNY1,chr7,R,148987135,148987248,17198959,113,705128577,32615,0
6085,RNY3,chr7,F,148983754,148983856,17199061,102,705128679,32616,0
6086,RNY4,chr7,F,148963314,148963410,17199157,96,705128775,32617,0
6090,RNY5,chr7,F,148941487,148941571,17199241,84,705128859,32618,0
6100,RP9,chr7,R,33094796,33109390,17213835,14594,705143453,32619,6
6119,RPA3,chr7,R,7636943,7718607,17295499,81664,705225117,32620,7
6369,CCL24,chr7,R,75811428,75823356,17307427,11928,705237045,32621,5
6424,SFRP4,chr7,R,37905931,37916923,17318419,10992,705248037,32622,5
6469,SHH,chr7,R,155802863,155812273,17327829,9410,705257447,32623,5
6522,SLC4A2,chr7,F,151058211,151076527,17346145,18316,705275763,32624,25
6561,SLC13A1,chr7,R,123113533,123199975,17432587,86442,705362205,32625,18
6604,SMARCD3,chr7,R,151238972,151277149,17470764,38177,705400382,32626,15
6608,SMO,chr7,F,129188871,129213546,17495439,24675,705425057,32627,12
6624,FSCN1,chr7,F,5592804,5606656,17509291,13852,705438909,32628,4
6671,SP4,chr7,F,21428070,21514822,17596043,86752,705525661,32629,11
6677,SPAM1,chr7,F,123925231,123971410,17642222,46179,705571840,32630,8
6717,SRI,chr7,R,88205114,88226993,17664101,21879,705593719,32631,8
6718,AKR1D1,chr7,F,138076431,138118304,17705974,41873,705635592,32632,8
6733,SRPK2,chr7,R,105113600,105399366,17991740,285766,705921358,32633,24
6742,SSBP1,chr7,F,141738320,141750488,18003908,12168,705933526,32634,8
6804,STX1A,chr7,R,73699204,73719702,18024406,20498,705954024,32635,10
6856,SYPL1,chr7,R,106090367,106112647,18046686,22280,705976304,32636,6
6863,TAC1,chr7,F,97731958,97740472,18055200,8514,705984818,32637,6
6878,TAF6,chr7,R,100107069,100119858,18067989,12789,705997607,32638,17
6916,TBXAS1,chr7,F,139778247,140020325,18310067,242078,706239685,32639,18
7036,TFR2,chr7,R,100620415,100642765,18332417,22350,706262035,32640,19
7205,TRIP6,chr7,F,100866220,100873455,18339652,7235,706269270,32641,9
7291,TWIST1,chr7,R,19113046,19117672,18344278,4626,706273896,32642,3
7328,UBE2H,chr7,R,129830731,129952960,18466507,122229,706396125,32643,8
7378,UPP1,chr7,F,48088602,48108733,18486638,20131,706416256,32644,10
7425,VGF,chr7,R,101162508,101169935,18494065,7427,706423683,32645,4
7434,VIPR2,chr7,R,159028174,159144957,18610848,116783,706540466,32646,16
7455,ZAN,chr7,F,100733582,100797797,18675063,64215,706604681,32647,46
7458,EIF4H,chr7,F,74174375,74197101,18697789,22726,706627407,32648,7
7461,CLIP2,chr7,F,74289474,74405943,18814258,116469,706743876,32649,16
7462,LAT2,chr7,F,74209391,74229834,18834701,20443,706764319,32650,13
7472,WNT2,chr7,R,117276630,117323289,18881360,46659,706810978,32651,4
7516,XRCC2,chr7,R,152646497,152676165,18911028,29668,706840646,32652,2
7532,YWHAG,chr7,R,76326790,76359025,18943263,32235,706872881,32653,1
7551,ZNF3,chr7,R,100063846,100082548,18961965,18702,706891583,32654,6
7559,ZNF12,chr7,R,6688432,6706969,18980502,18537,706910120,32655,4
7586,ZKSCAN1,chr7,F,100015571,100045143,19010074,29572,706939692,32656,7
7589,ZSCAN21,chr7,F,100049766,100065042,19025350,15276,706954968,32657,5
7697,ZNF138,chr7,F,64794387,64853800,19084763,59413,707014381,32658,9
7784,ZP3,chr7,F,76397523,76442071,19129311,44548,707058929,32659,8
7791,ZYX,chr7,F,143378328,143391111,19142094,12783,707071712,32660,9
7965,AIMP2,chr7,F,6009250,6023834,19156678,14584,707086296,32661,7
7975,MAFK,chr7,F,1530731,1543043,19168990,12312,707098608,32662,4
7978,MTERF1,chr7,R,91872875,91880720,19176835,7845,707106453,32663,3
7979,SHFM1,chr7,R,96688766,96709891,19197960,21125,707127578,32664,2
7980,TFPI2,chr7,R,93885396,93890991,19203555,5595,707133173,32665,4
7982,ST7,chr7,F,116953326,117230023,19480252,276697,707409870,32666,16
7984,ARHGEF5,chr7,F,144355395,144380632,19505489,25237,707435107,32667,14
7988,ZNF212,chr7,F,149239647,149255609,19521451,15962,707451069,32668,5
8295,TRRAP,chr7,F,98878489,99013243,19656205,134754,707585823,32669,71
8321,FZD1,chr7,F,91264467,91268817,19660555,4350,707590173,32670,0
8326,FZD9,chr7,F,73433778,73436120,19662897,2342,707592515,32671,0
8379,MAD1L1,chr7,R,1815791,2232948,20080054,417157,708009672,32672,24
8427,ZNF282,chr7,F,149195461,149226248,20110841,30787,708040459,32673,8
8454,CUL1,chr7,F,148698177,148801110,20213774,102933,708143392,32674,24
8460,TPST1,chr7,F,66205271,66360451,20368954,155180,708298572,32675,7
8468,FKBP6,chr7,F,73328151,73358637,20399440,30486,708329058,32676,8
8621,CDK13,chr7,F,39949837,40097134,20546737,147297,708476355,32677,15
8662,EIF3B,chr7,F,2354539,2380745,20572943,26206,708502561,32678,18
8701,DNAH11,chr7,F,21543214,21901568,20931297,358354,708860915,32679,81
8805,TRIM24,chr7,F,138460215,138585588,21056670,125373,708986288,32680,19
8887,TAX1BP1,chr7,F,27739372,27829767,21147065,90395,709076683,32681,17
8896,BUD31,chr7,F,99408640,99419616,21158041,10976,709087659,32682,6
8910,SGCE,chr7,R,94585223,94656209,21229027,70986,709158645,32683,14
8935,SKAP2,chr7,R,26667061,26864743,21426709,197682,709356327,32684,13
8972,MGAM,chr7,F,141988887,142106747,21544569,117860,709474187,32685,73
8976,WASL,chr7,R,123681926,123749071,21611714,67145,709541332,32686,10
8985,PLOD3,chr7,R,101205976,101217730,21623468,11754,709553086,32687,18
9031,BAZ1B,chr7,R,73440397,73522298,21705369,81901,709634987,32688,20
9069,CLDN12,chr7,F,90403333,90415954,21717990,12621,709647608,32689,3
9162,DGKI,chr7,R,137387653,137846863,22177200,459210,710106818,32690,40
9179,AP4M1,chr7,F,100101411,100107180,22182969,5769,710112587,32691,16
9238,TBRG4,chr7,R,45100099,45111747,22194617,11648,710124235,32692,10
9263,STK17A,chr7,F,43583092,43627379,22238904,44287,710168522,32693,6
9265,CYTH3,chr7,R,6161778,6272611,22349737,110833,710279355,32694,12
9275,BCL7B,chr7,R,73536352,73557735,22371120,21383,710300738,32695,7
9296,ATP6V1F,chr7,F,128862802,128865849,22374167,3047,710303785,32696,2
9311,ASIC3,chr7,F,151048291,151052756,22378632,4465,710308250,32697,10
9512,PMPCB,chr7,F,103297425,103329902,22411109,32477,710340727,32698,13
9551,ATP5J2,chr7,R,99458160,99466201,22419150,8041,710348768,32699,8
9569,GTF2IRD1,chr7,F,74453789,74602605,22567966,148816,710497584,32700,27
9586,CREB5,chr7,F,28299320,28825894,23094540,526574,711024158,32701,17
9601,PDIA4,chr7,R,149003050,149028690,23120180,25640,711049798,32702,9
9603,NFE2L3,chr7,F,26152226,26187137,23155091,34911,711084709,32703,3
9678,PHF14,chr7,F,10957891,11169828,23367028,211937,711296646,32704,23
9690,UBE3C,chr7,F,157138958,157269372,23497442,130414,711427060,32705,23
9715,FAM131B,chr7,R,143353399,143382304,23526347,28905,711455965,32706,8
9723,SEMA3E,chr7,R,83363905,83649163,23811605,285258,711741223,32707,18
9732,DOCK4,chr7,R,111726107,112206407,24291905,480300,712221523,32708,52
9734,HDAC9,chr7,F,18086941,18999521,25204485,912580,713134103,32709,36
9747,TCAF1,chr7,R,143851367,143902198,25255316,50831,713184934,32710,11
9771,RAPGEF5,chr7,R,22118289,22357133,25494160,238844,713423778,32711,27
9805,SCRN1,chr7,R,29920102,29990289,25564347,70187,713493965,32712,11
9808,KIAA0087,chr7,R,26533120,26538825,25570052,5705,713499670,32713,1
9844,ELMO1,chr7,R,36852905,37449409,26166556,596504,714096174,32714,27
9863,MAGI2,chr7,R,78017054,79453805,27603307,1436751,715532925,32715,29
9865,TRIL,chr7,R,28953357,28958413,27608363,5056,715537981,32716,0
9883,POM121,chr7,F,72879334,72951440,27680469,72106,715610087,32717,18
9907,AP5Z1,chr7,F,4775630,4794395,27699234,18765,715628852,32718,16
9988,DMTF1,chr7,F,87152360,87196332,27743206,43972,715672824,32719,20
10049,DNAJB6,chr7,F,157337015,157417439,27823630,80424,715753248,32720,10
10061,ABCF2,chr7,R,151207829,151227374,27843175,19545,715772793,32721,16
10071,MUC12,chr7,F,100969622,101018949,27892502,49327,715822120,32722,11
10095,ARPC1B,chr7,F,99374674,99394801,27912629,20127,715842247,32723,10
10124,ARL4A,chr7,F,12686826,12690934,27916737,4108,715846355,32724,2
10135,NAMPT,chr7,R,106248284,106285732,27954185,37448,715883803,32725,12
10142,AKAP9,chr7,F,91940866,92110673,28123992,169807,716053610,32726,53
10156,RASA4,chr7,R,102579645,102616758,28161105,37113,716090723,32727,20
10157,AASS,chr7,R,122073543,122144290,28231852,70747,716161470,32728,25
10165,SLC25A13,chr7,R,96120219,96322147,28433780,201928,716363398,32729,19
10234,LRRC17,chr7,F,102912896,102945111,28465995,32215,716395613,32730,5
10248,POP7,chr7,F,100706052,100707500,28467443,1448,716397061,32731,1
10268,RAMP3,chr7,F,45157767,45184250,28493926,26483,716423544,32732,4
10282,BET1,chr7,R,93962769,94004390,28535547,41621,716465165,32733,6
10320,IKZF1,chr7,F,50303464,50405101,28637184,101637,716566802,32734,14
10344,CCL26,chr7,R,75769523,75789746,28657407,20223,716587025,32735,3
10371,SEMA3A,chr7,R,83956804,84492724,29193327,535920,717122945,32736,23
10392,NOD1,chr7,R,30424526,30478797,29247598,54271,717177216,32737,18
10447,FAM3C,chr7,R,121348244,121396369,29295723,48125,717225341,32738,11
10457,GPNMB,chr7,F,23246685,23275110,29324148,28425,717253766,32739,10
10466,COG5,chr7,R,107201743,107564514,29686919,362771,717616537,32740,22
10467,ZNHIT1,chr7,F,101217703,101224192,29693408,6489,717623026,32741,5
10512,SEMA3C,chr7,R,80742537,80919351,29870222,176814,717799840,32742,18
10551,AGR2,chr7,R,16791810,16805114,29883526,13304,717813144,32743,7
10552,ARPC1A,chr7,F,99325872,99366262,29923916,40390,717853534,32744,9
10603,SH2B2,chr7,F,102285058,102321711,29960569,36653,717890187,32745,11
10643,IGF2BP3,chr7,R,23310208,23470527,30120888,160319,718050506,32746,17
10652,YKT6,chr7,F,44200967,44214294,30134215,13327,718063833,32747,7
10734,STAG3,chr7,F,100177562,100214387,30171040,36825,718100658,32748,34
10793,ZNF273,chr7,F,64870176,64932239,30233103,62063,718162721,32749,12
10842,PPP1R17,chr7,F,31687016,31709911,30255998,22895,718185616,32750,4
10875,FGL2,chr7,R,77193370,77199833,30262461,6463,718192079,32751,1
10898,CPSF4,chr7,F,99438939,99457373,30280895,18434,718210513,32752,8
10922,FASTK,chr7,R,151076619,151080883,30285159,4264,718214777,32753,8
10926,DBF4,chr7,F,87876228,87909541,30318472,33313,718248090,32754,11
10980,COPS6,chr7,F,100088959,100092200,30321713,3241,718251331,32755,9
11014,KDELR2,chr7,R,6461080,6484218,30344851,23138,718274469,32756,4
11033,ADAP1,chr7,R,897899,955407,30402359,57508,718331977,32757,14
11055,ZPBP,chr7,R,49850321,50093264,30645302,242943,718574920,32758,12
11062,DUS4L,chr7,F,107563956,107578523,30659869,14567,718589487,32759,7
11097,NUPL2,chr7,F,23181826,23201011,30679054,19185,718608672,32760,8
11112,HIBADH,chr7,R,27525439,27663001,30816616,137562,718746234,32761,8
11179,ZNF277,chr7,F,112206587,112343934,30953963,137347,718883581,32762,11
11185,INMT,chr7,F,30752134,30757602,30959431,5468,718889049,32763,2
11194,ABCB8,chr7,F,151028421,151047782,30978792,19361,718908410,32764,16
11257,TP53TG1,chr7,R,87325346,87345492,30998938,20146,718928556,32765,2
11281,POU6F2,chr7,F,38977903,39468601,31489636,490698,719419254,32766,11
11328,FKBP9,chr7,F,32957403,33006931,31539164,49528,719468782,32767,12
11333,PDAP1,chr7,R,99394672,99408682,31553174,14010,719482792,32768,5
11335,CBX3,chr7,F,26201210,26213607,31565571,12397,719495189,32769,7
22797,TFEC,chr7,R,115935147,116159891,31790315,224744,719719933,32770,16
22798,LAMB4,chr7,R,108003985,108130356,31916686,126371,719846304,32771,41
22853,LMTK2,chr7,F,98106874,98209636,32019448,102762,719949066,32772,13
22932,POMZP3,chr7,R,76609985,76627303,32036766,17318,719966384,32773,6
22976,PAXIP1,chr7,R,154943686,155003178,32096258,59492,720025876,32774,23
23008,KLHDC10,chr7,F,130070508,130135720,32161470,65212,720091088,32775,9
23072,HECW1,chr7,F,43112598,43563654,32612526,451056,720542144,32776,34
23080,AVL9,chr7,F,32495425,32588741,32705842,93316,720635460,32777,17
23089,PEG10,chr7,F,94656324,94669695,32719213,13371,720648831,32778,1
23145,SSPO,chr7,F,149776041,149833965,32777137,57924,720706755,32779,102
23148,NACAD,chr7,R,45080436,45088961,32785662,8525,720715280,32780,7
23161,SNX13,chr7,R,17790760,17940518,32935420,149758,720865038,32781,32
23165,NUP205,chr7,F,135557913,135648753,33026260,90840,720955878,32782,42
23242,COBL,chr7,R,51016211,51316818,33326867,300607,721256485,32783,16
23288,IQCE,chr7,F,2558971,2614734,33382630,55763,721312248,32784,23
23333,DPY19L1,chr7,R,34928878,35038041,33491793,109163,721421411,32785,22
23353,SUN1,chr7,F,815556,874920,33551157,59364,721480775,32786,21
23366,KIAA0895,chr7,R,36324149,36390125,33617133,65976,721546751,32787,8
23382,AHCYL2,chr7,F,129225013,129430211,33822331,205198,721751949,32788,19
23386,NUDCD3,chr7,R,44382365,44490878,33930844,108513,721860462,32789,6
23480,SEC61G,chr7,R,54752246,54759246,33937844,7000,721867462,32790,3
23534,TNPO3,chr7,R,128954179,129055173,34038838,100994,721968456,32791,24
23553,HYAL4,chr7,F,123845168,123877481,34071151,32313,722000769,32792,7
23554,TSPAN12,chr7,R,120787319,120858366,34142198,71047,722071816,32793,10
23601,CLEC5A,chr7,R,141927356,141947007,34161849,19651,722091467,32794,6
23608,MKRN1,chr7,R,140453039,140479569,34188379,26530,722117997,32795,10
23658,LSM5,chr7,R,32485332,32495258,34198305,9926,722127923,32796,5
23660,ZKSCAN5,chr7,F,99501296,99534107,34231116,32811,722160734,32797,10
24146,CLDN15,chr7,R,101232091,101238820,34237845,6729,722167463,32798,4
25798,BRI3,chr7,F,98281666,98323430,34279609,41764,722209227,32799,6
25851,TECPR1,chr7,R,98215442,98252251,34316418,36809,722246036,32800,26
25870,SUMF2,chr7,F,56064006,56080672,34333084,16666,722262702,32801,9
25913,POT1,chr7,R,124822385,124929983,34440682,107598,722370300,32802,21
25928,SOSTDC1,chr7,R,16461480,16465849,34445051,4369,722374669,32803,1
25948,KBTBD2,chr7,R,32868165,32892144,34469030,23979,722398648,32804,5
26024,PTCD1,chr7,R,99416738,99438839,34491131,22101,722420749,32805,7
26031,OSBPL3,chr7,R,24796536,24980212,34674807,183676,722604425,32806,25
26047,CNTNAP2,chr7,F,146116360,148420998,36979445,2304638,724909063,32807,24
26053,AUTS2,chr7,F,69598474,70793068,38174039,1194594,726103657,32808,22
26062,HYALP1,chr7,F,123814138,123819430,38179331,5292,726108949,32809,1
26100,WIPI2,chr7,F,5190203,5233855,38222983,43652,726152601,32810,12
26136,TES,chr7,F,116210492,116258786,38271277,48294,726200895,32811,7
26157,GIMAP2,chr7,F,150685705,150693641,38279213,7936,726208831,32812,2
26173,INTS1,chr7,R,1470276,1504382,38313319,34106,726242937,32813,47
26211,OR2F1,chr7,F,143907125,143961015,38367209,53890,726296827,32814,4
26261,FBXO24,chr7,F,100586332,100601117,38381994,14785,726311612,32815,11
26266,SLC13A4,chr7,R,135681230,135728185,38428949,46955,726358567,32816,15
26608,TBL2,chr7,R,73568943,73578683,38438689,9740,726368307,32817,8
26872,STEAP1,chr7,F,90154374,90164827,38449142,10453,726378760,32818,4
26958,COPG2,chr7,R,130506237,130668758,38611663,162521,726541281,32819,23
26959,HBP1,chr7,F,107168960,107202529,38645232,33569,726574850,32820,12
27000,DNAJC2,chr7,R,103312473,103344873,38677632,32400,726607250,32821,17
27010,TPK1,chr7,R,144451940,144836411,39062103,384471,726991721,32822,26
27044,SND1,chr7,F,127652118,128092607,39502592,440489,727432210,32823,25
27072,VPS41,chr7,R,38723942,38909200,39687850,185258,727617468,32824,29
27075,TSPAN13,chr7,F,16753725,16784536,39718661,30811,727648279,32825,5
27099,SND1-IT1,chr7,F,127997508,128000077,39721230,2569,727650848,32826,0
27102,EIF2AK1,chr7,R,6022246,6059229,39758213,36983,727687831,32827,14
27147,DENND2A,chr7,R,140518417,140641732,39881528,123315,727811146,32828,24
27153,ZNF777,chr7,R,149431362,149460962,39911128,29600,727840746,32829,7
27241,BBS9,chr7,F,33129243,33635769,40417654,506526,728347272,32830,25
27297,CRCP,chr7,F,66114817,66154568,40457405,39751,728387023,32831,6
27342,RABGEF1,chr7,F,66682090,66811464,40586779,129374,728516397,32832,13
27434,POLM,chr7,R,44072061,44082540,40597258,10479,728526876,32833,12
27445,PCLO,chr7,R,82754004,83162881,41006135,408877,728935753,32834,24
28959,TMEM176B,chr7,R,150791286,150801360,41016209,10074,728945827,32835,8
28969,BZW2,chr7,F,16646133,16706523,41076599,60390,729006217,32836,14
28988,DBNL,chr7,F,44044639,44061716,41093676,17077,729023294,32837,12
28996,HIPK2,chr7,R,139561569,139777894,41310001,216325,729239619,32838,18
29062,WDR91,chr7,R,135183837,135211564,41337728,27727,729267346,32839,16
29803,REPIN1,chr7,F,150368228,150374044,41343544,5816,729273162,32840,2
29881,NPC1L1,chr7,R,44512534,44541330,41372340,28796,729301958,32841,19
29886,SNX8,chr7,R,2251769,2314475,41435046,62706,729364664,32842,12
29887,SNX10,chr7,F,26291894,26374383,41517535,82489,729447153,32843,10
29896,TRA2A,chr7,R,23504779,23532041,41544797,27262,729474415,32844,8
29923,HILPDA,chr7,F,128455829,128458418,41547386,2589,729477004,32845,1
29960,FTSJ2,chr7,R,2234290,2242198,41555294,7908,729484912,32846,2
29969,MDFIC,chr7,F,114922153,115019916,41653057,97763,729582675,32847,5
29990,PILRB,chr7,F,100358002,100367831,41662886,9829,729592504,32848,16
29992,PILRA,chr7,F,100373444,100400099,41689541,26655,729619159,32849,6
29999,FSCN3,chr7,F,127593634,127601797,41697704,8163,729627322,32850,6
30010,NXPH1,chr7,F,8433954,8752963,42016713,319009,729946331,32851,3
30816,ERVW-1,chr7,R,92468379,92477915,42026249,9536,729955867,32852,1
50617,ATP6V0A4,chr7,R,138706293,138799632,42119588,93339,730049206,32853,23
50640,PNPLA8,chr7,R,108470421,108528161,42177328,57740,730106946,32854,14
50831,TAS2R3,chr7,F,141764096,141765197,42178429,1101,730108047,32855,0
50832,TAS2R4,chr7,F,141778488,141779388,42179329,900,730108947,32856,0
50833,TAS2R16,chr7,R,122994704,122995700,42180325,996,730109943,32857,0
51024,FIS1,chr7,R,101239611,101245090,42185804,5479,730115422,32858,4
51085,MLXIPL,chr7,R,73593193,73624540,42217151,31347,730146769,32859,17
51119,SBDS,chr7,R,66987702,66995601,42225050,7899,730154668,32860,4
51142,CHCHD2,chr7,R,56101572,56106494,42229972,4922,730159590,32861,3
51200,CPA4,chr7,F,130293133,130324180,42261019,31047,730190637,32862,10
51251,NT5C3A,chr7,R,33014112,33062797,42309704,48685,730239322,32863,11
51314,NME8,chr7,F,37848596,37900401,42361509,51805,730291127,32864,17
51351,ZNF117,chr7,R,64974451,64991036,42378094,16585,730307712,32865,3
51373,MRPS17,chr7,F,55951917,55955341,42381518,3424,730311136,32866,2
51384,WNT16,chr7,F,121325366,121341104,42397256,15738,730326874,32867,4
51412,ACTL6B,chr7,R,100643096,100656461,42410621,13365,730340239,32868,13
51422,PRKAG2,chr7,R,151556113,151877231,42731739,321118,730661357,32869,19
51427,ZNF107,chr7,F,64666082,64711582,42777239,45500,730706857,32870,7
51530,ZC3HC1,chr7,R,130018285,130051451,42810405,33166,730740023,32871,12
51593,SRRT,chr7,F,100874970,100888664,42824099,13694,730753717,32872,22
51608,GET4,chr7,F,876553,896434,42843980,19881,730773598,32873,8
51619,UBE2D4,chr7,F,43926435,43956136,42873681,29701,730803299,32874,8
51622,CCZ1,chr7,F,5898709,5925976,42900948,27267,730830566,32875,14
51631,LUC7L2,chr7,F,139340358,139423457,42984047,83099,730913665,32876,12
51650,MRPS33,chr7,R,141006160,141014981,42992868,8821,730922486,32877,3
51657,STYXL1,chr7,R,75995833,76048003,43045038,52170,730974656,32878,8
51666,ASB4,chr7,F,95461541,95540231,43123728,78690,731053346,32879,6
51667,NUB1,chr7,F,151341698,151378461,43160491,36763,731090109,32880,15
51678,MPP6,chr7,F,24573345,24693703,43280849,120358,731210467,32881,14
51691,LSM8,chr7,F,118184031,118204039,43300857,20008,731230475,32882,3
53616,ADAM22,chr7,F,87934156,88202889,43569590,268733,731499208,32883,34
53844,COPG2IT1,chr7,F,130543452,130546900,43573038,3448,731502656,32884,0
54103,GSAP,chr7,R,77310750,77416408,43678696,105658,731608314,32885,33
54205,CYCS,chr7,R,25118650,25125361,43685407,6711,731615025,32886,2
54329,GPR85,chr7,R,113080412,113087778,43692773,7366,731622391,32887,2
54429,TAS2R5,chr7,F,141790216,141791366,43693923,1150,731623541,32888,0
54441,STAG3L1,chr7,F,75359199,75367809,43702533,8610,731632151,32889,9
54443,ANLN,chr7,F,36389802,36453791,43766522,63989,731696140,32890,24
54467,ANKIB1,chr7,F,92246215,92401770,43922077,155555,731851695,32891,21
54468,MIOS,chr7,F,7566890,7607514,43962701,40624,731892319,32892,13
54476,RNF216,chr7,R,5620040,5781730,44124391,161690,732054009,32893,20
54480,CHPF2,chr7,F,151232488,151238827,44130730,6339,732060348,32894,3
54504,CPVL,chr7,R,28995630,29146537,44281637,150907,732211255,32895,12
54517,PUS7,chr7,R,105456510,105522242,44347369,65732,732276987,32896,16
54543,TOMM7,chr7,R,22812631,22822852,44357590,10221,732287208,32897,2
54556,ING3,chr7,F,120950762,120975657,44382485,24895,732312103,32898,12
54606,DDX56,chr7,R,44565416,44574538,44391607,9122,732321225,32899,13
54664,TMEM106B,chr7,F,12211221,12237264,44417650,26043,732347268,32900,8
54674,LRRN3,chr7,F,111091005,111125454,44452099,34449,732381717,32901,3
54677,CROT,chr7,F,87345634,87399796,44506261,54162,732435879,32902,19
54749,EPDR1,chr7,F,37920560,37951941,44537642,31381,732467260,32903,3
54753,ZNF853,chr7,F,6615718,6624290,44546214,8572,732475832,32904,3
54784,ALKBH4,chr7,R,102456219,102464874,44554869,8655,732484487,32905,2
54809,SAMD9,chr7,R,93099512,93118023,44573380,18511,732502998,32906,2
54892,NCAPG2,chr7,R,158631168,158704831,44647043,73663,732576661,32907,34
54905,CYP2W1,chr7,F,983155,989640,44653528,6485,732583146,32908,8
54919,DNAAF5,chr7,F,726700,786479,44713307,59779,732642925,32909,12
54927,CHCHD3,chr7,R,132784861,133082079,45010525,297218,732940143,32910,10
55025,FLJ20712,chr7,F,33726516,33728456,45012465,1940,732942083,32911,1
55033,FKBP14,chr7,R,30010582,30026801,45028684,16219,732958302,32912,4
55063,ZCWPW1,chr7,R,100400871,100429414,45057227,28543,732986845,32913,18
55069,TMEM248,chr7,F,66921215,66958551,45094563,37336,733024181,32914,7
55112,WDR60,chr7,F,158856577,158946192,45184178,89615,733113796,32915,26
55131,RBM28,chr7,R,128310382,128343913,45217709,33531,733147327,32916,19
55146,ZDHHC4,chr7,F,6577411,6588979,45229277,11568,733158895,32917,7
55253,TYW1,chr7,F,66996804,67239520,45471993,242716,733401611,32918,18
55262,C7orf43,chr7,R,100154419,100158721,45476295,4302,733405913,32919,10
55281,TMEM140,chr7,F,135148013,135166215,45494497,18202,733424115,32920,1
55303,GIMAP4,chr7,F,150567369,150573955,45501083,6586,733430701,32921,2
55340,GIMAP5,chr7,F,150737347,150743649,45507385,6302,733437003,32922,5
55365,TMEM176A,chr7,F,150800524,150805120,45511981,4596,733441599,32923,7
55501,CHST12,chr7,F,2403525,2434607,45543063,31082,733472681,32924,3
55503,TRPV6,chr7,R,142871202,142885745,45557606,14543,733487224,32925,14
55536,CDCA7L,chr7,R,21900898,21945924,45602632,45026,733532250,32926,10
55607,PPP1R9A,chr7,F,94907201,95296415,45991846,389214,733921464,32927,25
55610,CCDC132,chr7,F,93232339,93361123,46120630,128784,734050248,32928,29
55665,URGCP,chr7,R,43875893,43926411,46171148,50518,734100766,32929,7
55695,NSUN5,chr7,R,73302515,73308867,46177500,6352,734107118,32930,8
55698,RADIL,chr7,R,4799108,4883704,46262096,84596,734191714,32931,14
55744,COA1,chr7,R,43608451,43729541,46383186,121090,734312804,32932,12
55750,AGK,chr7,F,141551277,141654409,46486318,103132,734415936,32933,17
55798,METTL2B,chr7,F,128476728,128502924,46512514,26196,734442132,32934,8
55904,KMT2E,chr7,F,105014189,105114085,46612410,99896,734542028,32935,28
55915,LANCL2,chr7,F,55365447,55433742,46680705,68295,734610323,32936,9
55971,BAIAP2L1,chr7,R,98291649,98401115,46790171,109466,734719789,32937,13
55972,SLC25A40,chr7,R,87833567,87876377,46832981,42810,734762599,32938,15
55973,BCAP29,chr7,F,107579976,107623317,46876322,43341,734805940,32939,10
55975,KLHL7,chr7,F,23105733,23175421,46946010,69688,734875628,32940,14
56164,STK31,chr7,F,23710166,23832513,47068357,122347,734997975,32941,24
56257,MEPCE,chr7,F,100428697,100434126,47073786,5429,735003404,32942,4
56302,TRPV5,chr7,R,142908100,142933723,47099409,25623,735029027,32943,14
56311,ANKRD7,chr7,F,118224657,118242731,47117483,18074,735047101,32944,6
56829,ZC3HAV1,chr7,R,139043519,139109720,47183684,66201,735113302,32945,12
56903,PAPOLB,chr7,R,4857737,4861994,47187941,4257,735117559,32946,0
56913,C1GALT1,chr7,F,7182546,7248651,47254046,66105,735183664,32947,5
56975,FAM20C,chr7,F,192776,260774,47322044,67998,735251662,32948,10
56996,SLC12A9,chr7,F,100834035,100867012,47355021,32977,735284639,32949,15
57001,SDHAF3,chr7,F,97116592,97181763,47420192,65171,735349810,32950,3
57002,YAE1D1,chr7,F,39566375,39612089,47465906,45714,735395524,32951,3
57016,AKR1B10,chr7,F,134527591,134541414,47479729,13823,735409347,32952,10
57037,ANKMY2,chr7,R,16599775,16645817,47525771,46042,735455389,32953,10
57057,TBX20,chr7,R,35202429,35254100,47577442,51671,735507060,32954,7
57154,SMURF1,chr7,R,99027434,99144120,47694128,116686,735623746,32955,20
57157,PHTF2,chr7,F,77798791,77957504,47852841,158713,735782459,32956,20
57180,ACTR3B,chr7,F,152759748,152887759,47980852,128011,735910470,32957,19
57189,KIAA1147,chr7,R,141656727,141702169,48026294,45442,735955912,32958,9
57414,RHBDD2,chr7,F,75878998,75888926,48036222,9928,735965840,32959,4
57464,STRIP2,chr7,F,129434432,129488399,48090189,53967,736019807,32960,24
57488,ESYT2,chr7,R,158730997,158829628,48188820,98631,736118438,32961,21
57541,ZNF398,chr7,F,149126415,149183042,48245447,56627,736175065,32962,11
57639,CCDC146,chr7,F,77122616,77295204,48418035,172588,736347653,32963,18
57670,KIAA1549,chr7,R,138831380,138981318,48567973,149938,736497591,32964,19
57786,RBAK,chr7,F,5045820,5069488,48591641,23668,736521259,32965,4
57798,GATAD1,chr7,F,92447447,92491328,48635522,43881,736565140,32966,11
58160,NFE4,chr7,F,102973436,102978667,48640753,5231,736570371,32967,2
58498,MYL7,chr7,R,44138863,44141388,48643278,2525,736572896,32968,6
58508,KMT2C,chr7,R,152134924,152436638,48944992,301714,736874610,32969,63
60412,EXOC4,chr7,F,133253066,134065761,49757687,812695,737687305,32970,19
60561,RINT1,chr7,F,105532084,105567678,49793281,35594,737722899,32971,15
63917,GALNT11,chr7,F,152025673,152122347,49889955,96674,737819573,32972,14
63974,NEUROD6,chr7,R,31337460,31340924,49893419,3464,737823037,32973,1
63979,FIGNL1,chr7,R,50444128,50450390,49899681,6262,737829299,32974,3
64005,MYO1G,chr7,R,44962660,44979105,49916126,16445,737845744,32975,20
64101,LRRC4,chr7,R,128027070,128032107,49921163,5037,737850781,32976,2
64111,NPVF,chr7,R,25224569,25228486,49925080,3917,737854698,32977,2
64224,HERPUD2,chr7,R,35632658,35695187,49987609,62529,737917227,32978,7
64327,LMBR1,chr7,R,156668945,156893208,50211872,224263,738141490,32979,21
64409,WBSCR17,chr7,F,71132413,71713601,50793060,581188,738722678,32980,13
64418,TMEM168,chr7,R,112762381,112790713,50821392,28332,738751010,32981,6
64433,LINC00244,chr7,F,156540490,156541101,50822003,611,738751621,32982,0
64434,NOM1,chr7,F,156949722,156973182,50845463,23460,738775081,32983,11
64598,MOSPD3,chr7,F,100612101,100615384,50848746,3283,738778364,32984,5
64599,GIGYF1,chr7,R,100679506,100694268,50863508,14762,738793126,32985,26
64753,CCDC136,chr7,F,128791409,128822133,50894232,30724,738823850,32986,21
64759,TNS3,chr7,R,47275143,47582553,51201642,307410,739131260,32987,40
64761,PARP12,chr7,R,140023743,140063828,51241727,40085,739171345,32988,13
64764,CREB3L2,chr7,R,137874978,138002101,51368850,127123,739298468,32989,13
64792,IFT22,chr7,R,101313366,101321823,51377307,8457,739306925,32990,5
64816,CYP3A43,chr7,F,99828012,99867092,51416387,39080,739346005,32991,15
64921,CASD1,chr7,F,94509857,94631872,51538402,122015,739468020,32992,21
64940,STAG3L4,chr7,F,67302637,67321526,51557291,18889,739486909,32993,5
64951,MRPS24,chr7,R,43866557,43869546,51560280,2989,739489898,32994,3
64983,MRPL32,chr7,F,42932204,42937857,51565933,5653,739495551,32995,3
65999,LRRC61,chr7,F,150322638,150338156,51581451,15518,739511069,32996,3
78996,C7orf49,chr7,R,135165779,135170826,51586498,5047,739516116,32997,4
79017,GGCT,chr7,R,30496620,30504841,51594719,8221,739524337,32998,4
79020,C7orf25,chr7,R,42909272,42912090,51597537,2818,739527155,32999,3
79027,ZNF655,chr7,F,99558421,99576453,51615569,18032,739545187,33000,7
79034,C7orf26,chr7,F,6589367,6608726,51634928,19359,739564546,33001,7
79037,PVRIG,chr7,F,100216716,100221490,51639702,4774,739569320,33002,6
79161,TMEM243,chr7,R,87196159,87220573,51664116,24414,739593734,33003,4
79571,GCC1,chr7,R,127580627,127585600,51669089,4973,739598707,33004,1
79689,STEAP4,chr7,R,88276428,88306913,51699574,30485,739629192,33005,5
79690,GAL3ST4,chr7,R,100159241,100168750,51709083,9509,739638701,33006,3
79706,PRKRIP1,chr7,F,102396356,102426682,51739409,30326,739669027,33007,5
79778,MICALL2,chr7,R,1428464,1459497,51770442,31033,739700060,33008,18
79783,SUGCT,chr7,F,40134964,40860767,52496245,725803,740425863,33009,18
79846,CFAP69,chr7,F,90245173,90324208,52575280,79035,740504898,33010,29
79872,CBLL1,chr7,F,107743496,107762011,52593795,18515,740523413,33011,6
79970,ZNF767P,chr7,R,149547153,149624790,52671432,77637,740601050,33012,8
79974,CPED1,chr7,F,120988696,121297444,52980180,308748,740909798,33013,22
79989,TTC26,chr7,F,139133369,139191986,53038797,58617,740968415,33014,18
80028,FBXL18,chr7,R,5454464,5513805,53098138,59341,741027756,33015,7
80099,C7orf69,chr7,F,47795290,47819847,53122695,24557,741052313,33016,4
80228,ORAI2,chr7,F,102433529,102456821,53145987,23292,741075605,33017,3
80727,TTYH3,chr7,F,2631968,2664802,53178821,32834,741108439,33018,15
80820,EEPD1,chr7,F,36153226,36301543,53327138,148317,741256756,33019,7
80853,KDM7A,chr7,R,140084745,140176956,53419349,92211,741348967,33020,20
81392,OR2AE1,chr7,R,99876061,99877033,53420321,972,741349939,33021,0
81552,VOPP1,chr7,R,55434405,55573355,53559271,138950,741488889,33022,13
81554,WBSCR16,chr7,R,75027118,75073881,53606034,46763,741535652,33023,12
81628,TSC22D4,chr7,R,100466518,100479279,53618795,12761,741548413,33024,4
81844,TRIM56,chr7,F,101085423,101091738,53625110,6315,741554728,33025,2
83451,ABHD11,chr7,R,73736093,73738885,53627902,2792,741557520,33026,5
83590,TMUB1,chr7,R,151081084,151083533,53630351,2449,741559969,33027,3
83605,CCM2,chr7,F,44999745,45076470,53707076,76725,741636694,33028,12
83637,ZMIZ2,chr7,F,44748546,44769881,53728411,21335,741658029,33029,23
83698,CALN1,chr7,R,71779490,72447151,54396072,667661,742325690,33030,13
83787,ARMC10,chr7,F,103074726,103099763,54421109,25037,742350727,33031,8
83862,TMEM120A,chr7,R,75986836,75994674,54428947,7838,742358565,33032,11
83930,STARD3NL,chr7,F,38178205,38230671,54481413,52466,742411031,33033,11
83943,IMMP2L,chr7,R,110662644,111562531,55381300,899887,743310918,33034,17
83992,CTTNBP2,chr7,R,117710647,117873507,55544160,162860,743473778,33035,26
84060,RBM48,chr7,F,92528691,92539405,55554874,10714,743484492,33036,3
84124,ZNF394,chr7,R,99493230,99500254,55561898,7024,743491516,33037,2
84132,USP42,chr7,F,6078742,6161564,55644720,82822,743574338,33038,27
84163,GTF2IRD2,chr7,R,74796143,74851792,55700369,55649,743629987,33039,16
84176,MYH16,chr7,F,99273300,99297972,55725041,24672,743654659,33040,15
84182,FAM188B,chr7,F,30771416,30892387,55846012,120971,743775630,33041,17
84214,LOC84214,chr7,F,65837859,65842398,55850551,4539,743780169,33042,1
84255,SLC37A3,chr7,R,140333751,140398639,55915439,64888,743845057,33043,15
84262,PSMG3,chr7,R,1567331,1570493,55918601,3162,743848219,33044,3
84277,DNAJC30,chr7,R,73680917,73683451,55921135,2534,743850753,33045,0
84310,C7orf50,chr7,R,978497,1138275,56080913,159778,744010531,33046,7
84433,CARD11,chr7,R,2906074,3043945,56218784,137871,744148402,33047,25
84626,KRBA1,chr7,F,149714968,149734575,56238391,19607,744168009,33048,16
84629,TNRC18,chr7,R,5306789,5423546,56355148,116757,744284766,33049,32
84668,FAM126A,chr7,R,22895847,23014195,56473496,118348,744403114,33050,13
84691,FAM71F1,chr7,F,128709060,128731743,56496179,22683,744425797,33051,9
84725,PLEKHA8,chr7,F,30028360,30130483,56598302,102123,744527920,33052,18
84792,FAM220A,chr7,R,6329408,6348959,56617853,19551,744547471,33053,1
84820,POLR2J4,chr7,R,43940894,44019194,56696153,78300,744625771,33054,15
84847,LINC00525,chr7,F,47761475,47766772,56701450,5297,744631068,33055,2
84849,MGC16142,chr7,F,92538474,92539765,56702741,1291,744632359,33056,0
84912,SLC35B4,chr7,R,134289331,134320314,56733724,30983,744663342,33057,10
84928,TMEM209,chr7,R,130164712,130206197,56775209,41485,744704827,33058,16
85025,TMEM60,chr7,R,77793727,77798430,56779912,4703,744709530,33059,1
85477,SCIN,chr7,F,12570348,12653603,56863167,83255,744792785,33060,16
85865,GTPBP10,chr7,F,90346664,90391455,56907958,44791,744837576,33061,9
89122,TRIM4,chr7,R,99890406,99919600,56937152,29194,744866770,33062,6
89883,OR6W1P,chr7,R,143062283,143063785,56938654,1502,744868272,33063,0
90637,ZFAND2A,chr7,R,1152906,1160219,56945967,7313,744875585,33064,4
90639,COX19,chr7,R,964849,975599,56956717,10750,744886335,33065,2
90693,CCDC126,chr7,F,23597378,23644708,57004047,47330,744933665,33066,3
90827,ZNF479,chr7,R,57119573,57142003,57026477,22430,744956095,33067,10
90956,ADCK2,chr7,F,140672924,140695111,57048664,22187,744978282,33068,7
91584,PLXNA4,chr7,R,132123331,132648688,57574021,525357,745503639,33069,39
92092,ZC3HAV1L,chr7,R,139021497,139036489,57589013,14992,745518631,33070,7
93408,MYL10,chr7,R,101613324,101629296,57604985,15972,745534603,33071,8
93432,LOC93432,chr7,F,142111721,142223533,57716797,111812,745646415,33072,48
93653,ST7-AS1,chr7,R,116952445,116954334,57718686,1889,745648304,33073,0
93654,ST7-AS2,chr7,R,117072071,117145592,57792207,73521,745721825,33074,11
93655,ST7-OT3,chr7,F,117182680,117209937,57819464,27257,745749082,33075,8
93664,CADPS2,chr7,R,122318423,122886759,58387800,568336,746317418,33076,31
93979,CPA5,chr7,F,130344789,130374709,58417720,29920,746347338,33077,17
93986,FOXP2,chr7,F,114086309,114693772,59025183,607463,746954801,33078,23
94239,H2AFV,chr7,R,44826888,44848126,59046421,21238,746976039,33079,5
95681,CEP41,chr7,R,130393770,130441741,59094392,47971,747024010,33080,14
113263,GLCCI1,chr7,F,7968742,8089080,59214730,120338,747144348,33081,7
113763,ZBED6CL,chr7,F,150329848,150332721,59217603,2873,747147221,33082,0
113878,DTX2,chr7,F,76461654,76505998,59261947,44344,747191565,33083,14
114049,WBSCR22,chr7,F,73683565,73698221,59276603,14656,747206221,33084,12
114796,PSMG3-AS1,chr7,F,1570072,1589626,59296157,19554,747225775,33085,4
114960,TSGA13,chr7,R,130668645,130687432,59314944,18787,747244562,33086,8
115330,GPR146,chr7,F,1044572,1059269,59329641,14697,747259259,33087,3
115416,MALSU1,chr7,F,23299320,23309561,59339882,10241,747269500,33088,3
116988,AGAP3,chr7,F,151085830,151144436,59398488,58606,747328106,33089,22
129790,C7orf13,chr7,R,156638365,156640654,59400777,2289,747330395,33090,0
130075,OR9A4,chr7,F,141873478,141986420,59513719,112942,747443337,33091,2
135886,WBSCR28,chr7,F,73861158,73865894,59518455,4736,747448073,33092,3
135892,TRIM50,chr7,R,73312471,73328279,59534263,15808,747463881,33093,8
135924,OR9A2,chr7,R,142997850,143027284,59563697,29434,747493315,33094,4
135927,C7orf34,chr7,F,142939505,142940870,59565062,1365,747494680,33095,1
135932,TMEM139,chr7,F,143284898,143288049,59568213,3151,747497831,33096,3
135935,NOBOX,chr7,R,144396913,144410227,59581527,13314,747511145,33097,10
135941,OR2A14,chr7,F,144129112,144130045,59582460,933,747512078,33098,0
135946,OR6B1,chr7,F,144003996,144004932,59583396,936,747513014,33099,0
135948,OR2F2,chr7,F,143935232,143936186,59584350,954,747513968,33100,0
136051,ZNF786,chr7,R,149069640,149090777,59605487,21137,747535105,33101,3
136227,COL26A1,chr7,F,101362819,101559024,59801692,196205,747731310,33102,12
136242,PRSS37,chr7,R,141836277,141842499,59807914,6222,747737532,33103,7
136259,KLF14,chr7,R,130732553,130734033,59809394,1480,747739012,33104,0
136263,SSMEM1,chr7,F,130205402,130216844,59820836,11442,747750454,33105,5
136288,C7orf57,chr7,F,48035510,48061297,59846623,25787,747776241,33106,8
136306,SVOPL,chr7,R,138594284,138701354,59953693,107070,747883311,33107,16
136319,MTPN,chr7,R,135926754,135977456,60004395,50702,747934013,33108,3
136332,LRGUK,chr7,F,134127351,134264181,60141225,136830,748070843,33109,22
136371,ASB10,chr7,R,151175697,151187832,60153360,12135,748082978,33110,7
136541,PRSS58,chr7,R,142252137,142258058,60159281,5921,748088899,33111,5
136647,MPLKIP,chr7,R,40132742,40134652,60161191,1910,748090809,33112,1
136853,SSC4D,chr7,R,76389328,76409695,60181558,20367,748111176,33113,10
136895,C7orf31,chr7,R,25125199,25180748,60237107,55549,748166725,33114,10
136991,ASZ1,chr7,R,117363221,117427523,60301409,64302,748231027,33115,12
140453,MUC17,chr7,F,101020075,101058859,60340193,38784,748269811,33116,12
140545,RNF32,chr7,F,156640285,156677893,60377801,37608,748307419,33117,13
142685,ASB15,chr7,F,123566998,123637900,60448703,70902,748378321,33118,14
154661,RUNDC3B,chr7,F,87627674,87832298,60653327,204624,748582945,33119,14
154664,ABCA13,chr7,F,48171447,48647497,61129377,476050,749058995,33120,76
154743,C7orf60,chr7,R,112819146,112939877,61250108,120731,749179726,33121,4
154761,LOC154761,chr7,R,143811967,143836717,61274858,24750,749204476,33122,2
154790,CLEC2L,chr7,F,139523927,139544985,61295916,21058,749225534,33123,4
154791,C7orf55,chr7,F,139340449,139346319,61301786,5870,749231404,33124,3
154807,VKORC1L1,chr7,F,65836335,65959563,61425014,123228,749354632,33125,5
154822,LINC00689,chr7,F,159008353,159026238,61442899,17885,749372517,33126,4
154860,FEZF1-AS1,chr7,F,122303657,122310077,61449319,6420,749378937,33127,6
154865,IQUB,chr7,R,123452180,123534664,61531803,82484,749461421,33128,17
154872,LOC154872,chr7,R,124777291,124790810,61545322,13519,749474940,33129,3
154881,KCTD7,chr7,F,66628880,66643229,61559671,14349,749489289,33130,3
154907,C7orf66,chr7,R,108883974,108896211,61571908,12237,749501526,33131,3
155006,TMEM213,chr7,F,138797914,138806024,61580018,8110,749509636,33132,2
155038,GIMAP8,chr7,F,150450629,150479395,61608784,28766,749538402,33133,5
155051,CRYGN,chr7,R,151429969,151448419,61627234,18450,749556852,33134,5
155054,ZNF425,chr7,R,149102783,149126346,61650797,23563,749580415,33135,3
155060,LOC155060,chr7,F,149285280,149297312,61662829,12032,749592447,33136,10
155061,ZNF746,chr7,R,149472792,149497837,61687874,25045,749617492,33137,7
155066,ATP6V0E2,chr7,F,149872967,149880713,61695620,7746,749625238,33138,4
155185,AMZ1,chr7,F,2679521,2765679,61781778,86158,749711396,33139,8
155368,WBSCR27,chr7,R,73834589,73842525,61789714,7936,749719332,33140,6
155370,SBDSP1,chr7,F,72829372,72837399,61797741,8027,749727359,33141,4
155382,VPS37D,chr7,F,73667843,73672110,61802008,4267,749731626,33142,3
155400,NSUN5P1,chr7,F,75410321,75416792,61808479,6471,749738097,33143,8
155435,RBM33,chr7,F,155644493,155781485,61945471,136992,749875089,33144,18
155465,AGR3,chr7,R,16854727,16881989,61972733,27262,749902351,33145,9
157247,MGC27345,chr7,R,128297684,128307763,61982812,10079,749912430,33146,0
168374,ZNF92,chr7,F,65373798,65401135,62010149,27337,749939767,33147,4
168391,GALNTL5,chr7,F,151956378,152019934,62073705,63556,750003323,33148,14
168417,ZNF679,chr7,F,64228473,64266931,62112163,38458,750041781,33149,4
168433,RNF133,chr7,R,122697711,122699154,62113606,1443,750043224,33150,0
168448,CDC14C,chr7,F,48924560,48927453,62116499,2893,750046117,33151,0
168451,THAP5,chr7,R,108562143,108569768,62124124,7625,750053742,33152,3
168455,CCDC71L,chr7,R,106656764,106661188,62128548,4424,750058166,33153,0
168507,PKD1L1,chr7,R,47774651,47964635,62318532,189984,750248150,33154,57
168537,GIMAP7,chr7,F,150514856,150521073,62324749,6217,750254367,33155,1
168544,ZNF467,chr7,R,149764181,149776323,62336891,12142,750266509,33156,8
168620,BHLHA15,chr7,F,98212253,98212959,62337597,706,750267215,33157,0
168667,BMPER,chr7,F,33904910,34155872,62588559,250962,750518177,33158,15
168741,PER4,chr7,F,9634269,9635817,62590107,1548,750519725,33159,0
168850,ZNF800,chr7,R,127346720,127392724,62636111,46004,750565729,33160,6
170575,GIMAP1,chr7,F,150716556,150724280,62643835,7724,750573453,33161,2
171022,ABHD11-AS1,chr7,F,73735068,73736000,62644767,932,750574385,33162,3
202781,PAXIP1-AS1,chr7,F,155003432,155005703,62647038,2271,750576656,33163,0
202865,C7orf33,chr7,F,148590564,148615860,62672334,25296,750601952,33164,2
202915,TMEM184A,chr7,R,1542234,1560821,62690921,18587,750620539,33165,9
207147,TRY2P,chr7,R,142268283,142272249,62694887,3966,750624505,33166,2
219285,SAMD9L,chr7,R,93130053,93148393,62713227,18340,750642845,33167,5
219557,C7orf62,chr7,R,88794105,88795773,62714895,1668,750644513,33168,1
219578,ZNF804B,chr7,F,88759367,89337057,63292585,577690,751222203,33169,3
220832,FABP5P3,chr7,F,152436894,152443016,63298707,6122,751228325,33170,1
221785,ZSCAN25,chr7,F,99616610,99738530,63420627,121920,751350245,33171,13
221786,FAM200A,chr7,R,99546299,99559395,63433723,13096,751363341,33172,5
221806,VWDE,chr7,R,12330882,12404226,63507067,73344,751436685,33173,30
221823,PRPS1L1,chr7,R,18026773,18027863,63508157,1090,751437775,33174,0
221830,TWISTNB,chr7,R,19695461,19709037,63521733,13576,751451351,33175,3
221833,SP8,chr7,R,20781466,20786889,63527156,5423,751456774,33176,3
221883,HOXA11-AS,chr7,F,27185407,27189293,63531042,3886,751460660,33177,1
221895,JAZF1,chr7,R,27830572,28180818,63881288,350246,751810906,33178,6
221908,PPP1R35,chr7,R,100435276,100436615,63882627,1339,751812245,33179,4
221914,GPC2,chr7,R,100169605,100177426,63890448,7821,751820066,33180,9
221927,BRAT1,chr7,R,2537809,2555758,63908397,17949,751838015,33181,16
221935,SDK1,chr7,F,3301447,4269000,64875950,967553,752805568,33182,45
221937,FOXK1,chr7,F,4644690,4771443,65002703,126753,752932321,33183,11
221938,MMD2,chr7,R,4892244,4959213,65069672,66969,752999290,33184,9
221946,LOC221946,chr7,F,5513853,5525545,65081364,11692,753010982,33185,3
221955,DAGLB,chr7,R,6409115,6448012,65120261,38897,753049879,33186,14
221960,CCZ1B,chr7,R,6798934,6826295,65147622,27361,753077240,33187,14
221981,THSD7A,chr7,R,11370434,11832198,65609386,461764,753539004,33188,29
222008,VSTM2A,chr7,F,54542324,54571080,65638142,28756,753567760,33189,6
222029,DKFZp434L192,chr7,F,56496222,56497284,65639204,1062,753568822,33190,0
222068,TMED4,chr7,R,44577893,44582295,65643606,4402,753573224,33191,3
222161,DKFZP586I1420,chr7,F,30370049,30372809,65646366,2760,753575984,33192,0
222166,MTURN,chr7,F,30134935,30162765,65674196,27830,753603814,33193,2
222171,PRR15,chr7,F,29563810,29567300,65677686,3490,753607304,33194,2
222183,SRRM3,chr7,F,76166674,76287292,65798304,120618,753727922,33195,22
222194,RSBN1L,chr7,F,77696425,77779803,65881682,83378,753811300,33196,7
222223,KIAA1324L,chr7,R,86876905,87059698,66064475,182793,753994093,33197,27
222229,LRWD1,chr7,F,102464942,102473168,66072701,8226,754002319,33198,14
222234,FAM185A,chr7,F,102748943,102912918,66236676,163975,754166294,33199,14
222235,FBXL13,chr7,R,102700061,103074841,66611456,374780,754541074,33200,32
222236,NAPEPLD,chr7,R,103099575,103149322,66661203,49747,754590821,33201,7
222255,ATXN7L1,chr7,R,105604773,105877232,66933662,272459,754863280,33202,22
222256,CDHR3,chr7,F,105877199,106036431,67092894,159232,755022512,33203,21
222865,TMEM130,chr7,R,98846487,98870050,67116457,23563,755046075,33204,7
222894,FERD3L,chr7,R,19144781,19145421,67117097,640,755046715,33205,0
222901,RPL23P8,chr7,F,20827297,20827820,67117620,523,755047238,33206,0
222950,NYAP1,chr7,F,100483861,100494802,67128561,10941,755058179,33207,6
222962,SLC29A4,chr7,F,5274373,5304073,67158261,29700,755087879,33208,11
222967,RSPH10B,chr7,R,5926135,5970684,67202810,44549,755132428,33209,20
223075,CCDC129,chr7,F,31514070,31658720,67347460,144650,755277078,33210,20
223082,ZNRF2,chr7,F,30284306,30367692,67430846,83386,755360464,33211,8
223117,SEMA3D,chr7,R,84995191,85186855,67622510,191664,755552128,33212,20
245812,CNPY4,chr7,F,100119641,100125508,67628377,5867,755557995,33213,5
246721,POLR2J2,chr7,R,102636747,102671729,67663359,34982,755592977,33214,8
253012,HEPACAM2,chr7,R,93188585,93232297,67707071,43712,755636689,33215,12
254048,UBN2,chr7,F,139229564,139329421,67806928,99857,755736546,33216,18
255031,LINC00957,chr7,F,44039048,44044296,67812176,5248,755741794,33217,3
255374,MBLAC1,chr7,F,100126693,100128724,67814207,2031,755743825,33218,1
256130,TMEM196,chr7,R,19719314,19773576,67868469,54262,755798087,33219,4
256227,STEAP1B,chr7,R,22419443,22500282,67949308,80839,755878926,33220,5
256355,RPS2P32,chr7,F,23490387,23491428,67950349,1041,755879967,33221,0
256979,SUN3,chr7,R,47987147,48029127,67992329,41980,755921947,33222,12
257415,FAM133B,chr7,R,92560757,92590394,68021966,29637,755951584,33223,13
259285,TAS2R39,chr7,F,143183418,143184435,68022983,1017,755952601,33224,0
259286,TAS2R40,chr7,F,143222078,143223050,68023955,972,755953573,33225,0
259287,TAS2R41,chr7,F,143477872,143478796,68024879,924,755954497,33226,0
260294,NSUN5P2,chr7,R,72948292,72954763,68031350,6471,755960968,33227,10
260341,TFAMP1,chr7,F,1614469,1616692,68033573,2223,755963191,33228,0
261729,STEAP2,chr7,F,90211685,90237678,68059566,25993,755989184,33229,7
285877,POM121L12,chr7,F,53035655,53036925,68060836,1270,755990454,33230,0
285878,VSTM2A-OT1,chr7,F,54556969,54571726,68075593,14757,756005211,33231,3
285888,CNPY1,chr7,R,155501257,155533844,68108180,32587,756037798,33232,3
285889,LOC285889,chr7,R,156437788,156445588,68115980,7800,756045598,33233,2
285905,INTS4P1,chr7,F,65141192,65233303,68208091,92111,756137709,33234,16
285908,LINC00174,chr7,R,66376043,66400408,68232456,24365,756162074,33235,4
285941,C7orf71,chr7,F,26637487,26651531,68246500,14044,756176118,33236,5
285943,HOXA-AS2,chr7,F,27121918,27128760,68253342,6842,756182960,33237,3
285954,INHBA-AS1,chr7,F,41693915,41779378,68338805,85463,756268423,33238,4
285955,SPDYE1,chr7,F,43997439,44010124,68351490,12685,756281108,33239,8
285958,SNHG15,chr7,R,44983027,44986660,68355123,3633,756284741,33240,4
285962,WEE2-AS1,chr7,R,141704337,141738230,68389016,33893,756318634,33241,6
285965,EPHA1-AS1,chr7,F,143407812,143523449,68504653,115637,756434271,33242,4
285966,TCAF2,chr7,F,143620951,143730080,68613782,109129,756543400,33243,10
285971,ZNF775,chr7,F,150379300,150398635,68633117,19335,756562735,33244,6
285972,LINC00996,chr7,F,150433653,150448140,68647604,14487,756577222,33245,3
285973,ATG9B,chr7,R,151012208,151024499,68659895,12291,756589513,33246,17
285987,DLX6-AS1,chr7,R,96968514,97014065,68705446,45551,756635064,33247,2
285989,ZNF789,chr7,F,99472828,99487600,68720218,14772,756649836,33248,8
286002,SLC26A4-AS1,chr7,R,107656515,107661798,68725501,5283,756655119,33249,1
286006,LSMEM1,chr7,F,112480237,112491062,68736326,10825,756665944,33250,3
286016,TPI1P2,chr7,F,129055222,129057239,68738343,2017,756667961,33251,0
286023,FLJ40288,chr7,F,132648793,132728769,68818319,79976,756747937,33252,4
317751,MESTIT1,chr7,R,130487056,130491172,68822435,4116,756752053,33253,1
338069,ST7-OT4,chr7,F,116953898,116959813,68828350,5915,756757968,33254,4
338398,TAS2R60,chr7,F,143443452,143444409,68829307,957,756758925,33255,0
338436,BLACE,chr7,R,155356987,155367933,68840253,10946,756769871,33256,5
340252,ZNF680,chr7,R,64501289,64563127,68902091,61838,756831709,33257,8
340260,UNCX,chr7,F,1233017,1236977,68906051,3960,756835669,33258,2
340267,COL28A1,chr7,R,7338548,7537277,69104780,198729,757034398,33259,44
340273,ABCB5,chr7,F,20615621,20757014,69246173,141393,757175791,33260,29
340277,FAM221A,chr7,F,23679462,23703249,69269960,23787,757199578,33261,10
340286,FAM183B,chr7,R,38685345,38687089,69271704,1744,757201322,33262,1
340307,CTAGE6,chr7,R,143755088,143757750,69274366,2662,757203984,33263,0
340348,TSPAN33,chr7,F,129144715,129169694,69299345,24979,757228963,33264,7
340351,AGBL3,chr7,F,134986507,135135778,69448616,149271,757378234,33265,16
346288,SEPT14,chr7,R,55793543,55862789,69517862,69246,757447480,33266,10
346389,MACC1,chr7,R,20134654,20217390,69600598,82736,757530216,33267,6
346517,OR6V1,chr7,F,143052340,143053282,69601540,942,757531158,33268,0
346525,OR2A12,chr7,F,144095107,144096040,69602473,933,757532091,33269,0
346528,OR2A1,chr7,F,144311945,144321105,69611633,9160,757541251,33270,1
346562,GNAT3,chr7,R,80457291,80527915,69682257,70624,757611875,33271,10
346606,MOGAT3,chr7,R,101195728,101201060,69687589,5332,757617207,33272,5
346653,FAM71F2,chr7,F,128671635,128702262,69718216,30627,757647834,33273,8
346673,STRA8,chr7,F,135231978,135258661,69744899,26683,757674517,33274,9
346689,KLRG2,chr7,R,139426932,139483711,69801678,56779,757731296,33275,6
349075,ZNF713,chr7,F,55887276,55942225,69856627,54949,757786245,33276,6
349114,LINC00265,chr7,F,39733567,39794623,69917683,61056,757847301,33277,11
349136,WDR86,chr7,R,151378540,151410705,69949848,32165,757879466,33278,13
349149,GJC3,chr7,R,99923268,99935091,69961671,11823,757891289,33279,2
349152,DPY19L2P2,chr7,R,103175012,103280466,70067125,105454,757996743,33280,24
349160,LOC349160,chr7,R,136898772,137164341,70332694,265569,758262312,33281,3
352954,GATS,chr7,R,100200652,100272232,70404274,71580,758333892,33282,7
353345,GPR141,chr7,F,37683624,37742310,70462960,58686,758392578,33283,10
360132,FKBP9P1,chr7,R,55681073,55704567,70486454,23494,758416072,33284,6
373156,GSTK1,chr7,F,143263428,143269129,70492155,5701,758421773,33285,6
375567,VWC2,chr7,F,49773660,49921950,70640445,148290,758570063,33286,4
375593,TRIM73,chr7,F,75395628,75405613,70650430,9985,758580048,33287,4
375607,NAT16,chr7,R,101170492,101195908,70675846,25416,758605464,33288,5
375611,SLC26A5,chr7,R,103352729,103446177,70769294,93448,758698912,33289,21
375612,LHFPL3,chr7,F,104328655,104908558,71349197,579903,759278815,33290,3
375616,KCP,chr7,R,128868933,128910719,71390983,41786,759320601,33291,47
378108,TRIM74,chr7,R,72954848,72969681,71405816,14833,759335434,33292,7
378805,LINC-PINT,chr7,R,130877561,131109916,71638171,232355,759567789,33293,15
378925,RNF148,chr7,R,122701665,122702967,71639473,1302,759569091,33294,0
387129,NPSR1,chr7,F,34658238,34878332,71859567,220094,759789185,33295,10
389458,RBAKDN,chr7,F,5072059,5073223,71860731,1164,759790349,33296,5
389493,NUPR1L,chr7,R,56114680,56116397,71862448,1717,759792066,33297,1
389524,GTF2IRD2B,chr7,F,75092395,75149817,71919870,57422,759849488,33298,16
389538,MGC72080,chr7,R,97966595,97972326,71925601,5731,759855219,33299,3
389541,LAMTOR4,chr7,F,100148906,100154210,71930905,5304,759860523,33300,3
389549,FEZF1,chr7,R,122301308,122311853,71941450,10545,759871068,33301,5
389558,FAM180A,chr7,R,135729597,135748867,71960720,19270,759890338,33302,2
389602,LOC389602,chr7,F,155962631,155966343,71964432,3712,759894050,33303,1
392138,OR2A25,chr7,F,144074219,144075152,71965365,933,759894983,33304,0
392617,ELFN1,chr7,F,1666055,1747954,72047264,81899,759976882,33305,9
392636,AGMO,chr7,R,15159123,15562015,72450156,402892,760379774,33306,15
392843,IQCA1L,chr7,R,151190872,151205519,72464803,14647,760394421,33307,21
392862,GRID2IP,chr7,R,6496777,6551436,72519462,54659,760449080,33308,22
393046,OR2A5,chr7,F,144050401,144051337,72520398,936,760450016,33309,0
399670,RPL13AP17,chr7,F,78347241,78359458,72532615,12217,760462233,33310,5
401296,LOC401296,chr7,R,1692111,1694437,72534941,2326,760464559,33311,2
401303,ZNF815P,chr7,F,5823159,5854435,72566217,31276,760495835,33312,6
401312,LOC401312,chr7,R,22649959,22665533,72581791,15574,760511409,33313,4
401320,LOC401320,chr7,R,30548356,30577779,72611214,29423,760540832,33314,6
401321,LINC00997,chr7,F,32758285,32762924,72615853,4639,760545471,33315,0
401324,LOC401324,chr7,F,35313854,35376476,72678475,62622,760608093,33316,2
401331,RASA4CP,chr7,R,44028886,44040623,72690212,11737,760619830,33317,8
401335,C7orf65,chr7,F,47655243,47661648,72696617,6405,760626235,33318,2
401337,LINC01446,chr7,R,53655508,53811931,72853040,156423,760782658,33319,5
401357,LOC401357,chr7,R,56809123,56812736,72856653,3613,760786271,33320,0
401387,LRRD1,chr7,R,92144883,92165276,72877046,20393,760806664,33321,4
401388,C7orf76,chr7,R,96481625,96503523,72898944,21898,760828562,33322,4
401397,LINC00998,chr7,R,113116717,113118582,72900809,1865,760830427,33323,2
401398,POT1-AS1,chr7,F,124929872,125145234,73116171,215362,761045789,33324,12
401399,PRRT4,chr7,R,128350324,128362069,73127916,11745,761057534,33325,6
401409,RAB19,chr7,F,140403821,140426878,73150973,23057,761080591,33326,6
401427,OR2A7,chr7,R,144258695,144259628,73151906,933,761081524,33327,0
401428,OR2A20P,chr7,R,144250673,144251603,73152836,930,761082454,33328,0
401431,ATP6V0E2-AS1,chr7,R,149867693,149873862,73159005,6169,761088623,33329,3
402269,LOC402269,chr7,F,63632666,63640929,73167268,8263,761096886,33330,4
402317,OR2A42,chr7,R,144231910,144232843,73168201,933,761097819,33331,0
402483,LINC01000,chr7,F,128641240,128660998,73187959,19758,761117577,33332,4
402569,KPNA7,chr7,R,99173573,99219333,73233719,45760,761163337,33333,14
402573,C7orf61,chr7,R,100456614,100464271,73241376,7657,761170994,33334,2
402635,GRIFIN,chr7,R,2474635,2476855,73243596,2220,761173214,33335,4
402682,UFSP1,chr7,R,100888722,100889718,73244592,996,761174210,33336,0
404744,NPSR1-AS1,chr7,R,34346511,34834331,73732412,487820,761662030,33337,8
406900,MIR106B,chr7,R,100093992,100094074,73732494,82,761662112,33338,0
406917,MIR129-1,chr7,F,128207871,128207943,73732566,72,761662184,33339,0
406940,MIR148A,chr7,R,25949918,25949986,73732634,68,761662252,33340,0
406945,MIR153-2,chr7,R,157574335,157574422,73732721,87,761662339,33341,0
406958,MIR182,chr7,R,129770382,129770492,73732831,110,761662449,33342,0
406959,MIR183,chr7,R,129774904,129775014,73732941,110,761662559,33343,0
407014,MIR25,chr7,R,100093559,100093643,73733025,84,761662643,33344,0
407021,MIR29A,chr7,R,130876746,130876810,73733089,64,761662707,33345,0
407024,MIR29B1,chr7,R,130877458,130877539,73733170,81,761662788,33346,0
407050,MIR93,chr7,R,100093767,100093847,73733250,80,761662868,33347,0
407053,MIR96,chr7,R,129774691,129774769,73733328,78,761662946,33348,0
407835,LOC407835,chr7,F,129126270,129128007,73735065,1737,761664683,33349,0
441191,RNF216P1,chr7,F,4973984,4998169,73759250,24185,761688868,33350,7
441194,PMS2CL,chr7,F,6735304,6751601,73775547,16297,761705165,33351,5
441204,LOC441204,chr7,F,26486667,26496367,73785247,9700,761714865,33352,4
441208,ZNRF2P1,chr7,F,32727949,32729983,73787281,2034,761716899,33353,0
441212,RP9P,chr7,R,32916814,32943170,73813637,26356,761743255,33354,5
441234,ZNF716,chr7,F,57450176,57473559,73837020,23383,761766638,33355,3
441239,LOC441239,chr7,R,64887750,64890100,73839370,2350,761768988,33356,2
441242,LOC441242,chr7,R,65647009,65770810,73963171,123801,761892789,33357,10
441250,TYW1B,chr7,R,72574506,72828234,74216899,253728,762146517,33358,18
441251,SPDYE7P,chr7,R,72862756,72869091,74223234,6335,762152852,33359,5
441263,DTX2P1-UPK3BP1-PMS2P11,chr7,F,76980821,77023761,74266174,42940,762195792,33360,10
441272,SPDYE3,chr7,F,100306811,100322196,74281559,15385,762211177,33361,9
441273,SPDYE2,chr7,F,102550748,102562633,74293444,11885,762223062,33362,6
441282,AKR1B15,chr7,F,134546244,134579861,74327061,33617,762256679,33363,11
441294,CTAGE15,chr7,F,143571800,143574387,74329648,2587,762259266,33364,0
441295,OR2A9P,chr7,F,144299520,144300505,74330633,985,762260251,33365,0
441307,FLJ44511,chr7,F,520390,525232,74335475,4842,762265093,33366,2
442319,ZNF727,chr7,F,64044800,64085184,74375859,40384,762305477,33367,4
442361,OR2A2,chr7,F,144109582,144110539,74376816,957,762306434,33368,0
442497,LOC442497,chr7,F,379424,382879,74380271,3455,762309889,33369,2
442523,DPY19L2P4,chr7,F,90119399,90125600,74386472,6201,762316090,33370,2
442524,DPY19L2P3,chr7,F,29685153,29688243,74389562,3090,762319180,33371,1
442578,STAG3L3,chr7,R,72997294,73005943,74398211,8649,762327829,33372,8
442582,STAG3L2,chr7,R,74881989,74890612,74406834,8623,762336452,33373,7
442590,SPDYE5,chr7,F,75493181,75504304,74417957,11123,762347575,33374,7
442720,EIF3IP1,chr7,R,109959226,109960213,74418944,987,762348562,33375,0
442721,LMOD2,chr7,F,123655806,123664093,74427231,8287,762356849,33376,2
442904,MIR335,chr7,F,130496110,130496204,74427325,94,762356943,33377,0
442907,MIR339,chr7,R,1022932,1023026,74427419,94,762357037,33378,0
442920,MIR196B,chr7,R,27169479,27169563,74427503,84,762357121,33379,0
445328,ARHGEF35,chr7,R,144186082,144195698,74437119,9616,762366737,33380,1
445347,TARP,chr7,R,38257878,38305646,74484887,47768,762414505,33381,7
474344,GIMAP6,chr7,R,150625374,150632648,74492161,7274,762421779,33382,2
493754,LOC493754,chr7,R,66530304,66592407,74554264,62103,762483882,33383,11
494551,WEE2,chr7,F,141708352,141731271,74577183,22919,762506801,33384,11
541473,LOC541473,chr7,R,75391948,75395461,74580696,3513,762510314,33385,4
548644,POLR2J3,chr7,R,102521170,102572660,74632186,51490,762561804,33386,18
554236,DPY19L2P1,chr7,R,35081286,35186162,74737062,104876,762666680,33387,21
574442,MIR489,chr7,R,93483935,93484019,74737146,84,762666764,33388,0
574443,MIR490,chr7,F,136903166,136903294,74737274,128,762666892,33389,0
613126,CYP51A1-AS1,chr7,F,92134562,92180725,74783437,46163,762713055,33390,4
619190,FDPSP2,chr7,R,76470019,76475000,74788418,4981,762718036,33391,0
641746,LOC641746,chr7,F,64582609,64583751,74789560,1142,762719178,33392,0
641977,SEPT7P2,chr7,R,45723786,45769018,74834792,45232,762764410,33393,12
642006,GUSBP10,chr7,R,57165669,57180156,74849279,14487,762778897,33394,3
643180,CCT6P3,chr7,F,65038353,65074713,74885639,36360,762815257,33395,10
643253,CCT6P1,chr7,F,65751104,65763675,74898210,12571,762827828,33396,11
643641,ZNF862,chr7,F,149838419,149867479,74927270,29060,762856888,33397,12
643955,ZNF733P,chr7,R,63291286,63304056,74940040,12770,762869658,33398,2
644090,LOC644090,chr7,F,151806140,151810820,74944720,4680,762874338,33399,1
644150,WIPF3,chr7,F,29806553,29917066,75055233,110513,762984851,33400,13
644619,INTS4P2,chr7,F,65647853,65718688,75126068,70835,763055686,33401,12
644794,LOC644794,chr7,F,66903863,66906297,75128502,2434,763058120,33402,0
645249,MNX1-AS1,chr7,F,157010856,157016424,75134070,5568,763063688,33403,1
645591,LHFPL3-AS1,chr7,R,104796505,104804092,75141657,7587,763071275,33404,3
645700,ZNF890P,chr7,R,5121309,5144546,75164894,23237,763094512,33405,5
646282,AZGP1P1,chr7,F,99980761,99984237,75168370,3476,763097988,33406,1
646588,LOC646588,chr7,R,25655208,25670674,75183836,15466,763113454,33407,4
646762,LOC646762,chr7,R,29645921,29685138,75223053,39217,763152671,33408,1
647087,C7orf73,chr7,F,135662472,135676412,75236993,13940,763166611,33409,2
649395,YWHAEP1,chr7,F,64433692,64435520,75238821,1828,763168439,33410,0
650226,LOC650226,chr7,R,56423703,56448375,75263493,24672,763193111,33411,5
653361,NCF1,chr7,F,74773961,74789376,75278908,15415,763208526,33412,11
653691,TCAF2P1,chr7,F,143809989,143815389,75284308,5400,763213926,33413,4
653857,ACTR3C,chr7,R,149887177,150323669,75720800,436492,763650418,33414,26
654231,OCM,chr7,F,5859803,5886363,75747360,26560,763676978,33415,4
654319,SNORA5A,chr7,R,45104348,45104482,75747494,134,763677112,33416,0
654816,NCF1B,chr7,F,73220638,73235945,75762801,15307,763692419,33417,7
654817,NCF1C,chr7,R,75156577,75171998,75778222,15421,763707840,33418,10
677795,SNORA5B,chr7,R,45105967,45106099,75778354,132,763707972,33419,0
677796,SNORA5C,chr7,R,45104905,45105042,75778491,137,763708109,33420,0
677798,SNORA9,chr7,R,44985377,44985510,75778624,133,763708242,33421,0
677801,SNORA14A,chr7,F,75943782,75943916,75778758,134,763708376,33422,0
677803,SNORA15,chr7,F,56060469,56060602,75778891,133,763708509,33423,0
677807,SNORA22,chr7,F,65755525,65755659,75779025,134,763708643,33424,0
692210,SNORD93,chr7,F,22856612,22856686,75779099,74,763708717,33425,0
693133,MIR550A1,chr7,F,30289793,30289890,75779196,97,763708814,33426,0
693134,MIR550A2,chr7,F,32732980,32733077,75779293,97,763708911,33427,0
693174,MIR589,chr7,R,5495818,5495917,75779392,99,763709010,33428,0
693175,MIR590,chr7,F,74191197,74191294,75779489,97,763709107,33429,0
693176,MIR591,chr7,R,96219661,96219756,75779584,95,763709202,33430,0
693177,MIR592,chr7,R,127058087,127058184,75779681,97,763709299,33431,0
693178,MIR593,chr7,F,128081860,128081960,75779781,100,763709399,33432,0
693180,MIR595,chr7,R,158532717,158532813,75779877,96,763709495,33433,0
723809,LHFPL3-AS2,chr7,R,104894627,104926645,75811895,32018,763741513,33434,3
724023,MIR653,chr7,R,93482759,93482855,75811991,96,763741609,33435,0
728194,RSPH10B2,chr7,F,6754107,6798775,75856659,44668,763786277,33436,21
728377,ARHGEF34P,chr7,R,144258995,144286003,75883667,27008,763813285,33437,12
728524,SPDYE8P,chr7,R,73019730,73029762,75893699,10032,763823317,33438,7
728743,LOC728743,chr7,F,150405751,150412470,75900418,6719,763830036,33439,2
728927,ZNF736,chr7,F,64313872,64356634,75943180,42762,763872798,33440,3
729156,GTF2IRD1P1,chr7,R,66809992,66844826,75978014,34834,763907632,33441,10
729438,GATSL2,chr7,F,74964817,75031532,76044729,66715,763974347,33442,8
729597,SPDYE6,chr7,R,102345751,102357047,76056025,11296,763985643,33443,5
729852,UMAD1,chr7,F,7640635,7879223,76294613,238588,764224231,33444,4
729920,ISPD,chr7,R,15916850,16530558,76908321,613708,764837939,33445,23
730130,TMEM229A,chr7,R,124030915,124033469,76910875,2554,764840493,33446,0
730291,ZNF735,chr7,F,64207202,64220290,76923963,13088,764853581,33447,3
730338,LOC730338,chr7,R,46687878,46697122,76933207,9244,764862825,33448,2
731075,LOC731075,chr7,R,152121953,152133298,76944552,11345,764874170,33449,3
767558,LUZP6,chr7,R,135926754,135977456,76995254,50702,764924872,33450,3
768213,MIR671,chr7,F,151238420,151238538,76995372,118,764924990,33451,0
790953,TSL,chr7,F,27615973,27627492,77006891,11519,764936509,33452,2
100093631,LOC100093631,chr7,F,73154923,73207296,77059264,52373,764988882,33453,23
100101148,LOC100101148,chr7,F,72969681,72973143,77062726,3462,764992344,33454,3
100101267,POM121C,chr7,R,75416780,75486288,77132234,69508,765061852,33455,15
100101440,PMS2P7,chr7,F,73006079,73016375,77142530,10296,765072148,33456,5
100127950,HECW1-IT1,chr7,F,43117963,43138343,77162910,20380,765092528,33457,5
100127955,LOC100127955,chr7,F,1837681,1849931,77175160,12250,765104778,33458,2
100128081,JAZF1-AS1,chr7,F,28180456,28241377,77236081,60921,765165699,33459,3
100128264,HTR5A-AS1,chr7,R,155067066,155071557,77240572,4491,765170190,33460,1
100128317,LOC100128317,chr7,R,81576385,81691406,77355593,115021,765285211,33461,12
100128325,LOC100128325,chr7,F,130141516,130143423,77357500,1907,765287118,33462,1
100128364,LOC100128364,chr7,R,45077671,45080011,77359840,2340,765289458,33463,0
100128553,CTAGE4,chr7,F,144183454,144186080,77362466,2626,765292084,33464,0
100128653,LOC100128653,chr7,R,1532453,1534880,77364893,2427,765294511,33465,0
100128822,LINC01003,chr7,F,152464123,152465545,77366315,1422,765295933,33466,0
100128885,LOC100128885,chr7,F,64574694,64618589,77410210,43895,765339828,33467,2
100129148,LOC100129148,chr7,R,139417461,139427526,77420275,10065,765349893,33468,2
100129424,RPL19P12,chr7,R,103141269,103142403,77421409,1134,765351027,33469,0
100129427,DDC-AS1,chr7,F,50531758,50543463,77433114,11705,765362732,33470,4
100129460,DPY19L1P1,chr7,R,32580938,32719168,77571344,138230,765500962,33471,16
100129484,LOC100129484,chr7,R,5426280,5431023,77576087,4743,765505705,33472,0
100129603,LOC100129603,chr7,R,3140916,3158573,77593744,17657,765523362,33473,3
100129845,PCOLCE-AS1,chr7,R,100589400,100604038,77608382,14638,765538000,33474,8
100130673,LOC100130673,chr7,R,32456896,32458494,77609980,1598,765539598,33475,0
100130705,LOC100130705,chr7,F,128866409,128872047,77615618,5638,765545236,33476,1
100130771,EFCAB10,chr7,R,105565132,105581529,77632015,16397,765561633,33477,4
100130849,LOC100130849,chr7,R,56875384,56882146,77638777,6762,765568395,33478,4
100130880,LOC100130880,chr7,F,137953347,137957966,77643396,4619,765573014,33479,3
100130988,C7orf72,chr7,F,50095860,50159256,77706792,63396,765636410,33480,10
100131017,ZNF316,chr7,F,6637321,6658279,77727750,20958,765657368,33481,7
100131176,WDR86-AS1,chr7,F,151409160,151413354,77731944,4194,765661562,33482,5
100131257,LOC100131257,chr7,R,7075769,7096786,77752961,21017,765682579,33483,0
100131372,LOC100131372,chr7,R,427055,433613,77759519,6558,765689137,33484,0
100131472,LOC100131472,chr7,F,10702671,10707538,77764386,4867,765694004,33485,1
100132707,PAXIP1-AS2,chr7,F,154928516,154949490,77785360,20974,765714978,33486,7
100132832,PMS2P9,chr7,F,77039479,77053038,77798919,13559,765728537,33487,4
100133091,LOC100133091,chr7,F,76549340,76627982,77877561,78642,765807179,33488,2
100133311,HOXA-AS3,chr7,F,27140363,27155928,77893126,15565,765822744,33489,3
100134040,LOC100134040,chr7,F,150031333,150074885,77936678,43552,765866296,33490,21
100134229,JHDM1D-AS1,chr7,F,140177260,140179640,77939058,2380,765868676,33491,0
100134713,NDUFB2-AS1,chr7,R,140695335,140697077,77940800,1742,765870418,33492,1
100134938,UPK3BL,chr7,R,102637024,102642791,77946567,5767,765876185,33493,5
100142659,CTAGE8,chr7,R,144266673,144269784,77949678,3111,765879296,33494,0
100189008,TRC-GCA11-1,chr7,R,149415137,149415209,77949750,72,765879368,33495,0
100189049,TRC-GCA18-1,chr7,R,149375758,149375830,77949822,72,765879440,33496,0
100189075,TRC-GCA12-1,chr7,R,149646954,149647026,77949894,72,765879512,33497,0
100189097,TRC-GCA3-1,chr7,R,149589072,149589144,77949966,72,765879584,33498,0
100189144,TRC-GCA1-1,chr7,F,149310189,149310261,77950038,72,765879656,33499,0
100189146,TRC-GCA16-1,chr7,F,149546539,149546611,77950110,72,765879728,33500,0
100189177,TRC-GCA19-1,chr7,R,149613064,149613136,77950182,72,765879800,33501,0
100189190,TRW-CCA5-1,chr7,F,99469683,99469755,77950254,72,765879872,33502,0
100189267,TRC-GCA15-1,chr7,F,149584724,149584796,77950326,72,765879944,33503,0
100189276,TRP-AGG2-8,chr7,F,128783449,128783521,77950398,72,765880016,33504,0
100189289,TRC-GCA17-1,chr7,R,149691180,149691252,77950470,72,765880088,33505,0
100189305,TRC-GCA10-1,chr7,R,149377509,149377581,77950542,72,765880160,33506,0
100189355,TRC-GCA20-1,chr7,F,149597954,149598026,77950614,72,765880232,33507,0
100189357,TRC-GCA13-1,chr7,R,149355674,149355746,77950686,72,765880304,33508,0
100189376,TRC-GCA9-3,chr7,F,149635686,149635758,77950758,72,765880376,33509,0
100189379,TRC-GCA9-4,chr7,F,149707668,149707740,77950830,72,765880448,33510,0
100189406,TRR-CCT4-1,chr7,F,139340699,139340772,77950903,73,765880521,33511,0
100189413,TRC-GCA9-2,chr7,F,149331128,149331200,77950975,72,765880593,33512,0
100189432,TRS-AGA5-1,chr7,F,149608375,149608447,77951047,72,765880665,33513,0
100216545,KMT2E-AS1,chr7,R,105010541,105014141,77954647,3600,765884265,33514,0
100216546,LINC01004,chr7,R,104981746,104991165,77964066,9419,765893684,33515,0
100240728,LOC100240728,chr7,R,56482104,56483319,77965281,1215,765894899,33516,1
100271874,ZNRF2P2,chr7,R,29684771,29685821,77966331,1050,765895949,33517,0
100271927,RASA4B,chr7,R,102483138,102517777,78000970,34639,765930588,33518,21
100287294,LOC100287294,chr7,R,56936026,56945473,78010417,9447,765940035,33519,5
100287482,SMKR1,chr7,F,129502478,129512932,78020871,10454,765950489,33520,1
100287704,LOC100287704,chr7,F,63349069,63351774,78023576,2705,765953194,33521,1
100287834,LOC100287834,chr7,R,63396339,63399041,78026278,2702,765955896,33522,1
100288524,WI2-2373I1.2,chr7,F,290169,294422,78030531,4253,765960149,33523,4
100289017,MOXD2P,chr7,R,142240736,142247067,78036862,6331,765966480,33524,10
100289098,LOC100289098,chr7,F,66493683,66495474,78038653,1791,765968271,33525,1
100289187,GS1-259H13.2,chr7,F,99597955,99610833,78051531,12878,765981149,33526,9
100289561,LOC100289561,chr7,F,102363860,102380633,78068304,16773,765997922,33527,4
100289678,ZNF783,chr7,F,149262170,149284994,78091128,22824,766020746,33528,7
100302113,MIR1200,chr7,R,36919356,36919432,78091204,76,766020822,33529,0
100302122,MIR1183,chr7,F,21471057,21471146,78091293,89,766020911,33530,0
100302140,MIR1302-6,chr7,R,18127219,18127309,78091383,90,766021001,33531,0
100302152,MIR548N,chr7,R,34940759,34940834,78091458,75,766021076,33532,0
100302218,MIR1285-1,chr7,R,92204014,92204098,78091542,84,766021160,33533,0
100310812,SPDYE2B,chr7,F,102650324,102661400,78102618,11076,766032236,33534,6
100310846,ANKRD61,chr7,F,6031375,6036552,78107795,5177,766037413,33535,2
100313829,MIR548O,chr7,R,102405741,102405855,78107909,114,766037527,33536,0
100313895,MIR548F4,chr7,R,147378016,147378121,78108014,105,766037632,33537,0
100316868,HOTTIP,chr7,F,27200420,27207259,78114853,6839,766044471,33538,2
100316904,SAP25,chr7,R,100572225,100573864,78116492,1639,766046110,33539,5
100422848,MIR4283-2,chr7,F,63621089,63621169,78116572,80,766046190,33540,0
100422858,MIR4285,chr7,F,102293102,102293187,78116657,85,766046275,33541,0
100422917,MIR4283-1,chr7,R,56955784,56955864,78116737,80,766046355,33542,0
100422939,MIR3147,chr7,F,57405024,57405090,78116803,66,766046421,33543,0
100422948,MIR4284,chr7,F,73711316,73711397,78116884,81,766046502,33544,0
100422967,MIR3146,chr7,R,19705357,19705436,78116963,79,766046581,33545,0
100463482,MTRNR2L6,chr7,F,142666298,142667693,78118358,1395,766047976,33546,0
100500804,MIR3654,chr7,R,133034859,133034915,78118414,56,766048032,33547,0
100500819,MIR3609,chr7,F,98881649,98881729,78118494,80,766048112,33548,0
100500829,MIR3943,chr7,F,43150894,43150994,78118594,100,766048212,33549,0
100500830,MIR550B2,chr7,R,32732980,32733077,78118691,97,766048309,33550,0
100500835,MIR3907,chr7,R,151433488,151433639,78118842,151,766048460,33551,0
100500836,MIR3914-1,chr7,R,71307671,71307770,78118941,99,766048559,33552,0
100500883,MIR550B1,chr7,R,30289793,30289890,78119038,97,766048656,33553,0
100500886,MIR3683,chr7,R,7066963,7067045,78119120,82,766048738,33554,0
100500896,MIR3666,chr7,F,114653344,114653455,78119231,111,766048849,33555,0
100500920,MIR3914-2,chr7,F,71307673,71307768,78119326,95,766048944,33556,0
100505483,PRKAG2-AS1,chr7,F,151877041,151879223,78121508,2182,766051126,33557,2
100505767,SPDYE18,chr7,R,77051688,77060538,78130358,8850,766059976,33558,7
100505854,APTR,chr7,R,77683850,77697345,78143853,13495,766073471,33559,2
100505881,MAGI2-AS3,chr7,F,79452956,79471208,78162105,18252,766091723,33560,7
100505921,LOC100505921,chr7,R,7949838,7968752,78181019,18914,766110637,33561,4
100505938,LOC100505938,chr7,F,8262224,8343281,78262076,81057,766191694,33562,5
100506025,ISPD-AS1,chr7,F,16210485,16270604,78322195,60119,766251813,33563,5
100506049,LRRC72,chr7,F,16526826,16581554,78376923,54728,766306541,33564,9
100506050,LINC01005,chr7,R,64024415,64030102,78382610,5687,766312228,33565,3
100506098,LOC100506098,chr7,F,20213994,20221700,78390316,7706,766319934,33566,5
100506136,LOC100506136,chr7,R,96621656,96664338,78432998,42682,766362616,33567,4
100506178,LOC100506178,chr7,F,22563336,22573998,78443660,10662,766373278,33568,3
100506236,LOC100506236,chr7,R,25831290,25862265,78474635,30975,766404253,33569,5
100506289,LOC100506289,chr7,F,26551838,26557579,78480376,5741,766409994,33570,1
100506302,LOC100506302,chr7,R,155641915,155644406,78482867,2491,766412485,33571,2
100506311,HOTAIRM1,chr7,F,27096093,27100258,78487032,4165,766416650,33572,2
100506380,LINC01006,chr7,R,156472098,156603195,78618129,131097,766547747,33573,1
100506413,DOCK4-AS1,chr7,F,111808504,111821779,78631404,13275,766561022,33574,1
100506489,LOC100506489,chr7,R,115679344,115682618,78634678,3274,766564296,33575,1
100506497,LOC100506497,chr7,F,28979966,29013369,78668081,33403,766597699,33576,4
100506516,LINC01176,chr7,F,30390884,30404055,78681252,13171,766610870,33577,2
100506527,LINC01007,chr7,R,101562754,101569006,78687504,6252,766617122,33578,2
100506557,LOC100506557,chr7,F,157525739,157527319,78689084,1580,766618702,33579,0
100506585,LOC100506585,chr7,F,157854584,157866092,78700592,11508,766630210,33580,3
100506664,LOC100506664,chr7,F,125437854,125466310,78729048,28456,766658666,33581,2
100506682,LOC100506682,chr7,F,127476882,127485804,78737970,8922,766667588,33582,3
100506725,LOC100506725,chr7,F,35716436,35719712,78741246,3276,766670864,33583,2
100506776,TRG-AS1,chr7,F,38341576,38378637,78778307,37061,766707925,33584,3
100506860,LOC100506860,chr7,F,130913463,130921946,78786790,8483,766716408,33585,3
100506881,MKLN1-AS,chr7,R,131309743,131327779,78804826,18036,766734444,33586,5
100506895,LOC100506895,chr7,R,43508727,43522542,78818641,13815,766748259,33587,2
100506937,LOC100506937,chr7,F,132759006,132760632,78820267,1626,766749885,33588,1
100507421,TMEM178B,chr7,F,141073310,141497881,79244838,424571,767174456,33589,7
100507468,LOC100507468,chr7,R,69596136,69597495,79246197,1359,767175815,33590,1
100507500,EGFR-AS1,chr7,R,55179749,55188949,79255397,9200,767185015,33591,1
100507507,LOC100507507,chr7,R,143379154,143380795,79257038,1641,767186656,33592,1
100507642,LOC100507642,chr7,F,149717,155465,79262786,5748,767192404,33593,2
100526740,ATP5J2-PTCD1,chr7,R,99416738,99466201,79312249,49463,767241867,33594,8
100526825,INMT-FAM188B,chr7,F,30752134,30892387,79452502,140253,767382120,33595,17
100527949,GIMAP1-GIMAP5,chr7,F,150716556,150743649,79479595,27093,767409213,33596,5
100533952,RBAK-RBAKDN,chr7,F,5045820,5073223,79506998,27403,767436616,33597,5
100534589,HOXA10-HOXA9,chr7,R,27162437,27180261,79524822,17824,767454440,33598,2
100534592,URGCP-MRPS24,chr7,R,43866557,43906632,79564897,40075,767494515,33599,6
100616116,MIR4648,chr7,F,2527073,2527145,79564969,72,767494587,33600,0
100616117,MIR4653,chr7,F,101159472,101159555,79565052,83,767494670,33601,0
100616160,MIR4655,chr7,R,1844179,1844253,79565126,74,767494744,33602,0
100616206,MIR4652,chr7,F,93716927,93717005,79565204,78,767494822,33603,0
100616226,MIR4468,chr7,F,138123757,138123821,79565268,64,767494886,33604,0
100616270,MIR4651,chr7,F,75915196,75915269,79565341,73,767494959,33605,0
100616310,MIR4650-1,chr7,R,67114321,67114397,79565417,76,767495035,33606,0
100616331,MIR4650-2,chr7,F,72697902,72697978,79565493,76,767495111,33607,0
100616346,MIR4649,chr7,F,44110848,44110912,79565557,64,767495175,33608,0
100616354,MIR550A3,chr7,R,29680733,29680828,79565652,95,767495270,33609,0
100616367,MIR4467,chr7,F,102471468,102471531,79565715,63,767495333,33610,0
100616393,MIR4657,chr7,R,44881747,44881800,79565768,53,767495386,33611,0
100616439,MIR4658,chr7,R,100156604,100156669,79565833,65,767495451,33612,0
100616465,MIR4656,chr7,R,4788564,4788639,79565908,75,767495526,33613,0
100630923,LOC100630923,chr7,F,102363860,102426682,79628730,62822,767558348,33614,5
100653233,LOC100653233,chr7,F,57404766,57412147,79636111,7381,767565729,33615,2
100689074,POU6F2-AS2,chr7,R,38979894,39013567,79669784,33673,767599402,33616,6
100775104,KLHL7-AS1,chr7,R,23101227,23105703,79674260,4476,767603878,33617,2
100847017,MIR5692C2,chr7,R,97964404,97964481,79674337,77,767603955,33618,0
100847032,MIR5707,chr7,F,158591615,158591696,79674418,81,767604036,33619,0
100847066,MIR5692A1,chr7,F,97963657,97963726,79674487,69,767604105,33620,0
100847073,MIR5090,chr7,F,102465741,102465826,79674572,85,767604190,33621,0
100861514,ELMO1-AS1,chr7,F,36997795,37013630,79690407,15835,767620025,33622,2
100861520,POU6F2-AS1,chr7,R,39404597,39406346,79692156,1749,767621774,33623,3
100861540,CYP3A7-CYP3A51P,chr7,R,99684678,99735200,79742678,50522,767672296,33624,12
100873745,RNU6-10P,chr7,R,92701707,92701814,79742785,107,767672403,33625,0
100874021,MAGI2-AS2,chr7,F,79008987,79012277,79746075,3290,767675693,33626,2
100874041,MACC1-AS1,chr7,F,20141915,20153531,79757691,11616,767687309,33627,3
100874100,STEAP2-AS1,chr7,R,89882352,90211635,80086974,329283,768016592,33628,2
100874264,AOAH-IT1,chr7,R,36597833,36600120,80089261,2287,768018879,33629,2
100874323,HOXA10-AS,chr7,F,27168898,27171915,80092278,3017,768021896,33630,2
100874342,RNF216-IT1,chr7,R,5662431,5680461,80110308,18030,768039926,33631,2
100996249,LOC100996249,chr7,F,112618064,112620649,80112893,2585,768042511,33632,2
100996266,LINC01510,chr7,R,116563593,116614820,80164120,51227,768093738,33633,4
100996365,LOC100996365,chr7,F,63756808,63757407,80164719,599,768094337,33634,0
100996414,LOC100996414,chr7,F,63754797,63755530,80165452,733,768095070,33635,0
100996437,LOC100996437,chr7,F,66654518,66669602,80180536,15084,768110154,33636,3
100996654,LOC100996654,chr7,F,54759312,54804969,80226193,45657,768155811,33637,2
100996746,SPDYE11,chr7,R,73049243,73057172,80234122,7929,768163740,33638,5
100996928,C7orf55-LUC7L2,chr7,F,139341131,139423457,80316448,82326,768246066,33639,12
101060128,LOC101060128,chr7,F,63744445,63747240,80319243,2795,768248861,33640,1
101060341,LOC101060341,chr7,R,55746452,55750700,80323491,4248,768253109,33641,2
101409256,LOC101409256,chr7,F,90396291,90398236,80325436,1945,768255054,33642,0
101410536,EVX1-AS,chr7,R,27241428,27247229,80331237,5801,768260855,33643,3
101735302,STAG3L5P,chr7,F,100336078,100341328,80336487,5250,768266105,33644,3
101752334,PVRIG2P,chr7,F,100352317,100353936,80338106,1619,768267724,33645,4
101752399,STAG3L5P-PVRIG2P-PILRB,chr7,F,100336064,100367831,80369873,31767,768299491,33646,16
101926943,LOC101926943,chr7,R,74688936,74728918,80409855,39982,768339473,33647,3
101926963,LOC101926963,chr7,F,602844,608502,80415513,5658,768345131,33648,2
101927000,LOC101927000,chr7,F,561480,566230,80420263,4750,768349881,33649,2
101927021,LOC101927021,chr7,F,1160373,1165958,80425848,5585,768355466,33650,7
101927125,ELFN1-AS1,chr7,R,1738629,1742310,80429529,3681,768359147,33651,1
101927126,LOC101927126,chr7,R,76077254,76164388,80516663,87134,768446281,33652,26
101927160,LOC101927160,chr7,R,76071321,76072392,80517734,1071,768447352,33653,0
101927181,LOC101927181,chr7,F,2437762,2447850,80527822,10088,768457440,33654,1
101927243,LOC101927243,chr7,F,77415197,77425444,80538069,10247,768467687,33655,4
101927256,LOC101927256,chr7,F,2944553,2947091,80540607,2538,768470225,33656,1
101927269,LOC101927269,chr7,R,80371516,80374439,80543530,2923,768473148,33657,3
101927325,LOC101927325,chr7,F,6505904,6517035,80554661,11131,768484279,33658,3
101927354,LOC101927354,chr7,F,7255153,7278069,80577577,22916,768507195,33659,3
101927356,LOC101927356,chr7,F,82009176,82029955,80598356,20779,768527974,33660,4
101927378,LOC101927378,chr7,F,84532475,84584318,80650199,51843,768579817,33661,3
101927391,LOC101927391,chr7,R,7550103,7566065,80666161,15962,768595779,33662,4
101927420,LOC101927420,chr7,R,87151422,87156676,80671415,5254,768601033,33663,2
101927446,LOC101927446,chr7,F,90335222,90344094,80680287,8872,768609905,33664,5
101927473,LOC101927473,chr7,R,91367551,91380866,80693602,13315,768623220,33665,5
101927497,LOC101927497,chr7,F,92836482,92917187,80774307,80705,768703925,33666,4
101927524,MEOX2-AS1,chr7,F,15688377,15696892,80782822,8515,768712440,33667,1
101927525,LOC101927525,chr7,R,94277388,94397735,80903169,120347,768832787,33668,8
101927550,LOC101927550,chr7,F,99013164,99036492,80926497,23328,768856115,33669,5
101927558,LOC101927558,chr7,F,15702336,15727956,80952117,25620,768881735,33670,3
101927585,LOC101927585,chr7,R,16685984,16704540,80970673,18556,768900291,33671,2
101927609,LOC101927609,chr7,R,17279943,17298538,80989268,18595,768918886,33672,5
101927610,LOC101927610,chr7,F,99919646,99925310,80994932,5664,768924550,33673,1
101927630,LOC101927630,chr7,R,17463444,17558909,81090397,95465,769020015,33674,3
101927632,LOC101927632,chr7,F,100435705,100440064,81094756,4359,769024374,33675,7
101927655,ZASP,chr7,R,100574034,100574733,81095455,699,769025073,33676,0
101927668,LOC101927668,chr7,R,19918980,20140426,81316901,221446,769246519,33677,5
101927721,LOC101927721,chr7,F,101299612,101301344,81318633,1732,769248251,33678,1
101927746,LOC101927746,chr7,F,101308339,101321149,81331443,12810,769261061,33679,2
101927769,LOC101927769,chr7,F,20296707,20311712,81346448,15005,769276066,33680,4
101927811,LOC101927811,chr7,R,20328300,20331762,81349910,3462,769279528,33681,3
101927858,LOC101927858,chr7,R,156655047,156658121,81352984,3074,769282602,33682,2
101927870,LOC101927870,chr7,F,103445206,103514007,81421785,68801,769351403,33683,3
101927890,LOC101927890,chr7,F,23214007,23239759,81447537,25752,769377155,33684,1
101927902,LOC101927902,chr7,F,104940932,105002028,81508633,61096,769438251,33685,3
101927914,LOC101927914,chr7,F,157466230,157499716,81542119,33486,769471737,33686,3
101927974,LOC101927974,chr7,R,107742750,107744051,81543420,1301,769473038,33687,1
101927982,LOC101927982,chr7,F,159092713,159096034,81546741,3321,769476359,33688,1
101928012,LOC101928012,chr7,F,112622380,112708072,81632433,85692,769562051,33689,7
101928036,LOC101928036,chr7,R,112954634,112995643,81673442,41009,769603060,33690,5
101928077,LOC101928077,chr7,R,26598936,26623381,81697887,24445,769627505,33691,3
101928168,LOC101928168,chr7,F,29125032,29128172,81701027,3140,769630645,33692,2
101928208,LOC101928208,chr7,F,29720496,29742604,81723135,22108,769652753,33693,5
101928211,LOC101928211,chr7,R,124337379,124352096,81737852,14717,769667470,33694,3
101928254,LOC101928254,chr7,R,125229578,125264291,81772565,34713,769702183,33695,4
101928257,LOC101928257,chr7,F,52771389,52774861,81776037,3472,769705655,33696,3
101928268,LOC101928268,chr7,F,30460050,30469422,81785409,9372,769715027,33697,1
101928283,LOC101928283,chr7,F,125184568,125379321,81980162,194753,769909780,33698,8
101928333,LOC101928333,chr7,F,127215126,127229921,81994957,14795,769924575,33699,2
101928357,LOC101928357,chr7,F,126495193,126537276,82037040,42083,769966658,33700,4
101928397,LOC101928397,chr7,F,143363037,143364230,82038233,1193,769967851,33701,1
101928401,LOC101928401,chr7,R,56534229,56538130,82042134,3901,769971752,33702,1
101928421,LOC101928421,chr7,R,35609753,35629466,82061847,19713,769991465,33703,4
101928422,LOC101928422,chr7,F,143620923,143643937,82084861,23014,770014479,33704,4
101928423,LOC101928423,chr7,F,128205760,128224431,82103532,18671,770033150,33705,2
101928451,LOC101928451,chr7,F,128531354,128640002,82212180,108648,770141798,33706,21
101928466,LOC101928466,chr7,R,143588288,143620919,82244811,32631,770174429,33707,6
101928468,LOC101928468,chr7,R,56813395,56814205,82245621,810,770175239,33708,0
101928492,OR2A1-AS1,chr7,R,144238572,144355718,82362767,117146,770292385,33709,4
101928545,SEPT7-AS1,chr7,R,35754963,35800625,82408429,45662,770338047,33710,5
101928587,LOC101928587,chr7,R,56826849,56827843,82409423,994,770339041,33711,0
101928605,LOC101928605,chr7,F,144195320,144299589,82513692,104269,770443310,33712,4
101928618,LOC101928618,chr7,F,36095309,36100653,82519036,5344,770448654,33713,1
101928632,LOC101928632,chr7,R,130354730,130357168,82521474,2438,770451092,33714,1
101928652,LOC101928652,chr7,F,144386496,144390962,82525940,4466,770455558,33715,1
101928675,LOC101928675,chr7,R,51386081,51387506,82527365,1425,770456983,33716,1
101928688,LOC101928688,chr7,F,39816957,39899185,82609593,82228,770539211,33717,10
101928700,LOC101928700,chr7,R,147080937,147097609,82626265,16672,770555883,33718,3
101928716,LOC101928716,chr7,R,40538005,40547158,82635418,9153,770565036,33719,1
101928733,LOC101928733,chr7,F,149398203,149401456,82638671,3253,770568289,33720,1
101928744,LINC01450,chr7,R,40964677,40979939,82653933,15262,770583551,33721,2
101928773,LINC01449,chr7,F,41101603,41133501,82685831,31898,770615449,33722,5
101928782,LOC101928782,chr7,F,131910219,131948953,82724565,38734,770654183,33723,5
101928795,LINC01448,chr7,R,42661725,42706447,82769287,44722,770698905,33724,2
101928807,LOC101928807,chr7,F,132260826,132264224,82772685,3398,770702303,33725,2
101928860,LOC101928860,chr7,F,43664136,43667674,82776223,3538,770705841,33726,2
101928861,LOC101928861,chr7,R,133800492,133824888,82800619,24396,770730237,33727,3
101928915,LOC101928915,chr7,F,135774947,135932476,82958148,157529,770887766,33728,3
101928927,LOC101928927,chr7,F,44965091,44985875,82978932,20784,770908550,33729,2
101928984,LOC101928984,chr7,F,139641661,139657842,82995113,16181,770924731,33730,2
101929008,LOC101929008,chr7,F,45769084,45805139,83031168,36055,770960786,33731,14
101929022,LOC101929022,chr7,F,63394753,63395439,83031854,686,770961472,33732,1
101929050,LOC101929050,chr7,R,63378117,63394193,83047930,16076,770977548,33733,8
101929086,LINC01447,chr7,F,47621938,47629893,83055885,7955,770985503,33734,3
101929087,LOC101929087,chr7,R,153144204,153144588,83056269,384,770985887,33735,1
101929088,LOC101929088,chr7,F,63354292,63380868,83082845,26576,771012463,33736,10
101929114,LOC101929114,chr7,R,63352674,63353360,83083531,686,771013149,33737,1
101929190,LOC101929190,chr7,F,63746833,63752784,83089482,5951,771019100,33738,5
101929301,LOC101929301,chr7,F,44870945,44872158,83090695,1213,771020313,33739,4
101929322,LOC101929322,chr7,R,65499302,65555350,83146743,56048,771076361,33740,8
101929360,LOC101929360,chr7,R,65110629,65123062,83159176,12433,771088794,33741,1
101929463,LOC101929463,chr7,R,66435968,66491427,83214635,55459,771144253,33742,12
101929580,LOC101929580,chr7,F,66847162,66896593,83264066,49431,771193684,33743,22
101929736,LINC01372,chr7,F,67335975,67340024,83268115,4049,771197733,33744,2
101929756,LOC101929756,chr7,F,77055,83368,83274428,6313,771204046,33745,2
101929998,LOC101929998,chr7,R,154024915,154066002,83315515,41087,771245133,33746,19
101930085,LOC101930085,chr7,F,35694328,35699413,83320600,5085,771250218,33747,1
101930109,LOC101930109,chr7,R,56391247,56408798,83338151,17551,771267769,33748,3
101930332,LOC101930332,chr7,F,26398613,26462008,83401546,63395,771331164,33749,3
102465139,MIR6133,chr7,F,133290880,133290988,83401654,108,771331272,33750,0
102465254,MIR6509,chr7,R,135206993,135207078,83401739,85,771331357,33751,0
102465503,MIR6836,chr7,R,2257514,2257577,83401802,63,771331420,33752,0
102465504,MIR6838,chr7,R,44073377,44073433,83401858,56,771331476,33753,0
102465505,MIR6839,chr7,F,64679063,64679176,83401971,113,771331589,33754,0
102465538,MIR6892,chr7,F,143382685,143382800,83402086,115,771331704,33755,0
102466203,MIR6874,chr7,R,5711839,5711910,83402157,71,771331775,33756,0
102466616,MIR6132,chr7,F,117020210,117020319,83402266,109,771331884,33757,0
102466747,MIR6840,chr7,F,100356650,100356721,83402337,71,771331955,33758,0
102466755,MIR6875,chr7,F,100868035,100868107,83402409,72,771332027,33759,0
102466985,MIR6837,chr7,F,44051765,44051829,83402473,64,771332091,33760,0
102659288,LOC102659288,chr7,F,17374916,17467256,83494813,92340,771424431,33761,3
102723099,GHET1,chr7,F,148987526,148989429,83496716,1903,771426334,33762,0
102723307,LOC102723307,chr7,R,44583382,44606467,83519801,23085,771449419,33763,3
102723334,LOC102723334,chr7,R,44992635,44999810,83526976,7175,771456594,33764,5
102723427,LOC102723427,chr7,F,68020252,68032690,83539414,12438,771469032,33765,5
102723446,LOC102723446,chr7,F,45940559,46000627,83599482,60068,771529100,33766,6
102723533,LOC102723533,chr7,R,51395079,51402733,83607136,7654,771536754,33767,3
102723555,SPDYE16,chr7,R,76533537,76541484,83615083,7947,771544701,33768,6
102723605,LINC01445,chr7,F,54330696,54349845,83634232,19149,771563850,33769,2
102723622,LOC102723622,chr7,F,55029388,55045239,83650083,15851,771579701,33770,1
102723656,LOC102723656,chr7,R,55750746,55758569,83657906,7823,771587524,33771,3
102723672,LOC102723672,chr7,R,144443,149455,83662918,5012,771592536,33772,3
102723684,LOC102723684,chr7,F,56659156,56675101,83678863,15945,771608481,33773,2
102723686,LOC102723686,chr7,F,153225923,153256244,83709184,30321,771638802,33774,7
102723743,LOC102723743,chr7,R,846961,848411,83710634,1450,771640252,33775,1
102723758,LOC102723758,chr7,F,1124101,1130589,83717122,6488,771646740,33776,2
102723791,LOC102723791,chr7,R,77252132,77278397,83743387,26265,771673005,33777,6
102723795,LOC102723795,chr7,F,156893361,156922209,83772235,28848,771701853,33778,4
102723842,LOC102723842,chr7,R,57866001,57868127,83774361,2126,771703979,33779,2
102723849,SPDYE17,chr7,R,77023687,77031631,83782305,7944,771711923,33780,5
102723872,LOC102723872,chr7,R,12841,31446,83800910,18605,771730528,33781,4
102723885,LOC102723885,chr7,F,88216659,88229768,83814019,13109,771743637,33782,2
102723899,LOC102723899,chr7,F,90509144,90513397,83818272,4253,771747890,33783,2
102723965,LOC102723965,chr7,R,6793858,6797028,83821442,3170,771751060,33784,2
102724006,LOC102724006,chr7,R,99474558,99479725,83826609,5167,771756227,33785,2
102724094,LOC102724094,chr7,R,101014319,101017608,83829898,3289,771759516,33786,2
102724134,LOC102724134,chr7,F,61005068,61006535,83831365,1467,771760983,33787,2
102724143,LOC102724143,chr7,R,22110510,22112603,83833458,2093,771763076,33788,1
102724229,LOC102724229,chr7,R,102573647,102580440,83840251,6793,771769869,33789,1
102724284,LOC102724284,chr7,R,104822182,104826508,83844577,4326,771774195,33790,2
102724339,LOC102724339,chr7,R,106570754,106615753,83889576,44999,771819194,33791,4
102724363,LOC102724363,chr7,F,108164563,108177126,83902139,12563,771831757,33792,3
102724386,LINC01393,chr7,F,115078957,115126314,83949496,47357,771879114,33793,3
102724407,LOC102724407,chr7,F,115789911,115791323,83950908,1412,771880526,33794,2
102724434,LOC102724434,chr7,R,116275605,116286727,83962030,11122,771891648,33795,4
102724484,LOC102724484,chr7,R,29199039,29208970,83971961,9931,771901579,33796,2
102724495,LOC102724495,chr7,F,118259834,118322890,84035017,63056,771964635,33797,2
102724514,LOC102724514,chr7,R,121179966,121266708,84121759,86742,772051377,33798,2
102724527,LOC102724527,chr7,F,122192418,122219265,84148606,26847,772078224,33799,7
102724555,LOC102724555,chr7,R,123614160,123624957,84159403,10797,772089021,33800,4
102724577,LOC102724577,chr7,F,124388433,124392640,84163610,4207,772093228,33801,2
102724660,LOC102724660,chr7,F,128450784,128469400,84182226,18616,772111844,33802,6
102724668,LOC102724668,chr7,F,32772426,32833146,84242946,60720,772172564,33803,7
102724723,LOC102724723,chr7,F,34939373,34948608,84252181,9235,772181799,33804,3
102724738,LOC102724738,chr7,R,63346799,63350912,84256294,4113,772185912,33805,0
102724777,LOC102724777,chr7,F,63763950,63764555,84256899,605,772186517,33806,0
102724903,LOC102724903,chr7,R,43297315,43301360,84260944,4045,772190562,33807,2
102724906,LOC102724906,chr7,R,132409175,132414183,84265952,5008,772195570,33808,2
102724946,LOC102724946,chr7,R,43752481,43839019,84352490,86538,772282108,33809,7
102724947,LOC102724947,chr7,R,134660775,135004613,84696328,343838,772625946,33810,7
102724964,LOC102724964,chr7,F,44100836,44104135,84699627,3299,772629245,33811,2
102725191,LOC102725191,chr7,F,12496424,12544195,84747398,47771,772677016,33812,8
102725541,ELDR,chr7,R,55238435,55255635,84764598,17200,772694216,33813,3
103724390,LINC01287,chr7,R,153399918,153412234,84776914,12316,772706532,33814,3
104355138,LINC01162,chr7,F,20835430,21023148,84964632,187718,772894250,33815,5
104355291,LINC01392,chr7,R,115123598,115231355,85072389,107757,773002007,33816,4
105369146,LOC105369146,chr7,R,81472688,81570356,85170057,97668,773099675,33817,6
105375112,LOC105375112,chr7,R,31566,37465,85175956,5899,773105574,33818,3
105375113,LOC105375113,chr7,R,70808,75742,85180890,4934,773110508,33819,1
105375114,LOC105375114,chr7,R,112877,119313,85187326,6436,773116944,33820,2
105375115,LOC105375115,chr7,F,174919,176114,85188521,1195,773118139,33821,2
105375116,LOC105375116,chr7,F,176196,180728,85193053,4532,773122671,33822,1
105375117,LOC105375117,chr7,R,181484,183814,85195383,2330,773125001,33823,2
105375118,LOC105375118,chr7,R,330338,333249,85198294,2911,773127912,33824,2
105375119,LOC105375119,chr7,R,612960,614572,85199906,1612,773129524,33825,1
105375120,LOC105375120,chr7,F,1074247,1078875,85204534,4628,773134152,33826,2
105375121,LOC105375121,chr7,R,1521723,1525609,85208420,3886,773138038,33827,3
105375122,LOC105375122,chr7,F,1592356,1598609,85214673,6253,773144291,33828,2
105375123,LOC105375123,chr7,F,1601732,1603722,85216663,1990,773146281,33829,2
105375124,LOC105375124,chr7,R,1720766,1725035,85220932,4269,773150550,33830,4
105375125,LOC105375125,chr7,R,1718017,1718978,85221893,961,773151511,33831,2
105375126,LOC105375126,chr7,F,2182526,2205792,85245159,23266,773174777,33832,3
105375127,LOC105375127,chr7,F,2113563,2117740,85249336,4177,773178954,33833,1
105375128,LOC105375128,chr7,F,1817458,1819236,85251114,1778,773180732,33834,1
105375129,LOC105375129,chr7,F,3041843,3042662,85251933,819,773181551,33835,1
105375130,LOC105375130,chr7,R,3094029,3101381,85259285,7352,773188903,33836,2
105375131,LOC105375131,chr7,R,4126652,4137174,85269807,10522,773199425,33837,2
105375132,LOC105375132,chr7,R,3260332,3302522,85311997,42190,773241615,33838,3
105375133,LOC105375133,chr7,F,4533744,4569716,85347969,35972,773277587,33839,3
105375135,LOC105375135,chr7,R,5686024,5697583,85359528,11559,773289146,33840,4
105375136,LOC105375136,chr7,R,6588875,6589546,85360199,671,773289817,33841,1
105375137,LOC105375137,chr7,R,6950449,6955417,85365167,4968,773294785,33842,1
105375138,LOC105375138,chr7,F,7094961,7109629,85379835,14668,773309453,33843,4
105375139,LOC105375139,chr7,F,7929357,7968022,85418500,38665,773348118,33844,2
105375140,LOC105375140,chr7,F,7883074,7884695,85420121,1621,773349739,33845,2
105375141,LOC105375141,chr7,R,7738533,7742155,85423743,3622,773353361,33846,1
105375142,LOC105375142,chr7,F,8092700,8095681,85426724,2981,773356342,33847,2
105375143,LOC105375143,chr7,F,8209799,8216296,85433221,6497,773362839,33848,2
105375144,LOC105375144,chr7,R,8563493,8632624,85502352,69131,773431970,33849,7
105375145,LOC105375145,chr7,R,9639545,9667092,85529899,27547,773459517,33850,3
105375146,LOC105375146,chr7,F,9961074,9986360,85555185,25286,773484803,33851,4
105375147,LOC105375147,chr7,R,9708052,10085470,85932603,377418,773862221,33852,7
105375148,LOC105375148,chr7,F,9734269,9769513,85967847,35244,773897465,33853,6
105375149,LOC105375149,chr7,R,10090342,10161810,86039315,71468,773968933,33854,3
105375150,LOC105375150,chr7,R,10206693,10213281,86045903,6588,773975521,33855,3
105375151,LOC105375151,chr7,F,11567341,11594174,86072736,26833,774002354,33856,4
105375152,LOC105375152,chr7,F,11407062,11417286,86082960,10224,774012578,33857,2
105375153,LOC105375153,chr7,F,11320753,11385609,86147816,64856,774077434,33858,4
105375154,LOC105375154,chr7,F,12406088,12407895,86149623,1807,774079241,33859,2
105375155,LOC105375155,chr7,R,12433490,12443799,86159932,10309,774089550,33860,2
105375156,LOC105375156,chr7,R,12490482,12496343,86165793,5861,774095411,33861,5
105375157,LOC105375157,chr7,R,12674035,12675534,86167292,1499,774096910,33862,2
105375158,LOC105375158,chr7,F,12931339,13061535,86297488,130196,774227106,33863,2
105375159,LOC105375159,chr7,F,13092105,13217613,86422996,125508,774352614,33864,3
105375160,LOC105375160,chr7,F,13717781,13728612,86433827,10831,774363445,33865,3
105375161,LOC105375161,chr7,F,13728652,13743574,86448749,14922,774378367,33866,3
105375162,LOC105375162,chr7,F,14051110,14061781,86459420,10671,774389038,33867,2
105375163,LOC105375163,chr7,F,14799369,14816694,86476745,17325,774406363,33868,3
105375164,LOC105375164,chr7,F,14375773,14382903,86483875,7130,774413493,33869,2
105375165,LOC105375165,chr7,F,15237170,15312750,86559455,75580,774489073,33870,2
105375166,LOC105375166,chr7,F,15603766,15681980,86637669,78214,774567287,33871,6
105375167,LOC105375167,chr7,R,15735488,15802995,86705176,67507,774634794,33872,2
105375168,LOC105375168,chr7,F,16460199,16471809,86716786,11610,774646404,33873,1
105375169,LOC105375169,chr7,F,16604823,16628475,86740438,23652,774670056,33874,6
105375170,LOC105375170,chr7,F,16988839,17021616,86773215,32777,774702833,33875,2
105375171,LOC105375171,chr7,R,17362444,17371846,86782617,9402,774712235,33876,3
105375172,LOC105375172,chr7,R,17430586,17463138,86815169,32552,774744787,33877,6
105375173,LOC105375173,chr7,F,17900285,17958952,86873836,58667,774803454,33878,2
105375174,LOC105375174,chr7,F,19112480,19115880,86877236,3400,774806854,33879,1
105375175,LOC105375175,chr7,R,18999722,19106636,86984150,106914,774913768,33880,2
105375176,LOC105375176,chr7,R,18885888,18902613,87000875,16725,774930493,33881,2
105375177,LOC105375177,chr7,R,18653148,18659887,87007614,6739,774937232,33882,2
105375178,LOC105375178,chr7,F,18543291,18545930,87010253,2639,774939871,33883,1
105375179,LOC105375179,chr7,F,19403695,19433670,87040228,29975,774969846,33884,2
105375180,LOC105375180,chr7,F,19589164,19668277,87119341,79113,775048959,33885,3
105375181,LOC105375181,chr7,F,20104917,20119655,87134079,14738,775063697,33886,2
105375182,LOC105375182,chr7,F,19944908,19984764,87173935,39856,775103553,33887,2
105375183,LOC105375183,chr7,R,21560085,21576423,87190273,16338,775119891,33888,3
105375184,LOC105375184,chr7,R,22213999,22215603,87191877,1604,775121495,33889,1
105375185,LOC105375185,chr7,F,23021720,23030374,87200531,8654,775130149,33890,4
105375186,LOC105375186,chr7,R,23077789,23099195,87221937,21406,775151555,33891,2
105375187,LOC105375187,chr7,R,23586693,23597266,87232510,10573,775162128,33892,1
105375188,LOC105375188,chr7,F,24017155,24027698,87243053,10543,775172671,33893,3
105375189,LOC105375189,chr7,F,24227785,24234603,87249871,6818,775179489,33894,3
105375190,LOC105375190,chr7,R,24760271,24762168,87251768,1897,775181386,33895,2
105375191,LOC105375191,chr7,F,25186953,25193921,87258736,6968,775188354,33896,2
105375193,LOC105375193,chr7,F,25321502,25321920,87259154,418,775188772,33897,1
105375194,LOC105375194,chr7,F,25332889,25333714,87259979,825,775189597,33898,1
105375195,LOC105375195,chr7,F,25329204,25359926,87290701,30722,775220319,33899,2
105375196,LOC105375196,chr7,R,25486967,25496732,87300466,9765,775230084,33900,2
105375197,LOC105375197,chr7,R,25762757,25777196,87314905,14439,775244523,33901,2
105375198,LOC105375198,chr7,F,26101637,26123242,87336510,21605,775266128,33902,3
105375199,LOC105375199,chr7,R,25939086,26130930,87528354,191844,775457972,33903,10
105375200,LOC105375200,chr7,F,25941536,25945831,87532649,4295,775462267,33904,2
105375201,LOC105375201,chr7,R,26171510,26185286,87546425,13776,775476043,33905,2
105375202,LOC105375202,chr7,F,26429027,26430872,87548270,1845,775477888,33906,2
105375203,LOC105375203,chr7,R,26585560,26598242,87560952,12682,775490570,33907,1
105375204,LOC105375204,chr7,F,26805510,26858152,87613594,52642,775543212,33908,3
105375205,LOC105375205,chr7,F,27114129,27116665,87616130,2536,775545748,33909,2
105375206,LOC105375206,chr7,F,27379932,27381328,87617526,1396,775547144,33910,1
105375207,LOC105375207,chr7,F,27387777,27409118,87638867,21341,775568485,33911,2
105375208,LOC105375208,chr7,F,28037568,28063180,87664479,25612,775594097,33912,3
105375209,LOC105375209,chr7,R,27943308,27955715,87676886,12407,775606504,33913,4
105375210,LOC105375210,chr7,R,27733052,27740101,87683935,7049,775613553,33914,1
105375211,LOC105375211,chr7,F,27647092,27723002,87759845,75910,775689463,33915,3
105375212,LOC105375212,chr7,F,28186840,28193003,87766008,6163,775695626,33916,2
105375213,LOC105375213,chr7,R,29639694,29645161,87771475,5467,775701093,33917,1
105375214,LOC105375214,chr7,R,29510184,29512557,87773848,2373,775703466,33918,1
105375215,LOC105375215,chr7,F,29987805,30026305,87812348,38500,775741966,33919,2
105375216,LOC105375216,chr7,R,30130578,30134670,87816440,4092,775746058,33920,2
105375217,LOC105375217,chr7,R,30162494,30183210,87837156,20716,775766774,33921,2
105375218,LOC105375218,chr7,R,30243597,30282382,87875941,38785,775805559,33922,7
105375219,LOC105375219,chr7,R,30717587,30727274,87885628,9687,775815246,33923,3
105375220,LOC105375220,chr7,F,30697998,30750346,87937976,52348,775867594,33924,3
105375221,LOC105375221,chr7,R,30994089,31001326,87945213,7237,775874831,33925,2
105375222,LOC105375222,chr7,F,30983867,31031031,87992377,47164,775921995,33926,4
105375223,LOC105375223,chr7,R,32029289,32030412,87993500,1123,775923118,33927,2
105375224,LOC105375224,chr7,R,31413753,31416904,87996651,3151,775926269,33928,2
105375225,LOC105375225,chr7,F,32834791,32838704,88000564,3913,775930182,33929,1
105375226,LOC105375226,chr7,R,33464934,33467207,88002837,2273,775932455,33930,2
105375227,LOC105375227,chr7,F,33637840,33652754,88017751,14914,775947369,33931,5
105375228,LOC105375228,chr7,F,35035033,35036050,88018768,1017,775948386,33932,2
105375229,LOC105375229,chr7,F,35190685,35199219,88027302,8534,775956920,33933,1
105375230,LOC105375230,chr7,F,35384948,35387287,88029641,2339,775959259,33934,2
105375231,LOC105375231,chr7,R,35594219,35609712,88045134,15493,775974752,33935,2
105375232,LOC105375232,chr7,F,35908451,35912190,88048873,3739,775978491,33936,2
105375233,LOC105375233,chr7,F,36001518,36030574,88077929,29056,776007547,33937,2
105375234,LOC105375234,chr7,R,36053247,36105035,88129717,51788,776059335,33938,2
105375235,LOC105375235,chr7,F,36883758,36894836,88140795,11078,776070413,33939,2
105375236,LOC105375236,chr7,F,38003228,38044111,88181678,40883,776111296,33940,4
105375237,LOC105375237,chr7,R,39506587,39522502,88197593,15915,776127211,33941,4
105375238,LOC105375238,chr7,R,39416276,39474451,88255768,58175,776185386,33942,3
105375239,LOC105375239,chr7,R,39327556,39335202,88263414,7646,776193032,33943,2
105375240,LOC105375240,chr7,R,39551637,39566353,88278130,14716,776207748,33944,3
105375241,LOC105375241,chr7,R,41108867,41149795,88319058,40928,776248676,33945,3
105375242,LOC105375242,chr7,R,40858424,40902292,88362926,43868,776292544,33946,3
105375243,LOC105375243,chr7,R,40708083,40709013,88363856,930,776293474,33947,2
105375244,LOC105375244,chr7,R,40565172,40595291,88393975,30119,776323593,33948,7
105375245,LOC105375245,chr7,R,40239915,40297221,88451281,57306,776380899,33949,3
105375246,LOC105375246,chr7,F,41332088,41355671,88474864,23583,776404482,33950,5
105375247,LOC105375247,chr7,R,41656420,41667312,88485756,10892,776415374,33951,2
105375248,LOC105375248,chr7,F,41933592,41936933,88489097,3341,776418715,33952,2
105375249,LOC105375249,chr7,R,42326357,42338382,88501122,12025,776430740,33953,3
105375250,LOC105375250,chr7,F,42496295,42516554,88521381,20259,776450999,33954,2
105375251,LOC105375251,chr7,R,42591290,42650382,88580473,59092,776510091,33955,5
105375253,LOC105375253,chr7,R,42953226,42956129,88583376,2903,776512994,33956,2
105375254,LOC105375254,chr7,R,42972331,43044627,88655672,72296,776585290,33957,2
105375255,LOC105375255,chr7,F,43649715,43650639,88656596,924,776586214,33958,2
105375256,LOC105375256,chr7,F,44065427,44071671,88662840,6244,776592458,33959,2
105375257,LOC105375257,chr7,F,44172374,44184141,88674607,11767,776604225,33960,3
105375258,LOC105375258,chr7,F,44147666,44149773,88676714,2107,776606332,33961,2
105375259,LOC105375259,chr7,R,44795585,44796159,88677288,574,776606906,33962,1
105375260,LOC105375260,chr7,F,44821993,44824842,88680137,2849,776609755,33963,2
105375261,LOC105375261,chr7,F,44848438,44849565,88681264,1127,776610882,33964,1
105375262,LOC105375262,chr7,F,44904770,44908780,88685274,4010,776614892,33965,1
105375263,LOC105375263,chr7,R,45534588,45539918,88690604,5330,776620222,33966,3
105375264,LOC105375264,chr7,R,45992865,46024296,88722035,31431,776651653,33967,2
105375265,LOC105375265,chr7,F,46302127,46353154,88773062,51027,776702680,33968,4
105375266,LOC105375266,chr7,R,46476456,46481587,88778193,5131,776707811,33969,3
105375267,LOC105375267,chr7,F,46969691,46981879,88790381,12188,776719999,33970,3
105375268,LOC105375268,chr7,R,47000619,47079809,88869571,79190,776799189,33971,3
105375269,LOC105375269,chr7,R,47265299,47268847,88873119,3548,776802737,33972,2
105375270,LOC105375270,chr7,F,47982588,47986467,88876998,3879,776806616,33973,2
105375271,LOC105375271,chr7,R,48111245,48114370,88880123,3125,776809741,33974,3
105375272,LOC105375272,chr7,R,48659485,48669491,88890129,10006,776819747,33975,2
105375273,LOC105375273,chr7,F,48708468,48711484,88893145,3016,776822763,33976,1
105375274,LOC105375274,chr7,F,48847488,48851619,88897276,4131,776826894,33977,0
105375275,LOC105375275,chr7,R,50382722,50399390,88913944,16668,776843562,33978,2
105375276,LOC105375276,chr7,F,50781514,50782187,88914617,673,776844235,33979,1
105375277,LOC105375277,chr7,F,51544218,51579388,88949787,35170,776879405,33980,2
105375278,LOC105375278,chr7,F,51707968,51717668,88959487,9700,776889105,33981,4
105375279,LOC105375279,chr7,R,52022308,52046314,88983493,24006,776913111,33982,2
105375280,LOC105375280,chr7,F,52415922,52426630,88994201,10708,776923819,33983,2
105375281,LOC105375281,chr7,F,52839564,52843577,88998214,4013,776927832,33984,2
105375282,LOC105375282,chr7,R,53348023,53418890,89069081,70867,776998699,33985,5
105375283,LOC105375283,chr7,R,53564197,53574528,89079412,10331,777009030,33986,2
105375284,LOC105375284,chr7,R,54993023,54995619,89082008,2596,777011626,33987,2
105375285,LOC105375285,chr7,F,55366328,55368010,89083690,1682,777013308,33988,1
105375286,LOC105375286,chr7,R,55553770,55559862,89089782,6092,777019400,33989,2
105375287,LOC105375287,chr7,F,55587730,55596180,89098232,8450,777027850,33990,14
105375288,LOC105375288,chr7,R,56119881,56126445,89104796,6564,777034414,33991,2
105375289,LOC105375289,chr7,F,56667612,56669561,89106745,1949,777036363,33992,2
105375290,LOC105375290,chr7,R,56651010,56658811,89114546,7801,777044164,33993,2
105375291,LOC105375291,chr7,R,56576607,56617967,89155906,41360,777085524,33994,9
105375292,LOC105375292,chr7,R,56381764,56388488,89162630,6724,777092248,33995,2
105375293,LOC105375293,chr7,F,56373986,56374802,89163446,816,777093064,33996,1
105375294,LOC105375294,chr7,R,56836224,56849683,89176905,13459,777106523,33997,4
105375295,LOC105375295,chr7,R,56857999,56862321,89181227,4322,777110845,33998,3
105375296,LOC105375296,chr7,F,57140609,57148387,89189005,7778,777118623,33999,2
105375297,LOC105375297,chr7,R,57209801,57222887,89202091,13086,777131709,34000,4
105375298,LOC105375298,chr7,F,57242678,57245963,89205376,3285,777134994,34001,3
105375299,LOC105375299,chr7,R,57401996,57404717,89208097,2721,777137715,34002,1
105375300,LOC105375300,chr7,R,57518012,57520665,89210750,2653,777140368,34003,2
105375301,LOC105375301,chr7,F,57540791,57549935,89219894,9144,777149512,34004,2
105375302,LOC105375302,chr7,F,57770208,57840981,89290667,70773,777220285,34005,8
105375303,LOC105375303,chr7,F,1616879,1642739,89316527,25860,777246145,34006,5
105375304,LOC105375304,chr7,R,26372437,26376794,89320884,4357,777250502,34007,2
105375305,LOC105375305,chr7,F,39948745,39950638,89322777,1893,777252395,34008,2
105375313,LOC105375313,chr7,F,63699205,63707105,89330677,7900,777260295,34009,2
105375314,LOC105375314,chr7,F,63714586,63718963,89335054,4377,777264672,34010,3
105375315,LOC105375315,chr7,F,63727305,63739638,89347387,12333,777277005,34011,3
105375316,LOC105375316,chr7,F,63765654,63767001,89348734,1347,777278352,34012,1
105375317,LOC105375317,chr7,R,64032105,64039611,89356240,7506,777285858,34013,2
105375318,LOC105375318,chr7,F,63925902,63966074,89396412,40172,777326030,34014,4
105375319,LOC105375319,chr7,R,64225750,64227621,89398283,1871,777327901,34015,3
105375320,LOC105375320,chr7,F,64381837,64401995,89418441,20158,777348059,34016,3
105375321,LOC105375321,chr7,F,64371318,64374770,89421893,3452,777351511,34017,3
105375322,LOC105375322,chr7,R,64294504,64308015,89435404,13511,777365022,34018,10
105375323,LOC105375323,chr7,R,64287419,64292262,89440247,4843,777369865,34019,6
105375324,LOC105375324,chr7,F,64402038,64412499,89450708,10461,777380326,34020,1
105375325,LOC105375325,chr7,F,64600305,64604054,89454457,3749,777384075,34021,3
105375326,LOC105375326,chr7,R,64633089,64636078,89457446,2989,777387064,34022,2
105375327,LOC105375327,chr7,F,64631045,64634081,89460482,3036,777390100,34023,2
105375328,LOC105375328,chr7,F,64947545,64950664,89463601,3119,777393219,34024,3
105375329,LOC105375329,chr7,F,65026793,65029426,89466234,2633,777395852,34025,2
105375330,LOC105375330,chr7,R,65008673,65038261,89495822,29588,777425440,34026,5
105375331,LOC105375331,chr7,R,65059352,65081281,89517751,21929,777447369,34027,2
105375332,LOC105375332,chr7,R,65072096,65073445,89519100,1349,777448718,34028,1
105375333,LOC105375333,chr7,F,65531314,65553682,89541468,22368,777471086,34029,2
105375334,LOC105375334,chr7,F,65303554,65338614,89576528,35060,777506146,34030,3
105375335,LOC105375335,chr7,R,65828901,65863735,89611362,34834,777540980,34031,3
105375336,LOC105375336,chr7,R,66000863,66038095,89648594,37232,777578212,34032,4
105375337,LOC105375337,chr7,F,67342851,67356275,89662018,13424,777591636,34033,2
105375338,LOC105375338,chr7,R,67229938,67236948,89669028,7010,777598646,34034,2
105375339,LOC105375339,chr7,R,66958300,66960925,89671653,2625,777601271,34035,1
105375340,LOC105375340,chr7,R,67595650,67604480,89680483,8830,777610101,34036,4
105375341,LOC105375341,chr7,R,68155125,68330391,89855749,175266,777785367,34037,9
105375342,LOC105375342,chr7,F,69040177,69046781,89862353,6604,777791971,34038,2
105375343,LOC105375343,chr7,R,69115869,69150203,89896687,34334,777826305,34039,2
105375344,LOC105375344,chr7,R,69162420,69172832,89907099,10412,777836717,34040,1
105375345,LOC105375345,chr7,R,69283013,69304166,89928252,21153,777857870,34041,4
105375346,LOC105375346,chr7,F,69544024,69580727,89964955,36703,777894573,34042,4
105375347,LOC105375347,chr7,F,70744013,70746136,89967078,2123,777896696,34043,1
105375348,LOC105375348,chr7,R,70595122,70596799,89968755,1677,777898373,34044,2
105375349,LOC105375349,chr7,R,73210535,73211198,89969418,663,777899036,34045,1
105375350,LOC105375350,chr7,F,73703001,73705160,89971577,2159,777901195,34046,1
105375351,LOC105375351,chr7,R,74763934,74764574,89972217,640,777901835,34047,1
105375352,LOC105375352,chr7,F,74947725,74954289,89978781,6564,777908399,34048,3
105375353,LOC105375353,chr7,F,75181458,75182121,89979444,663,777909062,34049,1
105375354,LOC105375354,chr7,F,76524382,76544090,89999152,19708,777928770,34050,3
105375355,LOC105375355,chr7,F,76510101,76524424,90013475,14323,777943093,34051,6
105375356,LOC105375356,chr7,R,76650796,76728561,90091240,77765,778020858,34052,5
105375357,LOC105375357,chr7,R,76552954,76578809,90117095,25855,778046713,34053,2
105375358,LOC105375358,chr7,F,76902505,76919127,90133717,16622,778063335,34054,2
105375359,LOC105375359,chr7,R,77221195,77246728,90159250,25533,778088868,34055,4
105375360,LOC105375360,chr7,R,77125976,77165747,90199021,39771,778128639,34056,2
105375361,LOC105375361,chr7,R,76971187,76977221,90205055,6034,778134673,34057,3
105375362,LOC105375362,chr7,F,77446744,77460536,90218847,13792,778148465,34058,2
105375363,LOC105375363,chr7,F,77653365,77655912,90221394,2547,778151012,34059,2
105375364,LOC105375364,chr7,R,77657659,77661301,90225036,3642,778154654,34060,1
105375365,LOC105375365,chr7,R,77911038,77920260,90234258,9222,778163876,34061,2
105375366,LOC105375366,chr7,F,79139788,79177270,90271740,37482,778201358,34062,2
105375367,LOC105375367,chr7,F,78185458,78215014,90301296,29556,778230914,34063,2
105375368,LOC105375368,chr7,F,77990388,77996366,90307274,5978,778236892,34064,2
105375369,LOC105375369,chr7,F,79634686,79670974,90343562,36288,778273180,34065,5
105375370,LOC105375370,chr7,F,79696923,79716240,90362879,19317,778292497,34066,5
105375371,LOC105375371,chr7,F,79768024,79839246,90434101,71222,778363719,34067,2
105375372,LOC105375372,chr7,F,79948935,79957033,90442199,8098,778371817,34068,2
105375373,LOC105375373,chr7,R,80330290,80334950,90446859,4660,778376477,34069,4
105375374,LOC105375374,chr7,F,82341204,82354347,90460002,13143,778389620,34070,2
105375375,LOC105375375,chr7,F,82311742,82313714,90461974,1972,778391592,34071,1
105375376,LOC105375376,chr7,R,82690718,82695876,90467132,5158,778396750,34072,4
105375377,LOC105375377,chr7,R,83168154,83175460,90474438,7306,778404056,34073,2
105375378,LOC105375378,chr7,R,83471780,83482249,90484907,10469,778414525,34074,2
105375379,LOC105375379,chr7,R,84648535,84880517,90716889,231982,778646507,34075,3
105375380,LOC105375380,chr7,F,85475226,85489338,90731001,14112,778660619,34076,1
105375381,LOC105375381,chr7,R,86594338,86614750,90751413,20412,778681031,34077,2
105375382,LOC105375382,chr7,R,86773313,86795187,90773287,21874,778702905,34078,3
105375383,LOC105375383,chr7,F,87058642,87111964,90826609,53322,778756227,34079,5
105375384,LOC105375384,chr7,F,87199301,87202754,90830062,3453,778759680,34080,1
105375385,LOC105375385,chr7,R,87888065,87926669,90868666,38604,778798284,34081,3
105375386,LOC105375386,chr7,R,88140084,88157816,90886398,17732,778816016,34082,6
105375387,LOC105375387,chr7,F,89443973,89497132,90939557,53159,778869175,34083,8
105375388,LOC105375388,chr7,R,90289095,90294895,90945357,5800,778874975,34084,2
105375389,LOC105375389,chr7,R,90235142,90243164,90953379,8022,778882997,34085,1
105375390,LOC105375390,chr7,R,90355335,90418856,91016900,63521,778946518,34086,2
105375391,LOC105375391,chr7,F,91287753,91292339,91021486,4586,778951104,34087,2
105375392,LOC105375392,chr7,F,91311310,91316055,91026231,4745,778955849,34088,2
105375393,LOC105375393,chr7,R,91515329,91556282,91067184,40953,778996802,34089,2
105375394,LOC105375394,chr7,F,91496561,91515322,91085945,18761,779015563,34090,3
105375395,LOC105375395,chr7,R,92319931,92323807,91089821,3876,779019439,34091,2
105375396,LOC105375396,chr7,R,92412549,92437456,91114728,24907,779044346,34092,9
105375397,LOC105375397,chr7,R,92591932,92600603,91123399,8671,779053017,34093,2
105375398,LOC105375398,chr7,F,92651140,92659435,91131694,8295,779061312,34094,1
105375399,LOC105375399,chr7,F,92627108,92650952,91155538,23844,779085156,34095,4
105375400,LOC105375400,chr7,F,93533246,93559530,91181822,26284,779111440,34096,3
105375401,LOC105375401,chr7,F,93890843,93893588,91184567,2745,779114185,34097,1
105375402,LOC105375402,chr7,R,93914499,93937436,91207504,22937,779137122,34098,2
105375403,LOC105375403,chr7,F,93966032,93993694,91235166,27662,779164784,34099,2
105375404,LOC105375404,chr7,R,94477909,94564586,91321843,86677,779251461,34100,7
105375405,LOC105375405,chr7,R,95035451,95214946,91501338,179495,779430956,34101,5
105375406,LOC105375406,chr7,R,94926166,94928540,91503712,2374,779433330,34102,2
105375407,LOC105375407,chr7,F,95553003,95562440,91513149,9437,779442767,34103,1
105375408,LOC105375408,chr7,F,95679147,95682153,91516155,3006,779445773,34104,1
105375409,LOC105375409,chr7,F,95660321,95719917,91575751,59596,779505369,34105,5
105375410,LOC105375410,chr7,F,96358525,96445087,91662313,86562,779591931,34106,7
105375411,LOC105375411,chr7,F,96450177,96509218,91721354,59041,779650972,34107,3
105375412,LOC105375412,chr7,F,96509237,96531299,91743416,22062,779673034,34108,2
105375413,LOC105375413,chr7,R,96703965,96709009,91748460,5044,779678078,34109,2
105375414,LOC105375414,chr7,F,96786822,96804686,91766324,17864,779695942,34110,3
105375415,LOC105375415,chr7,F,96945552,96960417,91781189,14865,779710807,34111,3
105375416,LOC105375416,chr7,R,97328529,97372151,91824811,43622,779754429,34112,2
105375417,LOC105375417,chr7,R,97159616,97177389,91842584,17773,779772202,34113,4
105375418,LOC105375418,chr7,F,98668219,98671131,91845496,2912,779775114,34114,2
105375419,LOC105375419,chr7,R,98652638,98657602,91850460,4964,779780078,34115,3
105375420,LOC105375420,chr7,F,99047888,99081068,91883640,33180,779813258,34116,3
105375421,LOC105375421,chr7,R,99278270,99325799,91931169,47529,779860787,34117,4
105375422,LOC105375422,chr7,F,99552151,99554822,91933840,2671,779863458,34118,3
105375423,LOC105375423,chr7,F,99999450,100011750,91946140,12300,779875758,34119,2
105375424,LOC105375424,chr7,F,100108483,100109898,91947555,1415,779877173,34120,1
105375425,LOC105375425,chr7,F,100130670,100143647,91960532,12977,779890150,34121,3
105375426,LOC105375426,chr7,R,100264866,100267483,91963149,2617,779892767,34122,1
105375427,LOC105375427,chr7,F,100233680,100234760,91964229,1080,779893847,34123,1
105375428,LOC105375428,chr7,F,100622121,100633005,91975113,10884,779904731,34124,2
105375429,LOC105375429,chr7,F,100655814,100666793,91986092,10979,779915710,34125,4
105375430,LOC105375430,chr7,R,100836893,100852637,92001836,15744,779931454,34126,2
105375431,LOC105375431,chr7,R,100942058,100964228,92024006,22170,779953624,34127,3
105375432,LOC105375432,chr7,R,102240548,102247538,92030996,6990,779960614,34128,2
105375433,LOC105375433,chr7,R,102407506,102421280,92044770,13774,779974388,34129,3
105375434,LOC105375434,chr7,F,103149734,103200285,92095321,50551,780024939,34130,5
105375435,LOC105375435,chr7,F,103534589,103539064,92099796,4475,780029414,34131,2
105375436,LOC105375436,chr7,R,104738550,104753116,92114362,14566,780043980,34132,2
105375437,LOC105375437,chr7,F,105807642,105816676,92123396,9034,780053014,34133,2
105375438,LOC105375438,chr7,R,106461957,106466551,92127990,4594,780057608,34134,2
105375439,LOC105375439,chr7,R,106588136,106598900,92138754,10764,780068372,34135,2
105375440,LOC105375440,chr7,F,106624103,106628849,92143500,4746,780073118,34136,4
105375441,LOC105375441,chr7,R,107066924,107079609,92156185,12685,780085803,34137,3
105375442,LOC105375442,chr7,F,107221775,107235472,92169882,13697,780099500,34138,2
105375443,LOC105375443,chr7,R,107631893,107643352,92181341,11459,780110959,34139,1
105375444,LOC105375444,chr7,R,107856478,107870881,92195744,14403,780125362,34140,2
105375445,LOC105375445,chr7,R,107870923,107874273,92199094,3350,780128712,34141,2
105375446,LOC105375446,chr7,F,108084270,108091374,92206198,7104,780135816,34142,2
105375447,LOC105375447,chr7,R,108554542,108561807,92213463,7265,780143081,34143,1
105375448,LOC105375448,chr7,F,108577417,108614273,92250319,36856,780179937,34144,7
105375449,LOC105375449,chr7,F,110531188,110554153,92273284,22965,780202902,34145,2
105375450,LOC105375450,chr7,F,110436520,110456520,92293284,20000,780222902,34146,2
105375451,LOC105375451,chr7,R,110432747,110534687,92395224,101940,780324842,34147,3
105375452,LOC105375452,chr7,F,110555233,110588106,92428097,32873,780357715,34148,5
105375453,LOC105375453,chr7,R,110591465,110622056,92458688,30591,780388306,34149,2
105375454,LOC105375454,chr7,F,111840693,111846992,92464987,6299,780394605,34150,2
105375455,LOC105375455,chr7,F,111756973,111758372,92466386,1399,780396004,34151,2
105375456,LOC105375456,chr7,R,112370879,112391337,92486844,20458,780416462,34152,2
105375457,LOC105375457,chr7,R,112399041,112445306,92533109,46265,780462727,34153,8
105375458,LOC105375458,chr7,F,112522273,112617338,92628174,95065,780557792,34154,5
105375459,LOC105375459,chr7,F,112752833,112758678,92634019,5845,780563637,34155,1
105375460,LOC105375460,chr7,F,113055667,113061751,92640103,6084,780569721,34156,2
105375461,LOC105375461,chr7,F,115682790,115684594,92641907,1804,780571525,34157,2
105375462,LOC105375462,chr7,R,115756734,115758871,92644044,2137,780573662,34158,2
105375463,LOC105375463,chr7,F,116285340,116349745,92708449,64405,780638067,34159,11
105375464,LOC105375464,chr7,R,116235867,116243799,92716381,7932,780645999,34160,1
105375465,LOC105375465,chr7,F,116940338,116947897,92723940,7559,780653558,34161,2
105375466,LOC105375466,chr7,F,117232820,117241161,92732281,8341,780661899,34162,2
105375467,LOC105375467,chr7,F,117286796,117322563,92768048,35767,780697666,34163,4
105375468,LOC105375468,chr7,F,117447915,117475729,92795862,27814,780725480,34164,2
105375469,LOC105375469,chr7,F,117715738,117730525,92810649,14787,780740267,34165,2
105375470,LOC105375470,chr7,R,118152313,118184002,92842338,31689,780771956,34166,3
105375471,LOC105375471,chr7,F,118427039,118444086,92859385,17047,780789003,34167,3
105375472,LOC105375472,chr7,F,118474807,118480594,92865172,5787,780794790,34168,3
105375473,LOC105375473,chr7,F,118503017,118545686,92907841,42669,780837459,34169,8
105375474,LOC105375474,chr7,F,118859069,118862193,92910965,3124,780840583,34170,2
105375475,LOC105375475,chr7,R,119764936,119895309,93041338,130373,780970956,34171,2
105375476,LOC105375476,chr7,F,120166480,120185032,93059890,18552,780989508,34172,2
105375477,LOC105375477,chr7,R,120216559,120227118,93070449,10559,781000067,34173,2
105375478,LOC105375478,chr7,R,121486316,121505159,93089292,18843,781018910,34174,3
105375479,LOC105375479,chr7,F,121480302,121490711,93099701,10409,781029319,34175,2
105375480,LOC105375480,chr7,R,121731681,121756004,93124024,24323,781053642,34176,2
105375481,LOC105375481,chr7,F,122527731,122563437,93159730,35706,781089348,34177,5
105375482,LOC105375482,chr7,F,122915557,122967210,93211383,51653,781141001,34178,2
105375483,LOC105375483,chr7,F,123994630,124027646,93244399,33016,781174017,34179,4
105375484,LOC105375484,chr7,R,124274234,124288855,93259020,14621,781188638,34180,2
105375485,LOC105375485,chr7,F,124048765,124090520,93300775,41755,781230393,34181,2
105375486,LOC105375486,chr7,R,125151163,125160038,93309650,8875,781239268,34182,1
105375487,LOC105375487,chr7,R,125845207,125854216,93318659,9009,781248277,34183,2
105375488,LOC105375488,chr7,F,126233569,126253648,93338738,20079,781268356,34184,4
105375489,LOC105375489,chr7,R,127591581,127592196,93339353,615,781268971,34185,1
105375490,LOC105375490,chr7,R,127485196,127590059,93444216,104863,781373834,34186,5
105375491,LOC105375491,chr7,R,128049577,128061568,93456207,11991,781385825,34187,3
105375492,LOC105375492,chr7,R,127938213,128008045,93526039,69832,781455657,34188,3
105375493,LOC105375493,chr7,F,128121846,128126321,93530514,4475,781460132,34189,2
105375494,LOC105375494,chr7,R,128235682,128236798,93531630,1116,781461248,34190,2
105375495,LOC105375495,chr7,R,128434062,128455594,93553162,21532,781482780,34191,3
105375496,LOC105375496,chr7,R,128822550,128828979,93559591,6429,781489209,34192,1
105375497,LOC105375497,chr7,F,128891228,128900919,93569282,9691,781498900,34193,2
105375498,LOC105375498,chr7,R,129413688,129434311,93589905,20623,781519523,34194,3
105375499,LOC105375499,chr7,R,129363158,129367502,93594249,4344,781523867,34195,1
105375500,LOC105375500,chr7,F,129350980,129352477,93595746,1497,781525364,34196,1
105375501,LOC105375501,chr7,R,129763057,129769186,93601875,6129,781531493,34197,2
105375502,LOC105375502,chr7,F,130170473,130200917,93632319,30444,781561937,34198,2
105375503,LOC105375503,chr7,R,130318648,130344572,93658243,25924,781587861,34199,6
105375504,LOC105375504,chr7,R,130365649,130367127,93659721,1478,781589339,34200,1
105375505,LOC105375505,chr7,F,130441975,130443226,93660972,1251,781590590,34201,2
105375506,LOC105375506,chr7,R,130660022,130662627,93663577,2605,781593195,34202,2
105375507,LOC105375507,chr7,F,130595571,130597009,93665015,1438,781594633,34203,2
105375508,LOC105375508,chr7,F,130734251,130862158,93792922,127907,781722540,34204,7
105375509,LOC105375509,chr7,R,130791461,130832757,93834218,41296,781763836,34205,3
105375510,LOC105375510,chr7,R,132421841,132448248,93860625,26407,781790243,34206,2
105375511,LOC105375511,chr7,F,132403447,132410331,93867509,6884,781797127,34207,3
105375512,LOC105375512,chr7,R,133099070,133108591,93877030,9521,781806648,34208,2
105375513,LOC105375513,chr7,F,134073214,134102412,93906228,29198,781835846,34209,3
105375514,LOC105375514,chr7,R,134072426,134098189,93931991,25763,781861609,34210,5
105375515,LOC105375515,chr7,F,134065796,134072990,93939185,7194,781868803,34211,2
105375516,LOC105375516,chr7,F,134119316,134125756,93945625,6440,781875243,34212,2
105375517,LOC105375517,chr7,R,134368822,134374270,93951073,5448,781880691,34213,4
105375518,LOC105375518,chr7,F,134366770,134384225,93968528,17455,781898146,34214,2
105375519,LOC105375519,chr7,R,134415575,134432407,93985360,16832,781914978,34215,3
105375520,LOC105375520,chr7,R,134549247,134558334,93994447,9087,781924065,34216,1
105375521,LOC105375521,chr7,F,135687023,135708104,94015528,21081,781945146,34217,3
105375522,LOC105375522,chr7,F,135758456,135771179,94028251,12723,781957869,34218,4
105375523,LOC105375523,chr7,F,136025621,136439517,94442147,413896,782371765,34219,9
105375524,LOC105375524,chr7,R,136743804,136752301,94450644,8497,782380262,34220,2
105375525,LOC105375525,chr7,R,137196763,137204824,94458705,8061,782388323,34221,2
105375526,LOC105375526,chr7,R,137363711,137365167,94460161,1456,782389779,34222,2
105375527,LOC105375527,chr7,F,137324588,137326027,94461600,1439,782391218,34223,1
105375528,LOC105375528,chr7,F,137303167,137321266,94479699,18099,782409317,34224,2
105375529,LOC105375529,chr7,F,139424734,139425500,94480465,766,782410083,34225,1
105375530,LOC105375530,chr7,F,139584071,139615848,94512242,31777,782441860,34226,4
105375531,LOC105375531,chr7,F,139970392,139978524,94520374,8132,782449992,34227,1
105375532,LOC105375532,chr7,F,139939362,139947147,94528159,7785,782457777,34228,1
105375533,LOC105375533,chr7,F,140073426,140083502,94538235,10076,782467853,34229,2
105375534,LOC105375534,chr7,R,140294528,140297436,94541143,2908,782470761,34230,2
105375535,LOC105375535,chr7,F,140640966,140652431,94552608,11465,782482226,34231,3
105375536,LOC105375536,chr7,F,140925085,141014544,94642067,89459,782571685,34232,7
105375537,LOC105375537,chr7,F,141056879,141070707,94655895,13828,782585513,34233,2
105375538,LOC105375538,chr7,R,141500094,141551231,94707032,51137,782636650,34234,8
105375539,LOC105375539,chr7,R,142321555,142336648,94722125,15093,782651743,34235,2
105375540,LOC105375540,chr7,R,142309749,142312366,94724742,2617,782654360,34236,2
105375541,LOC105375541,chr7,F,142813300,142817433,94728875,4133,782658493,34237,2
105375542,LOC105375542,chr7,R,142935726,142936950,94730099,1224,782659717,34238,1
105375543,LOC105375543,chr7,R,142937554,142939092,94731637,1538,782661255,34239,1
105375544,LOC105375544,chr7,R,143029259,143039487,94741865,10228,782671483,34240,1
105375545,LOC105375545,chr7,R,143255306,143286202,94772761,30896,782702379,34241,4
105375546,LOC105375546,chr7,F,143237574,143263243,94798430,25669,782728048,34242,3
105375547,LOC105375547,chr7,F,143495358,143496986,94800058,1628,782729676,34243,1
105375548,LOC105375548,chr7,R,144058489,144084827,94826396,26338,782756014,34244,4
105375549,LOC105375549,chr7,F,143885445,143901949,94842900,16504,782772518,34245,1
105375550,LOC105375550,chr7,F,143836867,143875981,94882014,39114,782811632,34246,6
105375551,LOC105375551,chr7,F,145042674,145165679,95005019,123005,782934637,34247,7
105375552,LOC105375552,chr7,F,144976900,144979545,95007664,2645,782937282,34248,2
105375553,LOC105375553,chr7,R,145675838,145681460,95013286,5622,782942904,34249,1
105375554,LOC105375554,chr7,R,148381637,148436899,95068548,55262,782998166,34250,5
105375555,LOC105375555,chr7,R,148103200,148155390,95120738,52190,783050356,34251,4
105375556,LOC105375556,chr7,F,147671698,147673144,95122184,1446,783051802,34252,1
105375557,LOC105375557,chr7,R,148543560,148625612,95204236,82052,783133854,34253,3
105375558,LOC105375558,chr7,F,148802092,148824109,95226253,22017,783155871,34254,3
105375559,LOC105375559,chr7,R,149397230,149401431,95230454,4201,783160072,34255,2
105375560,LOC105375560,chr7,R,150332700,150334318,95232072,1618,783161690,34256,1
105375561,LOC105375561,chr7,F,150076553,150092263,95247782,15710,783177400,34257,2
105375562,LOC105375562,chr7,F,149973527,149984139,95258394,10612,783188012,34258,3
105375563,LOC105375563,chr7,R,150362698,150368844,95264540,6146,783194158,34259,3
105375564,LOC105375564,chr7,R,150379843,150384006,95268703,4163,783198321,34260,1
105375565,LOC105375565,chr7,R,150648475,150686725,95306953,38250,783236571,34261,2
105375566,LOC105375566,chr7,R,150761586,150782108,95327475,20522,783257093,34262,6
105375567,LOC105375567,chr7,R,150823032,150877309,95381752,54277,783311370,34263,5
105375568,LOC105375568,chr7,R,151024994,151028267,95385025,3273,783314643,34264,3
105375569,LOC105375569,chr7,F,151248746,151257102,95393381,8356,783322999,34265,2
105375570,LOC105375570,chr7,R,151946950,151954995,95401426,8045,783331044,34266,2
105375571,LOC105375571,chr7,R,151955118,151956345,95402653,1227,783332271,34267,1
105375572,LOC105375572,chr7,R,152100983,152102433,95404103,1450,783333721,34268,1
105375573,LOC105375573,chr7,R,152071792,152085656,95417967,13864,783347585,34269,2
105375574,LOC105375574,chr7,F,152513882,152523309,95427394,9427,783357012,34270,2
105375575,LOC105375575,chr7,R,153129526,153144071,95441939,14545,783371557,34271,2
105375576,LOC105375576,chr7,F,153190794,153225409,95476554,34615,783406172,34272,2
105375577,LOC105375577,chr7,F,153389596,153396975,95483933,7379,783413551,34273,2
105375578,LOC105375578,chr7,R,153423959,153436251,95496225,12292,783425843,34274,2
105375579,LOC105375579,chr7,F,153507090,153508337,95497472,1247,783427090,34275,1
105375580,LOC105375580,chr7,R,154825115,154865463,95537820,40348,783467438,34276,2
105375581,LOC105375581,chr7,R,154614758,154624910,95547972,10152,783477590,34277,3
105375582,LOC105375582,chr7,R,154232354,154248178,95563796,15824,783493414,34278,4
105375583,LOC105375583,chr7,F,153754377,153755904,95565323,1527,783494941,34279,2
105375584,LOC105375584,chr7,F,155169335,155173319,95569307,3984,783498925,34280,3
105375585,LOC105375585,chr7,R,155222626,155227237,95573918,4611,783503536,34281,2
105375586,LOC105375586,chr7,F,155203699,155214634,95584853,10935,783514471,34282,3
105375587,LOC105375587,chr7,R,155238657,155254119,95600315,15462,783529933,34283,5
105375588,LOC105375588,chr7,R,155262892,155266679,95604102,3787,783533720,34284,4
105375589,LOC105375589,chr7,F,155267146,155268074,95605030,928,783534648,34285,1
105375590,LOC105375590,chr7,R,155269529,155278415,95613916,8886,783543534,34286,2
105375591,LOC105375591,chr7,R,155288608,155298252,95623560,9644,783553178,34287,2
105375592,LOC105375592,chr7,R,155311335,155337461,95649686,26126,783579304,34288,2
105375593,LOC105375593,chr7,F,155364221,155370289,95655754,6068,783585372,34289,2
105375594,LOC105375594,chr7,F,155414883,155418811,95659682,3928,783589300,34290,2
105375595,LOC105375595,chr7,R,155799979,155801870,95661573,1891,783591191,34291,1
105375596,LOC105375596,chr7,R,155939890,155944973,95666656,5083,783596274,34292,2
105375597,LOC105375597,chr7,F,156012679,156033398,95687375,20719,783616993,34293,2
105375598,LOC105375598,chr7,F,156522097,156525230,95690508,3133,783620126,34294,2
105375599,LOC105375599,chr7,R,156432366,156433006,95691148,640,783620766,34295,1
105375600,LOC105375600,chr7,F,156223470,156236167,95703845,12697,783633463,34296,4
105375601,LOC105375601,chr7,F,156194063,156209890,95719672,15827,783649290,34297,4
105375602,LOC105375602,chr7,F,156146077,156158167,95731762,12090,783661380,34298,2
105375603,LOC105375603,chr7,R,156140073,156145989,95737678,5916,783667296,34299,2
105375604,LOC105375604,chr7,R,156937416,156939681,95739943,2265,783669561,34300,2
105375605,LOC105375605,chr7,F,156942429,156945780,95743294,3351,783672912,34301,2
105375606,LOC105375606,chr7,F,157005880,157007120,95744534,1240,783674152,34302,1
105375607,LOC105375607,chr7,F,157111165,157124009,95757378,12844,783686996,34303,4
105375608,LOC105375608,chr7,F,157368182,157373439,95762635,5257,783692253,34304,2
105375609,LOC105375609,chr7,R,157465523,157466177,95763289,654,783692907,34305,1
105375610,LOC105375610,chr7,F,157501190,157518614,95780713,17424,783710331,34306,7
105375611,LOC105375611,chr7,F,158537494,158551601,95794820,14107,783724438,34307,3
105375612,LOC105375612,chr7,F,158433390,158447848,95809278,14458,783738896,34308,4
105375613,LOC105375613,chr7,F,157987157,157989196,95811317,2039,783740935,34309,2
105375614,LOC105375614,chr7,F,157614022,157618771,95816066,4749,783745684,34310,1
105375615,LOC105375615,chr7,R,157609874,157613149,95819341,3275,783748959,34311,1
105375616,LOC105375616,chr7,F,158590235,158591120,95820226,885,783749844,34312,1
105375617,LOC105375617,chr7,R,158608248,158610454,95822432,2206,783752050,34313,2
105375618,LOC105375618,chr7,F,63753005,63754024,95823451,1019,783753069,34314,0
105375620,LOC105375620,chr7,R,129609398,129612722,95826775,3324,783756393,34315,2
105375621,LOC105375621,chr7,F,157428232,157441783,95840326,13551,783769944,34316,2
9,NAT1,chr8,F,18170461,18223689,53228,53228,783823172,34317,10
10,NAT2,chr8,F,18391244,18401219,63203,9975,783833147,34318,2
114,ADCY8,chr8,R,130780299,131041598,324502,261299,784094446,34319,17
148,ADRA1A,chr8,R,26742846,26871008,452664,128162,784222608,34320,5
155,ADRB3,chr8,R,37962994,37966666,456336,3672,784226280,34321,1
284,ANGPT1,chr8,R,107249481,107498026,704881,248545,784474825,34322,8
285,ANGPT2,chr8,R,6499650,6563263,768494,63613,784538438,34323,8
286,ANK1,chr8,R,41653224,41896762,1012032,243538,784781976,34324,48
312,ANXA13,chr8,R,123680793,123737407,1068646,56614,784838590,34325,11
427,ASAH1,chr8,R,18056415,18084998,1097229,28583,784867173,34326,15
444,ASPH,chr8,R,61500555,61714640,1311314,214085,785081258,34327,31
526,ATP6V1B2,chr8,F,20197192,20221696,1335818,24504,785105762,34328,13
528,ATP6V1C1,chr8,F,103021019,103073057,1387856,52038,785157800,34329,12
575,ADGRB1,chr8,F,142449887,142545008,1482977,95121,785252921,34330,30
640,BLK,chr8,F,11493990,11564599,1553586,70609,785323530,34331,15
649,BMP1,chr8,F,22165139,22212326,1600773,47187,785370717,34332,24
661,POLR3D,chr8,F,22245103,22254355,1610025,9252,785379969,34333,8
665,BNIP3L,chr8,F,26383006,26413129,1640148,30123,785410092,34334,7
734,OSGIN2,chr8,F,89901867,89927868,1666149,26001,785436093,34335,8
759,CA1,chr8,R,85328228,85378154,1716075,49926,785486019,34336,10
760,CA2,chr8,F,85463901,85481492,1733666,17591,785503610,34337,6
761,CA3,chr8,F,85438826,85449040,1743880,10214,785513824,34338,6
767,CA8,chr8,R,60187346,60281395,1837929,94049,785607873,34339,12
793,CALB1,chr8,R,90058607,90082881,1862203,24274,785632147,34340,10
862,RUNX1T1,chr8,R,91954966,92103226,2010463,148260,785780407,34341,17
1015,CDH17,chr8,R,94127161,94217303,2100605,90142,785870549,34342,18
1052,CEBPD,chr8,R,47736913,47738164,2101856,1251,785871800,34343,0
1135,CHRNA2,chr8,R,27459760,27479296,2121392,19536,785891336,34344,7
1142,CHRNB3,chr8,F,42697418,42737407,2161381,39989,785931325,34345,6
1191,CLU,chr8,R,27596916,27615031,2179496,18115,785949440,34346,10
1345,COX6C,chr8,R,99877994,99894014,2195516,16020,785965460,34347,3
1392,CRH,chr8,R,66176376,66178611,2197751,2235,785967695,34348,1
1508,CTSB,chr8,R,11842523,11868137,2223365,25614,785993309,34349,14
1537,CYC1,chr8,F,144095034,144097527,2225858,2493,785995802,34350,6
1581,CYP7A1,chr8,R,58490177,58500959,2236640,10782,786006584,34351,6
1584,CYP11B1,chr8,R,142872353,142879846,2244133,7493,786014077,34352,10
1585,CYP11B2,chr8,R,142910557,142917862,2251438,7305,786021382,34353,9
1587,ADAM3A,chr8,R,39451044,39522989,2323383,71945,786093327,34354,21
1666,DECR1,chr8,F,90001351,90052004,2374036,50653,786143980,34355,10
1667,DEFA1,chr8,R,6977648,6980122,2376510,2474,786146454,34356,3
1668,DEFA3,chr8,R,7015868,7018339,2378981,2471,786148925,34357,3
1669,DEFA4,chr8,R,6935819,6938338,2381500,2519,786151444,34358,2
1670,DEFA5,chr8,R,7055299,7056739,2382940,1440,786152884,34359,1
1671,DEFA6,chr8,R,6924693,6926076,2384323,1383,786154267,34360,1
1672,DEFB1,chr8,R,6870574,6878007,2391756,7433,786161700,34361,1
1673,DEFB4A,chr8,F,7894564,7896716,2393908,2152,786163852,34362,1
1807,DPYS,chr8,R,104379423,104467049,2481534,87626,786251478,34363,12
1808,DPYSL2,chr8,F,26514192,26658177,2625519,143985,786395463,34364,15
1846,DUSP4,chr8,R,29333061,29350750,2643208,17689,786413152,34365,4
1875,E2F5,chr8,F,85177055,85214518,2680671,37463,786450615,34366,9
1936,EEF1D,chr8,R,143579696,143597675,2698650,17979,786468594,34367,12
1960,EGR3,chr8,R,22687658,22693302,2704294,5644,786474238,34368,4
1978,EIF4EBP1,chr8,F,38030501,38060365,2734158,29864,786504102,34369,2
2039,DMTN,chr8,F,22049148,22082527,2767537,33379,786537481,34370,20
2053,EPHX2,chr8,F,27491001,27544922,2821458,53921,786591402,34371,18
2055,CLN8,chr8,F,1755777,1786570,2852251,30793,786622195,34372,5
2131,EXT1,chr8,R,117799362,118111819,3164708,312457,786934652,34373,10
2137,EXTL3,chr8,F,28701472,28753690,3216926,52218,786986870,34374,6
2138,EYA1,chr8,R,71197432,71548109,3567603,350677,787337547,34375,23
2167,FABP4,chr8,R,81478496,81483238,3572345,4742,787342289,34376,3
2171,FABP5,chr8,F,81280482,81284777,3576640,4295,787346584,34377,3
2185,PTK2B,chr8,F,27311481,27459391,3724550,147910,787494494,34378,37
2222,FDFT1,chr8,F,11795572,11839309,3768287,43737,787538231,34379,12
2260,FGFR1,chr8,R,38411137,38468834,3825984,57697,787595928,34380,22
2267,FGL1,chr8,R,17864390,17895538,3857132,31148,787627076,34381,9
2339,FNTA,chr8,F,43056298,43085788,3886622,29490,787656566,34382,8
2515,ADAM2,chr8,R,39743734,39838289,3981177,94555,787751121,34383,20
2626,GATA4,chr8,F,11676923,11760001,4064255,83078,787834199,34384,11
2669,GEM,chr8,R,94249252,94262319,4077322,13067,787847266,34385,4
2675,GFRA2,chr8,R,21692013,21789294,4174603,97281,787944547,34386,10
2738,GLI4,chr8,F,143267436,143276931,4184098,9495,787954042,34387,3
2765,GML,chr8,F,142833997,142917044,4267145,83047,788037089,34388,7
2796,GNRH1,chr8,R,25419257,25425040,4272928,5783,788042872,34389,2
2831,NPBWR1,chr8,F,52939907,52940894,4273915,987,788043859,34390,0
2843,GPR20,chr8,R,141353406,141367271,4287780,13865,788057724,34391,1
2875,GPT,chr8,F,144502220,144507174,4292734,4954,788062678,34392,11
2907,GRINA,chr8,F,143990057,143993419,4296096,3362,788066040,34393,7
2936,GSR,chr8,R,30678060,30727969,4346005,49909,788115949,34394,12
2961,GTF2E2,chr8,R,30578513,30658241,4425733,79728,788195677,34395,9
3037,HAS2,chr8,R,121612115,121641390,4455008,29275,788224952,34396,6
3084,NRG1,chr8,F,31639303,32767957,5583662,1128654,789353606,34397,18
3174,HNF4G,chr8,F,75407680,75566843,5742825,159163,789512769,34398,16
3297,HSF1,chr8,F,144291587,144314722,5765960,23135,789535904,34399,13
3551,IKBKB,chr8,F,42271301,42332653,5827312,61352,789597256,34400,23
3574,IL7,chr8,R,78675871,78805523,5956964,129652,789726908,34401,8
3612,IMPA1,chr8,R,81656915,81686354,5986403,29439,789756347,34402,9
3620,IDO1,chr8,F,39913808,39928790,6001385,14982,789771329,34403,9
3646,EIF3E,chr8,R,108201742,108248730,6048373,46988,789818317,34404,12
3786,KCNQ3,chr8,R,132120857,132480757,6408273,359900,790178217,34405,16
3788,KCNS2,chr8,F,98427021,98430797,6412049,3776,790181993,34406,1
4017,LOXL2,chr8,R,23296896,23404209,6519362,107313,790289306,34407,13
4023,LPL,chr8,F,19939070,19967259,6547551,28189,790317495,34408,9
4061,LY6E,chr8,F,143018484,143022410,6551477,3926,790321421,34409,3
4062,LY6H,chr8,R,143157913,143160636,6554200,2723,790324144,34410,5
4067,LYN,chr8,F,55878462,56012447,6688185,133985,790458129,34411,15
4147,MATN2,chr8,F,97869055,98036720,6855850,167665,790625794,34412,18
4173,MCM4,chr8,F,47960202,47978160,6873808,17958,790643752,34413,15
4325,MMP16,chr8,R,88003094,88327488,7198202,324394,790968146,34414,14
4342,MOS,chr8,R,56112941,56113982,7199243,1041,790969187,34415,0
4481,MSR1,chr8,R,16107877,16192791,7284157,84914,791054101,34416,10
4482,MSRA,chr8,F,10054223,10428891,7658825,374668,791428769,34417,9
4603,MYBL1,chr8,R,66562174,66613249,7709900,51075,791479844,34418,16
4609,MYC,chr8,F,127736068,127741434,7715266,5366,791485210,34419,2
4683,NBN,chr8,R,89933335,89984733,7766664,51398,791536608,34420,18
4715,NDUFB9,chr8,F,124539101,124549986,7777549,10885,791547493,34421,3
4741,NEFM,chr8,F,24913760,24919093,7782882,5333,791552826,34422,3
4747,NEFL,chr8,R,24950954,24956869,7788797,5915,791558741,34423,3
4796,TONSL,chr8,R,144428779,144444488,7804506,15709,791574450,34424,26
4824,NKX3-1,chr8,R,23678692,23682937,7808751,4245,791578695,34425,1
4856,NOV,chr8,F,119416311,119424438,7816878,8127,791586822,34426,4
4956,ODF1,chr8,F,102551619,102561017,7826276,9398,791596220,34427,1
4982,TNFRSF11B,chr8,R,118923556,118952144,7854864,28588,791624808,34428,4
4986,OPRK1,chr8,R,53225715,53251697,7880846,25982,791650790,34429,4
5108,PCM1,chr8,F,17922856,18029948,7987938,107092,791757882,34430,45
5150,PDE7A,chr8,R,65714333,65841734,8115339,127401,791885283,34431,13
5157,PDGFRL,chr8,F,17576432,17643133,8182040,66701,791951984,34432,6
5168,ENPP2,chr8,R,119557076,119673404,8298368,116328,792068312,34433,28
5179,PENK,chr8,R,56440953,56446723,8304138,5770,792074082,34434,3
5324,PLAG1,chr8,R,56160908,56211314,8354544,50406,792124488,34435,5
5327,PLAT,chr8,R,42174717,42207676,8387503,32959,792157447,34436,13
5339,PLEC,chr8,R,143915146,143976792,8449149,61646,792219093,34437,42
5368,PNOC,chr8,F,28316990,28343355,8475514,26365,792245458,34438,4
5375,PMP2,chr8,R,81440325,81447484,8482673,7159,792252617,34439,3
5423,POLB,chr8,F,42338454,42371813,8516032,33359,792285976,34440,15
5440,POLR2K,chr8,F,100150610,100154002,8519424,3392,792289368,34441,3
5462,POU5F1B,chr8,F,127415611,127417210,8521023,1599,792290967,34442,0
5516,PPP2CB,chr8,R,30785609,30812836,8548250,27227,792318194,34443,6
5520,PPP2R2A,chr8,F,26291490,26372680,8629440,81190,792399384,34444,14
5533,PPP3CC,chr8,F,22440969,22541144,8729615,100175,792499559,34445,16
5569,PKIA,chr8,F,78516100,78605267,8818782,89167,792588726,34446,3
5591,PRKDC,chr8,R,47773107,47960183,9005858,187076,792775802,34447,85
5747,PTK2,chr8,R,140658381,141001313,9348790,342932,793118734,34448,40
5820,PVT1,chr8,F,127890627,128101253,9559416,210626,793329360,34449,7
5828,PEX2,chr8,R,76980257,77001044,9580203,20787,793350147,34450,4
5862,RAB2A,chr8,F,60516909,60623644,9686938,106735,793456882,34451,7
5885,RAD21,chr8,R,116845933,116874866,9715871,28933,793485815,34452,13
6101,RP1,chr8,F,54616066,54630834,9730639,14768,793500583,34453,3
6129,RPL7,chr8,R,73290638,73294494,9734495,3856,793504439,34454,7
6132,RPL8,chr8,R,144789766,144792420,9737149,2654,793507093,34455,5
6156,RPL30,chr8,R,98041709,98045590,9741030,3881,793510974,34456,4
6224,RPS20,chr8,R,56068179,56074581,9747432,6402,793517376,34457,5
6383,SDC2,chr8,F,96493350,96611809,9865891,118459,793635835,34458,8
6386,SDCBP,chr8,F,58553168,58582860,9895583,29692,793665527,34459,9
6422,SFRP1,chr8,R,41261956,41309471,9943098,47515,793713042,34460,2
6440,SFTPC,chr8,F,22161670,22164479,9945907,2809,793715851,34461,4
6482,ST3GAL1,chr8,R,133454847,133572454,10063514,117607,793833458,34462,11
6503,SLA,chr8,R,133036727,133103066,10129853,66339,793899797,34463,9
6542,SLC7A2,chr8,F,17497087,17570568,10203334,73481,793973278,34464,15
6570,SLC18A1,chr8,R,20144854,20183338,10241818,38484,794011762,34465,16
6575,SLC20A2,chr8,R,42416461,42542213,10367570,125752,794137514,34466,15
6591,SNAI2,chr8,R,48917676,48921440,10371334,3764,794141278,34467,2
6641,SNTB1,chr8,R,120535744,120812069,10647659,276325,794417603,34468,7
6674,SPAG1,chr8,F,100158002,100241904,10731561,83902,794501505,34469,20
6713,SQLE,chr8,F,124998477,125022284,10755368,23807,794525312,34470,11
6770,STAR,chr8,R,38142699,38151265,10763934,8566,794533878,34471,6
6781,STC1,chr8,R,23841920,23854807,10776821,12887,794546765,34472,3
6788,STK3,chr8,R,98371354,98942571,11348038,571217,795117982,34473,27
6867,TACC1,chr8,F,38728185,38853028,11472881,124843,795242825,34474,18
6873,TAF2,chr8,R,119730772,119832858,11574967,102086,795344911,34475,26
6917,TCEA1,chr8,R,53966553,54022456,11630870,55903,795400814,34476,12
6921,TCEB1,chr8,R,73945137,73972287,11658020,27150,795427964,34477,8
7013,TERF1,chr8,F,73008861,73048123,11697282,39262,795467226,34478,11
7038,TG,chr8,F,132866934,133134902,11965250,267968,795735194,34479,51
7071,KLF10,chr8,R,102648776,102655902,11972376,7126,795742320,34480,4
7163,TPD52,chr8,R,80034867,80171659,12109168,136792,795879112,34481,11
7201,TRHR,chr8,F,109086341,109119584,12142411,33243,795912355,34482,2
7227,TRPS1,chr8,R,115408495,115669580,12403496,261085,796173440,34483,10
7264,TSTA3,chr8,R,143612617,143618043,12408922,5426,796178866,34484,12
7274,TTPA,chr8,R,63059487,63086100,12435535,26613,796205479,34485,4
7336,UBE2V2,chr8,F,47998287,48064708,12501956,66421,796271900,34486,5
7373,COL14A1,chr8,F,120125107,120373573,12750422,248466,796520366,34487,49
7381,UQCRB,chr8,R,96226675,96235634,12759381,8959,796529325,34488,5
7419,VDAC3,chr8,F,42391623,42405937,12773695,14314,796543639,34489,10
7486,WRN,chr8,F,31033261,31173761,12914195,140500,796684139,34490,36
7534,YWHAZ,chr8,R,100918575,100954596,12950216,36021,796720160,34491,11
7553,ZNF7,chr8,F,144827517,144847508,12970207,19991,796740151,34492,8
7564,ZNF16,chr8,R,144930357,144950888,12990738,20531,796760682,34493,4
7976,FZD3,chr8,F,28494204,28574268,13070802,80064,796840746,34494,14
7991,TUSC3,chr8,F,15540086,15766649,13297365,226563,797067309,34495,11
7993,UBXN8,chr8,F,30729106,30767006,13335265,37900,797105209,34496,10
7994,KAT6A,chr8,R,41929478,42051989,13457776,122511,797227720,34497,18
8000,PSCA,chr8,F,142670307,142682727,13470196,12420,797240140,34498,3
8323,FZD6,chr8,F,103298432,103332866,13504630,34434,797274574,34499,7
8439,NSMAF,chr8,R,58583503,58659845,13580972,76342,797350916,34500,31
8581,LY6D,chr8,R,142784881,142786592,13582683,1711,797352627,34501,2
8601,RGS20,chr8,F,53851807,53959304,13690180,107497,797460124,34502,8
8629,JRK,chr8,R,142651500,142670132,13708812,18632,797478756,34503,4
8658,TNKS,chr8,F,9555213,9782346,13935945,227133,797705889,34504,28
8667,EIF3H,chr8,R,116644815,116755823,14046953,111008,797816897,34505,7
8694,DGAT1,chr8,R,144314582,144326919,14059290,12337,797829234,34506,17
8733,GPAA1,chr8,F,144082620,144086216,14062886,3596,797832830,34507,11
8749,ADAM18,chr8,F,39584567,39730064,14208383,145497,797978327,34508,19
8754,ADAM9,chr8,F,38996964,39105261,14316680,108297,798086624,34509,23
8756,ADAM7,chr8,F,24440995,24512760,14388445,71765,798158389,34510,23
8767,RIPK2,chr8,F,89757732,89791064,14421777,33332,798191721,34511,11
8793,TNFRSF10D,chr8,R,23135587,23164030,14450220,28443,798220164,34512,8
8794,TNFRSF10C,chr8,F,23102813,23117437,14464844,14624,798234788,34513,4
8795,TNFRSF10B,chr8,R,23006382,23069187,14527649,62805,798297593,34514,9
8797,TNFRSF10A,chr8,R,23191456,23225167,14561360,33711,798331304,34515,9
8822,FGF17,chr8,F,22039708,22048809,14570461,9101,798340405,34516,6
8836,GGH,chr8,R,63015078,63039445,14594828,24367,798364772,34517,9
8840,WISP1,chr8,F,133191038,133231690,14635480,40652,798405424,34518,5
8895,CPNE3,chr8,F,86514426,86561498,14682552,47072,798452496,34519,16
8928,FOXH1,chr8,R,144473731,144476335,14685156,2604,798455100,34520,2
8973,CHRNA6,chr8,R,42752619,42768786,14701323,16167,798471267,34521,5
8989,TRPA1,chr8,R,72021250,72090009,14770082,68759,798540026,34522,28
9046,DOK2,chr8,R,21908872,21913743,14774953,4871,798544897,34523,4
9070,ASH2L,chr8,F,38104964,38140080,14810069,35116,798580013,34524,17
9108,MTMR7,chr8,R,17296796,17413531,14926804,116735,798696748,34525,17
9134,CCNE2,chr8,R,94880223,94896653,14943234,16430,798713178,34526,13
9166,EBAG9,chr8,F,109539699,109565996,14969531,26297,798739475,34527,8
9172,MYOM2,chr8,F,2045042,2145456,15069945,100414,798839889,34528,36
9228,DLGAP2,chr8,F,1019560,1708476,15758861,688916,799528805,34529,17
9242,MSC,chr8,R,71841541,71844496,15761816,2955,799531760,34530,1
9258,MFHAS1,chr8,R,8783353,8893621,15872084,110268,799642028,34531,4
9312,KCNB2,chr8,F,72537390,72938349,16273043,400959,800042987,34532,2
9401,RECQL4,chr8,R,144511283,144517827,16279587,6544,800049531,34533,19
9420,CYP7B1,chr8,R,64595971,64798791,16482407,202820,800252351,34534,5
9530,BAG4,chr8,F,38176587,38213301,16519121,36714,800289065,34535,4
9583,ENTPD4,chr8,R,23429151,23457731,16547701,28580,800317645,34536,12
9639,ARHGEF10,chr8,F,1823982,1958641,16682360,134659,800452304,34537,30
9650,MTFR1,chr8,F,65643872,65771252,16809740,127380,800579684,34538,12
9684,LRRC14,chr8,F,144517964,144525178,16816954,7214,800586898,34539,4
9694,EMC2,chr8,F,108443623,108486907,16860238,43284,800630182,34540,10
9699,RIMS2,chr8,F,103500641,104254429,17614026,753788,801383970,34541,42
9705,ST18,chr8,R,52110831,52409902,17913097,299071,801683041,34542,31
9760,TOX,chr8,R,58805417,59119208,18226888,313791,801996832,34543,8
9788,MTSS1,chr8,R,124550769,124728507,18404626,177738,802174570,34544,18
9791,PTDSS1,chr8,F,96261885,96334552,18477293,72667,802247237,34545,12
9796,PHYHIP,chr8,R,22219702,22232338,18489929,12636,802259873,34546,5
9821,RB1CC1,chr8,R,52622457,52714466,18581938,92009,802351882,34547,27
9831,ZNF623,chr8,F,143636012,143653775,18599701,17763,802369645,34548,3
9897,KIAA0196,chr8,R,125024259,125091819,18667261,67560,802437205,34549,30
9920,KBTBD11,chr8,F,1970709,2006943,18703495,36234,802473439,34550,5
10086,HHLA1,chr8,R,132061485,132105265,18747275,43780,802517219,34551,15
10174,SORBS3,chr8,F,22544989,22575495,18777781,30506,802547725,34552,23
10221,TRIB1,chr8,F,125430320,125438405,18785866,8085,802555810,34553,3
10247,HRSP12,chr8,R,98102338,98117190,18800718,14852,802570662,34554,5
10361,NPM2,chr8,F,22023707,22036897,18813908,13190,802583852,34555,10
10395,DLC1,chr8,R,13083360,13515658,19246206,432298,803016150,34556,21
10397,NDRG1,chr8,R,133237170,133297587,19306623,60417,803076567,34557,16
10404,CPQ,chr8,F,96645226,97143503,19804900,498277,803574844,34558,13
10407,SPAG11B,chr8,R,7447753,7463670,19820817,15917,803590761,34559,6
10434,LYPLA1,chr8,R,54046366,54102017,19876468,55651,803646412,34560,9
10499,NCOA2,chr8,R,70109769,70405437,20172136,295668,803942080,34561,31
10565,ARFGEF1,chr8,R,67175295,67343897,20340738,168602,804110682,34562,40
10584,COLEC10,chr8,F,118952239,119108455,20496954,156216,804266898,34563,8
10656,KHDRBS3,chr8,F,135457460,135656516,20696010,199056,804465954,34564,14
10671,DCTN6,chr8,F,30156296,30183639,20723353,27343,804493297,34565,6
10687,PNMA2,chr8,R,26504678,26513967,20732642,9289,804502586,34566,3
10863,ADAM28,chr8,F,24294039,24359018,20797621,64979,804567565,34567,27
10940,POP1,chr8,F,98117292,98159841,20840170,42549,804610114,34568,18
10947,AP3M2,chr8,F,42152945,42171183,20858408,18238,804628352,34569,9
10987,COPS5,chr8,R,67043078,67062327,20877657,19249,804647601,34570,7
11030,RBPMS,chr8,F,30384464,30572261,21065454,187797,804835398,34571,15
11059,WWP1,chr8,F,86342735,86468265,21190984,125530,804960928,34572,24
11075,STMN2,chr8,F,79610813,79666175,21246346,55362,805016290,34573,7
11156,PTP4A3,chr8,F,141391992,141432454,21286808,40462,805056752,34574,10
11160,ERLIN2,chr8,F,37736578,37757801,21308031,21223,805077975,34575,13
11178,LZTS1,chr8,R,20246164,20303981,21365848,57817,805135792,34576,8
11212,PROSC,chr8,F,37762582,37779768,21383034,17186,805152978,34577,7
11236,RNF139,chr8,F,124474766,124488618,21396886,13852,805166830,34578,1
11244,ZHX1,chr8,R,123248449,123275541,21423978,27092,805193922,34579,4
22827,PUF60,chr8,R,143816343,143829386,21437021,13043,805206965,34580,13
22882,ZHX2,chr8,F,122781348,122974515,21630188,193167,805400132,34581,6
22898,DENND3,chr8,F,141128620,141195804,21697372,67184,805467316,34582,31
23039,XPO7,chr8,F,21919668,22006585,21784289,86917,805554233,34583,27
23087,TRIM35,chr8,R,27284885,27311319,21810723,26434,805580667,34584,6
23144,ZC3H3,chr8,R,143437654,143542245,21915314,104591,805685258,34585,16
23167,EFR3A,chr8,F,131904108,132013642,22024848,109534,805794792,34586,24
23212,RRS1,chr8,F,66429027,66430733,22026554,1706,805796498,34587,0
23213,SULF1,chr8,F,69466623,69660912,22220843,194289,805990787,34588,24
23221,RHOBTB2,chr8,F,22987257,23020197,22253783,32940,806023727,34589,14
23237,ARC,chr8,R,142611043,142614472,22257212,3429,806027156,34590,2
23246,BOP1,chr8,R,144262045,144291438,22286605,29393,806056549,34591,15
23259,DDHD2,chr8,F,38231342,38273885,22329148,42543,806099092,34592,21
23303,KIF13B,chr8,R,29067277,29263304,22525175,196027,806295119,34593,41
23362,PSD3,chr8,R,18527302,19086921,23084794,559619,806854738,34594,32
23414,ZFPM2,chr8,F,105246435,105804539,23642898,558104,807412842,34595,9
23462,HEY1,chr8,R,79764009,79767863,23646752,3854,807416696,34596,5
23471,TRAM1,chr8,R,70573217,70608459,23681994,35242,807451938,34597,11
23484,LEPROTL1,chr8,F,30095405,30137706,23724295,42301,807494239,34598,4
23513,SCRIB,chr8,R,143790919,143815379,23748755,24460,807518699,34599,36
23514,SPIDR,chr8,F,47260877,47736001,24223879,475124,807993823,34600,30
23516,SLC39A14,chr8,F,22367248,22434129,24290760,66881,808060704,34601,15
23639,LRRC6,chr8,R,132570415,132685097,24405442,114682,808175386,34602,16
23643,LY96,chr8,F,73991328,74032562,24446676,41234,808216620,34603,5
23678,SGK3,chr8,F,66712417,66862022,24596281,149605,808366225,34604,18
25788,RAD54B,chr8,R,94371959,94475115,24699437,103156,808469381,34605,16
25879,DCAF13,chr8,F,103414713,103443453,24728177,28740,808498121,34606,10
25897,RNF19A,chr8,R,100257058,100336218,24807337,79160,808577281,34607,14
25960,ADGRA2,chr8,F,37796882,37843986,24854441,47104,808624385,34608,19
25962,KIAA1429,chr8,R,94487776,94553518,24920183,65742,808690127,34609,23
26138,LINC00588,chr8,F,57279542,57284731,24925372,5189,808695316,34610,3
26166,RGS22,chr8,R,99960935,100106116,25070553,145181,808840497,34611,30
26233,FBXL6,chr8,R,144355427,144358523,25073649,3096,808843593,34612,8
26255,PTTG3P,chr8,R,66767396,66768005,25074258,609,808844202,34613,0
26260,FBXO25,chr8,F,406807,469876,25137327,63069,808907271,34614,13
26281,FGF20,chr8,R,16992824,17002165,25146668,9341,808916612,34615,2
26766,RNU105C,chr8,F,54330685,54330895,25146878,210,808916822,34616,0
26775,SNORA72,chr8,R,98042085,98042217,25147010,132,808916954,34617,0
26795,SNORD54,chr8,R,56073838,56073901,25147073,63,808917017,34618,0
26873,OPLAH,chr8,R,144051265,144064026,25159834,12761,808929778,34619,27
26986,PABPC1,chr8,R,100702915,100722998,25179917,20083,808949861,34620,14
27012,KCNV1,chr8,R,109963635,109975734,25192016,12099,808961960,34621,3
27067,STAU2,chr8,R,73420368,73747708,25519356,327340,809289300,34622,16
27085,MTBP,chr8,F,120445397,120523635,25597594,78238,809367538,34623,24
27121,DKK4,chr8,R,42373193,42391754,25616155,18561,809386099,34624,6
27161,AGO2,chr8,R,140520155,140642326,25738326,122171,809508270,34625,23
27257,LSM1,chr8,R,38163320,38176730,25751736,13410,809521680,34626,3
27299,ADAMDEC1,chr8,F,24384284,24406013,25773465,21729,809543409,34627,14
27319,BHLHE22,chr8,F,64580237,64583634,25776862,3397,809546806,34628,0
28957,MRPS28,chr8,R,79918859,80030271,25888274,111412,809658218,34629,2
28991,COMMD5,chr8,R,144837977,144853640,25903937,15663,809673881,34630,4
28998,MRPL13,chr8,R,120395843,120445407,25953501,49564,809723445,34631,6
29028,ATAD2,chr8,R,123319849,123396465,26030117,76616,809800061,34632,27
29065,ASAP1-IT1,chr8,R,130295354,130296533,26031296,1179,809801240,34633,0
29088,MRPL15,chr8,F,54135220,54148514,26044590,13294,809814534,34634,4
29883,CNOT7,chr8,R,17226029,17246878,26065439,20849,809835383,34635,9
29894,CPSF1,chr8,R,144393230,144409400,26081609,16170,809851553,34636,41
29942,PURG,chr8,R,30995801,31033715,26119523,37914,809889467,34637,1
29967,LRP12,chr8,R,104489230,104589024,26219317,99794,809989261,34638,6
50484,RRM2B,chr8,R,102204500,102239118,26253935,34618,810023879,34639,8
50626,CYHR1,chr8,R,144449581,144465691,26270045,16110,810039989,34640,7
50807,ASAP1,chr8,R,130052103,130443660,26661602,391557,810431546,34641,35
51001,MTERF3,chr8,R,96239397,96261613,26683818,22216,810453762,34642,10
51050,PI15,chr8,F,74824468,74855044,26714394,30576,810484338,34643,6
51059,FAM135B,chr8,R,138130022,138496822,27081194,366800,810851138,34644,29
51101,ZC2HC1A,chr8,F,78666046,78719765,27134913,53719,810904857,34645,11
51105,PHF20L1,chr8,F,132775357,132848807,27208363,73450,810978307,34646,23
51110,LACTB2,chr8,R,70637265,70669212,27240310,31947,811010254,34647,6
51115,RMDN1,chr8,R,86467397,86514338,27287251,46941,811057195,34648,13
51123,ZNF706,chr8,R,101197037,101206064,27296278,9027,811066222,34649,6
51125,GOLGA7,chr8,F,41490561,41510980,27316697,20419,811086641,34650,5
51160,VPS28,chr8,R,144423600,144428563,27321660,4963,811091604,34651,8
51201,ZDHHC2,chr8,F,17156019,17222732,27388373,66713,811158317,34652,15
51236,HGH1,chr8,F,144137768,144140843,27391448,3075,811161392,34653,5
51305,KCNK9,chr8,R,139600837,139703068,27493679,102231,811263623,34654,4
51312,SLC25A37,chr8,F,23528849,23572550,27537380,43701,811307324,34655,7
51337,THEM6,chr8,F,142727202,142736932,27547110,9730,811317054,34656,1
51366,UBR5,chr8,R,102252272,102412689,27707527,160417,811477471,34657,59
51435,SCARA3,chr8,F,27633893,27712743,27786377,78850,811556321,34658,9
51571,FAM49B,chr8,R,129839592,130016697,27963482,177105,811733426,34659,18
51582,AZIN1,chr8,R,102826301,102864200,28001381,37899,811771325,34660,12
51606,ATP6V1H,chr8,R,53715542,53843311,28129150,127769,811899094,34661,14
51633,OTUD6B,chr8,F,91070195,91087095,28146050,16900,811915994,34662,7
51669,SARAF,chr8,R,30063011,30083208,28166247,20197,811936191,34663,5
54108,CHRAC1,chr8,F,140511297,140517153,28172103,5856,811942047,34664,3
54212,SNTG1,chr8,F,49909788,50796442,29058757,886654,812828701,34665,23
54332,GDAP1,chr8,F,74349250,74367110,29076617,17860,812846561,34666,5
54512,EXOSC4,chr8,F,144064086,144080648,29093179,16562,812863123,34667,3
54704,PDP1,chr8,F,93916854,93926068,29102393,9214,812872337,34668,4
54714,CNGB3,chr8,R,86573842,86743675,29272226,169833,813042170,34669,18
54742,LY6K,chr8,F,142699927,142704170,29276469,4243,813046413,34670,2
54793,KCTD9,chr8,R,25427841,25458468,29307096,30627,813077040,34671,13
54845,ESRP1,chr8,F,94641135,94707466,29373427,66331,813143371,34672,15
54904,WHSC1L1,chr8,R,38269698,38382354,29486083,112656,813256027,34673,25
54928,IMPAD1,chr8,R,56957928,56993871,29522026,35943,813291970,34674,5
54968,TMEM70,chr8,F,73976141,73982783,29528668,6642,813298612,34675,3
54984,PINX1,chr8,R,10764960,10839899,29603607,74939,813373551,34676,6
55039,TRMT12,chr8,F,124450806,124453026,29605827,2220,813375771,34677,0
55074,OXR1,chr8,F,106270177,106752694,30088344,482517,813858288,34678,24
55093,WDYHV1,chr8,F,123416724,123448380,30120000,31656,813889944,34679,9
55124,PIWIL2,chr8,F,22275296,22357568,30202272,82272,813972216,34680,24
55140,ELP3,chr8,F,28090230,28191153,30303195,100923,814073139,34681,15
55145,THAP1,chr8,R,42836673,42843331,30309853,6658,814079797,34682,2
55156,ARMC1,chr8,R,65602455,65634217,30341615,31762,814111559,34683,7
55174,INTS10,chr8,F,19817148,19852078,30376545,34930,814146489,34684,18
55246,CCDC25,chr8,R,27733315,27772655,30415885,39340,814185829,34685,9
55284,UBE2W,chr8,R,73780096,73878910,30514699,98814,814284643,34686,9
55290,BRF2,chr8,R,37843879,37849913,30520733,6034,814290677,34687,3
55326,AGPAT5,chr8,F,6708356,6761503,30573880,53147,814343824,34688,7
55353,LAPTM4B,chr8,F,97775580,97852602,30650902,77022,814420846,34689,6
55472,RBM12B-AS1,chr8,F,93740110,93740819,30651611,709,814421555,34690,0
55529,TMEM55A,chr8,R,90994270,91040975,30698316,46705,814468260,34691,7
55630,SLC39A4,chr8,R,144412413,144418034,30703937,5621,814473881,34692,11
55636,CHD7,chr8,F,60678761,60868028,30893204,189267,814663148,34693,43
55638,SYBU,chr8,R,109574175,109691791,31010820,117616,814780764,34694,14
55656,INTS8,chr8,F,94813310,94880493,31078003,67183,814847947,34695,29
55756,INTS9,chr8,R,28767657,28890389,31200735,122732,814970679,34696,19
55790,CSGALNACT1,chr8,R,19404160,19757271,31553846,353111,815323790,34697,24
55806,HR,chr8,R,22114418,22131053,31570481,16635,815340425,34698,18
55824,PAG1,chr8,R,80967809,81112068,31714740,144259,815484684,34699,13
55872,PBK,chr8,R,27809620,27838095,31743215,28475,815513159,34700,7
55893,ZNF395,chr8,R,28345584,28386460,31784091,40876,815554035,34701,9
55894,DEFB103B,chr8,R,7428887,7430348,31785552,1461,815555496,34702,1
55909,BIN3,chr8,R,22620417,22669148,31834283,48731,815604227,34703,11
56154,TEX15,chr8,R,30831422,30913015,31915876,81593,815685820,34704,16
56169,GSDMC,chr8,R,129705902,129786888,31996862,80986,815766806,34705,20
56260,C8orf44,chr8,F,66667551,66681149,32010460,13598,815780404,34706,2
56704,JPH1,chr8,R,74234699,74321500,32097261,86801,815867205,34707,5
56892,C8orf4,chr8,F,40153467,40155308,32099102,1841,815869046,34708,0
56943,ENY2,chr8,F,109334322,109345960,32110740,11638,815880684,34709,4
57094,CPA6,chr8,R,67422169,67746571,32435142,324402,816205086,34710,11
57152,SLURP1,chr8,R,142740943,142742411,32436610,1468,816206554,34711,2
57210,SLC45A4,chr8,R,141207165,141308310,32537755,101145,816307699,34712,15
57509,MTUS1,chr8,R,17643793,17801220,32695182,157427,816465126,34713,19
57604,KIAA1456,chr8,F,12945673,13029777,32779286,84104,816549230,34714,12
57623,ZFAT,chr8,R,134477787,134713049,33014548,235262,816784492,34715,22
57805,CCAR2,chr8,F,22604631,22620471,33030388,15840,816800332,34716,21
58500,ZNF250,chr8,R,144876950,144902305,33055743,25355,816825687,34717,8
59339,PLEKHA2,chr8,F,38901234,38973912,33128421,72678,816898365,34718,13
63898,SH2D4A,chr8,F,19313442,19396218,33211197,82776,816981141,34719,10
63978,PRDM14,chr8,R,70051125,70071327,33231399,20202,817001343,34720,8
64089,SNX16,chr8,R,81799582,81842325,33274142,42743,817044086,34721,10
64168,NECAB1,chr8,F,90791692,90959402,33441852,167710,817211796,34722,12
64236,PDLIM2,chr8,F,22578740,22598025,33461137,19285,817231081,34723,10
64321,SOX17,chr8,F,54457934,54460896,33464099,2962,817234043,34724,1
64478,CSMD1,chr8,R,2935352,4994806,35523553,2059454,819293497,34725,71
64641,EBF2,chr8,R,25841729,26045124,35726948,203395,819496892,34726,15
64760,FAM160B2,chr8,F,22089183,22104380,35742145,15197,819512089,34727,20
64798,DEPTOR,chr8,F,119873654,120050918,35919409,177264,819689353,34728,8
65263,PYCRL,chr8,R,143603912,143609614,35925111,5702,819695055,34729,5
65265,C8orf33,chr8,F,145052437,145065864,35938538,13427,819708482,34730,5
65986,ZBTB10,chr8,F,80485618,80526265,35979185,40647,819749129,34731,6
66004,LYNX1,chr8,R,142764333,142777848,35992700,13515,819762644,34732,8
66036,MTMR9,chr8,F,11284490,11328146,36036356,43656,819806300,34733,11
78986,DUSP26,chr8,R,33591329,33600028,36045055,8699,819814999,34734,3
78998,RHPN1-AS1,chr8,R,143366622,143368635,36047068,2013,819817012,34735,0
79075,DSCC1,chr8,R,119833940,119855930,36069058,21990,819839002,34736,8
79139,DERL1,chr8,R,123013163,123042423,36098318,29260,819868262,34737,8
79145,CHCHD7,chr8,F,56211755,56218619,36105182,6864,819875126,34738,5
79581,SLC52A2,chr8,F,144358556,144361286,36107912,2730,819877856,34739,5
79618,HMBOX1,chr8,F,28890393,29064939,36282458,174546,820052402,34740,17
79645,EFCAB1,chr8,R,48714914,48735311,36302855,20397,820072799,34741,8
79648,MCPH1,chr8,F,6406591,6643619,36539883,237028,820309827,34742,18
79660,PPP1R3B,chr8,R,9136253,9151642,36555272,15389,820325216,34743,2
79666,PLEKHF2,chr8,F,95133720,95156685,36578237,22965,820348181,34744,1
79698,ZMAT4,chr8,R,40530589,40897824,36945472,367235,820715416,34745,7
79752,ZFAND1,chr8,R,81701330,81721304,36965446,19974,820735390,34746,8
79776,ZFHX4,chr8,F,76681218,76867285,37151513,186067,820921457,34747,14
79792,GSDMD,chr8,F,143553386,143563062,37161189,9676,820931133,34748,12
79815,NIPAL2,chr8,R,98189825,98295442,37266806,105617,821036750,34749,15
79845,RNF122,chr8,R,33547753,33567128,37286181,19375,821056125,34750,5
79848,CSPP1,chr8,F,67062416,67196614,37420379,134198,821190323,34751,36
79870,BAALC,chr8,F,103140692,103230305,37509992,89613,821279936,34752,2
79873,NUDT18,chr8,R,22106871,22110355,37513476,3484,821283420,34753,3
79943,ZNF696,chr8,F,143291388,143299952,37522040,8564,821291984,34754,2
79977,GRHL2,chr8,F,101492405,101678098,37707733,185693,821477677,34755,16
80005,DOCK5,chr8,F,25184771,25415716,37938678,230945,821708622,34756,52
80094,BIN3-IT1,chr8,R,22640370,22642209,37940517,1839,821710461,34757,0
80124,VCPIP1,chr8,R,66630252,66667217,37977482,36965,821747426,34758,2
80139,ZNF703,chr8,F,37695750,37700021,37981753,4271,821751697,34759,1
80185,TTI2,chr8,R,33498508,33513185,37996430,14677,821766374,34760,6
80223,RAB11FIP1,chr8,R,37858946,37899497,38036981,40551,821806925,34761,5
80243,PREX2,chr8,F,67951982,68231662,38316661,279680,822086605,34762,40
80346,REEP4,chr8,R,22138019,22141935,38320577,3916,822090521,34763,7
80728,ARHGAP39,chr8,R,144529178,144700520,38491919,171342,822261863,34764,15
80778,ZNF34,chr8,R,144772223,144787359,38507055,15136,822276999,34765,10
81034,SLC25A32,chr8,R,103398637,103415335,38523753,16698,822293697,34766,7
81501,DCSTAMP,chr8,F,104339086,104356689,38541356,17603,822311300,34767,5
81551,STMN4,chr8,R,27235322,27258865,38564899,23543,822334843,34768,7
81790,RNF170,chr8,R,42849636,42897931,38613194,48295,822383138,34769,10
81796,SLCO5A1,chr8,R,69667045,69835064,38781213,168019,822551157,34770,9
81858,SHARPIN,chr8,R,144098632,144104237,38786818,5605,822556762,34771,8
83481,EPPK1,chr8,R,143857318,143878464,38807964,21146,822577908,34772,2
83482,SCRT1,chr8,R,144330564,144336281,38813681,5717,822583625,34773,1
83595,SOX7,chr8,R,10723767,10730574,38820488,6807,822590432,34774,1
83648,FAM167A,chr8,R,11421463,11475915,38874940,54452,822644884,34775,8
83650,SLC35G5,chr8,F,11330985,11332186,38876141,1201,822646085,34776,0
83655,LINC00208,chr8,F,11576534,11581341,38880948,4807,822650892,34777,2
83656,FAM167A-AS1,chr8,F,11368401,11438657,38951204,70256,822721148,34778,6
83690,CRISPLD1,chr8,F,74984472,75034558,39001290,50086,822771234,34779,15
83696,TRAPPC9,chr8,R,139728080,140458579,39731789,730499,823501733,34780,29
83877,TM2D2,chr8,R,38988807,38996816,39739798,8009,823509742,34781,4
83940,TATDN1,chr8,R,124488493,124539088,39790393,50595,823560337,34782,13
83955,NACAP1,chr8,F,101368892,101369595,39791096,703,823561040,34783,0
83988,NCALD,chr8,R,101686541,102124907,40229462,438366,823999406,34784,13
84197,POMK,chr8,F,43093505,43123440,40259397,29935,824029341,34785,4
84232,MAF1,chr8,F,144104401,144107612,40262608,3211,824032552,34786,7
84294,UTP23,chr8,F,116766502,116848959,40345065,82457,824115009,34787,6
84296,GINS4,chr8,F,41529205,41545046,40360906,15841,824130850,34788,7
84376,HOOK3,chr8,F,42896889,43030539,40494556,133650,824264500,34789,21
84513,PPAPDC1B,chr8,R,38261789,38269437,40502204,7648,824272148,34790,8
84549,MAK16,chr8,F,33485166,33501260,40518298,16094,824288242,34791,9
84675,TRIM55,chr8,F,66112666,66175489,40581121,62823,824351065,34792,14
84750,FUT10,chr8,R,33308610,33473478,40745989,164868,824515933,34793,8
84875,PARP10,chr8,R,143977151,143986467,40755305,9316,824525249,34794,10
84933,C8orf76,chr8,R,123219955,123241398,40776748,21443,824546692,34795,5
84948,TIGD5,chr8,F,143597903,143600315,40779160,2412,824549104,34796,0
84955,NUDCD1,chr8,R,109240918,109334121,40872363,93203,824642307,34797,11
84985,FAM83A,chr8,F,123179046,123210079,40903396,31033,824673340,34798,6
84988,PPP1R16A,chr8,F,144477986,144502121,40927531,24135,824697475,34799,16
85002,FAM86B1,chr8,R,12182103,12194149,40939577,12046,824709521,34800,7
85444,LRRCC1,chr8,F,85107087,85146080,40978570,38993,824748514,34801,18
85453,TSPYL5,chr8,R,97273485,97277948,40983033,4463,824752977,34802,0
85479,DNAJC5B,chr8,F,66015041,66100520,41068512,85479,824838456,34803,8
85481,PSKH2,chr8,R,86047108,86069622,41091026,22514,824860970,34804,3
90362,FAM110B,chr8,F,57994508,58149718,41246236,155210,825016180,34805,5
90390,MED30,chr8,F,117520712,117540262,41265786,19550,825035730,34806,4
90459,ERI1,chr8,F,9002803,9100256,41363239,97453,825133183,34807,11
90987,ZNF251,chr8,R,144720908,144755585,41397916,34677,825167860,34808,7
90990,KIFC2,chr8,F,144466148,144474116,41405884,7968,825175828,34809,17
91147,TMEM67,chr8,F,93754843,93832649,41483690,77806,825253634,34810,34
91694,LONRF1,chr8,R,12721896,12755485,41517279,33589,825287223,34811,12
91782,CHMP7,chr8,F,23243636,23261999,41535642,18363,825305586,34812,11
92140,MTDH,chr8,F,97644146,97730260,41621756,86114,825391700,34813,12
92421,CHMP4C,chr8,F,81732452,81759515,41648819,27063,825418763,34814,4
93035,PKHD1L1,chr8,F,109362476,109532686,41819029,170210,825588973,34815,80
93100,NAPRT,chr8,R,143574663,143579626,41823992,4963,825593936,34816,12
93594,TBC1D31,chr8,F,123072679,123165173,41916486,92494,825686430,34817,23
93668,HPYR1,chr8,R,132560497,132561479,41917468,982,825687412,34818,0
94137,RP1L1,chr8,R,10606348,10655107,41966227,48759,825736171,34819,3
94241,TP53INP1,chr8,R,94925971,94949387,41989643,23416,825759587,34820,5
96764,TGS1,chr8,F,55773231,55825448,42041860,52217,825811804,34821,12
113655,MFSD3,chr8,F,144507266,144511228,42045822,3962,825815766,34822,4
114569,MAL2,chr8,F,119208370,119245673,42083125,37303,825853069,34823,3
114786,XKR4,chr8,F,55102456,55526155,42506824,423699,826276768,34824,2
114788,CSMD3,chr8,R,112222927,113437467,43721364,1214540,827491308,34825,80
114822,RHPN1,chr8,F,143368841,143384220,43736743,15379,827506687,34826,17
114907,FBXO32,chr8,R,123497886,123541253,43780110,43367,827550054,34827,8
114926,SMIM19,chr8,F,42541154,42552997,43791953,11843,827561897,34828,4
115111,SLC26A7,chr8,F,91209493,91398155,43980615,188662,827750559,34829,21
115294,PCMTD1,chr8,R,51817574,51899186,44062227,81612,827832171,34830,7
115908,CTHRC1,chr8,F,103371508,103383005,44073724,11497,827843668,34831,4
116039,OSR2,chr8,F,98938103,98952110,44087731,14007,827857675,34832,5
116328,C8orf34,chr8,F,68330721,68819023,44576033,488302,828345977,34833,16
116447,TOP1MT,chr8,R,143309323,143359977,44626687,50654,828396631,34834,15
137075,CLDN23,chr8,F,8702155,8704107,44628639,1952,828398583,34835,0
137196,CCDC26,chr8,R,129351693,129680239,44957185,328546,828727129,34836,5
137209,ZNF572,chr8,F,124848551,124979511,45088145,130960,828858089,34837,11
137362,GOT1L1,chr8,R,37934280,37940157,45094022,5877,828863966,34838,9
137392,FAM92A1,chr8,F,93700251,93729253,45123024,29002,828892968,34839,16
137492,VPS37A,chr8,F,17246891,17298024,45174157,51133,828944101,34840,12
137682,NDUFAF6,chr8,F,94895450,95058716,45337423,163266,829107367,34841,18
137695,TMEM68,chr8,R,55738743,55773407,45372087,34664,829142031,34842,7
137735,ABRA,chr8,R,106759482,106770244,45382849,10762,829152793,34843,1
137797,LYPD2,chr8,R,142750209,142752534,45385174,2325,829155118,34844,2
137814,NKX2-6,chr8,R,23702450,23706598,45389322,4148,829159266,34845,1
137835,TMEM71,chr8,R,132709944,132760712,45440090,50768,829210034,34846,9
137868,SGCZ,chr8,R,14089863,15238283,46588510,1148420,830358454,34847,7
137872,ADHFE1,chr8,F,66432482,66468809,46624837,36327,830394781,34848,13
137886,UBXN2B,chr8,F,58411263,58451501,46665075,40238,830435019,34849,8
137902,PXDNL,chr8,R,51319574,51811029,47156530,491455,830926474,34850,24
137964,AGPAT6,chr8,F,41578187,41625001,47203344,46814,830973288,34851,16
137970,UNC5D,chr8,F,35235456,35796550,47764438,561094,831534382,34852,19
137994,LETM2,chr8,F,38386428,38409527,47787537,23099,831557481,34853,12
138009,DCAF4L2,chr8,R,87870742,87874068,47790863,3326,831560807,34854,0
138046,RALYL,chr8,F,84183217,84921844,48529490,738627,832299434,34855,13
138050,HGSNAT,chr8,F,43140448,43202827,48591869,62379,832361813,34856,19
140596,DEFB104A,chr8,F,7836470,7841242,48596641,4772,832366585,34857,1
157273,LOC157273,chr8,F,9325050,9335080,48606671,10030,832376615,34858,2
157285,SGK223,chr8,R,8317735,8386443,48675379,68708,832445323,34859,7
157310,PEBP4,chr8,R,22713250,22999754,48961883,286504,832731827,34860,8
157313,CDCA2,chr8,F,25458573,25511308,49014618,52735,832784562,34861,16
157376,FER1L6-AS2,chr8,R,124046070,124171522,49140070,125452,832910014,34862,4
157378,TMEM65,chr8,R,124306188,124372699,49206581,66511,832976525,34863,7
157381,LINC00964,chr8,F,124942007,124951095,49215669,9088,832985613,34864,3
157506,RDH10,chr8,F,73294601,73325285,49246353,30684,833016297,34865,6
157556,BAALC-AS2,chr8,R,103132962,103141342,49254733,8380,833024677,34866,1
157567,ANKRD46,chr8,R,100509751,100559786,49304768,50035,833074712,34867,6
157570,ESCO2,chr8,F,27771476,27812396,49345688,40920,833115632,34868,13
157574,FBXO16,chr8,R,28428407,28490318,49407599,61911,833177543,34869,8
157627,LINC00599,chr8,R,9900063,9903329,49410865,3266,833180809,34870,2
157638,FAM84B,chr8,R,126552437,126558478,49416906,6041,833186850,34871,1
157657,C8orf37,chr8,R,95244912,95270337,49442331,25425,833212275,34872,5
157680,VPS13B,chr8,F,99013070,99877586,50306847,864516,834076791,34873,78
157693,FAM87A,chr8,R,375930,383174,50314091,7244,834084035,34874,3
157695,TDRP,chr8,R,457017,545781,50402855,88764,834172799,34875,14
157697,ERICH1,chr8,R,614736,731239,50519358,116503,834289302,34876,15
157724,SLC7A13,chr8,R,86201762,86230380,50547976,28618,834317920,34877,4
157739,TDH,chr8,F,11339636,11368452,50576792,28816,834346736,34878,8
157753,TMEM74,chr8,R,108783116,108787541,50581217,4425,834351161,34879,1
157769,FAM91A1,chr8,F,123768438,123815452,50628231,47014,834398175,34880,24
157773,C8orf48,chr8,F,13566842,13568288,50629677,1446,834399621,34881,0
157777,MCMDC2,chr8,F,66870748,66926386,50685315,55638,834455259,34882,18
157807,CLVS1,chr8,F,60966437,61501645,51220523,535208,834990467,34883,9
157848,NKX6-3,chr8,R,41646309,41647359,51221573,1050,834991517,34884,1
157855,KCNU1,chr8,F,36784323,36936125,51373375,151802,835143319,34885,32
157869,SBSPON,chr8,R,73064542,73093272,51402105,28730,835172049,34886,6
168975,CNBD1,chr8,F,86866447,87382727,51918385,516280,835688329,34887,10
169026,SLC30A8,chr8,F,116950179,117176714,52144920,226535,835914864,34888,13
169044,COL22A1,chr8,R,138588234,138914094,52470780,325860,836240724,34889,69
169166,SNX31,chr8,R,100572881,100663410,52561309,90529,836331253,34890,17
169200,TMEM64,chr8,R,90621994,90645905,52585220,23911,836355164,34891,2
169270,ZNF596,chr8,F,232136,247340,52600424,15204,836370368,34892,6
169355,IDO2,chr8,F,39934954,40016391,52681861,81437,836451805,34893,10
170949,DEFT1P,chr8,R,6987177,6989721,52684405,2544,836454349,34894,2
195814,SDR16C5,chr8,R,56300010,56320776,52705171,20766,836475115,34895,7
203054,ADCK5,chr8,F,144374014,144393242,52724399,19228,836494343,34896,17
203062,TSNARE1,chr8,R,142212079,142403291,52915611,191212,836685555,34897,21
203069,R3HCC1,chr8,F,23288091,23296279,52923799,8188,836693743,34898,7
203074,PRSS55,chr8,F,10525476,10554166,52952489,28690,836722433,34899,10
203076,C8orf74,chr8,F,10672591,10700613,52980511,28022,836750455,34900,3
203100,HTRA4,chr8,F,38974148,38988662,52995025,14514,836764969,34901,10
203102,ADAM32,chr8,F,39107530,39284917,53172412,177387,836942356,34902,24
203111,ERICH5,chr8,F,98064521,98093610,53201501,29089,836971445,34903,2
203190,LGI3,chr8,R,22146829,22156831,53211503,10002,836981447,34904,7
225689,MAPK15,chr8,F,143716301,143722463,53217665,6162,836987609,34905,13
245908,DEFB105A,chr8,R,7820778,7823891,53220778,3113,836990722,34906,3
245909,DEFB106A,chr8,F,7825171,7829053,53224660,3882,836994604,34907,1
245910,DEFB107A,chr8,R,7811719,7815716,53228657,3997,836998601,34908,1
245912,DEFB109P1,chr8,R,12393283,12400365,53235739,7082,837005683,34909,1
245940,DEFB130,chr8,R,12310961,12318316,53243094,7355,837013038,34910,1
245972,ATP6V0D2,chr8,F,86098909,86154225,53298410,55316,837068354,34911,8
252969,NEIL2,chr8,F,11769662,11787345,53316093,17683,837086037,34912,4
253943,YTHDF3,chr8,F,63168552,63212788,53360329,44236,837130273,34913,7
254778,C8orf46,chr8,F,66493255,66518524,53385598,25269,837155542,34914,5
254896,LOC254896,chr8,F,23084354,23103558,53404802,19204,837174746,34915,3
254958,REXO1L1P,chr8,R,85661469,85663497,53406830,2028,837176774,34916,0
255926,ADAM5,chr8,F,39314662,39417226,53509394,102564,837279338,34917,15
286042,FAM86B3P,chr8,F,8228569,8244865,53525690,16296,837295634,34918,10
286046,XKR6,chr8,R,10896044,11201381,53831027,305337,837600971,34919,8
286053,NSMCE2,chr8,F,125091817,125367125,54106335,275308,837876279,34920,8
286059,LOC286059,chr8,F,23068228,23083619,54121726,15391,837891670,34921,2
286075,ZNF707,chr8,F,143684451,143695385,54132660,10934,837902604,34922,11
286076,BREA2,chr8,F,143697114,143698413,54133959,1299,837903903,34923,1
286077,FAM83H,chr8,R,143723932,143738030,54148057,14098,837918001,34924,6
286083,LOC286083,chr8,R,1296033,1302607,54154631,6574,837924575,34925,2
286094,LOC286094,chr8,F,135234130,135299719,54220220,65589,837990164,34926,5
286097,MICU3,chr8,F,17027237,17122639,54315622,95402,838085566,34927,16
286101,ZNF252P,chr8,R,144973588,145002899,54344933,29311,838114877,34928,4
286102,TMED10P1,chr8,F,144994864,144998897,54348966,4033,838118910,34929,0
286103,ZNF252P-AS1,chr8,F,145002810,145006046,54352202,3236,838122146,34930,0
286114,LOC286114,chr8,F,20973985,20995119,54373336,21134,838143280,34931,4
286122,C8orf31,chr8,F,143039208,143054303,54388431,15095,838158375,34932,7
286128,ZFP41,chr8,F,143246820,143262705,54404316,15885,838174260,34933,3
286133,SCARA5,chr8,R,27869881,27992852,54527287,122971,838297231,34934,8
286135,FAM183CP,chr8,F,29921512,29953609,54559384,32097,838329328,34935,2
286140,RNF5P1,chr8,R,38600172,38601257,54560469,1085,838330413,34936,0
286144,TRIQK,chr8,R,92883529,92966144,54643084,82615,838413028,34937,8
286148,DPY19L4,chr8,F,94719874,94793848,54717058,73974,838487002,34938,19
286151,FBXO43,chr8,R,100133359,100150569,54734268,17210,838504212,34939,7
286177,LOC286177,chr8,F,57261225,57266611,54739654,5386,838509598,34940,2
286178,LOC286178,chr8,F,57746223,57750197,54743628,3974,838513572,34941,1
286183,NKAIN3,chr8,F,62248309,62999652,55494971,751343,839264915,34942,11
286184,LINC01289,chr8,F,63769429,63785501,55511043,16072,839280987,34943,2
286186,LINC01299,chr8,R,65527007,65562666,55546702,35659,839316646,34944,4
286187,PPP1R42,chr8,R,66988130,67028551,55587123,40421,839357067,34945,5
286189,LOC286189,chr8,R,68303467,68331491,55615147,28024,839385091,34946,2
286190,LOC286190,chr8,F,70608576,70663279,55669850,54703,839439794,34947,3
338328,GPIHBP1,chr8,F,143213192,143217170,55673828,3978,839443772,34948,3
340357,LOC340357,chr8,R,12766061,12811401,55719168,45340,839489112,34949,3
340359,KLHL38,chr8,R,123645504,123653866,55727530,8362,839497474,34950,3
340371,NRBP2,chr8,R,143830015,143840974,55738489,10959,839508433,34951,16
340385,ZNF517,chr8,F,144798875,144809144,55748758,10269,839518702,34952,5
340390,KIAA1875,chr8,F,144107725,144118315,55759348,10590,839529292,34953,22
340393,TMEM249,chr8,R,144353225,144355609,55761732,2384,839531676,34954,4
340419,RSPO2,chr8,R,107899315,108083685,55946102,184370,839716046,34955,6
340441,POTEA,chr8,F,43292369,43366407,56020140,74038,839790084,34956,13
347051,SLC10A5,chr8,R,81693655,81694972,56021457,1317,839791401,34957,0
349196,LINC00965,chr8,R,7260618,7263492,56024331,2874,839794275,34958,0
375686,SPATC1,chr8,F,144010992,144047114,56060453,36122,839830397,34959,10
377630,USP17L2,chr8,R,12137167,12138760,56062046,1593,839831990,34960,0
377677,CA13,chr8,F,85245486,85284073,56100633,38587,839870577,34961,6
389610,XKR5,chr8,R,6808516,6835644,56127761,27128,839897705,34962,8
389633,FAM90A25P,chr8,R,12414520,12418032,56131273,3512,839901217,34963,3
389641,LOC389641,chr8,F,23225220,23230926,56136979,5706,839906923,34964,2
389643,NUGGC,chr8,R,28021963,28084063,56199079,62100,839969023,34965,19
389649,C8orf86,chr8,R,38504581,38528665,56223163,24084,839993107,34966,3
389658,FAM150A,chr8,R,52534036,52565461,56254588,31425,840024532,34967,4
389668,XKR9,chr8,F,70669362,71065788,56651014,396426,840420958,34968,9
389676,C8orf87,chr8,R,93134094,93166850,56683770,32756,840453714,34969,2
389677,RBM12B,chr8,R,93731499,93741012,56693283,9513,840463227,34970,5
389690,MROH5,chr8,R,141433828,141507230,56766685,73402,840536629,34971,30
389692,MAFA,chr8,R,143428059,143430432,56769058,2373,840539002,34972,0
392188,USP17L8,chr8,R,7971660,7973253,56770651,1593,840540595,34973,0
392196,LOC392196,chr8,R,12127857,12129297,56772091,1440,840542035,34974,0
392197,USP17L7,chr8,R,12132416,12134009,56773684,1593,840543628,34975,0
392232,LOC392232,chr8,R,72205298,72251634,56820020,46336,840589964,34976,20
392255,GDF6,chr8,R,96142329,96160792,56838483,18463,840608427,34977,2
392275,SMPD5,chr8,F,144047113,144051294,56842664,4181,840612608,34978,5
401442,LOC401442,chr8,F,738553,740374,56844485,1821,840614429,34979,0
401447,USP17L1,chr8,F,7332386,7333979,56846078,1593,840616022,34980,0
401463,LOC401463,chr8,R,64574307,64577263,56849034,2956,840618978,34981,1
401466,C8orf59,chr8,R,85214052,85220422,56855404,6370,840625348,34982,5
401471,LOC401471,chr8,F,101008329,101009860,56856935,1531,840626879,34983,3
401474,SAMD12,chr8,R,118131827,118621995,57347103,490168,841117047,34984,14
401478,LOC401478,chr8,R,137812895,138088186,57622394,275291,841392338,34985,15
406907,MIR124-1,chr8,R,9903387,9903472,57622479,85,841392423,34986,0
406908,MIR124-2,chr8,F,64379148,64379257,57622588,109,841392532,34987,0
407030,MIR30B,chr8,R,134800519,134800607,57622676,88,841392620,34988,0
407033,MIR30D,chr8,R,134804875,134804945,57622746,70,841392690,34989,0
407037,MIR320A,chr8,R,22244961,22245043,57622828,82,841392772,34990,0
414325,DEFB103A,chr8,F,7881203,7882664,57624289,1461,841394233,34991,1
414919,C8orf82,chr8,R,144526218,144529074,57627145,2856,841397089,34992,2
439941,FER1L6-AS1,chr8,R,123984137,124040782,57683790,56645,841453734,34993,5
441308,OR4F21,chr8,R,166085,167024,57684729,939,841454673,34994,0
441317,FAM90A7P,chr8,R,7556137,7559104,57687696,2967,841457640,34995,2
441328,FAM90A10P,chr8,F,7769583,7771313,57689426,1730,841459370,34996,2
441355,FLJ39080,chr8,F,74599865,74758352,57847913,158487,841617857,34997,5
441369,FLJ46284,chr8,R,92712961,92786060,57921012,73099,841690956,34998,2
441374,FLJ42969,chr8,F,101052053,101076251,57945210,24198,841715154,34999,2
441376,AARD,chr8,F,116938224,116944000,57950986,5776,841720930,35000,1
441381,LRRC24,chr8,R,144522376,144527032,57955642,4656,841725586,35001,4
442388,SDR16C6P,chr8,R,56374717,56390710,57971635,15993,841741579,35002,3
442893,MIR151A,chr8,R,140732563,140732653,57971725,90,841741669,35003,0
449491,DEFA8P,chr8,R,6950725,6951599,57972599,874,841742543,35004,1
449492,DEFA9P,chr8,R,6959288,6960161,57973472,873,841743416,35005,1
449493,DEFA10P,chr8,R,6968140,6969113,57974445,973,841744389,35006,1
492307,C8orf22,chr8,F,49054335,49076083,57996193,21748,841766137,35007,5
494332,MIR383,chr8,R,14853437,14853510,57996266,73,841766210,35008,0
497634,LINC00293,chr8,F,46840885,46855785,58011166,14900,841781110,35009,10
503614,DEFB107B,chr8,F,7495845,7509311,58024632,13466,841794576,35010,1
503618,DEFB104B,chr8,R,7470307,7475082,58029407,4775,841799351,35011,1
503841,DEFB106B,chr8,R,7482503,7486387,58033291,3884,841803235,35012,1
504180,DEFB105B,chr8,F,7487667,7490779,58036403,3112,841806347,35013,3
541565,C8orf58,chr8,F,22599600,22604150,58040953,4550,841810897,35014,6
552853,NCRNA00250,chr8,F,134838068,134842637,58045522,4569,841815466,35015,2
552859,LINC00251,chr8,R,65161144,65180340,58064718,19196,841834662,35016,3
552860,SAMD12-AS1,chr8,F,118621000,118726067,58169785,105067,841939729,35017,4
594840,ZFAT-AS1,chr8,F,134598070,134600689,58172404,2619,841942348,35018,1
594842,HAS2-AS1,chr8,F,121639345,121645325,58178384,5980,841948328,35019,3
606553,C8orf49,chr8,F,11761255,11763223,58180352,1968,841950296,35020,0
613209,DEFB135,chr8,F,11982320,11984590,58182622,2270,841952566,35021,1
613210,DEFB136,chr8,R,11973936,11974599,58183285,663,841953229,35022,1
613211,DEFB134,chr8,R,11993176,12000752,58190861,7576,841960805,35023,2
619279,ZNF704,chr8,R,80628450,80874781,58437192,246331,842207136,35024,10
619343,ERICH1-AS1,chr8,F,737604,1137777,58837365,400173,842607309,35025,3
619344,LINC01298,chr8,R,95207006,95216374,58846733,9368,842616677,35026,2
619351,LINC00589,chr8,R,29721258,29748109,58873584,26851,842643528,35027,3
619373,MBOAT4,chr8,R,30131453,30158699,58900830,27246,842670774,35028,5
619423,FAM85A,chr8,F,12186896,12204842,58918776,17946,842688720,35029,6
619434,LINC00051,chr8,F,142198355,142209003,58929424,10648,842699368,35030,2
619554,MIR486-1,chr8,R,41660440,41660508,58929492,68,842699436,35031,0
641384,TMEM75,chr8,R,127946558,127948723,58931657,2165,842701601,35032,0
641517,DEFB109P1B,chr8,F,7312845,7319951,58938763,7106,842708707,35033,1
641638,SNHG6,chr8,R,66921929,66925542,58942376,3613,842712320,35034,3
641648,SNORD87,chr8,R,66922473,66922549,58942452,76,842712396,35035,0
642475,MROH6,chr8,R,143566188,143572758,58949022,6570,842718966,35036,11
642574,LOC642574,chr8,F,143766663,143790701,58973060,24038,842743004,35037,7
642658,SCX,chr8,F,144265059,144268483,58976484,3424,842746428,35038,2
642924,LINC00535,chr8,R,93346466,93700433,59330451,353967,843100395,35039,10
643763,UG0898H09,chr8,F,62977860,62984901,59337492,7041,843107436,35040,0
644128,RPL23AP53,chr8,R,208343,232318,59361467,23975,843131411,35041,3
644660,RAD21-AS1,chr8,F,116874423,116876868,59363912,2445,843133856,35042,1
645402,USP17L4,chr8,F,7337114,7338707,59365505,1593,843135449,35043,0
645836,USP17L3,chr8,R,7976392,7977985,59367098,1593,843137042,35044,0
646480,FABP9,chr8,R,81458382,81461523,59370239,3141,843140183,35045,3
646486,FABP12,chr8,R,81524980,81590596,59435855,65616,843205799,35046,7
649352,LOC649352,chr8,R,12379266,12379789,59436378,523,843206322,35047,0
653333,FAM86B2,chr8,R,12425613,12436417,59447182,10804,843217126,35048,9
653423,SPAG11A,chr8,F,7847863,7863797,59463116,15934,843233060,35049,5
654463,FER1L6,chr8,F,123851986,124120061,59731191,268075,843501135,35050,48
692084,SNORD13,chr8,F,33513474,33513578,59731295,104,843501239,35051,0
693127,MIR548A3,chr8,R,104484368,104484465,59731392,97,843501336,35052,0
693130,MIR548D1,chr8,R,123348033,123348130,59731489,97,843501433,35053,0
693181,MIR596,chr8,F,1817230,1817307,59731566,77,843501510,35054,0
693182,MIR597,chr8,F,9741671,9741768,59731663,97,843501607,35055,0
693183,MIR598,chr8,R,11035205,11035302,59731760,97,843501704,35056,0
693184,MIR599,chr8,R,99536635,99536730,59731855,95,843501799,35057,0
724031,MIR661,chr8,R,143945190,143945279,59731944,89,843501888,35058,0
724068,DEFA11P,chr8,R,7028600,7029489,59732833,889,843502777,35059,1
727677,CASC8,chr8,R,127289675,127482139,59925297,192464,843695241,35060,6
727957,MROH1,chr8,F,144148015,144261940,60039222,113925,843809166,35061,48
728024,LOC728024,chr8,R,37746553,37748046,60040715,1493,843810659,35062,0
728358,DEFA1B,chr8,R,6996765,6999202,60043152,2437,843813096,35063,3
728724,LINC00977,chr8,R,129216466,129241240,60067926,24774,843837870,35064,2
728957,ZNF705D,chr8,F,12089337,12115516,60094105,26179,843864049,35065,8
729330,OC90,chr8,R,132024219,132059380,60129266,35161,843899210,35066,13
729689,FAM90A2P,chr8,R,12173453,12177267,60133080,3814,843903024,35067,4
729732,LOC729732,chr8,R,12537078,12665611,60261613,128533,844031557,35068,8
731779,LINC01300,chr8,F,141340548,141344621,60265686,4073,844035630,35069,3
100126309,MIR875,chr8,R,99536785,99536861,60265762,76,844035706,35070,0
100126338,MIR937,chr8,R,143812956,143813042,60265848,86,844035792,35071,0
100126351,MIR939,chr8,R,144394148,144394230,60265930,82,844035874,35072,0
100127983,C8orf88,chr8,R,90958477,90985257,60292710,26780,844062654,35073,5
100128126,STAU2-AS1,chr8,F,73420073,73441518,60314155,21445,844084099,35074,2
100128338,FAM83H-AS1,chr8,F,143734139,143746337,60326353,12198,844096297,35075,3
100128627,CDC42P3,chr8,F,142995827,142997663,60328189,1836,844098133,35076,0
100128750,RBPMS-AS1,chr8,R,30382118,30385401,60331472,3283,844101416,35077,2
100128890,FAM66B,chr8,R,7301610,7355354,60385216,53744,844155160,35078,6
100128993,LOC100128993,chr8,R,19183673,19245522,60447065,61849,844217009,35079,4
100129098,LOC100129098,chr8,R,54465593,54470426,60451898,4833,844221842,35080,2
100129654,TCF24,chr8,R,66946500,66962590,60467988,16090,844237932,35081,3
100130155,MIR124-2HG,chr8,F,64373217,64387504,60482275,14287,844252219,35082,3
100130231,LINC00861,chr8,R,125922522,125951197,60510950,28675,844280894,35083,3
100130274,CCDC166,chr8,R,143706693,143708109,60512366,1416,844282310,35084,1
100130298,LOC100130298,chr8,R,60966120,60967748,60513994,1628,844283938,35085,1
100130301,C8orf89,chr8,R,73241363,73285712,60558343,44349,844328287,35086,5
100130742,LRRC69,chr8,F,91102618,91219236,60674961,116618,844444905,35087,7
100130964,LOC100130964,chr8,F,39563111,39580134,60691984,17023,844461928,35088,4
100131395,LOC100131395,chr8,R,1934390,1938216,60695810,3826,844465754,35089,0
100131608,PRR23D1,chr8,F,7536779,7542450,60701481,5671,844471425,35090,4
100131726,FAM83A-AS1,chr8,R,123201171,123202743,60703053,1572,844472997,35091,2
100131980,ZNF705G,chr8,R,7357975,7362968,60708046,4993,844477990,35092,4
100132103,FAM66E,chr8,F,7955012,8008755,60761789,53743,844531733,35093,6
100132396,ZNF705B,chr8,F,7926336,7952413,60787866,26077,844557810,35094,6
100132813,LOC100132813,chr8,F,109644114,109648032,60791784,3918,844561728,35095,1
100132891,LOC100132891,chr8,F,71843122,72056312,61004974,213190,844774918,35096,4
100132923,FAM66D,chr8,F,12115781,12151189,61040382,35408,844810326,35097,5
100133172,FAM66A,chr8,F,12362018,12411001,61089365,48983,844859309,35098,4
100133234,SBF1P1,chr8,R,55449196,55455321,61095490,6125,844865434,35099,0
100133251,PRR23D2,chr8,R,7778590,7784165,61101065,5575,844871009,35100,4
100133267,LOC100133267,chr8,R,12064388,12071747,61108424,7359,844878368,35101,1
100133669,LOC100133669,chr8,R,142982030,143018390,61144784,36360,844914728,35102,1
100189102,TRY-GTA5-5,chr8,F,66113987,66114076,61144873,89,844914817,35103,1
100189201,TRM-CAT1-1,chr8,R,123157229,123157302,61144946,73,844914890,35104,0
100189248,TRS-AGA2-6,chr8,R,95269656,95269738,61145028,82,844914972,35105,0
100189437,TRY-GTA5-4,chr8,F,66113366,66113459,61145121,93,844915065,35106,1
100192378,ZFHX4-AS1,chr8,R,76610878,76683275,61217518,72397,844987462,35107,3
100270680,CASC11,chr8,R,127700607,127733967,61250878,33360,845020822,35108,4
100287015,LOC100287015,chr8,R,6403555,6406548,61253871,2993,845023815,35109,1
100287083,DEFT1P2,chr8,R,7006280,7008824,61256415,2544,845026359,35110,2
100287098,LOC100287098,chr8,F,144435167,144439893,61261141,4726,845031085,35111,5
100287846,LOC100287846,chr8,F,47189306,47192816,61264651,3510,845034595,35112,0
100288181,LOC100288181,chr8,R,142702251,142726973,61289373,24722,845059317,35113,2
100288527,REXO1L2P,chr8,R,85775015,85776093,61290451,1078,845060395,35114,0
100288562,LOC100288562,chr8,R,85790324,85792352,61292479,2028,845062423,35115,0
100288748,LOC100288748,chr8,R,94637284,94639467,61294662,2183,845064606,35116,0
100289462,DEFB4B,chr8,R,7414862,7416832,61296632,1970,845066576,35117,1
100302147,MIR1302-7,chr8,R,141786241,141786313,61296704,72,845066648,35118,0
100302161,MIR1205,chr8,F,127960632,127960695,61296767,63,845066711,35119,0
100302165,MIR1273A,chr8,R,100023981,100024084,61296870,103,845066814,35120,0
100302166,MIR1322,chr8,R,10825372,10825443,61296941,71,845066885,35121,0
100302170,MIR1206,chr8,F,128008897,128008956,61297000,59,845066944,35122,0
100302175,MIR1207,chr8,F,128049151,128049238,61297087,87,845067031,35123,0
100302185,MIR1204,chr8,F,127795961,127796028,61297154,67,845067098,35124,0
100302186,MIR548I3,chr8,R,8088940,8089089,61297303,149,845067247,35125,0
100302196,MIR1234,chr8,R,144400085,144400165,61297383,80,845067327,35126,0
100302225,MIR2053,chr8,F,112643492,112643583,61297474,91,845067418,35127,0
100302260,MIR2052,chr8,F,74705692,74705747,61297529,55,845067473,35128,0
100302281,MIR1208,chr8,F,128150115,128150188,61297602,73,845067546,35129,0
100313884,MIR548H4,chr8,R,27048852,27048963,61297713,111,845067657,35130,0
100422828,MIR4287,chr8,R,27886038,27886116,61297791,78,845067735,35131,0
100422850,MIR548V,chr8,R,17681577,17681657,61297871,80,845067815,35132,0
100422876,MIR3148,chr8,R,29957271,29957348,61297948,77,845067892,35133,0
100422903,MIR4288,chr8,R,28505115,28505182,61298015,67,845067959,35134,0
100422921,MIR3149,chr8,R,76966767,76966850,61298098,83,845068042,35135,0
100422964,MIR3150A,chr8,F,95072913,95072993,61298178,80,845068122,35136,0
100422982,MIR4286,chr8,F,10666977,10667070,61298271,93,845068215,35137,0
100422992,MIR3151,chr8,F,103154613,103154689,61298347,76,845068291,35138,0
100499183,BAALC-AS1,chr8,R,103156989,103172140,61313498,15151,845083442,35139,2
100500773,LOC100500773,chr8,R,95946983,95948348,61314863,1365,845084807,35140,0
100500838,MIR3926-2,chr8,F,12727236,12727299,61314926,63,845084870,35141,0
100500839,MIR3686,chr8,R,129484056,129484142,61315012,86,845084956,35142,0
100500858,MIR3622A,chr8,F,27701676,27701759,61315095,83,845085039,35143,0
100500863,MIR548AA1,chr8,F,123348033,123348130,61315192,97,845085136,35144,0
100500870,MIR3926-1,chr8,R,12727231,12727304,61315265,73,845085209,35145,0
100500871,MIR3622B,chr8,R,27701672,27701767,61315360,95,845085304,35146,0
100500907,MIR3150B,chr8,R,95072910,95072996,61315446,86,845085390,35147,0
100500912,MIR3674,chr8,F,1801124,1801192,61315514,68,845085458,35148,0
100500914,MIR3610,chr8,R,116874727,116874800,61315587,73,845085531,35149,0
100505477,T1560,chr8,F,57978357,57984126,61321356,5769,845091300,35150,2
100505501,LOC100505501,chr8,F,59119842,59121347,61322861,1505,845092805,35151,1
100505532,LINC01301,chr8,R,60402170,60413818,61334509,11648,845104453,35152,2
100505659,LINC00967,chr8,F,66192113,66197319,61339715,5206,845109659,35153,2
100505676,RRS1-AS1,chr8,R,66419586,66428977,61349106,9391,845119050,35154,2
100505718,LOC100505718,chr8,R,68911802,69104190,61541494,192388,845311438,35155,4
100505739,LOC100505739,chr8,R,69424869,69448244,61564869,23375,845334813,35156,3
100506365,OTUD6B-AS1,chr8,R,91059905,91070189,61575153,10284,845345097,35157,2
100506753,LOC100506753,chr8,F,102864270,102977876,61688759,113606,845458703,35158,3
100506990,LOC100506990,chr8,F,12437012,12566845,61818592,129833,845588536,35159,7
100507056,CCAT1,chr8,R,127207381,127219268,61830479,11887,845600423,35160,1
100507071,LOC100507071,chr8,R,22254575,22275233,61851137,20658,845621081,35161,1
100507117,ASAP1-IT2,chr8,R,130082737,130084768,61853168,2031,845623112,35162,0
100507156,LOC100507156,chr8,F,23336207,23366125,61883086,29918,845653030,35163,2
100507236,LOC100507236,chr8,R,25941228,25943863,61885721,2635,845655665,35164,0
100507258,LOC100507258,chr8,F,85220508,85240654,61905867,20146,845675811,35165,5
100507316,LOC100507316,chr8,R,143280154,143281700,61907413,1546,845677357,35166,2
100507341,SMIM18,chr8,F,30638599,30645956,61914770,7357,845684714,35167,2
100507403,LOC100507403,chr8,R,37326956,37332008,61919822,5052,845689766,35168,2
100507420,LOC100507420,chr8,R,37406463,37521386,62034745,114923,845804689,35169,9
100507435,DLGAP2-AS1,chr8,R,1565508,1621664,62090901,56156,845860845,35170,3
100507464,LOC100507464,chr8,R,49496762,49512234,62106373,15472,845876317,35171,1
100507516,LOC100507516,chr8,R,53511778,53524084,62118679,12306,845888623,35172,1
100507530,LOC100507530,chr8,R,6615602,6708209,62211286,92607,845981230,35173,4
100507632,LINC00968,chr8,R,56518317,56559823,62252792,41506,846022736,35174,2
100507651,LOC100507651,chr8,F,57218275,57232954,62267471,14679,846037415,35175,9
100533105,C8orf44-SGK3,chr8,F,66667551,66862022,62461942,194471,846231886,35176,18
100533106,ZHX1-C8orf76,chr8,R,123226188,123274487,62510241,48299,846280185,35177,5
100616115,MIR4469,chr8,R,42896196,42896275,62510320,79,846280264,35178,0
100616169,MIR378D2,chr8,R,93916021,93916119,62510418,98,846280362,35179,0
100616221,MIR4662A,chr8,F,124821984,124822051,62510485,67,846280429,35180,0
100616245,MIR4661,chr8,F,91205484,91205559,62510560,75,846280504,35181,0
100616255,MIR4662B,chr8,R,124821977,124822058,62510641,81,846280585,35182,0
100616260,MIR4663,chr8,R,123215787,123215863,62510717,76,846280661,35183,0
100616268,MIR4472-1,chr8,F,142176338,142176418,62510797,80,846280741,35184,0
100616318,MIR4664,chr8,R,143733082,143733153,62510868,71,846280812,35185,0
100616348,MIR4659A,chr8,F,6745163,6745244,62510949,81,846280893,35186,0
100616350,MIR4660,chr8,F,9048444,9048518,62511023,74,846280967,35187,0
100616372,MIR4659B,chr8,R,6745167,6745240,62511096,73,846281040,35188,0
100616451,MIR4471,chr8,F,100382762,100382845,62511179,83,846281123,35189,0
100616484,MIR4470,chr8,F,61714787,61714859,62511251,72,846281195,35190,0
100616530,C8orf37-AS1,chr8,F,95268835,95810143,63052559,541308,846822503,35191,7
100652791,GS1-24F4.2,chr8,F,6835553,6842454,63059460,6901,846829404,35192,2
100750225,PCAT1,chr8,F,127013153,127021014,63067321,7861,846837265,35193,1
100847001,MIR5680,chr8,F,102125431,102125515,63067405,84,846837349,35194,0
100847038,MIR5692A2,chr8,F,12719131,12719190,63067464,59,846837408,35195,0
100847051,MIR5194,chr8,R,130008333,130008453,63067584,120,846837528,35196,0
100847056,MIR5708,chr8,F,80241388,80241473,63067669,85,846837613,35197,0
100847058,MIR5681A,chr8,F,74548542,74548617,63067744,75,846837688,35198,0
100847068,MIR548AO,chr8,R,41271047,41271143,63067840,96,846837784,35199,0
100847091,MIR5681B,chr8,R,74548549,74548609,63067900,60,846837844,35200,0
100856811,NRG1-IT1,chr8,F,32025735,32139477,63181642,113742,846951586,35201,4
100859921,LINC00536,chr8,R,115950510,116325059,63556191,374549,847326135,35202,13
100861412,FSBP,chr8,R,94427711,94436952,63565432,9241,847335376,35203,1
100874051,LZTS1-AS1,chr8,F,20275772,20290458,63580118,14686,847350062,35204,2
100874052,LINC00534,chr8,F,90221487,90387959,63746590,166472,847516534,35205,3
100874286,NRG1-IT3,chr8,F,32440745,32442725,63748570,1980,847518514,35206,2
100996348,LOC100996348,chr8,R,85441805,85464915,63771680,23110,847541624,35207,5
100996662,LOC100996662,chr8,F,144700393,144709597,63780884,9204,847550828,35208,4
101241902,LOC101241902,chr8,R,78722846,78724374,63782412,1528,847552356,35209,0
101409254,LINC00681,chr8,F,12794242,12818291,63806461,24049,847576405,35210,1
101410533,YTHDF3-AS1,chr8,R,63167724,63168442,63807179,718,847577123,35211,0
101805488,CCAT2,chr8,F,127400398,127402150,63808931,1752,847578875,35212,0
101805492,CASC9,chr8,R,75223116,75278889,63864704,55773,847634648,35213,3
101867536,PRNCR1,chr8,F,127079873,127092595,63877426,12722,847647370,35214,0
101926892,LOC101926892,chr8,F,70471133,70485687,63891980,14554,847661924,35215,3
101926899,LOC101926899,chr8,R,90294926,90364844,63961898,69918,847731842,35216,5
101926908,LOC101926908,chr8,F,72732044,72751843,63981697,19799,847751641,35217,2
101926926,LOC101926926,chr8,R,73310905,73356461,64027253,45556,847797197,35218,5
101926947,NCRNA00249,chr8,F,73879004,73904734,64052983,25730,847822927,35219,4
101926956,LOC101926956,chr8,F,92668655,92683445,64067773,14790,847837717,35220,3
101926965,LOC101926965,chr8,F,74267169,74269687,64070291,2518,847840235,35221,3
101926977,LOC101926977,chr8,F,94553621,94594761,64111431,41140,847881375,35222,4
101926978,LINC01111,chr8,F,76406653,76524356,64229134,117703,847999078,35223,5
101927003,LOC101927003,chr8,R,78533891,78558503,64253746,24612,848023690,35224,2
101927039,LOC101927039,chr8,F,96235627,96238031,64256150,2404,848026094,35225,3
101927040,LOC101927040,chr8,R,79769371,79871737,64358516,102366,848128460,35226,5
101927066,LOC101927066,chr8,R,96951863,97446497,64853150,494634,848623094,35227,2
101927067,LOC101927067,chr8,F,79768141,79802842,64887851,34701,848657795,35228,3
101927118,LOC101927118,chr8,F,81523067,81579444,64944228,56377,848714172,35229,8
101927141,LOC101927141,chr8,F,82912103,82913023,64945148,920,848715092,35230,1
101927172,LOC101927172,chr8,R,101491256,101492683,64946575,1427,848716519,35231,1
101927221,LOC101927221,chr8,F,102239450,102252174,64959299,12724,848729243,35232,2
101927245,LOC101927245,chr8,F,102654317,102730395,65035377,76078,848805321,35233,16
101927392,LOC101927392,chr8,R,105142859,105188773,65081291,45914,848851235,35234,4
101927413,LOC101927413,chr8,R,108894891,108970266,65156666,75375,848926610,35235,7
101927459,LOC101927459,chr8,R,110937689,111027433,65246410,89744,849016354,35236,6
101927487,LOC101927487,chr8,R,111098960,111236203,65383653,137243,849153597,35237,3
101927506,LOC101927506,chr8,R,63712,112953,65432894,49241,849202838,35238,6
101927513,LOC101927513,chr8,R,119062941,119068782,65438735,5841,849208679,35239,1
101927543,LOC101927543,chr8,F,120761252,120776832,65454315,15580,849224259,35240,4
101927561,LOC101927561,chr8,R,120714116,120716114,65456313,1998,849226257,35241,2
101927566,LOC101927566,chr8,R,258274,274363,65472402,16089,849242346,35242,4
101927588,LOC101927588,chr8,R,124192690,124247398,65527110,54708,849297054,35243,2
101927595,LOC101927595,chr8,R,303404,306956,65530662,3552,849300606,35244,2
101927612,RNF139-AS1,chr8,R,124462492,124474563,65542733,12071,849312677,35245,2
101927657,LOC101927657,chr8,F,126325494,126329535,65546774,4041,849316718,35246,2
101927752,LOC101927752,chr8,R,1758207,1763334,65551901,5127,849321845,35247,3
101927774,LINC00824,chr8,R,128405268,128564679,65711312,159411,849481256,35248,9
101927798,LOC101927798,chr8,R,133775550,133777352,65713114,1802,849483058,35249,2
101927815,LOC101927815,chr8,R,2530091,2728451,65911474,198360,849681418,35250,9
101927822,LOC101927822,chr8,F,133886495,133902407,65927386,15912,849697330,35251,3
101927845,LOC101927845,chr8,F,134849934,134881899,65959351,31965,849729295,35252,2
101927872,LOC101927872,chr8,R,135375090,135457967,66042228,82877,849812172,35253,8
101927892,LOC101927892,chr8,F,137196243,137201141,66047126,4898,849817070,35254,2
101927915,LOC101927915,chr8,R,137406100,137413588,66054614,7488,849824558,35255,2
101927963,LOC101927963,chr8,R,141125939,141130272,66058947,4333,849828891,35256,4
101928037,LOC101928037,chr8,F,141374182,141382220,66066985,8038,849836929,35257,2
101928058,LOC101928058,chr8,R,1972617,1973870,66068238,1253,849838182,35258,1
101928087,LOC101928087,chr8,F,142638491,142640648,66070395,2157,849840339,35259,1
101928108,LOC101928108,chr8,F,143080042,143083478,66073831,3436,849843775,35260,4
101928160,LOC101928160,chr8,F,143707016,143713898,66080713,6882,849850657,35261,5
101928902,LOC101928902,chr8,R,144368936,144372465,66084242,3529,849854186,35262,1
101928998,LOC101928998,chr8,R,12509562,12527742,66102422,18180,849872366,35263,4
101929028,LOC101929028,chr8,R,16367444,16685849,66420827,318405,850190771,35264,12
101929066,LOC101929066,chr8,F,18084867,18097651,66433611,12784,850203555,35265,5
101929128,LOC101929128,chr8,F,9188998,9202858,66447471,13860,850217415,35266,3
101929172,LOC101929172,chr8,F,21298238,21309449,66458682,11211,850228626,35267,2
101929191,LINCR-0001,chr8,F,10474564,10481974,66466092,7410,850236036,35268,4
101929217,LOC101929217,chr8,F,48620402,48623895,66469585,3493,850239529,35269,1
101929229,LOC101929229,chr8,F,10840025,10846509,66476069,6484,850246013,35270,2
101929237,LOC101929237,chr8,F,22877971,22888022,66486120,10051,850256064,35271,3
101929248,LOC101929248,chr8,F,10850646,10859974,66495448,9328,850265392,35272,2
101929258,LOC101929258,chr8,R,23711901,23726988,66510535,15087,850280479,35273,3
101929268,LOC101929268,chr8,F,48551566,48698510,66657479,146944,850427423,35274,3
101929269,LOC101929269,chr8,R,11062651,11067119,66661947,4468,850431891,35275,1
101929290,LOC101929290,chr8,R,11320856,11329186,66670277,8330,850440221,35276,1
101929294,LOC101929294,chr8,R,24295813,24548618,66923082,252805,850693026,35277,5
101929315,LOC101929315,chr8,R,24490311,24514868,66947639,24557,850717583,35278,4
101929341,LOC101929341,chr8,F,52194319,52199552,66952872,5233,850722816,35279,1
101929400,LOC101929400,chr8,R,7676600,7687580,66963852,10980,850733796,35280,4
101929402,EXTL3-AS1,chr8,R,28698402,28701464,66966914,3062,850736858,35281,2
101929415,LOC101929415,chr8,F,56445806,56552067,67073175,106261,850843119,35282,3
101929419,LOC101929419,chr8,R,29288789,29320461,67104847,31672,850874791,35283,2
101929450,LOC101929450,chr8,F,29748308,29798492,67155031,50184,850924975,35284,5
101929470,LOC101929470,chr8,R,29815003,29828504,67168532,13501,850938476,35285,2
101929488,LOC101929488,chr8,F,57343786,57364857,67189603,21071,850959547,35286,8
101929490,LOC101929490,chr8,F,11677070,11682039,67194572,4969,850964516,35287,1
101929492,LOC101929492,chr8,F,31275582,31401108,67320098,125526,851090042,35288,6
101929528,LOC101929528,chr8,R,58255770,58272101,67336429,16331,851106373,35289,7
101929550,LOC101929550,chr8,R,35672162,35710320,67374587,38158,851144531,35290,4
101929576,LOC101929576,chr8,F,60884891,60904825,67394521,19934,851164465,35291,2
101929601,LOC101929601,chr8,F,85735313,85737341,67396549,2028,851166493,35292,0
101929622,LOC101929622,chr8,F,37717578,37733493,67412464,15915,851182408,35293,2
101929627,LOC101929627,chr8,R,85744488,85746516,67414492,2028,851184436,35294,0
101929628,LOC101929628,chr8,F,61785071,62052364,67681785,267293,851451729,35295,28
101929675,LOC101929675,chr8,R,64410273,64462935,67734447,52662,851504391,35296,3
101929709,LOC101929709,chr8,R,89717398,89757711,67774760,40313,851544704,35297,4
101929722,LOC101929722,chr8,R,66139116,66141674,67777318,2558,851547262,35298,1
101929759,LOC101929759,chr8,F,69834110,69837829,67781037,3719,851550981,35299,1
101929897,LOC101929897,chr8,R,42255319,42270961,67796679,15642,851566623,35300,2
101930072,LOC101930072,chr8,F,141437478,141437954,67797155,476,851567099,35301,1
101930149,LOC101930149,chr8,F,13338308,13357501,67816348,19193,851586292,35302,3
101930275,LOC101930275,chr8,F,17801462,17822430,67837316,20968,851607260,35303,3
101937451,LINC01030,chr8,R,90592774,90606063,67850605,13289,851620549,35304,2
102465506,MIR6841,chr8,R,24953795,24953867,67850677,72,851620621,35305,0
102465507,MIR6842,chr8,F,27433369,27433434,67850742,65,851620686,35306,0
102465508,MIR6843,chr8,R,27610600,27610751,67850893,151,851620837,35307,0
102465509,MIR6846,chr8,R,144057320,144057380,67850953,60,851620897,35308,0
102465510,MIR6847,chr8,F,144079873,144079942,67851022,69,851620966,35309,0
102465511,MIR6848,chr8,R,144317245,144317315,67851092,70,851621036,35310,0
102465527,MIR6876,chr8,F,25345401,25345474,67851165,73,851621109,35311,0
102465695,MIR7160,chr8,F,2076588,2076640,67851217,52,851621161,35312,0
102465696,MIR486-2,chr8,F,41660443,41660507,67851281,64,851621225,35313,0
102465861,MIR8055,chr8,R,6622123,6622220,67851378,97,851621322,35314,0
102465906,MIR7112,chr8,R,144262672,144262737,67851443,65,851621387,35315,0
102465978,MIR6850,chr8,R,144791930,144791991,67851504,61,851621448,35316,0
102466162,MIR548AZ,chr8,F,119325170,119325265,67851599,95,851621543,35317,0
102466200,MIR6844,chr8,R,124508514,124508576,67851661,62,851621605,35318,0
102466271,MIR6893,chr8,R,144435550,144435619,67851730,69,851621674,35319,0
102466748,MIR6845,chr8,R,143837755,143837816,67851791,61,851621735,35320,0
102466749,MIR6849,chr8,R,144400276,144400345,67851860,69,851621804,35321,0
102466854,MIR7705,chr8,R,100702967,100703024,67851917,57,851621861,35322,0
102466865,MIR7848,chr8,R,133046480,133046581,67852018,101,851621962,35323,0
102467005,MIR8084,chr8,F,93029750,93029839,67852107,89,851622051,35324,0
102467222,LOC102467222,chr8,F,20953632,20968938,67867413,15306,851637357,35325,5
102723313,LOC102723313,chr8,F,10728357,10780112,67919168,51755,851689112,35326,5
102723322,LOC102723322,chr8,R,85172437,85177041,67923772,4604,851693716,35327,1
102723356,ZFPM2-AS1,chr8,R,105780409,106060503,68203866,280094,851973810,35328,8
102723368,LOC102723368,chr8,R,108756963,108770865,68217768,13902,851987712,35329,2
102723395,LOC102723395,chr8,F,25836382,25873700,68255086,37318,852025030,35330,5
102723447,LOC102723447,chr8,R,116337121,116450672,68368637,113551,852138581,35331,5
102723535,LOC102723535,chr8,R,30554415,30578043,68392265,23628,852162209,35332,2
102723549,LOC102723549,chr8,F,30442718,30446648,68396195,3930,852166139,35333,2
102723635,LOC102723635,chr8,R,133211425,133212987,68397757,1562,852167701,35334,3
102723694,LOC102723694,chr8,R,134792011,134832031,68437777,40020,852207721,35335,6
102723701,LOC102723701,chr8,R,37734760,37737426,68440443,2666,852210387,35336,1
102723716,LOC102723716,chr8,R,38400415,38403940,68443968,3525,852213912,35337,2
102723729,LOC102723729,chr8,R,41534304,41578368,68488032,44064,852257976,35338,2
102724241,LOC102724241,chr8,R,46829504,46833878,68492406,4374,852262350,35339,2
102724330,LOC102724330,chr8,F,51899281,52022948,68616073,123667,852386017,35340,3
102724359,LOC102724359,chr8,R,53393830,53487960,68710203,94130,852480147,35341,9
102724612,LOC102724612,chr8,F,63465848,63475482,68719837,9634,852489781,35342,3
102724623,LOC102724623,chr8,R,63856942,64368558,69231453,511616,853001397,35343,4
102724670,LOC102724670,chr8,F,90647714,90687843,69271582,40129,853041526,35344,4
102724687,LOC102724687,chr8,R,66203724,66432418,69500276,228694,853270220,35345,6
102724708,LOC102724708,chr8,F,67343646,67375213,69531843,31567,853301787,35346,2
102724710,LOC102724710,chr8,R,92565442,92655494,69621895,90052,853391839,35347,4
102724772,LOC102724772,chr8,F,71547631,71553798,69628062,6167,853398006,35348,5
102724804,LOC102724804,chr8,R,96371925,96387438,69643575,15513,853413519,35349,3
102724838,LOC102724838,chr8,F,17345013,17382440,69681002,37427,853450946,35350,3
102724858,LOC102724858,chr8,R,76140902,76308493,69848593,167591,853618537,35351,7
102724874,LOC102724874,chr8,F,77450696,77476331,69874228,25635,853644172,35352,2
102724880,LOC102724880,chr8,F,9151731,9169478,69891975,17747,853661919,35353,7
102724881,LOC102724881,chr8,R,19344396,19403517,69951096,59121,853721040,35354,4
102725080,LOC102725080,chr8,F,13629634,13631936,69953398,2302,853723342,35355,2
103021164,CASC21,chr8,F,127244636,127392631,70101393,147995,853871337,35356,3
103021165,CASC19,chr8,R,127187784,127197627,70111236,9843,853881180,35357,2
103164619,PCAT2,chr8,R,127072693,127082221,70120764,9528,853890708,35358,3
103352670,LINC01419,chr8,F,83403757,83408900,70125907,5143,853895851,35359,1
103689844,LINC01288,chr8,F,34783920,34864798,70206785,80878,853976729,35360,3
104054148,LOC104054148,chr8,F,101984431,101994850,70217204,10419,853987148,35361,4
104266957,KBTBD11-OT1,chr8,F,1971396,1976444,70222252,5048,853992196,35362,2
104266958,LINC01151,chr8,R,122670384,122694106,70245974,23722,854015918,35363,3
104326051,MAFA-AS1,chr8,F,143417678,143419150,70247446,1472,854017390,35364,1
105369147,LOC105369147,chr8,R,103224445,103298433,70321434,73988,854091378,35365,9
105369148,LOC105369148,chr8,F,145000544,145035864,70356754,35320,854126698,35366,1
105369180,LOC105369180,chr8,R,22656180,22664431,70365005,8251,854134949,35367,1
105369207,LOC105369207,chr8,F,57193536,57201049,70372518,7513,854142462,35368,2
105369288,LOC105369288,chr8,F,7092219,7114659,70394958,22440,854164902,35369,2
105375622,LOC105375622,chr8,R,85851629,85861603,70404932,9974,854174876,35370,3
105375623,LOC105375623,chr8,F,86180419,86212477,70436990,32058,854206934,35371,4
105375624,LOC105375624,chr8,R,86333273,86345460,70449177,12187,854219121,35372,5
105375625,LOC105375625,chr8,F,86616774,86627996,70460399,11222,854230343,35373,3
105375626,LOC105375626,chr8,F,87609833,87668439,70519005,58606,854288949,35374,2
105375627,LOC105375627,chr8,R,87925731,87926224,70519498,493,854289442,35375,2
105375628,LOC105375628,chr8,R,87960980,87971037,70529555,10057,854299499,35376,3
105375629,LOC105375629,chr8,R,88552697,88598872,70575730,46175,854345674,35377,3
105375630,LOC105375630,chr8,F,88825671,88886096,70636155,60425,854406099,35378,4
105375631,LOC105375631,chr8,R,88807903,88894051,70722303,86148,854492247,35379,7
105375632,LOC105375632,chr8,F,88910804,88952076,70763575,41272,854533519,35380,3
105375633,LOC105375633,chr8,R,90690440,90791632,70864767,101192,854634711,35381,3
105375634,LOC105375634,chr8,R,90845953,90953980,70972794,108027,854742738,35382,8
105375635,LOC105375635,chr8,R,90806474,90812939,70979259,6465,854749203,35383,2
105375636,LOC105375636,chr8,F,91015620,91018383,70982022,2763,854751966,35384,3
105375637,LOC105375637,chr8,F,91261443,91263949,70984528,2506,854754472,35385,1
105375638,LOC105375638,chr8,R,92407963,92413639,70990204,5676,854760148,35386,3
105375639,LOC105375639,chr8,R,92444500,92509815,71055519,65315,854825463,35387,11
105375640,LOC105375640,chr8,R,92984565,93017710,71088664,33145,854858608,35388,1
105375641,LOC105375641,chr8,F,93495347,93506835,71100152,11488,854870096,35389,3
105375642,LOC105375642,chr8,F,93327720,93342882,71115314,15162,854885258,35390,5
105375643,LOC105375643,chr8,F,93226138,93230444,71119620,4306,854889564,35391,1
105375644,LOC105375644,chr8,F,93156980,93174333,71136973,17353,854906917,35392,5
105375645,LOC105375645,chr8,F,93741418,93744614,71140169,3196,854910113,35393,2
105375646,LOC105375646,chr8,R,93899861,93904743,71145051,4882,854914995,35394,2
105375647,LOC105375647,chr8,F,94144154,94168090,71168987,23936,854938931,35395,2
105375648,LOC105375648,chr8,R,94225565,94228074,71171496,2509,854941440,35396,2
105375649,LOC105375649,chr8,R,94253661,94260061,71177896,6400,854947840,35397,1
105375650,LOC105375650,chr8,F,95064173,95116455,71230178,52282,855000122,35398,5
105375651,LOC105375651,chr8,R,95729378,95733947,71234747,4569,855004691,35399,1
105375652,LOC105375652,chr8,R,96264672,96284001,71254076,19329,855024020,35400,2
105375653,LOC105375653,chr8,F,96419769,96459472,71293779,39703,855063723,35401,4
105375654,LOC105375654,chr8,R,96774986,96793342,71312135,18356,855082079,35402,2
105375655,LOC105375655,chr8,F,97148038,97171806,71335903,23768,855105847,35403,2
105375656,LOC105375656,chr8,F,97188223,97193986,71341666,5763,855111610,35404,1
105375657,LOC105375657,chr8,F,97512978,97519147,71347835,6169,855117779,35405,2
105375658,LOC105375658,chr8,R,97865360,97869408,71351883,4048,855121827,35406,3
105375659,LOC105375659,chr8,F,98254307,98305689,71403265,51382,855173209,35407,5
105375660,LOC105375660,chr8,F,98176485,98249528,71476308,73043,855246252,35408,3
105375661,LOC105375661,chr8,R,98923916,98942358,71494750,18442,855264694,35409,1
105375662,LOC105375662,chr8,F,98373036,98397739,71519453,24703,855289397,35410,3
105375663,LOC105375663,chr8,R,99718972,99784307,71584788,65335,855354732,35411,2
105375664,LOC105375664,chr8,R,99655361,99689589,71619016,34228,855388960,35412,2
105375666,LOC105375666,chr8,R,98996759,99013022,71635279,16263,855405223,35413,1
105375667,LOC105375667,chr8,F,100106004,100107768,71637043,1764,855406987,35414,0
105375668,LOC105375668,chr8,R,100234181,100241939,71644801,7758,855414745,35415,2
105375669,LOC105375669,chr8,R,100217171,100230686,71658316,13515,855428260,35416,4
105375670,LOC105375670,chr8,F,100431066,100500705,71727955,69639,855497899,35417,4
105375671,LOC105375671,chr8,F,100618527,100620020,71729448,1493,855499392,35418,2
105375672,LOC105375672,chr8,F,100663611,100669096,71734933,5485,855504877,35419,3
105375673,LOC105375673,chr8,F,100723079,100745851,71757705,22772,855527649,35420,3
105375674,LOC105375674,chr8,R,101121817,101126631,71762519,4814,855532463,35421,2
105375675,LOC105375675,chr8,F,101128995,101139903,71773427,10908,855543371,35422,6
105375676,LOC105375676,chr8,R,101144091,101148321,71777657,4230,855547601,35423,2
105375677,LOC105375677,chr8,R,101175165,101183996,71786488,8831,855556432,35424,1
105375678,LOC105375678,chr8,F,101214030,101321227,71893685,107197,855663629,35425,13
105375679,LOC105375679,chr8,R,101261549,101262978,71895114,1429,855665058,35426,1
105375680,LOC105375680,chr8,R,101387318,101393173,71900969,5855,855670913,35427,2
105375681,LOC105375681,chr8,F,102062647,102077466,71915788,14819,855685732,35428,4
105375682,LOC105375682,chr8,F,101856684,101861166,71920270,4482,855690214,35429,2
105375683,LOC105375683,chr8,F,102412941,102468670,71975999,55729,855745943,35430,3
105375684,LOC105375684,chr8,R,102541066,102551575,71986508,10509,855756452,35431,2
105375685,LOC105375685,chr8,R,102680343,102685814,71991979,5471,855761923,35432,2
105375686,LOC105375686,chr8,R,102669610,102680094,72002463,10484,855772407,35433,2
105375687,LOC105375687,chr8,R,103444697,103445577,72003343,880,855773287,35434,1
105375688,LOC105375688,chr8,R,104074665,104111648,72040326,36983,855810270,35435,6
105375689,LOC105375689,chr8,R,103958756,104005876,72087446,47120,855857390,35436,5
105375690,LOC105375690,chr8,R,103487643,103499488,72099291,11845,855869235,35437,3
105375691,LOC105375691,chr8,F,104465875,104484896,72118312,19021,855888256,35438,3
105375692,LOC105375692,chr8,F,104428128,104431295,72121479,3167,855891423,35439,2
105375693,LOC105375693,chr8,R,104880925,104886052,72126606,5127,855896550,35440,2
105375694,LOC105375694,chr8,F,104827382,104895717,72194941,68335,855964885,35441,2
105375695,LOC105375695,chr8,R,105117395,105140172,72217718,22777,855987662,35442,2
105375696,LOC105375696,chr8,R,105543279,105557528,72231967,14249,856001911,35443,4
105375697,LOC105375697,chr8,R,105534461,105543267,72240773,8806,856010717,35444,3
105375698,LOC105375698,chr8,R,105530431,105534428,72244770,3997,856014714,35445,2
105375699,LOC105375699,chr8,F,105823177,105834043,72255636,10866,856025580,35446,1
105375700,LOC105375700,chr8,R,106646436,106657734,72266934,11298,856036878,35447,2
105375701,LOC105375701,chr8,R,107165864,107166757,72267827,893,856037771,35448,1
105375702,LOC105375702,chr8,F,107252025,107256843,72272645,4818,856042589,35449,2
105375703,LOC105375703,chr8,R,107776391,107778747,72275001,2356,856044945,35450,2
105375704,LOC105375704,chr8,R,108267858,108443467,72450610,175609,856220554,35451,3
105375705,LOC105375705,chr8,R,111178853,111179736,72451493,883,856221437,35452,1
105375706,LOC105375706,chr8,F,111376627,111617595,72692461,240968,856462405,35453,5
105375707,LOC105375707,chr8,F,111741953,111758305,72708813,16352,856478757,35454,4
105375708,LOC105375708,chr8,F,112188841,112194453,72714425,5612,856484369,35455,2
105375709,LOC105375709,chr8,F,113432177,113433272,72715520,1095,856485464,35456,1
105375710,LOC105375710,chr8,R,114294501,114311356,72732375,16855,856502319,35457,5
105375711,LOC105375711,chr8,F,116454152,116474403,72752626,20251,856522570,35458,3
105375712,LOC105375712,chr8,F,116604518,116615299,72763407,10781,856533351,35459,3
105375713,LOC105375713,chr8,F,116648932,116654642,72769117,5710,856539061,35460,1
105375714,LOC105375714,chr8,R,116755898,116766531,72779750,10633,856549694,35461,3
105375715,LOC105375715,chr8,R,116944394,116948719,72784075,4325,856554019,35462,2
105375716,LOC105375716,chr8,R,117084524,117520695,73220246,436171,856990190,35463,14
105375717,LOC105375717,chr8,F,117273753,117311087,73257580,37334,857027524,35464,5
105375718,LOC105375718,chr8,R,117108455,117114078,73263203,5623,857033147,35465,2
105375719,LOC105375719,chr8,R,117096229,117107679,73274653,11450,857044597,35466,3
105375720,LOC105375720,chr8,R,117613499,117632750,73293904,19251,857063848,35467,2
105375721,LOC105375721,chr8,R,117679812,117713902,73327994,34090,857097938,35468,6
105375722,LOC105375722,chr8,F,117890463,117894233,73331764,3770,857101708,35469,2
105375723,LOC105375723,chr8,R,118833337,118861895,73360322,28558,857130266,35470,3
105375724,LOC105375724,chr8,F,118281185,118424994,73504131,143809,857274075,35471,10
105375725,LOC105375725,chr8,F,119152051,119203654,73555734,51603,857325678,35472,2
105375726,LOC105375726,chr8,R,119214622,119247004,73588116,32382,857358060,35473,3
105375727,LOC105375727,chr8,F,119671949,119675343,73591510,3394,857361454,35474,2
105375728,LOC105375728,chr8,F,119832950,119855597,73614157,22647,857384101,35475,2
105375729,LOC105375729,chr8,R,120072404,120080747,73622500,8343,857392444,35476,2
105375730,LOC105375730,chr8,F,120058881,120107546,73671165,48665,857441109,35477,3
105375731,LOC105375731,chr8,R,121158672,121162325,73674818,3653,857444762,35478,2
105375732,LOC105375732,chr8,R,121668950,121684593,73690461,15643,857460405,35479,3
105375733,LOC105375733,chr8,R,122338735,122402417,73754143,63682,857524087,35480,3
105375734,LOC105375734,chr8,R,122413689,122568733,73909187,155044,857679131,35481,3
105375735,LOC105375735,chr8,R,122977029,123000154,73932312,23125,857702256,35482,2
105375736,LOC105375736,chr8,R,123215266,123217228,73934274,1962,857704218,35483,2
105375737,LOC105375737,chr8,R,123403575,123416423,73947122,12848,857717066,35484,3
105375738,LOC105375738,chr8,F,123657957,123667312,73956477,9355,857726421,35485,3
105375739,LOC105375739,chr8,F,123719809,123766246,74002914,46437,857772858,35486,2
105375740,LOC105375740,chr8,F,124568826,124583975,74018063,15149,857788007,35487,1
105375741,LOC105375741,chr8,F,124728617,124757131,74046577,28514,857816521,35488,3
105375742,LOC105375742,chr8,R,124935129,124941930,74053378,6801,857823322,35489,1
105375743,LOC105375743,chr8,R,124830159,124857485,74080704,27326,857850648,35490,7
105375744,LOC105375744,chr8,R,124996987,124998198,74081915,1211,857851859,35491,1
105375745,LOC105375745,chr8,F,125466956,125624733,74239692,157777,858009636,35492,2
105375746,LOC105375746,chr8,F,125648154,125680038,74271576,31884,858041520,35493,2
105375747,LOC105375747,chr8,R,125749054,125749943,74272465,889,858042409,35494,1
105375748,LOC105375748,chr8,R,125859824,125873101,74285742,13277,858055686,35495,2
105375749,LOC105375749,chr8,F,126497157,126501053,74289638,3896,858059582,35496,1
105375750,LOC105375750,chr8,F,126506358,126522310,74305590,15952,858075534,35497,2
105375751,LOC105375751,chr8,F,126557484,126634564,74382670,77080,858152614,35498,3
105375752,LOC105375752,chr8,R,127140083,127144150,74386737,4067,858156681,35499,2
105375753,LOC105375753,chr8,R,126750467,126846987,74483257,96520,858253201,35500,6
105375754,LOC105375754,chr8,R,127664551,127669024,74487730,4473,858257674,35501,3
105375755,LOC105375755,chr8,F,128150985,128186746,74523491,35761,858293435,35502,4
105375756,LOC105375756,chr8,R,128799955,128816667,74540203,16712,858310147,35503,2
105375757,LOC105375757,chr8,F,130300387,130333346,74573162,32959,858343106,35504,4
105375758,LOC105375758,chr8,R,130526943,130549775,74595994,22832,858365938,35505,5
105375759,LOC105375759,chr8,R,131096377,131144908,74644525,48531,858414469,35506,3
105375760,LOC105375760,chr8,F,131039521,131129953,74734957,90432,858504901,35507,4
105375761,LOC105375761,chr8,F,130884566,130907176,74757567,22610,858527511,35508,4
105375762,LOC105375762,chr8,F,130850136,130884544,74791975,34408,858561919,35509,3
105375763,LOC105375763,chr8,R,131463040,131470316,74799251,7276,858569195,35510,2
105375764,LOC105375764,chr8,F,132381540,132384431,74802142,2891,858572086,35511,2
105375765,LOC105375765,chr8,F,132487344,132503418,74818216,16074,858588160,35512,4
105375766,LOC105375766,chr8,R,132687461,132707668,74838423,20207,858608367,35513,3
105375767,LOC105375767,chr8,F,132675638,132676075,74838860,437,858608804,35514,1
105375768,LOC105375768,chr8,F,133013770,133017586,74842676,3816,858612620,35515,1
105375769,LOC105375769,chr8,F,133143698,133166333,74865311,22635,858635255,35516,2
105375770,LOC105375770,chr8,R,133326550,133354334,74893095,27784,858663039,35517,2
105375771,LOC105375771,chr8,R,133361734,133377649,74909010,15915,858678954,35518,2
105375772,LOC105375772,chr8,F,133359188,133361524,74911346,2336,858681290,35519,2
105375773,LOC105375773,chr8,R,133663760,133684096,74931682,20336,858701626,35520,3
105375774,LOC105375774,chr8,F,134719007,134723907,74936582,4900,858706526,35521,2
105375775,LOC105375775,chr8,R,136237260,136238931,74938253,1671,858708197,35522,2
105375776,LOC105375776,chr8,F,137763879,137782112,74956486,18233,858726430,35523,2
105375777,LOC105375777,chr8,F,139702852,139707127,74960761,4275,858730705,35524,1
105375778,LOC105375778,chr8,F,140349811,140353348,74964298,3537,858734242,35525,2
105375779,LOC105375779,chr8,F,140262852,140282281,74983727,19429,858753671,35526,3
105375780,LOC105375780,chr8,F,140007461,140009425,74985691,1964,858755635,35527,1
105375781,LOC105375781,chr8,F,139911237,139917182,74991636,5945,858761580,35528,3
105375782,LOC105375782,chr8,F,140464873,140468915,74995678,4042,858765622,35529,2
105375783,LOC105375783,chr8,F,141023546,141033014,75005146,9468,858775090,35530,2
105375784,LOC105375784,chr8,F,141058452,141062493,75009187,4041,858779131,35531,2
105375785,LOC105375785,chr8,R,141194867,141202539,75016859,7672,858786803,35532,3
105375786,LOC105375786,chr8,R,141288851,141290819,75018827,1968,858788771,35533,2
105375787,LOC105375787,chr8,F,141254648,141256817,75020996,2169,858790940,35534,1
105375788,LOC105375788,chr8,F,141507301,141509650,75023345,2349,858793289,35535,1
105375789,LOC105375789,chr8,F,141446706,141464934,75041573,18228,858811517,35536,2
105375790,LOC105375790,chr8,R,141388117,141391805,75045261,3688,858815205,35537,2
105375791,LOC105375791,chr8,R,141512608,141514215,75046868,1607,858816812,35538,2
105375792,LOC105375792,chr8,R,142185144,142189736,75051460,4592,858821404,35539,1
105375793,LOC105375793,chr8,F,142920129,142925092,75056423,4963,858826367,35540,2
105375794,LOC105375794,chr8,F,142925292,142927173,75058304,1881,858828248,35541,1
105375795,LOC105375795,chr8,R,143043081,143073956,75089179,30875,858859123,35542,3
105375796,LOC105375796,chr8,R,143551962,143553407,75090624,1445,858860568,35543,2
105375797,LOC105375797,chr8,F,143592465,143594965,75093124,2500,858863068,35544,1
105375798,LOC105375798,chr8,R,143620438,143635068,75107754,14630,858877698,35545,3
105375799,LOC105375799,chr8,F,143663117,143668478,75113115,5361,858883059,35546,3
105375801,LOC105375801,chr8,F,143986054,143989509,75116570,3455,858886514,35547,2
105375802,LOC105375802,chr8,R,144497356,144505078,75124292,7722,858894236,35548,4
105375803,LOC105375803,chr8,R,144494203,144496461,75126550,2258,858896494,35549,2
105375804,LOC105375804,chr8,F,144711849,144714845,75129546,2996,858899490,35550,1
105375805,LOC105375805,chr8,R,144765392,144770252,75134406,4860,858904350,35551,2
105375806,LOC105375806,chr8,R,144854870,144857698,75137234,2828,858907178,35552,1
105375811,LOC105375811,chr8,F,46641339,46656765,75152660,15426,858922604,35553,6
105375812,LOC105375812,chr8,F,46816162,46818525,75155023,2363,858924967,35554,2
105375813,LOC105375813,chr8,F,46876956,46880014,75158081,3058,858928025,35555,2
105375814,LOC105375814,chr8,R,46928859,46951840,75181062,22981,858951006,35556,3
105375815,LOC105375815,chr8,F,47003711,47084213,75261564,80502,859031508,35557,8
105375816,LOC105375816,chr8,R,47088583,47092604,75265585,4021,859035529,35558,2
105375817,LOC105375817,chr8,R,47100919,47168769,75333435,67850,859103379,35559,11
105375818,LOC105375818,chr8,F,47941434,47945779,75337780,4345,859107724,35560,2
105375819,LOC105375819,chr8,R,47989027,47999102,75347855,10075,859117799,35561,3
105375820,LOC105375820,chr8,R,48309220,48313182,75351817,3962,859121761,35562,2
105375821,LOC105375821,chr8,F,48422997,48474576,75403396,51579,859173340,35563,3
105375822,LOC105375822,chr8,R,48515851,48518036,75405581,2185,859175525,35564,2
105375823,LOC105375823,chr8,R,48597086,48621018,75429513,23932,859199457,35565,3
105375824,LOC105375824,chr8,R,48627870,48635955,75437598,8085,859207542,35566,1
105375825,LOC105375825,chr8,F,48780611,48828608,75485595,47997,859255539,35567,4
105375826,LOC105375826,chr8,F,49168088,49193297,75510804,25209,859280748,35568,2
105375827,LOC105375827,chr8,F,49224971,49229278,75515111,4307,859285055,35569,2
105375828,LOC105375828,chr8,R,50364445,50377000,75527666,12555,859297610,35570,2
105375829,LOC105375829,chr8,R,50214983,50237236,75549919,22253,859319863,35571,5
105375830,LOC105375830,chr8,R,50926491,50934774,75558202,8283,859328146,35572,3
105375831,LOC105375831,chr8,F,51107068,51113064,75564198,5996,859334142,35573,2
105375832,LOC105375832,chr8,F,51209593,51251028,75605633,41435,859375577,35574,2
105375833,LOC105375833,chr8,R,51756744,51779953,75628842,23209,859398786,35575,3
105375834,LOC105375834,chr8,F,51647313,51649283,75630812,1970,859400756,35576,2
105375835,LOC105375835,chr8,F,52714342,52778045,75694515,63703,859464459,35577,7
105375836,LOC105375836,chr8,F,53177570,53228012,75744957,50442,859514901,35578,2
105375837,LOC105375837,chr8,R,53276675,53303362,75771644,26687,859541588,35579,2
105375838,LOC105375838,chr8,F,53397359,53399838,75774123,2479,859544067,35580,1
105375839,LOC105375839,chr8,R,54042986,54045833,75776970,2847,859546914,35581,3
105375840,LOC105375840,chr8,F,54373206,54395505,75799269,22299,859569213,35582,4
105375841,LOC105375841,chr8,R,54426895,54454838,75827212,27943,859597156,35583,3
105375842,LOC105375842,chr8,R,54769809,54775298,75832701,5489,859602645,35584,2
105375843,LOC105375843,chr8,R,55514454,55521012,75839259,6558,859609203,35585,3
105375844,LOC105375844,chr8,F,55161475,55164451,75842235,2976,859612179,35586,1
105375845,LOC105375845,chr8,F,55682470,55683021,75842786,551,859612730,35587,1
105375846,LOC105375846,chr8,R,55695368,55729495,75876913,34127,859646857,35588,3
105375847,LOC105375847,chr8,F,56074591,56081915,75884237,7324,859654181,35589,4
105375848,LOC105375848,chr8,R,56436675,56438667,75886229,1992,859656173,35590,1
105375849,LOC105375849,chr8,R,56394927,56434882,75926184,39955,859696128,35591,6
105375850,LOC105375850,chr8,F,56565249,56566703,75927638,1454,859697582,35592,2
105375851,LOC105375851,chr8,R,56638921,56656474,75945191,17553,859715135,35593,3
105375852,LOC105375852,chr8,F,56683231,56715513,75977473,32282,859747417,35594,3
105375853,LOC105375853,chr8,F,56998036,57007957,75987394,9921,859757338,35595,2
105375854,LOC105375854,chr8,F,57142675,57154821,75999540,12146,859769484,35596,2
105375855,LOC105375855,chr8,F,57462713,57552718,76089545,90005,859859489,35597,2
105375856,LOC105375856,chr8,F,57855479,57958510,76192576,103031,859962520,35598,2
105375857,LOC105375857,chr8,F,58519022,58527370,76200924,8348,859970868,35599,2
105375858,LOC105375858,chr8,R,58739525,58750170,76211569,10645,859981513,35600,2
105375859,LOC105375859,chr8,F,59601008,59620198,76230759,19190,860000703,35601,4
105375860,LOC105375860,chr8,R,59593360,59603073,76240472,9713,860010416,35602,2
105375861,LOC105375861,chr8,F,60058459,60116407,76298420,57948,860068364,35603,4
105375862,LOC105375862,chr8,F,60046782,60050059,76301697,3277,860071641,35604,2
105375863,LOC105375863,chr8,R,60135863,60138043,76303877,2180,860073821,35605,1
105375864,LOC105375864,chr8,R,60284981,60385396,76404292,100415,860174236,35606,10
105375865,LOC105375865,chr8,F,60493756,60514501,76425037,20745,860194981,35607,2
105375866,LOC105375866,chr8,R,60468224,60516851,76473664,48627,860243608,35608,7
105375867,LOC105375867,chr8,R,60464576,60465928,76475016,1352,860244960,35609,1
105375868,LOC105375868,chr8,R,60799243,60808632,76484405,9389,860254349,35610,2
105375869,LOC105375869,chr8,R,60676847,60679027,76486585,2180,860256529,35611,2
105375870,LOC105375870,chr8,R,61350175,61379509,76515919,29334,860285863,35612,2
105375871,LOC105375871,chr8,R,61810479,61825224,76530664,14745,860300608,35613,3
105375872,LOC105375872,chr8,R,62990977,62993185,76532872,2208,860302816,35614,2
105375873,LOC105375873,chr8,F,63243402,63308374,76597844,64972,860367788,35615,3
105375874,LOC105375874,chr8,F,63435760,63457186,76619270,21426,860389214,35616,5
105375875,LOC105375875,chr8,R,63384838,63470197,76704629,85359,860474573,35617,7
105375876,LOC105375876,chr8,R,63687056,63691935,76709508,4879,860479452,35618,2
105375877,LOC105375877,chr8,F,64354505,64356300,76711303,1795,860481247,35619,2
105375878,LOC105375878,chr8,R,64803889,64817542,76724956,13653,860494900,35620,2
105375879,LOC105375879,chr8,F,64798937,64817458,76743477,18521,860513421,35621,2
105375880,LOC105375880,chr8,F,65006899,65017822,76754400,10923,860524344,35622,3
105375881,LOC105375881,chr8,F,65215977,65220407,76758830,4430,860528774,35623,2
105375882,LOC105375882,chr8,F,65721989,65729414,76766255,7425,860536199,35624,2
105375883,LOC105375883,chr8,R,65979830,66023482,76809907,43652,860579851,35625,10
105375884,LOC105375884,chr8,F,66613541,66614828,76811194,1287,860581138,35626,1
105375885,LOC105375885,chr8,F,67028577,67037616,76820233,9039,860590177,35627,4
105375886,LOC105375886,chr8,F,67556042,67614760,76878951,58718,860648895,35628,2
105375887,LOC105375887,chr8,R,68202200,68220914,76897665,18714,860667609,35629,2
105375888,LOC105375888,chr8,R,68082050,68095113,76910728,13063,860680672,35630,1
105375889,LOC105375889,chr8,F,69711543,69719959,76919144,8416,860689088,35631,2
105375890,LOC105375890,chr8,R,70525103,70535939,76929980,10836,860699924,35632,2
105375891,LOC105375891,chr8,F,70789355,70796948,76937573,7593,860707517,35633,2
105375892,LOC105375892,chr8,R,71549719,71554714,76942568,4995,860712512,35634,2
105375893,LOC105375893,chr8,F,71510263,71531863,76964168,21600,860734112,35635,2
105375894,LOC105375894,chr8,F,71155443,71199220,77007945,43777,860777889,35636,3
105375895,LOC105375895,chr8,F,72117741,72121729,77011933,3988,860781877,35637,2
105375896,LOC105375896,chr8,F,72194209,72227255,77044979,33046,860814923,35638,1
105375897,LOC105375897,chr8,R,72516232,72533346,77062093,17114,860832037,35639,2
105375898,LOC105375898,chr8,R,72749370,72753570,77066293,4200,860836237,35640,2
105375899,LOC105375899,chr8,R,73367892,73370588,77068989,2696,860838933,35641,3
105375900,LOC105375900,chr8,F,73285829,73290671,77073831,4842,860843775,35642,1
105375901,LOC105375901,chr8,F,73224410,73232366,77081787,7956,860851731,35643,2
105375902,LOC105375902,chr8,R,73653659,73664104,77092232,10445,860862176,35644,2
105375903,LOC105375903,chr8,F,74199393,74208281,77101120,8888,860871064,35645,1
105375904,LOC105375904,chr8,R,74589625,74633263,77144758,43638,860914702,35646,8
105375905,LOC105375905,chr8,F,75122359,75136864,77159263,14505,860929207,35647,1
105375906,LOC105375906,chr8,R,76044504,76071389,77186148,26885,860956092,35648,3
105375907,LOC105375907,chr8,F,77000324,77007572,77193396,7248,860963340,35649,2
105375908,LOC105375908,chr8,F,77033425,77052999,77212970,19574,860982914,35650,2
105375909,LOC105375909,chr8,F,77378701,77418744,77253013,40043,861022957,35651,2
105375910,LOC105375910,chr8,F,77505800,77515343,77262556,9543,861032500,35652,2
105375911,LOC105375911,chr8,R,78406792,78665979,77521743,259187,861291687,35653,3
105375912,LOC105375912,chr8,R,78903195,78948907,77567455,45712,861337399,35654,3
105375913,LOC105375913,chr8,F,78938582,78947675,77576548,9093,861346492,35655,1
105375914,LOC105375914,chr8,F,78805215,78937680,77709013,132465,861478957,35656,3
105375915,LOC105375915,chr8,R,79282078,79288805,77715740,6727,861485684,35657,2
105375916,LOC105375916,chr8,R,79584169,79638166,77769737,53997,861539681,35658,5
105375917,LOC105375917,chr8,F,79892069,79931062,77808730,38993,861578674,35659,2
105375918,LOC105375918,chr8,F,80082072,80103863,77830521,21791,861600465,35660,4
105375919,LOC105375919,chr8,F,80079665,80081867,77832723,2202,861602667,35661,2
105375920,LOC105375920,chr8,R,80177710,80231553,77886566,53843,861656510,35662,6
105375921,LOC105375921,chr8,R,80483810,80485545,77888301,1735,861658245,35663,2
105375922,LOC105375922,chr8,R,80440093,80451051,77899259,10958,861669203,35664,3
105375923,LOC105375923,chr8,F,80558181,80580165,77921243,21984,861691187,35665,2
105375924,LOC105375924,chr8,F,81153967,81226927,77994203,72960,861764147,35666,5
105375925,LOC105375925,chr8,F,81333529,81347136,78007810,13607,861777754,35667,4
105375926,LOC105375926,chr8,F,81357096,81360953,78011667,3857,861781611,35668,2
105375927,LOC105375927,chr8,F,81399719,81406241,78018189,6522,861788133,35669,2
105375928,LOC105375928,chr8,F,81842030,81849812,78025971,7782,861795915,35670,4
105375929,LOC105375929,chr8,R,82108566,82160534,78077939,51968,861847883,35671,2
105375930,LOC105375930,chr8,F,82160783,82179726,78096882,18943,861866826,35672,3
105375931,LOC105375931,chr8,F,82442831,82632962,78287013,190131,862056957,35673,3
105375932,LOC105375932,chr8,R,83674852,83693285,78305446,18433,862075390,35674,3
105375933,LOC105375933,chr8,R,85086560,85109574,78328460,23014,862098404,35675,4
105375934,LOC105375934,chr8,R,84701238,84742581,78369803,41343,862139747,35676,2
105375935,LOC105375935,chr8,R,85243665,85255919,78382057,12254,862152001,35677,3
105375936,LOC105375936,chr8,R,85221679,85243485,78403863,21806,862173807,35678,3
105375937,LOC105375937,chr8,F,85495698,85534714,78442879,39016,862212823,35679,7
105375938,LOC105375938,chr8,R,60909751,60910855,78443983,1104,862213927,35680,1
105377773,LOC105377773,chr8,R,308406,311282,78446859,2876,862216803,35681,2
105377774,LOC105377774,chr8,R,651298,662434,78457995,11136,862227939,35682,1
105377775,LOC105377775,chr8,R,1428296,1437302,78467001,9006,862236945,35683,3
105377776,LOC105377776,chr8,R,1368647,1373228,78471582,4581,862241526,35684,1
105377777,LOC105377777,chr8,R,862573,882930,78491939,20357,862261883,35685,2
105377778,LOC105377778,chr8,R,1748301,1755682,78499320,7381,862269264,35686,2
105377779,LOC105377779,chr8,R,1810337,1814148,78503131,3811,862273075,35687,2
105377780,LOC105377780,chr8,F,2034490,2039974,78508615,5484,862278559,35688,2
105377781,LOC105377781,chr8,F,2156672,2196528,78548471,39856,862318415,35689,5
105377782,LOC105377782,chr8,F,2199669,2206182,78554984,6513,862324928,35690,2
105377783,LOC105377783,chr8,F,2251352,2254139,78557771,2787,862327715,35691,2
105377784,LOC105377784,chr8,R,2467498,2478505,78568778,11007,862338722,35692,3
105377785,LOC105377785,chr8,F,2727411,2834810,78676177,107399,862446121,35693,6
105377786,LOC105377786,chr8,F,2914185,2919605,78681597,5420,862451541,35694,2
105377787,LOC105377787,chr8,R,2900318,2923688,78704967,23370,862474911,35695,2
105377788,LOC105377788,chr8,F,2834835,2926781,78796913,91946,862566857,35696,4
105377789,LOC105377789,chr8,F,4528042,4537829,78806700,9787,862576644,35697,3
105377790,LOC105377790,chr8,F,3861262,3869294,78814732,8032,862584676,35698,2
105377791,LOC105377791,chr8,F,3409127,3426587,78832192,17460,862602136,35699,4
105377792,LOC105377792,chr8,F,3001060,3024227,78855359,23167,862625303,35700,4
105377793,LOC105377793,chr8,F,5534065,5545612,78866906,11547,862636850,35701,2
105377794,LOC105377794,chr8,R,5595230,5596726,78868402,1496,862638346,35702,2
105377795,LOC105377795,chr8,R,5858273,6004226,79014355,145953,862784299,35703,8
105377796,LOC105377796,chr8,R,6033654,6036938,79017639,3284,862787583,35704,2
105377797,LOC105377797,chr8,R,6058165,6066137,79025611,7972,862795555,35705,5
105377798,LOC105377798,chr8,R,6859026,6865673,79032258,6647,862802202,35706,1
105377799,LOC105377799,chr8,F,7072863,7073294,79032689,431,862802633,35707,1
105377800,LOC105377800,chr8,F,7575170,7584130,79041649,8960,862811593,35708,2
105377801,LOC105377801,chr8,F,7520339,7520815,79042125,476,862812069,35709,1
105377802,LOC105377802,chr8,R,7252290,7256411,79046246,4121,862816190,35710,1
105377803,LOC105377803,chr8,F,7138530,7186452,79094168,47922,862864112,35711,4
105379215,LOC105379215,chr8,R,7713186,7721556,79102538,8370,862872482,35712,2
105379216,LOC105379216,chr8,R,7800197,7800673,79103014,476,862872958,35713,1
105379217,LOC105379217,chr8,F,7830345,7834991,79107660,4646,862877604,35714,4
105379218,LOC105379218,chr8,F,8137923,8153282,79123019,15359,862892963,35715,4
105379219,LOC105379219,chr8,R,8101124,8143741,79165636,42617,862935580,35716,5
105379220,LOC105379220,chr8,F,8070370,8071735,79167001,1365,862936945,35717,2
105379221,LOC105379221,chr8,R,8220049,8227930,79174882,7881,862944826,35718,3
105379222,LOC105379222,chr8,F,8389264,8399297,79184915,10033,862954859,35719,2
105379223,LOC105379223,chr8,R,8414204,8424623,79195334,10419,862965278,35720,1
105379224,LOC105379224,chr8,F,8560947,8574010,79208397,13063,862978341,35721,4
105379225,LOC105379225,chr8,R,8686064,8686979,79209312,915,862979256,35722,2
105379226,LOC105379226,chr8,F,8991621,8995522,79213213,3901,862983157,35723,2
105379227,LOC105379227,chr8,R,8988276,9002790,79227727,14514,862997671,35724,2
105379228,LOC105379228,chr8,R,9351265,9359681,79236143,8416,863006087,35725,2
105379229,LOC105379229,chr8,R,9383970,9415960,79268133,31990,863038077,35726,2
105379230,LOC105379230,chr8,R,9365345,9375166,79277954,9821,863047898,35727,5
105379231,LOC105379231,chr8,F,9363287,9413878,79328545,50591,863098489,35728,2
105379232,LOC105379232,chr8,F,9669448,9672654,79331751,3206,863101695,35729,1
105379233,LOC105379233,chr8,F,10055543,10056299,79332507,756,863102451,35730,1
105379234,LOC105379234,chr8,R,10049129,10053053,79336431,3924,863106375,35731,1
105379235,LOC105379235,chr8,R,9985985,10054993,79405439,69008,863175383,35732,2
105379236,LOC105379236,chr8,F,10483206,10487478,79409711,4272,863179655,35733,1
105379237,LOC105379237,chr8,R,10578723,10580693,79411681,1970,863181625,35734,1
105379238,LOC105379238,chr8,R,10667198,10672600,79417083,5402,863187027,35735,3
105379239,LOC105379239,chr8,R,10856082,10860279,79421280,4197,863191224,35736,1
105379240,LOC105379240,chr8,R,11020564,11033189,79433905,12625,863203849,35737,2
105379241,LOC105379241,chr8,R,11553050,11555802,79436657,2752,863206601,35738,2
105379242,LOC105379242,chr8,F,11632213,11660901,79465345,28688,863235289,35739,5
105379243,LOC105379243,chr8,R,11787016,11801355,79479684,14339,863249628,35740,2
105379244,LOC105379244,chr8,F,11942303,11944137,79481518,1834,863251462,35741,2
105379245,LOC105379245,chr8,F,12000760,12007367,79488125,6607,863258069,35742,3
105379246,LOC105379246,chr8,F,12043488,12046779,79491416,3291,863261360,35743,2
105379247,LOC105379247,chr8,F,11264159,11284725,79511982,20566,863281926,35744,5
105379288,LOC105379288,chr8,F,12417984,12428636,79522634,10652,863292578,35745,3
105379289,LOC105379289,chr8,F,12865465,12890736,79547905,25271,863317849,35746,2
105379290,LOC105379290,chr8,R,12985150,13038442,79601197,53292,863371141,35747,9
105379291,LOC105379291,chr8,F,13462697,13479139,79617639,16442,863387583,35748,2
105379292,LOC105379292,chr8,R,13833034,13849100,79633705,16066,863403649,35749,2
105379293,LOC105379293,chr8,F,13986483,13995932,79643154,9449,863413098,35750,2
105379294,LOC105379294,chr8,F,14723149,14758738,79678743,35589,863448687,35751,2
105379295,LOC105379295,chr8,F,14404738,14420797,79694802,16059,863464746,35752,2
105379296,LOC105379296,chr8,R,16619531,16623828,79699099,4297,863469043,35753,2
105379297,LOC105379297,chr8,R,16783214,16916028,79831913,132814,863601857,35754,3
105379298,LOC105379298,chr8,F,17126122,17150130,79855921,24008,863625865,35755,4
105379299,LOC105379299,chr8,F,17899857,17908011,79864075,8154,863634019,35756,3
105379300,LOC105379300,chr8,F,19245598,19277381,79895858,31783,863665802,35757,3
105379301,LOC105379301,chr8,F,19091723,19145182,79949317,53459,863719261,35758,6
105379302,LOC105379302,chr8,F,19003941,19015343,79960719,11402,863730663,35759,2
105379303,LOC105379303,chr8,F,18989278,19003259,79974700,13981,863744644,35760,2
105379304,LOC105379304,chr8,F,18854427,18855280,79975553,853,863745497,35761,1
105379305,LOC105379305,chr8,R,18608998,18612069,79978624,3071,863748568,35762,1
105379306,LOC105379306,chr8,F,19300522,19311856,79989958,11334,863759902,35763,3
105379307,LOC105379307,chr8,F,19640643,19651126,80000441,10483,863770385,35764,2
105379308,LOC105379308,chr8,F,19549696,19551552,80002297,1856,863772241,35765,1
105379309,LOC105379309,chr8,R,19886233,19922836,80038900,36603,863808844,35766,5
105379310,LOC105379310,chr8,R,20106547,20109437,80041790,2890,863811734,35767,1
105379311,LOC105379311,chr8,F,20078738,20125001,80088053,46263,863857997,35768,4
105379312,LOC105379312,chr8,F,20125424,20133093,80095722,7669,863865666,35769,2
105379313,LOC105379313,chr8,F,20225364,20226480,80096838,1116,863866782,35770,2
105379314,LOC105379314,chr8,F,20343383,20370627,80124082,27244,863894026,35771,6
105379315,LOC105379315,chr8,F,20915984,20943031,80151129,27047,863921073,35772,3
105379316,LOC105379316,chr8,R,20952643,20955312,80153798,2669,863923742,35773,2
105379317,LOC105379317,chr8,F,21604990,21618185,80166993,13195,863936937,35774,2
105379318,LOC105379318,chr8,R,21850240,21861318,80178071,11078,863948015,35775,2
105379319,LOC105379319,chr8,R,22188428,22191478,80181121,3050,863951065,35776,2
105379320,LOC105379320,chr8,R,22564627,22567122,80183616,2495,863953560,35777,1
105379321,LOC105379321,chr8,F,22695127,22696326,80184815,1199,863954759,35778,2
105379322,LOC105379322,chr8,R,22693694,22694275,80185396,581,863955340,35779,1
105379323,LOC105379323,chr8,F,22898419,22902058,80189035,3639,863958979,35780,2
105379324,LOC105379324,chr8,R,22842163,22846765,80193637,4602,863963581,35781,2
105379325,LOC105379325,chr8,R,22811404,22815386,80197619,3982,863967563,35782,1
105379326,LOC105379326,chr8,F,23263109,23264728,80199238,1619,863969182,35783,1
105379327,LOC105379327,chr8,R,23492297,23493891,80200832,1594,863970776,35784,2
105379328,LOC105379328,chr8,F,24090099,24105096,80215829,14997,863985773,35785,2
105379329,LOC105379329,chr8,R,24884087,24924631,80256373,40544,864026317,35786,5
105379330,LOC105379330,chr8,F,24991876,25009973,80274470,18097,864044414,35787,2
105379331,LOC105379331,chr8,R,25350603,25361501,80285368,10898,864055312,35788,2
105379332,LOC105379332,chr8,F,25685825,25688759,80288302,2934,864058246,35789,2
105379333,LOC105379333,chr8,F,25670607,25685084,80302779,14477,864072723,35790,2
105379334,LOC105379334,chr8,F,25876480,25879101,80305400,2621,864075344,35791,2
105379335,LOC105379335,chr8,R,26121734,26127590,80311256,5856,864081200,35792,4
105379336,LOC105379336,chr8,R,26136156,26206775,80381875,70619,864151819,35793,5
105379337,LOC105379337,chr8,F,26440490,26442195,80383580,1705,864153524,35794,2
105379338,LOC105379338,chr8,F,26854443,26858782,80387919,4339,864157863,35795,2
105379339,LOC105379339,chr8,R,26963662,26974730,80398987,11068,864168931,35796,3
105379340,LOC105379340,chr8,F,27171490,27211333,80438830,39843,864208774,35797,4
105379341,LOC105379341,chr8,F,27590110,27598127,80446847,8017,864216791,35798,1
105379342,LOC105379342,chr8,F,27902370,27910289,80454766,7919,864224710,35799,2
105379343,LOC105379343,chr8,R,28177504,28182479,80459741,4975,864229685,35800,1
105379344,LOC105379344,chr8,F,28600474,28621699,80480966,21225,864250910,35801,2
105379345,LOC105379345,chr8,F,28622748,28644408,80502626,21660,864272570,35802,2
105379346,LOC105379346,chr8,R,29015032,29037444,80525038,22412,864294982,35803,3
105379347,LOC105379347,chr8,F,28763638,28769882,80531282,6244,864301226,35804,2
105379348,LOC105379348,chr8,F,29124129,29140526,80547679,16397,864317623,35805,2
105379349,LOC105379349,chr8,R,29368443,29373349,80552585,4906,864322529,35806,2
105379350,LOC105379350,chr8,F,29533701,29544551,80563435,10850,864333379,35807,2
105379351,LOC105379351,chr8,F,29564026,29583895,80583304,19869,864353248,35808,2
105379352,LOC105379352,chr8,F,29595495,29602274,80590083,6779,864360027,35809,2
105379353,LOC105379353,chr8,R,29667870,29671288,80593501,3418,864363445,35810,2
105379354,LOC105379354,chr8,F,29862366,29882387,80613522,20021,864383466,35811,4
105379355,LOC105379355,chr8,R,30740782,30743145,80615885,2363,864385829,35812,1
105379356,LOC105379356,chr8,F,30732476,30734324,80617733,1848,864387677,35813,1
105379357,LOC105379357,chr8,F,30888774,30901672,80630631,12898,864400575,35814,2
105379358,LOC105379358,chr8,F,31176319,31179268,80633580,2949,864403524,35815,3
105379359,LOC105379359,chr8,R,31143629,31177479,80667430,33850,864437374,35816,9
105379360,LOC105379360,chr8,F,31497311,31542644,80712763,45333,864482707,35817,5
105379361,LOC105379361,chr8,F,32428770,32429877,80713870,1107,864483814,35818,2
105379362,LOC105379362,chr8,F,32927944,33048479,80834405,120535,864604349,35819,5
105379363,LOC105379363,chr8,R,33604877,33609611,80839139,4734,864609083,35820,2
105379364,LOC105379364,chr8,F,33755808,34039059,81122390,283251,864892334,35821,4
105379365,LOC105379365,chr8,F,34174805,34227631,81175216,52826,864945160,35822,3
105379366,LOC105379366,chr8,R,34135682,34175233,81214767,39551,864984711,35823,7
105379367,LOC105379367,chr8,R,34858651,34874675,81230791,16024,865000735,35824,2
105379368,LOC105379368,chr8,F,34967482,34974950,81238259,7468,865008203,35825,2
105379369,LOC105379369,chr8,F,35080574,35093840,81251525,13266,865021469,35826,3
105379370,LOC105379370,chr8,F,36191523,36192942,81252944,1419,865022888,35827,2
105379371,LOC105379371,chr8,F,36195042,36266992,81324894,71950,865094838,35828,2
105379372,LOC105379372,chr8,F,36323572,36326636,81327958,3064,865097902,35829,2
105379373,LOC105379373,chr8,R,36537392,36758831,81549397,221439,865319341,35830,2
105379374,LOC105379374,chr8,R,36765193,36779164,81563368,13971,865333312,35831,2
105379375,LOC105379375,chr8,R,36883169,36925165,81605364,41996,865375308,35832,2
105379376,LOC105379376,chr8,R,36963763,36982005,81623606,18242,865393550,35833,2
105379377,LOC105379377,chr8,R,37066113,37076857,81634350,10744,865404294,35834,5
105379378,LOC105379378,chr8,F,37581514,37582959,81635795,1445,865405739,35835,2
105379379,LOC105379379,chr8,F,37559914,37565633,81641514,5719,865411458,35836,2
105379380,LOC105379380,chr8,R,37602803,37658398,81697109,55595,865467053,35837,2
105379381,LOC105379381,chr8,R,37790369,37794545,81701285,4176,865471229,35838,2
105379382,LOC105379382,chr8,F,38156219,38163494,81708560,7275,865478504,35839,1
105379383,LOC105379383,chr8,R,38552074,38559255,81715741,7181,865485685,35840,2
105379384,LOC105379384,chr8,F,38565065,38578485,81729161,13420,865499105,35841,5
105379385,LOC105379385,chr8,F,40104109,40173333,81798385,69224,865568329,35842,6
105379386,LOC105379386,chr8,F,40114692,40127118,81810811,12426,865580755,35843,2
105379387,LOC105379387,chr8,R,40333172,40353117,81830756,19945,865600700,35844,3
105379388,LOC105379388,chr8,F,40369988,40392796,81853564,22808,865623508,35845,2
105379389,LOC105379389,chr8,F,40904038,40928831,81878357,24793,865648301,35846,4
105379390,LOC105379390,chr8,R,40929834,40933923,81882446,4089,865652390,35847,2
105379391,LOC105379391,chr8,F,41435297,41440419,81887568,5122,865657512,35848,2
105379392,LOC105379392,chr8,F,41797794,41801977,81891751,4183,865661695,35849,1
105379393,LOC105379393,chr8,F,42051903,42104989,81944837,53086,865714781,35850,1
105379394,LOC105379394,chr8,F,42016986,42039641,81967492,22655,865737436,35851,4
105379395,LOC105379395,chr8,F,42297847,42301357,81971002,3510,865740946,35852,1
105379396,LOC105379396,chr8,R,42695921,42717097,81992178,21176,865762122,35853,7
105379397,LOC105379397,chr8,F,43486725,43510775,82016228,24050,865786172,35854,5
105379398,LOC105379398,chr8,F,20405484,20413289,82024033,7805,865793977,35855,5
105379399,LOC105379399,chr8,R,21227719,21297077,82093391,69358,865863335,35856,3
19,ABCA1,chr9,R,104781001,104928246,147245,147245,866010580,35857,52
20,ABCA2,chr9,R,137007233,137028974,168986,21741,866032321,35858,49
25,ABL1,chr9,F,130713880,130887675,342781,173795,866206116,35859,11
28,ABO,chr9,R,133255175,133275214,362820,20039,866226155,35860,6
48,ACO1,chr9,F,32384602,32450836,429054,66234,866292389,35861,22
123,PLIN2,chr9,R,19108387,19127606,448273,19219,866311608,35862,7
203,AK1,chr9,R,127866479,127877743,459537,11264,866322872,35863,8
210,ALAD,chr9,R,113386311,113401338,474564,15027,866337899,35864,15
216,ALDH1A1,chr9,R,72900661,72953317,527220,52656,866390555,35865,12
219,ALDH1B1,chr9,F,38392663,38398665,533222,6002,866396557,35866,2
229,ALDOB,chr9,R,101420559,101435780,548443,15221,866411778,35867,8
259,AMBP,chr9,R,114060126,114078472,566789,18346,866430124,35868,9
301,ANXA1,chr9,F,73151730,73170393,585452,18663,866448787,35869,14
304,ANXA2P2,chr9,F,33624224,33625534,586762,1310,866450097,35870,0
318,NUDT2,chr9,F,34329505,34343713,600970,14208,866464305,35871,4
320,APBA1,chr9,R,69427531,69673617,847056,246086,866710391,35872,15
360,AQP3,chr9,R,33441153,33447633,853536,6480,866716871,35873,5
364,AQP7,chr9,R,33384946,33402645,871235,17699,866734570,35874,10
445,ASS1,chr9,F,130444706,130501274,927803,56568,866791138,35875,17
549,AUH,chr9,R,91213814,91361939,1075928,148125,866939263,35876,17
570,BAAT,chr9,R,101360416,101385005,1100517,24589,866963852,35877,4
573,BAG1,chr9,R,33252470,33264761,1112808,12291,866976143,35878,6
687,KLF9,chr9,R,70384596,70414657,1142869,30061,867006204,35879,1
727,C5,chr9,R,120952334,121074925,1265460,122591,867128795,35880,44
733,C8G,chr9,F,136944874,136946974,1267560,2100,867130895,35881,6
768,CA9,chr9,F,35673917,35681159,1274802,7242,867138137,35882,11
774,CACNA1B,chr9,F,137877788,138124624,1521638,246836,867384973,35883,50
881,CCIN,chr9,F,36169391,36171334,1523581,1943,867386916,35884,0
883,CCBL1,chr9,R,128832941,128882513,1573153,49572,867436488,35885,18
944,TNFSF8,chr9,R,114893342,114930595,1610406,37253,867473741,35886,4
954,ENTPD2,chr9,R,137048097,137054069,1616378,5972,867479713,35887,8
971,CD72,chr9,R,35609978,35646857,1653257,36879,867516592,35888,10
1025,CDK9,chr9,F,127786025,127790773,1658005,4748,867521340,35889,6
1029,CDKN2A,chr9,R,21967751,21995043,1685297,27292,867548632,35890,11
1030,CDKN2B,chr9,R,22002902,22009313,1691708,6411,867555043,35891,1
1056,CEL,chr9,F,133061977,133071863,1701594,9886,867564929,35892,10
1057,CELP,chr9,F,133082538,133087091,1706147,4553,867569482,35893,4
1164,CKS2,chr9,F,89311194,89316703,1711656,5509,867574991,35894,2
1211,CLTA,chr9,F,36190855,36212062,1732863,21207,867596198,35895,6
1271,CNTFR,chr9,R,34551431,34590140,1771572,38709,867634907,35896,11
1289,COL5A1,chr9,F,134641785,134844843,1974630,203058,867837965,35897,66
1306,COL15A1,chr9,F,98943347,99070792,2102075,127445,867965410,35898,42
1317,SLC31A1,chr9,F,113221527,113264492,2145040,42965,868008375,35899,4
1318,SLC31A2,chr9,F,113150957,113164142,2158225,13185,868021560,35900,5
1384,CRAT,chr9,R,129094793,129110791,2174223,15998,868037558,35901,16
1514,CTSL,chr9,F,87725518,87731469,2180174,5951,868043509,35902,8
1515,CTSV,chr9,R,97029676,97039643,2190141,9967,868053476,35903,8
1518,CTSLP8,chr9,F,87844744,87847424,2192821,2680,868056156,35904,2
1539,CYLC2,chr9,F,102995310,103018488,2215999,23178,868079334,35905,7
1612,DAPK1,chr9,F,87497227,87708634,2427406,211407,868290741,35906,28
1620,BRINP1,chr9,R,119166629,119369461,2630238,202832,868493573,35907,7
1621,DBH,chr9,F,133636362,133659344,2653220,22982,868516555,35908,11
1757,SARDH,chr9,R,133661739,133739955,2731436,78216,868594771,35909,22
1759,DNM1,chr9,F,128203354,128255249,2783331,51895,868646666,35910,24
1761,DMRT1,chr9,F,841646,969090,2910775,127444,868774110,35911,6
1842,ECM2,chr9,R,92493546,92536092,2953321,42546,868816656,35912,10
1861,TOR1A,chr9,R,129812941,129824245,2964625,11304,868827960,35913,4
1902,LPAR1,chr9,R,110873260,111039243,3130608,165983,868993943,35914,6
1903,S1PR3,chr9,F,88991408,89005155,3144355,13747,869007690,35915,1
1955,MEGF9,chr9,R,120600917,120714487,3257925,113570,869121260,35916,5
1993,ELAVL2,chr9,R,23690103,23850706,3418528,160603,869281863,35917,16
2021,ENDOG,chr9,F,128818410,128822678,3422796,4268,869286131,35918,3
2022,ENG,chr9,R,127815011,127854773,3462558,39762,869325893,35919,14
2040,STOM,chr9,R,121338987,121370304,3493875,31317,869357210,35920,7
2176,FANCC,chr9,R,95099053,95317709,3712531,218656,869575866,35921,21
2189,FANCG,chr9,R,35073837,35080016,3718710,6179,869582045,35922,13
2203,FBP1,chr9,R,94603132,94640249,3755827,37117,869619162,35923,7
2218,FKTN,chr9,F,105558118,105641118,3838827,83000,869702162,35924,21
2219,FCN1,chr9,R,134909584,134917960,3847203,8376,869710538,35925,8
2220,FCN2,chr9,F,134864155,134889286,3872334,25131,869735669,35926,8
2298,FOXD4,chr9,R,116230,118417,3874521,2187,869737856,35927,0
2304,FOXE1,chr9,F,97853254,97856715,3877982,3461,869741317,35928,0
2315,MLANA,chr9,F,5890908,5909822,3896896,18914,869760231,35929,4
2356,FPGS,chr9,F,127802857,127814520,3908559,11663,869771894,35930,16
2395,FXN,chr9,F,69035562,69100178,3973175,64616,869836510,35931,5
2516,NR5A1,chr9,R,124481231,124507448,3999392,26217,869862727,35932,8
2529,FUT7,chr9,R,137030173,137032840,4002059,2667,869865394,35933,1
2592,GALT,chr9,F,34646588,34650598,4006069,4010,869869404,35934,10
2619,GAS1,chr9,R,86944361,86947189,4008897,2828,869872232,35935,0
2649,NR6A1,chr9,R,124517274,124771310,4262933,254036,870126268,35936,10
2650,GCNT1,chr9,F,76441665,76507416,4328684,65751,870192019,35937,6
2681,GGTA1P,chr9,R,121455040,121500027,4373671,44987,870237006,35938,6
2683,B4GALT1,chr9,R,33110636,33167358,4430393,56722,870293728,35939,5
2731,GLDC,chr9,R,6532463,6645692,4543622,113229,870406957,35940,24
2733,GLE1,chr9,F,128504691,128542301,4581232,37610,870444567,35941,18
2776,GNAQ,chr9,R,77716273,78031449,4896408,315176,870759743,35942,6
2790,GNG10,chr9,F,111661570,111670246,4905084,8676,870768419,35943,2
2800,GOLGA1,chr9,R,124878293,124941114,4967905,62821,870831240,35944,22
2801,GOLGA2,chr9,R,128255828,128276007,4988084,20179,870851419,35945,26
2844,GPR21,chr9,F,123030012,123039101,4997173,9089,870860508,35946,1
2889,RAPGEF1,chr9,R,131576769,131739944,5160348,163175,871023683,35947,32
2902,GRIN1,chr9,F,137139111,137168762,5189999,29651,871053334,35948,21
2934,GSN,chr9,F,121210802,121332844,5312041,122042,871175376,35949,31
3190,HNRNPK,chr9,R,83968082,83980654,5324613,12572,871187948,35950,17
3293,HSD17B3,chr9,R,96235305,96313983,5403291,78678,871266626,35951,15
3301,DNAJA1,chr9,F,33025210,33039064,5417145,13854,871280480,35952,8
3309,HSPA5,chr9,R,125234847,125241387,5423685,6540,871287020,35953,7
3371,TNC,chr9,R,115019574,115118257,5522368,98683,871385703,35954,29
3376,IARS,chr9,R,92210206,92293756,5605918,83550,871469253,35955,33
3439,IFNA1,chr9,F,21440453,21441316,5606781,863,871470116,35956,0
3440,IFNA2,chr9,R,21384254,21385397,5607924,1143,871471259,35957,0
3441,IFNA4,chr9,R,21186617,21187599,5608906,982,871472241,35958,0
3442,IFNA5,chr9,R,21304613,21305313,5609606,700,871472941,35959,0
3443,IFNA6,chr9,R,21350317,21350887,5610176,570,871473511,35960,0
3444,IFNA7,chr9,R,21201468,21202205,5610913,737,871474248,35961,0
3445,IFNA8,chr9,F,21409146,21410185,5611952,1039,871475287,35962,0
3446,IFNA10,chr9,R,21206180,21207143,5612915,963,871476250,35963,0
3447,IFNA13,chr9,R,21367371,21368076,5613620,705,871476955,35964,0
3448,IFNA14,chr9,R,21239201,21239979,5614398,778,871477733,35965,0
3449,IFNA16,chr9,R,21216372,21217311,5615337,939,871478672,35966,0
3451,IFNA17,chr9,R,21227242,21228222,5616317,980,871479652,35967,0
3452,IFNA21,chr9,R,21165636,21166660,5617341,1024,871480676,35968,0
3453,IFNA22P,chr9,R,21277687,21278563,5618217,876,871481552,35969,0
3456,IFNB1,chr9,R,21077104,21077944,5619057,840,871482392,35970,0
3467,IFNW1,chr9,R,21140631,21142145,5620571,1514,871483906,35971,0
3590,IL11RA,chr9,F,34652184,34661902,5630289,9718,871493624,35972,13
3641,INSL4,chr9,F,5231418,5233967,5632838,2549,871496173,35973,2
3717,JAK2,chr9,F,4985244,5128183,5775777,142939,871639112,35974,24
3933,LCN1,chr9,F,135521296,135526540,5781021,5244,871644356,35975,5
3934,LCN2,chr9,F,128149452,128153455,5785024,4003,871648359,35976,6
4010,LMX1B,chr9,F,126614442,126701032,5871614,86590,871734949,35977,7
4300,MLLT3,chr9,R,20341664,20622543,6152493,280879,872015828,35978,11
4507,MTAP,chr9,F,21802635,21865971,6215829,63336,872079164,35979,7
4593,MUSK,chr9,F,110668544,110806542,6353827,137998,872217162,35980,16
4686,NCBP1,chr9,F,97633422,97673748,6394153,40326,872257488,35981,23
4702,NDUFA8,chr9,R,122132465,122159819,6421507,27354,872284842,35982,4
4712,NDUFB6,chr9,R,32553525,32573184,6441166,19659,872304501,35983,3
4781,NFIB,chr9,R,14081842,14398983,6758307,317141,872621642,35984,15
4783,NFIL3,chr9,R,91409044,91424626,6773889,15582,872637224,35985,2
4799,NFX1,chr9,F,33290419,33371157,6854627,80738,872717962,35986,24
4814,NINJ1,chr9,R,93121488,93134304,6867443,12816,872730778,35987,4
4851,NOTCH1,chr9,R,136494443,136545786,6918786,51343,872782121,35988,33
4882,NPR2,chr9,F,35752944,35809731,6975573,56787,872838908,35989,26
4915,NTRK2,chr9,F,84668457,85027070,7334186,358613,873197521,35990,22
4920,ROR2,chr9,R,91722595,91950162,7561753,227567,873425088,35991,13
4957,ODF2,chr9,F,128455154,128501292,7607891,46138,873471226,35992,25
4958,OMD,chr9,R,92414244,92424554,7618201,10310,873481536,35993,2
4969,OGN,chr9,R,92383966,92404655,7638890,20689,873502225,35994,6
5004,ORM1,chr9,F,114323022,114326479,7642347,3457,873505682,35995,5
5005,ORM2,chr9,F,114329788,114333256,7645815,3468,873509150,35996,5
5047,PAEP,chr9,F,135561753,135566776,7650838,5023,873514173,35997,6
5069,PAPPA,chr9,F,116153791,116402321,7899368,248530,873762703,35998,21
5079,PAX5,chr9,R,36833274,37035319,8101413,202045,873964748,35999,11
5082,PDCL,chr9,R,122818096,122828656,8111973,10560,873975308,36000,3
5090,PBX3,chr9,F,125747337,125967377,8332013,220040,874195348,36001,12
5125,PCSK5,chr9,F,75890600,76362339,8803752,471739,874667087,36002,39
5239,PGM5,chr9,F,68356898,68531061,8977915,174163,874841250,36003,13
5253,PHF2,chr9,F,93576626,93679587,9080876,102961,874944211,36004,22
5524,PPP2R4,chr9,F,129110944,129148946,9118878,38002,874982213,36005,12
5535,PPP3R2,chr9,R,101591614,101595001,9122265,3387,874985600,36006,0
5537,PPP6C,chr9,R,125146572,125189939,9165632,43367,875028967,36007,8
5568,PRKACG,chr9,R,69012528,69014123,9167227,1595,875030562,36008,0
5646,PRSS3,chr9,F,33750465,33799231,9215993,48766,875079328,36009,8
5695,PSMB7,chr9,R,124353464,124415473,9278002,62009,875141337,36010,7
5711,PSMD5,chr9,R,120814778,120843021,9306245,28243,875169580,36011,10
5727,PTCH1,chr9,R,95442981,95516965,9380229,73984,875243564,36012,31
5730,PTGDS,chr9,F,136977503,136981742,9384468,4239,875247803,36013,6
5742,PTGS1,chr9,F,122370529,122395705,9409644,25176,875272979,36014,12
5774,PTPN3,chr9,R,109375693,109538353,9572304,162660,875435639,36015,30
5789,PTPRD,chr9,R,8314245,10612723,11870782,2298478,877734117,36016,47
5887,RAD23B,chr9,F,107283235,107332194,11919741,48959,877783076,36017,11
5900,RALGDS,chr9,R,133097719,133149220,11971242,51501,877834577,36018,20
5991,RFX3,chr9,R,3218296,3526001,12278947,307705,878142282,36019,25
5998,RGS3,chr9,F,113444728,113597743,12431962,153015,878295297,36020,35
6013,RLN1,chr9,R,5313626,5339873,12458209,26247,878321544,36021,3
6019,RLN2,chr9,R,5299863,5339412,12497758,39549,878361093,36022,5
6023,RMRP,chr9,R,35657750,35658018,12498026,268,878361361,36023,0
6096,RORB,chr9,F,74497335,74687201,12687892,189866,878551227,36024,9
6130,RPL7A,chr9,F,133348213,133351425,12691104,3212,878554439,36025,7
6136,RPL12,chr9,R,127447673,127451432,12694863,3759,878558198,36026,6
6194,RPS6,chr9,R,19376255,19380237,12698845,3982,878562180,36027,5
6256,RXRA,chr9,F,134326462,134440586,12812969,114124,878676304,36028,11
6363,CCL19,chr9,R,34689569,34691277,12814677,1708,878678012,36029,3
6366,CCL21,chr9,R,34709004,34710167,12815840,1163,878679175,36030,3
6418,SET,chr9,F,128683431,128696396,12828805,12965,878692140,36031,11
6456,SH3GL2,chr9,F,17578953,17797129,13046981,218176,878910316,36032,10
6461,SHB,chr9,R,37915897,38069213,13200297,153316,879063632,36033,5
6505,SLC1A1,chr9,F,4490426,4587469,13297340,97043,879160675,36034,13
6595,SMARCA2,chr9,F,2015218,2193624,13475746,178406,879339081,36035,37
6619,SNAPC3,chr9,F,15422695,15466751,13519802,44056,879383137,36036,10
6621,SNAPC4,chr9,R,136375570,136400208,13544440,24638,879407775,36037,24
6709,SPTAN1,chr9,F,128552557,128633665,13625548,81108,879488883,36038,58
6812,STXBP1,chr9,F,127612206,127692716,13706058,80510,879569393,36039,19
6834,SURF1,chr9,R,133351804,133356485,13710739,4681,879574074,36040,8
6835,SURF2,chr9,F,133356544,133361165,13715360,4621,879578695,36041,5
6836,SURF4,chr9,R,133361448,133377949,13731861,16501,879595196,36042,8
6837,MED22,chr9,R,133340900,133348156,13739117,7256,879602452,36043,3
6838,SURF6,chr9,R,133330706,133336210,13744621,5504,879607956,36044,4
6850,SYK,chr9,F,90801679,90898560,13841502,96881,879704837,36045,15
6887,TAL2,chr9,F,105662456,105663112,13842158,656,879705493,36046,0
7010,TEK,chr9,F,27109140,27230178,13963196,121038,879826531,36047,22
7016,TESK1,chr9,F,35605283,35610041,13967954,4758,879831289,36048,9
7046,TGFBR1,chr9,F,99104037,99154192,14018109,50155,879881444,36049,10
7088,TLE1,chr9,R,81583682,81689535,14123962,105853,879987297,36050,21
7091,TLE4,chr9,F,79571772,79726882,14279072,155110,880142407,36051,28
7094,TLN1,chr9,R,35697336,35732395,14314131,35059,880177466,36052,56
7099,TLR4,chr9,F,117704174,117717491,14327448,13317,880190783,36053,3
7111,TMOD1,chr9,F,97501179,97601743,14428012,100564,880291347,36054,10
7169,TPM2,chr9,R,35681992,35690056,14436076,8064,880299411,36055,9
7185,TRAF1,chr9,R,120902392,120929173,14462857,26781,880326192,36056,9
7186,TRAF2,chr9,F,136881932,136926621,14507546,44689,880370881,36057,16
7248,TSC1,chr9,R,132891347,132945370,14561569,54023,880424904,36058,24
7270,TTF1,chr9,R,132375547,132406871,14592893,31324,880456228,36059,11
7295,TXN,chr9,R,110243811,110256640,14605722,12829,880469057,36060,4
7306,TYRP1,chr9,F,12693385,12710266,14622603,16881,880485938,36061,7
7357,UGCG,chr9,F,111896765,111935374,14661212,38609,880524547,36062,9
7410,VAV2,chr9,R,133761893,133992374,14891693,230481,880755028,36063,31
7415,VCP,chr9,R,35056067,35072742,14908368,16675,880771703,36064,16
7436,VLDLR,chr9,F,2621678,2656100,14942790,34422,880806125,36065,18
7464,CORO2A,chr9,R,98120974,98192674,15014490,71700,880877825,36066,14
7507,XPA,chr9,R,97654397,97697409,15057502,43012,880920837,36067,9
7539,ZFP37,chr9,R,113041814,113056791,15072479,14977,880935814,36068,3
7633,ZNF79,chr9,F,127424373,127446964,15095070,22591,880958405,36069,5
7743,ZNF189,chr9,F,101398807,101410660,15106923,11853,880970258,36070,5
7763,ZFAND5,chr9,R,72351424,72365247,15120746,13823,880984081,36071,7
8013,NR4A3,chr9,F,99821854,99866893,15165785,45039,881029120,36072,10
8019,BRD3,chr9,R,134030304,134068533,15204014,38229,881067349,36073,13
8021,NUP214,chr9,F,131124958,131234670,15313726,109712,881177061,36074,37
8022,LHX3,chr9,R,136196249,136205109,15322586,8860,881185921,36075,7
8328,GFI1B,chr9,F,132945544,132993434,15370476,47890,881233811,36076,14
8395,PIP5K1B,chr9,F,68705216,69009176,15674436,303960,881537771,36077,21
8434,RECK,chr9,F,36036912,36124455,15761979,87543,881625314,36078,22
8518,IKBKAP,chr9,R,108867519,108934328,15828788,66809,881692123,36079,36
8555,CDC14B,chr9,R,96490217,96619830,15958401,129613,881821736,36080,25
8577,TMEFF1,chr9,F,100473237,100577636,16062800,104399,881926135,36081,9
8636,SSNA1,chr9,F,137188601,137190370,16064569,1769,881927904,36082,2
8721,EDF1,chr9,R,136862113,136866336,16068792,4223,881932127,36083,4
8727,CTNNAL1,chr9,R,108942568,109018802,16145026,76234,882008361,36084,20
8777,MPDZ,chr9,R,13105295,13279662,16319393,174367,882182728,36085,48
8789,FBP2,chr9,R,94558713,94593832,16354512,35119,882217847,36086,7
8818,DPM2,chr9,R,127935094,127938484,16357902,3390,882221237,36087,3
8939,FUBP3,chr9,F,130578856,130638352,16417398,59496,882280733,36088,23
9022,CLIC3,chr9,R,136994607,136996572,16419363,1965,882282698,36089,5
9128,PRPF4,chr9,F,113275633,113293914,16437644,18281,882300979,36090,13
9314,KLF4,chr9,R,107484851,107489766,16442559,4915,882305894,36091,3
9328,GTF3C5,chr9,F,133030674,133058503,16470388,27829,882333723,36092,11
9329,GTF3C4,chr9,F,132670034,132690084,16490438,20050,882353773,36093,5
9350,CER1,chr9,R,14719732,14722717,16493423,2985,882356758,36094,1
9355,LHX2,chr9,F,124011609,124033163,16514977,21554,882378312,36095,6
9373,PLAA,chr9,R,26903369,26947470,16559078,44101,882422413,36096,14
9380,GRHPR,chr9,F,37422665,37436993,16573406,14328,882436741,36097,8
9413,FAM189A2,chr9,F,69324571,69392456,16641291,67885,882504626,36098,12
9414,TJP2,chr9,F,69121263,69255208,16775236,133945,882638571,36099,29
9442,MED27,chr9,R,131860109,132079887,16995014,219778,882858349,36100,9
9536,PTGES,chr9,R,129738335,129777327,17034006,38992,882897341,36101,3
9550,ATP6V1G1,chr9,F,114587713,114598872,17045165,11159,882908500,36102,2
9568,GABBR2,chr9,R,98288081,98709197,17466281,421116,883329616,36103,19
9615,GDA,chr9,F,72114594,72259059,17610746,144465,883474081,36104,22
9630,GNA14,chr9,R,77423078,77648316,17835984,225238,883699319,36105,7
9649,RALGPS1,chr9,F,126914773,127223166,18144377,308393,884007712,36106,24
9719,ADAMTSL2,chr9,F,133532163,133575519,18187733,43356,884051068,36107,20
9827,RGP1,chr9,F,35749279,35753267,18191721,3988,884055056,36108,8
9830,TRIM14,chr9,R,98083188,98119408,18227941,36220,884091276,36109,10
9833,MELK,chr9,F,36572861,36677683,18332763,104822,884196098,36110,21
9853,RUSC2,chr9,F,35489837,35561898,18404824,72061,884268159,36111,12
9858,PPP1R26,chr9,F,135479698,135488894,18414020,9196,884277355,36112,4
9919,SEC16A,chr9,R,136440095,136484549,18458474,44454,884321809,36113,34
9925,ZBTB5,chr9,R,37438101,37465410,18485783,27309,884349118,36114,2
9933,KIAA0020,chr9,R,2804151,2844130,18525762,39979,884389097,36115,17
9966,TNFSF15,chr9,R,114784634,114806128,18547256,21494,884410591,36116,3
9991,PTBP3,chr9,R,112217714,112333664,18663206,115950,884526541,36117,16
10020,GNE,chr9,R,36214440,36277056,18725822,62616,884589157,36118,12
10044,SH2D3C,chr9,R,127738316,127785159,18772665,46843,884636000,36119,18
10171,RCL1,chr9,F,4792833,4861077,18840909,68244,884704244,36120,9
10210,TOPORS,chr9,R,32540543,32552628,18852994,12085,884716329,36121,2
10244,RABEPK,chr9,F,125200541,125234159,18886612,33618,884749947,36122,9
10280,SIGMAR1,chr9,R,34634721,34637826,18889717,3105,884753052,36123,3
10319,LAMC3,chr9,F,131009116,131093059,18973660,83943,884836995,36124,28
10383,TUBB4B,chr9,F,137241258,137243707,18976109,2449,884839444,36125,3
10422,UBAC1,chr9,R,135932968,135961380,19004521,28412,884867856,36126,9
10439,OLFM1,chr9,F,135075242,135121184,19050463,45942,884913798,36127,8
10444,ZER1,chr9,R,128729785,128772422,19093100,42637,884956435,36128,16
10488,CREB3,chr9,F,35732319,35737008,19097789,4689,884961124,36129,8
10497,UNC13B,chr9,F,35161981,35405337,19341145,243356,885204480,36130,42
10507,SEMA4D,chr9,R,89360790,89498014,19478369,137224,885341704,36131,29
10541,ANP32B,chr9,F,97983206,98015943,19511106,32737,885374441,36132,6
10555,AGPAT2,chr9,R,136673142,136687459,19525423,14317,885388758,36133,5
10558,SPTLC1,chr9,R,92031133,92115474,19609764,84341,885473099,36134,16
10585,POMT1,chr9,F,131502894,131523806,19630676,20912,885494011,36135,19
10592,SMC2,chr9,F,104093847,104141419,19678248,47572,885541583,36136,28
10655,DMRT2,chr9,F,1003241,1057554,19732561,54313,885595896,36137,10
10670,RRAGA,chr9,F,19049373,19051025,19734213,1652,885597548,36138,0
10773,ZBTB6,chr9,R,122908055,122913328,19739486,5273,885602821,36139,1
10783,NEK6,chr9,F,124257605,124378316,19860197,120711,885723532,36140,17
10807,SDCCAG3,chr9,R,136401921,136410602,19868878,8681,885732213,36141,9
10811,NOXA1,chr9,F,137423394,137434406,19879890,11012,885743225,36142,14
10850,CCL27,chr9,R,34661882,34662692,19880700,810,885744035,36143,2
10868,USP20,chr9,F,129835416,129881838,19927122,46422,885790457,36144,26
10880,ACTL7B,chr9,R,108854587,108855995,19928530,1408,885791865,36145,0
10881,ACTL7A,chr9,F,108862227,108863755,19930058,1528,885793393,36146,0
10912,GADD45G,chr9,F,89605011,89606555,19931602,1544,885794937,36147,3
10927,SPIN1,chr9,F,88388381,88478708,20021929,90327,885885264,36148,5
10952,SEC61B,chr9,F,99222287,99230619,20030261,8332,885893596,36149,3
10999,SLC27A4,chr9,F,128340559,128361470,20051172,20911,885914507,36150,12
11046,SLC35D2,chr9,R,96313436,96383710,20121446,70274,885984781,36151,13
11064,CNTRL,chr9,F,121074954,121177610,20224102,102656,886087437,36152,46
11091,WDR5,chr9,F,134135678,134159972,20248396,24294,886111731,36153,14
11092,C9orf9,chr9,F,132878894,132890034,20259536,11140,886122871,36154,3
11093,ADAMTS13,chr9,F,133414338,133459403,20304601,45065,886167936,36155,30
11094,CACFD1,chr9,F,133459964,133470787,20315424,10823,886178759,36156,8
11168,PSIP1,chr9,R,15464065,15511005,20362364,46940,886225699,36157,17
11172,INSL6,chr9,R,4991948,5185710,20556126,193762,886419461,36158,3
11182,SLC2A6,chr9,R,133471093,133479154,20564187,8061,886427522,36159,8
11191,PTENP1,chr9,R,33673503,33677420,20568104,3917,886431439,36160,0
11217,AKAP2,chr9,F,110048597,110172512,20692019,123915,886555354,36161,5
11224,RPL35,chr9,R,124857878,124861961,20696102,4083,886559437,36162,3
11253,MAN1B1,chr9,F,137086861,137109187,20718428,22326,886581763,36163,13
11258,DCTN3,chr9,R,34613544,34620523,20725407,6979,886588742,36164,6
22844,FRMPD1,chr9,F,37602977,37746904,20869334,143927,886732669,36165,18
22845,DOLK,chr9,R,128945529,128947733,20871538,2204,886734873,36166,0
22869,ZNF510,chr9,R,96754552,96778119,20895105,23567,886758440,36167,5
22927,HABP4,chr9,F,96450154,96491336,20936287,41182,886799622,36168,8
22949,PTGR1,chr9,R,111549721,111599855,20986421,50134,886849756,36169,13
22954,TRIM32,chr9,F,116687301,116701300,21000420,13999,886863755,36170,3
23048,FNBP1,chr9,R,129887186,130043194,21156428,156008,887019763,36171,17
23064,SETX,chr9,R,132261439,132356726,21251715,95287,887115050,36172,32
23071,ERP44,chr9,R,99979178,100099052,21371589,119874,887234924,36173,11
23081,KDM4C,chr9,F,6720862,7175648,21826375,454786,887689710,36174,31
23099,ZBTB43,chr9,F,126804071,126838210,21860514,34139,887723849,36175,7
23137,SMC5,chr9,F,70258961,70354873,21956426,95912,887819761,36176,24
23189,KANK1,chr9,F,470293,746106,22232239,275813,888095574,36177,28
23196,FAM120A,chr9,F,93451695,93566115,22346659,114420,888209994,36178,20
23203,PMPCA,chr9,F,136410572,136423761,22359848,13189,888223183,36179,12
23230,VPS13A,chr9,F,77177352,77417483,22599979,240131,888463314,36180,74
23245,ASTN2,chr9,R,116425224,117415039,23589794,989815,889453129,36181,23
23287,AGTPBP1,chr9,R,85546538,85742029,23785285,195491,889648620,36182,29
23299,BICD2,chr9,R,92711362,92764801,23838724,53439,889702059,36183,6
23307,FKBP15,chr9,R,113165518,113221361,23894567,55843,889757902,36184,27
23349,KIAA1045,chr9,F,34810039,34982544,24067072,172505,889930407,36185,10
23392,KIAA0368,chr9,R,111360692,111484745,24191125,124053,890054460,36186,52
23404,EXOSC2,chr9,F,130693759,130704894,24202260,11135,890065595,36187,9
23413,NCS1,chr9,F,130172577,130237304,24266987,64727,890130322,36188,8
23424,TDRD7,chr9,F,97411988,97496125,24351124,84137,890214459,36189,16
23446,SLC44A1,chr9,F,105244607,105438504,24545021,193897,890408356,36190,18
23452,ANGPTL2,chr9,R,127087348,127122797,24580470,35449,890443805,36191,5
23511,NUP188,chr9,F,128947692,129007096,24639874,59404,890503209,36192,43
23552,CDK20,chr9,R,87966440,87974780,24648214,8340,890511549,36193,8
23586,DDX58,chr9,R,32455301,32526324,24719237,71023,890582572,36194,17
23637,RABGAP1,chr9,F,122941008,123104868,24883097,163860,890746432,36195,29
23670,TMEM2,chr9,R,71683365,71769466,24969198,86101,890832533,36196,24
23731,TMEM245,chr9,R,109015134,109119945,25074009,104811,890937344,36197,17
23732,FRRS1L,chr9,R,109136187,109167291,25105113,31104,890968448,36198,6
25769,SLC24A2,chr9,R,19507451,19789695,25387357,282244,891250692,36199,11
25792,CIZ1,chr9,R,128166064,128204383,25425676,38319,891289011,36200,20
25822,DNAJB5,chr9,F,34989368,34998433,25434741,9065,891298076,36201,5
25853,DCAF12,chr9,R,34086382,34126773,25475132,40391,891338467,36202,9
25861,DFNB31,chr9,R,114402077,114505509,25578564,103432,891441899,36203,18
25920,NELFB,chr9,F,137255306,137273548,25596806,18242,891460141,36204,12
25934,NIPSNAP3A,chr9,F,104747687,104760122,25609241,12435,891472576,36205,5
26012,NSMF,chr9,R,137447569,137459357,25621029,11788,891484364,36206,16
26086,GPSM1,chr9,F,136327475,136359605,25653159,32130,891516494,36207,16
26102,DKFZP434A062,chr9,R,136322301,136327323,25658181,5022,891521516,36208,0
26130,GAPVD1,chr9,F,125241662,125365011,25781530,123349,891644865,36209,34
26134,RALGAPA1P,chr9,F,105519823,105527319,25789026,7496,891652361,36210,0
26147,PHF19,chr9,R,120855650,120894896,25828272,39246,891691607,36211,21
26149,ZNF658,chr9,F,66900728,66921653,25849197,20925,891712532,36212,6
26165,SPATA31A7,chr9,F,61190035,61196280,25855442,6245,891718777,36213,3
26190,FBXW2,chr9,R,120756975,120793462,25891929,36487,891755264,36214,8
26206,SPAG8,chr9,R,35807784,35812272,25896417,4488,891759752,36215,6
26219,OR1J4,chr9,F,122519140,122520082,25897359,942,891760694,36216,0
26248,OR2K2,chr9,R,111327369,111330173,25900163,2804,891763498,36217,3
26267,FBXO10,chr9,R,37510891,37576311,25965583,65420,891828918,36218,13
26301,GBGT1,chr9,R,133152947,133163945,25976581,10998,891839916,36219,6
26468,LHX6,chr9,R,122185651,122228893,26019823,43242,891883158,36220,14
26578,OSTF1,chr9,F,75088481,75148137,26079479,59656,891942814,36221,10
26735,OR1L3,chr9,F,122675129,122676104,26080454,975,891943789,36222,0
26737,OR1L1,chr9,F,122661715,122662648,26081387,933,891944722,36223,0
26740,OR1J2,chr9,F,122448952,122580751,26213186,131799,892076521,36224,7
26783,SNORA65,chr9,R,127448501,127448637,26213322,136,892076657,36225,0
26786,SNORD62A,chr9,F,131485664,131485750,26213408,86,892076743,36226,0
26813,SNORD36C,chr9,F,133350845,133350913,26213476,68,892076811,36227,0
26814,SNORD36B,chr9,F,133350093,133350164,26213547,71,892076882,36228,0
26815,SNORD36A,chr9,F,133350455,133350527,26213619,72,892076954,36229,0
26820,SNORD24,chr9,F,133349395,133349470,26213694,75,892077029,36230,0
26953,RANBP6,chr9,R,6011018,6015640,26218316,4622,892081651,36231,0
26995,TRUB2,chr9,R,128309116,128322418,26231618,13302,892094953,36232,7
27019,DNAI1,chr9,F,34458751,34520989,26293856,62238,892157191,36233,23
27090,ST6GALNAC4,chr9,R,127907885,127917051,26303022,9166,892166357,36234,7
27130,INVS,chr9,F,100099184,100338617,26542455,239433,892405790,36235,24
27158,NDOR1,chr9,F,137205666,137219361,26556150,13695,892419485,36236,12
27240,SIT1,chr9,R,35649297,35650950,26557803,1653,892421138,36237,4
27290,SPINK4,chr9,F,33240197,33248567,26566173,8370,892429508,36238,3
27348,TOR1B,chr9,F,129803147,129811284,26574310,8137,892437645,36239,4
27433,TOR2A,chr9,R,127731523,127736377,26579164,4854,892442499,36240,3
28989,NTMT1,chr9,F,129608883,129636131,26606412,27248,892469747,36241,6
29085,PHPT1,chr9,F,136848815,136851043,26608640,2228,892471975,36242,2
29126,CD274,chr9,F,5450380,5470567,26628827,20187,892492162,36243,6
29882,ANAPC2,chr9,R,137174783,137188605,26642649,13822,892505984,36244,13
29941,PKN3,chr9,F,128702498,128720920,26661071,18422,892524406,36245,22
29952,DPP7,chr9,R,137110539,137117980,26668512,7441,892531847,36246,12
29968,PSAT1,chr9,F,78297074,78330093,26701531,33019,892564866,36247,8
29979,UBQLN1,chr9,R,83659962,83708253,26749822,48291,892613157,36248,11
29988,SLC2A8,chr9,F,127397137,127407898,26760583,10761,892623918,36249,10
29989,OBP2B,chr9,R,133205278,133253397,26808702,48119,892672037,36250,11
29991,OBP2A,chr9,F,135546138,135549969,26812533,3831,892675868,36251,6
30815,ST6GALNAC6,chr9,R,127885320,127906731,26833944,21411,892697279,36252,9
30968,STOML2,chr9,R,35099775,35103195,26837364,3420,892700699,36253,9
50514,DEC1,chr9,F,115112616,115402644,27127392,290028,892990727,36254,9
50652,PCA3,chr9,F,76764437,76787549,27150504,23112,893013839,36255,2
50808,AK3,chr9,R,4709555,4742043,27182992,32488,893046327,36256,7
51010,EXOSC3,chr9,R,37779713,37785092,27188371,5379,893051706,36257,3
51104,ABHD17B,chr9,R,71862451,71911233,27237153,48782,893100488,36258,6
51116,MRPS2,chr9,F,135499985,135504673,27241841,4688,893105176,36259,6
51117,COQ4,chr9,F,128322511,128334072,27253402,11561,893116737,36260,7
51145,LOC51145,chr9,R,125743753,125745929,27255578,2176,893118913,36261,1
51148,CERCAM,chr9,F,128411574,128437351,27281355,25777,893144690,36262,17
51162,EGFL7,chr9,F,136658855,136672678,27295178,13823,893158513,36263,12
51198,CDKN2A-AS1,chr9,F,21967138,21967754,27295794,616,893159129,36264,0
51271,UBAP1,chr9,F,34179004,34252523,27369313,73519,893232648,36265,11
51280,GOLM1,chr9,R,86026140,86100201,27443374,74061,893306709,36266,10
51450,PRRX2,chr9,F,129665640,129722674,27500408,57034,893363743,36267,5
51490,C9orf114,chr9,R,128819650,128829847,27510605,10197,893373940,36268,11
51510,CHMP5,chr9,F,33264878,33282069,27527796,17191,893391131,36269,7
51531,C9orf156,chr9,R,97876323,97922570,27574043,46247,893437378,36270,9
51552,RAB14,chr9,R,121178136,121202087,27597994,23951,893461329,36271,7
51754,TMEM8B,chr9,F,35829224,35854847,27623617,25623,893486952,36272,16
51759,C9orf78,chr9,R,129827284,129835293,27631626,8009,893494961,36273,8
53358,SHC3,chr9,R,89005770,89182072,27807928,176302,893671263,36274,13
54107,POLE3,chr9,R,113407234,113410749,27811443,3515,893674778,36275,3
54187,NANS,chr9,F,98056676,98083083,27837850,26407,893701185,36276,6
54461,FBXW5,chr9,R,136940432,136944774,27842192,4342,893705527,36277,8
54534,MRPL50,chr9,R,101387632,101398641,27853201,11009,893716536,36278,2
54542,RC3H2,chr9,R,122849452,122905283,27909032,55831,893772367,36279,20
54566,EPB41L4B,chr9,R,109171973,109320964,28058023,148991,893921358,36280,28
54586,EQTN,chr9,R,27284653,27297139,28070509,12486,893933844,36281,9
54662,TBC1D13,chr9,F,128787206,128810432,28093735,23226,893957070,36282,11
54754,NUTM2F,chr9,R,94318195,94554847,28330387,236652,894193722,36283,9
54769,DIRAS2,chr9,R,90609831,90643105,28363661,33274,894226996,36284,1
54796,BNC2,chr9,R,16409502,16870838,28824997,461336,894688332,36285,17
54801,HAUS6,chr9,R,19053136,19102942,28874803,49806,894738138,36286,17
54829,ASPN,chr9,R,92456204,92482562,28901161,26358,894764496,36287,7
54836,BSPRY,chr9,F,113349531,113371233,28922863,21702,894786198,36288,5
54840,APTX,chr9,R,32972605,33025138,28975396,52533,894838731,36289,10
54863,TOR4A,chr9,F,137277827,137282641,28980210,4814,894843545,36290,1
54875,CNTLN,chr9,F,17134989,17503923,29349144,368934,895212479,36291,32
54881,TEX10,chr9,R,100302074,100352977,29400047,50903,895263382,36292,15
54886,LPPR1,chr9,F,101028748,101325135,29696434,296387,895559769,36293,9
54914,FOCAD,chr9,F,20658308,20995955,30034081,337647,895897416,36294,48
54926,UBE2R2,chr9,F,33817163,33920403,30137321,103240,896000656,36295,4
54932,EXD3,chr9,R,137306893,137423268,30253696,116375,896117031,36296,32
54942,FAM206A,chr9,F,108934392,108951041,30270345,16649,896133680,36297,6
54981,NMRK1,chr9,R,75060576,75088319,30298088,27743,896161423,36298,11
55014,STX17,chr9,F,99906632,99979337,30370793,72705,896234128,36299,11
55035,NOL8,chr9,R,92297357,92325994,30399430,28637,896262765,36300,19
55064,SPATA6L,chr9,R,4595836,4666801,30470395,70965,896333730,36301,17
55071,C9orf40,chr9,R,74946582,74952886,30476699,6304,896340034,36302,1
55151,TMEM38B,chr9,F,105694524,105776611,30558786,82087,896422121,36303,9
55234,SMU1,chr9,R,33041851,33076716,30593651,34865,896456986,36304,11
55312,RFK,chr9,R,76385516,76394528,30602663,9012,896465998,36305,3
55335,NIPSNAP3B,chr9,F,104763740,104777764,30616687,14024,896480022,36306,6
55342,STRBP,chr9,R,123109493,123268576,30775770,159083,896639105,36307,23
55357,TBC1D2,chr9,R,98198997,98255721,30832494,56724,896695829,36308,15
55363,HEMGN,chr9,R,97926790,97944915,30850619,18125,896713954,36309,5
55582,KIF27,chr9,R,83836697,83921467,30935389,84770,896798724,36310,22
55664,CDC37L1,chr9,F,4679552,4708399,30964236,28847,896827571,36311,6
55667,DENND4C,chr9,F,19230764,19374268,31107740,143504,896971075,36312,34
55684,RABL6,chr9,F,136807921,136841187,31141006,33266,897004341,36313,15
55755,CDK5RAP2,chr9,R,120388868,120580170,31332308,191302,897195643,36314,38
55833,UBAP2,chr9,R,33921692,34048949,31459565,127257,897322900,36315,29
55848,PLGRKT,chr9,R,5357965,5438456,31540056,80491,897403391,36316,7
55871,CBWD1,chr9,R,121037,179075,31598094,58038,897461429,36317,18
55958,KLHL9,chr9,R,21331018,21335430,31602506,4412,897465841,36318,0
56033,BARX1,chr9,R,93951626,93955326,31606206,3700,897469541,36319,3
56254,RNF20,chr9,F,101533848,101563344,31635702,29496,897499037,36320,20
56262,LRRC8A,chr9,F,128882111,128918042,31671633,35931,897534968,36321,9
56623,INPP5E,chr9,R,136428614,136439859,31682878,11245,897546213,36322,9
56654,NPDC1,chr9,R,137039456,137046224,31689646,6768,897552981,36323,8
56656,OR2S2,chr9,R,35957107,35958154,31690693,1047,897554028,36324,0
56751,BARHL1,chr9,F,132582605,132590253,31698341,7648,897561676,36325,2
56832,IFNK,chr9,F,27524313,27526498,31700526,2185,897563861,36326,1
56904,SH3GLB2,chr9,R,129007791,129028353,31721088,20562,897584423,36327,12
57000,GSN-AS1,chr9,R,121280767,121285530,31725851,4763,897589186,36328,0
57109,REXO4,chr9,R,133406057,133418172,31737966,12115,897601301,36329,7
57171,DOLPP1,chr9,F,129081103,129090438,31747301,9335,897610636,36330,7
57462,KIAA1161,chr9,R,34366665,34376896,31757532,10231,897620867,36331,1
57582,KCNT1,chr9,F,135702184,135793147,31848495,90963,897711830,36332,34
57589,RIC1,chr9,F,5629029,5778015,31997481,148986,897860816,36333,27
57653,LOC100499484-C9ORF174,chr9,F,97238425,97377295,32136351,138870,897999686,36334,50
57684,ZBTB26,chr9,R,122918028,122931551,32149874,13523,898013209,36335,2
57704,GBA2,chr9,R,35736865,35749228,32162237,12363,898025572,36336,18
57706,DENND1A,chr9,R,123379653,123930138,32712722,550485,898576057,36337,26
57720,GPR107,chr9,F,130053705,130140169,32799186,86464,898662521,36338,20
57864,SLC46A2,chr9,R,112878919,112890942,32811209,12023,898674544,36339,3
58483,LINC00474,chr9,R,115888264,115925098,32848043,36834,898711378,36340,2
58493,INIP,chr9,R,112685563,112718107,32880587,32544,898743922,36341,6
58499,ZNF462,chr9,F,106860164,107012455,33032878,152291,898896213,36342,15
58524,DMRT3,chr9,F,976967,991736,33047647,14769,898910982,36343,2
59335,PRDM12,chr9,F,130664593,130682997,33066051,18404,898929386,36344,4
60560,NAA35,chr9,F,85941141,86025462,33150372,84321,899013707,36345,26
63951,DMRTA1,chr9,F,22446840,22452473,33156005,5633,899019340,36346,1
64078,SLC28A3,chr9,R,84275849,84368632,33248788,92783,899112123,36347,20
64170,CARD9,chr9,R,136363955,136373681,33258514,9726,899121849,36348,12
64420,SUSD1,chr9,R,112040780,112175520,33393254,134740,899256589,36349,19
64425,POLR1E,chr9,F,37485934,37503697,33411017,17763,899274352,36350,12
64768,IPPK,chr9,R,92613183,92670265,33468099,57082,899331434,36351,13
64794,DDX31,chr9,R,132592996,132670401,33545504,77405,899408839,36352,23
64855,FAM129B,chr9,R,127505337,127579007,33619174,73670,899482509,36353,16
64922,LRRC19,chr9,R,26993135,27005693,33631732,12558,899495067,36354,4
64975,MRPL41,chr9,F,137551856,137552555,33632431,699,899495766,36355,1
65083,NOL6,chr9,R,33461352,33473943,33645022,12591,899508357,36356,25
65268,WNK2,chr9,F,93184154,93320572,33781440,136418,899644775,36357,36
79048,SECISBP2,chr9,F,89318472,89367117,33830085,48645,899693420,36358,21
79095,C9orf16,chr9,F,128159424,128163928,33834589,4504,899697924,36359,2
79109,MAPKAP1,chr9,R,125437393,125707234,34104430,269841,899967765,36360,15
79269,DCAF10,chr9,F,37800553,37867669,34171546,67116,900034881,36361,8
79670,ZCCHC6,chr9,R,86287732,86354501,34238315,66769,900101650,36362,31
79695,GALNT12,chr9,F,98807698,98850081,34280698,42383,900144033,36363,11
79813,EHMT1,chr9,F,137618991,137836127,34497834,217136,900361169,36364,36
79817,MOB3B,chr9,R,27325208,27529852,34702478,204644,900565813,36365,3
79886,CAAP1,chr9,R,26840684,26892828,34754622,52144,900617957,36366,6
79937,CNTNAP3,chr9,R,39070194,39288303,34972731,218109,900836066,36367,24
79956,ERMP1,chr9,R,5764060,5833081,35041752,69021,900905087,36368,17
79987,SVEP1,chr9,R,110365247,110579880,35256385,214633,901119720,36369,47
80010,RMI1,chr9,F,83980719,84004074,35279740,23355,901143075,36370,3
80036,TRPM3,chr9,R,70529062,71446924,36197602,917862,902060937,36371,28
80142,PTGES2,chr9,R,128120692,128128462,36205372,7770,902068707,36372,7
80173,IFT74,chr9,F,26947038,27066129,36324463,119091,902187798,36373,24
80256,FAM214B,chr9,R,35104120,35116351,36336694,12231,902200029,36374,14
80318,GKAP1,chr9,R,83739420,83817837,36415111,78417,902278446,36375,15
80380,PDCD1LG2,chr9,F,5510490,5571282,36475903,60792,902339238,36376,6
80709,AKNA,chr9,R,114334148,114398551,36540306,64403,902403641,36377,31
81571,MIR600HG,chr9,R,123109493,123115477,36546290,5984,902409625,36378,0
81605,URM1,chr9,F,128371318,128392016,36566988,20698,902430323,36379,2
81689,ISCA1,chr9,R,86264545,86282575,36585018,18030,902448353,36380,3
81704,DOCK8,chr9,F,214864,465259,36835413,250395,902698748,36381,52
81873,ARPC5L,chr9,F,124862134,124877733,36851012,15599,902714347,36382,6
81932,HDHD3,chr9,R,113373415,113377009,36854606,3594,902717941,36383,2
83543,AIF1L,chr9,F,131096475,131123152,36881283,26677,902744618,36384,6
83549,UCK1,chr9,R,131523795,131531275,36888763,7480,902752098,36385,7
83744,ZNF484,chr9,R,92842572,92878058,36924249,35486,902787584,36386,6
83856,FSD1L,chr9,F,105442241,105552433,37034441,110192,902897776,36387,17
84131,CEP78,chr9,F,78236061,78271883,37070263,35822,902933598,36388,16
84186,ZCCHC7,chr9,F,37120168,37358149,37308244,237981,903171579,36389,12
84210,ANKRD20A1,chr9,F,67859285,67902394,37351353,43109,903214688,36390,14
84253,GARNL3,chr9,F,127224470,127393549,37520432,169079,903383767,36391,33
84263,HSDL2,chr9,F,112379908,112472405,37612929,92497,903476264,36392,11
84267,C9orf64,chr9,R,83938306,83957067,37631690,18761,903495025,36393,5
84270,C9orf89,chr9,F,93096128,93113283,37648845,17155,903512180,36394,6
84278,HIATL2,chr9,R,96946044,97013580,37716381,67536,903579716,36395,4
84302,TMEM246,chr9,R,101473157,101487221,37730445,14064,903593780,36396,3
84628,NTNG2,chr9,F,132161651,132244534,37813328,82883,903676663,36397,21
84641,HIATL1,chr9,F,94374321,94460920,37899927,86599,903763262,36398,12
84681,HINT2,chr9,R,35812959,35815479,37902447,2520,903765782,36399,5
84688,C9orf24,chr9,R,34379018,34398577,37922006,19559,903785341,36400,7
84720,PIGO,chr9,R,35088687,35096601,37929920,7914,903793255,36401,12
84726,PRRC2B,chr9,F,131430089,131500191,38000022,70102,903863357,36402,30
84814,PPAPDC3,chr9,F,131289681,131309262,38019603,19581,903882938,36403,3
84850,GLIS3-AS1,chr9,F,3898645,3901248,38022206,2603,903885541,36404,1
84885,ZDHHC12,chr9,R,128720868,128724141,38025479,3273,903888814,36405,4
84895,FAM73B,chr9,F,129036604,129072082,38060957,35478,903924292,36406,17
84904,ARHGEF39,chr9,R,35658874,35675738,38077821,16864,903941156,36407,15
84909,C9orf3,chr9,F,94726603,95147311,38498529,420708,904361864,36408,36
84929,FIBCD1,chr9,R,130902437,130939068,38535160,36631,904398495,36409,7
84960,CCDC183,chr9,F,136796337,136807741,38546564,11404,904409899,36410,13
84973,SNHG7,chr9,R,136724593,136728184,38550155,3591,904413490,36411,2
85014,TMEM141,chr9,F,136791324,136793317,38552148,1993,904415483,36412,4
85026,ARRDC1-AS1,chr9,R,137615331,137618895,38555712,3564,904419047,36413,3
85301,COL27A1,chr9,F,114130330,114312516,38737898,182186,904601233,36414,66
85365,ALG2,chr9,R,99216424,99221964,38743438,5540,904606773,36415,2
89846,FGD3,chr9,F,92947318,93036236,38832356,88918,904695691,36416,19
89853,MVB12B,chr9,F,126326843,126507041,39012554,180198,904875889,36417,13
89882,TPD52L3,chr9,F,6328348,6331900,39016106,3552,904879441,36418,1
89891,WDR34,chr9,R,128633660,128656850,39039296,23190,904902631,36419,8
89958,SAPCD2,chr9,R,137062123,137070576,39047749,8453,904911084,36420,6
90120,C9orf69,chr9,R,136110219,136118885,39056415,8666,904919750,36421,3
90678,LRSAM1,chr9,F,127451485,127503501,39108431,52016,904971766,36422,25
90865,IL33,chr9,F,6215148,6257983,39151266,42835,905014601,36423,10
90871,TMEM261,chr9,R,7796489,7799817,39154594,3328,905017929,36424,1
91283,MSANTD3,chr9,F,100427212,100451734,39179116,24522,905042451,36425,5
91373,UAP1L1,chr9,F,137077464,137084538,39186190,7074,905049525,36426,8
92014,SLC25A51,chr9,R,37877574,37904353,39212969,26779,905076304,36427,5
92399,MRRF,chr9,F,122264602,122325297,39273664,60695,905136999,36428,9
92400,RBM18,chr9,R,122239554,122264864,39298974,25310,905162309,36429,7
92714,ARRDC1,chr9,F,137605639,137615360,39308695,9721,905172030,36430,6
92715,DPH7,chr9,R,137554898,137578935,39332732,24037,905196067,36431,12
92949,ADAMTSL1,chr9,F,17906602,18910950,40337080,1004348,906200415,36432,35
92973,LINC00950,chr9,F,35860273,35865518,40342325,5245,906205660,36433,0
94107,TMEM203,chr9,R,137204081,137205638,40343882,1557,906207217,36434,0
113220,KIF12,chr9,R,114091622,114100084,40352344,8462,906215679,36435,18
114224,PRO2852,chr9,F,34186107,34188127,40354364,2020,906217699,36436,0
114299,PALM2,chr9,F,109640787,109951476,40665053,310689,906528388,36437,7
114789,SLC25A25,chr9,F,128068199,128109258,40706112,41059,906569447,36438,12
114987,WDR31,chr9,R,113315264,113340340,40731188,25076,906594523,36439,10
114991,ZNF618,chr9,F,113876281,114056595,40911502,180314,906774837,36440,17
115426,UHRF2,chr9,F,6413147,6507056,41005411,93909,906868746,36441,19
116224,FAM122A,chr9,F,68780047,68783693,41009057,3646,906872392,36442,0
116225,ZMYND19,chr9,R,137582075,137590485,41017467,8410,906880802,36443,6
116443,GRIN3A,chr9,R,101569351,101738580,41186696,169229,907050031,36444,10
117531,TMC1,chr9,F,72521800,72836351,41501247,314551,907364582,36445,28
138065,RNF183,chr9,R,113297092,113303274,41507429,6182,907370764,36446,2
138151,NACC2,chr9,R,136006536,136095285,41596178,88749,907459513,36447,6
138162,C9orf116,chr9,R,135495179,135501832,41602831,6653,907466166,36448,3
138199,C9orf41,chr9,R,74981019,75028486,41650298,47467,907513633,36449,11
138240,C9orf57,chr9,R,72051380,72060605,41659523,9225,907522858,36450,4
138241,C9orf85,chr9,F,71911320,71973459,41721662,62139,907584997,36451,6
138255,C9orf135,chr9,F,69820799,69906237,41807100,85438,907670435,36452,8
138307,LCN8,chr9,R,136754387,136758279,41810992,3892,907674327,36453,3
138311,FAM69B,chr9,F,136712571,136724718,41823139,12147,907686474,36454,6
138428,PTRH1,chr9,R,127713947,127716714,41825906,2767,907689241,36455,4
138429,PIP5KL1,chr9,R,127921528,127930797,41835175,9269,907698510,36456,9
138474,TAF1L,chr9,R,32629453,32635669,41841391,6216,907704726,36457,0
138639,PTPDC1,chr9,F,94030793,94109856,41920454,79063,907783789,36458,14
138649,ANKRD19P,chr9,F,92809610,92838457,41949301,28847,907812636,36459,9
138715,ARID3C,chr9,R,34621285,34628950,41956966,7665,907820301,36460,6
138716,RPP25L,chr9,R,34610484,34612113,41958595,1629,907821930,36461,1
138724,C9orf131,chr9,F,35041094,35045991,41963492,4897,907826827,36462,3
138799,OR13C5,chr9,R,104598456,104599413,41964449,957,907827784,36463,0
138802,OR13C8,chr9,F,104569167,104570130,41965412,963,907828747,36464,0
138803,OR13C3,chr9,R,104535769,104536813,41966456,1044,907829791,36465,0
138804,OR13C4,chr9,R,104526252,104527209,41967413,957,907830748,36466,0
138805,OR13F1,chr9,F,104504262,104505222,41968373,960,907831708,36467,0
138881,OR1L8,chr9,R,122546235,122693914,42116052,147679,907979387,36468,7
138882,OR1N2,chr9,F,122553169,122554162,42117045,993,907980380,36469,0
138883,OR1N1,chr9,R,122526357,122527293,42117981,936,907981316,36470,0
138948,DBH-AS1,chr9,R,133654586,133657408,42120803,2822,907984138,36471,1
140459,ASB6,chr9,R,129634603,129642169,42128369,7566,907991704,36472,5
140803,TRPM6,chr9,R,74722494,74888094,42293969,165600,908157304,36473,46
142680,SLC34A3,chr9,F,137230115,137236554,42300408,6439,908163743,36474,13
152006,RNF38,chr9,R,36336395,36487182,42451195,150787,908314530,36475,16
152007,GLIPR2,chr9,F,36136535,36163913,42478573,27378,908341908,36476,7
153090,DAB2IP,chr9,F,121566882,121785530,42697221,218648,908560556,36477,24
157922,CAMSAP1,chr9,R,135808486,135907251,42795986,98765,908659321,36478,17
157927,C9orf62,chr9,F,135343248,135346562,42799300,3314,908662635,36479,2
157983,C9orf66,chr9,R,213107,215893,42802086,2786,908665421,36480,0
158035,LINC00032,chr9,R,27245683,27282793,42839196,37110,908702531,36481,16
158038,LINGO2,chr9,R,27937616,29213981,44115561,1276365,909978896,36482,21
158046,NXNL2,chr9,F,88535072,88584466,44164955,49394,910028290,36483,5
158055,C9orf163,chr9,F,136483494,136486067,44167528,2573,910030863,36484,0
158056,MAMDC4,chr9,F,136852366,136860799,44175961,8433,910039296,36485,26
158062,LCN6,chr9,R,136744016,136748528,44180473,4512,910043808,36486,6
158067,AK8,chr9,R,132725573,132878811,44333711,153238,910197046,36487,15
158131,OR1Q1,chr9,F,122568379,122615830,44381162,47451,910244497,36488,2
158135,TTLL11,chr9,R,121815673,122093606,44659095,277933,910522430,36489,12
158158,RASEF,chr9,R,82979584,83063177,44742688,83593,910606023,36490,17
158219,TTC39B,chr9,R,15170843,15307360,44879205,136517,910742540,36491,22
158228,FAM201A,chr9,F,38621087,38623284,44881402,2197,910744737,36492,1
158234,TRMT10B,chr9,F,37753203,37778972,44907171,25769,910770506,36493,10
158248,TTC16,chr9,F,127716063,127731600,44922708,15537,910786043,36494,16
158257,MIRLET7DHG,chr9,R,94176568,94204566,44950706,27998,910814041,36495,3
158293,FAM120AOS,chr9,R,93443331,93453592,44960967,10261,910824302,36496,3
158297,SAXO1,chr9,R,18927659,19049354,45082662,121695,910945997,36497,7
158314,LINC00475,chr9,F,92141466,92159608,45100804,18142,910964139,36498,3
158326,FREM1,chr9,R,14734665,14911647,45277786,176982,911141121,36499,44
158358,KIAA2026,chr9,R,5859594,6008479,45426671,148885,911290006,36500,21
158376,LINC00961,chr9,F,35909482,35911620,45428809,2138,911292144,36501,1
158381,ATP8B5P,chr9,F,35406754,35483029,45505084,76275,911368419,36502,17
158399,ZNF483,chr9,F,111524298,111577844,45558630,53546,911421965,36503,8
158401,C9orf84,chr9,R,111686174,111795008,45667464,108834,911530799,36504,33
158405,KIAA1958,chr9,F,112486967,112665311,45845808,178344,911709143,36505,5
158427,TSTD2,chr9,R,97600079,97633680,45879409,33601,911742744,36506,10
158431,ZNF782,chr9,R,96816698,97013673,46076384,196975,911939719,36507,18
158434,LOC158434,chr9,R,96106660,96116411,46086135,9751,911949470,36508,2
158435,LOC158435,chr9,F,96065838,96101912,46122209,36074,911985544,36509,8
158471,PRUNE2,chr9,R,76611375,76906220,46417054,294845,912280389,36510,21
169436,STKLD1,chr9,F,133376412,133406096,46446738,29684,912310073,36511,18
169522,KCNV2,chr9,F,2717238,2730037,46459537,12799,912322872,36512,3
169611,OLFML2A,chr9,F,124777157,124814891,46497271,37734,912360606,36513,10
169693,TMEM252,chr9,R,68530661,68540886,46507496,10225,912370831,36514,2
169714,QSOX2,chr9,R,136206332,136245841,46547005,39509,912410340,36515,11
169792,GLIS3,chr9,R,3824126,4310506,47033385,486380,912896720,36516,18
169834,ZNF883,chr9,R,112997119,113012192,47048458,15073,912911793,36517,4
169841,ZNF169,chr9,F,94259265,94303008,47092201,43743,912955536,36518,5
195827,AAED1,chr9,R,96641250,96655323,47106274,14073,912969609,36519,5
195828,ZNF367,chr9,R,96385940,96418720,47139054,32780,913002389,36520,7
203197,C9orf91,chr9,F,114603941,114646423,47181536,42482,913044871,36521,10
203228,C9orf72,chr9,R,27546545,27573866,47208857,27321,913072192,36522,11
203238,CCDC171,chr9,F,15552873,15971899,47627883,419026,913491218,36523,34
203245,NAIF1,chr9,R,128061232,128067321,47633972,6089,913497307,36524,1
203259,FAM219A,chr9,R,34398183,34458610,47694399,60427,913557734,36525,8
203260,CCDC107,chr9,F,35658281,35661503,47697621,3222,913560956,36526,4
203286,ANKS6,chr9,R,98732008,98796531,47762144,64523,913625479,36527,17
203328,SUSD3,chr9,F,93058687,93085138,47788595,26451,913651930,36528,8
220869,CBWD5,chr9,F,65675833,65734041,47846803,58208,913710138,36529,20
246184,CDC26,chr9,R,113267007,113275589,47855385,8582,913718720,36530,3
253039,PSMD5-AS1,chr9,F,120843041,120854373,47866717,11332,913730052,36531,3
253650,ANKRD18A,chr9,R,38542964,38620655,47944408,77691,913807743,36532,23
254295,PHYHD1,chr9,F,128920894,128942041,47965555,21147,913828890,36533,12
254956,MORN5,chr9,F,122159857,122200088,48005786,40231,913869121,36534,7
254973,OR1L4,chr9,F,122723989,122724925,48006722,936,913870057,36535,0
255220,TXNDC8,chr9,R,110276798,110337887,48067811,61089,913931146,36536,15
256158,HMCN2,chr9,F,130265758,130434123,48236176,168365,914099511,36537,99
256691,MAMDC2,chr9,F,70043518,70226972,48419630,183454,914282965,36538,17
257019,FRMD3,chr9,R,83242989,83538433,48715074,295444,914578409,36539,20
257169,C9orf43,chr9,F,113410643,113429684,48734115,19041,914597450,36540,15
259308,FAM205A,chr9,R,34723052,34729538,48740601,6486,914603936,36541,3
266655,LINC00094,chr9,F,134025438,134031597,48746760,6159,914610095,36542,2
286204,CRB2,chr9,F,123354458,123380335,48772637,25877,914635972,36543,16
286205,SCAI,chr9,R,124942607,125143559,48973589,200952,914836924,36544,20
286207,C9orf117,chr9,F,127706987,127716002,48982604,9015,914845939,36545,9
286223,C9orf47,chr9,F,88990862,88996142,48987884,5280,914851219,36546,2
286234,SPATA31E1,chr9,F,87882856,87888899,48993927,6043,914857262,36547,3
286238,LOC286238,chr9,R,88627067,88652179,49019039,25112,914882374,36548,5
286256,LCN12,chr9,F,136949194,136955498,49025343,6304,914888678,36549,7
286257,C9orf142,chr9,F,136992417,136993976,49026902,1559,914890237,36550,6
286262,TPRN,chr9,R,137191616,137200711,49035997,9095,914899332,36551,3
286297,LOC286297,chr9,R,63112402,63127100,49050695,14698,914914030,36552,3
286319,TUSC1,chr9,R,25676388,25678858,49053165,2470,914916500,36553,0
286333,FAM225A,chr9,F,113112895,113119846,49060116,6951,914923451,36554,2
286336,FAM78A,chr9,R,131258077,131281920,49083959,23843,914947294,36555,4
286343,LURAP1L,chr9,F,12774989,12823060,49132030,48071,914995365,36556,2
286359,LOC286359,chr9,R,97390835,97396691,49137886,5856,915001221,36557,5
286362,OR13C9,chr9,R,104617247,104618204,49138843,957,915002178,36558,0
286365,OR13D1,chr9,F,104694421,104695462,49139884,1041,915003219,36559,0
286370,LOC286370,chr9,R,90020653,90041499,49160730,20846,915024065,36560,3
286380,FOXD4L3,chr9,F,68302866,68305084,49162948,2218,915026283,36561,0
338376,IFNE,chr9,R,21480838,21482313,49164423,1475,915027758,36562,0
340481,ZDHHC21,chr9,R,14555500,14693482,49302405,137982,915165740,36563,12
340485,ACER2,chr9,F,19406010,19452505,49348900,46495,915212235,36564,11
340508,GAS2L1P2,chr9,R,97075670,97081945,49355175,6275,915218510,36565,2
340512,LOC340512,chr9,R,106974832,107102988,49483331,128156,915346666,36566,4
340515,LINC01501,chr9,R,90462431,90582746,49603646,120315,915466981,36567,5
347088,ADGRD2,chr9,F,124451086,124477771,49630331,26685,915493666,36568,22
347127,SPATA31D5P,chr9,F,81913436,81919927,49636822,6491,915500157,36569,3
347148,QRFP,chr9,R,130893427,130893838,49637233,411,915500568,36570,0
347168,OR1J1,chr9,R,122476957,122477926,49638202,969,915501537,36571,0
347169,OR1B1,chr9,R,122628578,122629535,49639159,957,915502494,36572,0
347240,KIF24,chr9,R,34252379,34359914,49746694,107535,915610029,36573,16
347252,IGFBPL1,chr9,R,38406527,38424447,49764614,17920,915627949,36574,4
347273,MURC,chr9,F,100576866,100588402,49776150,11536,915639485,36575,2
349334,FOXD4L4,chr9,F,65737145,65738396,49777401,1251,915640736,36576,0
360203,GLT6D1,chr9,R,135623655,135641216,49794962,17561,915658297,36577,9
375704,ENHO,chr9,R,34521041,34523039,49796960,1998,915660295,36578,1
375719,AQP7P1,chr9,R,63315242,63334520,49816238,19278,915679573,36579,3
375743,PTAR1,chr9,R,69709521,69760044,49866761,50523,915730096,36580,7
375748,ERCC6L2,chr9,F,95875617,96120476,50111620,244859,915974955,36581,26
375757,SWI5,chr9,F,128275383,128288989,50125226,13606,915988561,36582,6
375759,C9orf50,chr9,R,129612224,129622275,50135277,10051,915998612,36583,10
375775,PNPLA7,chr9,R,137459471,137550895,50226701,91424,916090036,36584,37
375791,CYSRT1,chr9,F,137224634,137226311,50228378,1677,916091713,36585,1
377841,ENTPD8,chr9,R,137434363,137441662,50235677,7299,916099012,36586,11
387628,KGFLP1,chr9,F,62376255,62435519,50294941,59264,916158276,36587,3
389705,LOC389705,chr9,F,14993326,15019724,50321339,26398,916184674,36588,4
389715,FAM205BP,chr9,R,34830266,34838586,50329659,8320,916192994,36589,3
389730,SPATA31A6,chr9,F,42183658,42189887,50335888,6229,916199223,36590,3
389741,GLIDR,chr9,R,39803495,39810159,50342552,6664,916205887,36591,1
389761,SPATA31D4,chr9,F,81928427,81934998,50349123,6571,916212458,36592,3
389762,SPATA31D3,chr9,F,81943499,81950094,50355718,6595,916219053,36593,3
389763,SPATA31D1,chr9,F,81987666,81995256,50363308,7590,916226643,36594,3
389765,LOC389765,chr9,F,85806001,85842879,50400186,36878,916263521,36595,8
389766,C9orf153,chr9,R,86220264,86259657,50439579,39393,916302914,36596,5
389791,PTGES2-AS1,chr9,F,128128528,128130634,50441685,2106,916305020,36597,0
389792,IER5L,chr9,R,129175551,129178261,50444395,2710,916307730,36598,0
389799,C9orf171,chr9,F,132410042,132573319,50607672,163277,916471007,36599,8
389812,LCN15,chr9,R,136759633,136770114,50618153,10481,916481488,36600,8
389813,C9orf172,chr9,F,136844414,136847345,50621084,2931,916484419,36601,0
389816,LRRC26,chr9,R,137168757,137170039,50622366,1282,916485701,36602,1
389827,TMEM8C,chr9,R,133514585,133528606,50636387,14021,916499722,36603,5
392307,FAM221B,chr9,R,35817016,35833805,50653176,16789,916516511,36604,10
392309,OR13J1,chr9,R,35869462,35870401,50654115,939,916517450,36605,0
392360,CTSL3P,chr9,F,87772914,87786884,50668085,13970,916531420,36606,4
392364,LOC392364,chr9,R,87858042,87859056,50669099,1014,916532434,36607,0
392376,OR13C2,chr9,R,104604670,104605627,50670056,957,916533391,36608,0
392390,OR1L6,chr9,F,122749847,122750783,50670992,936,916534327,36609,0
392391,OR5C1,chr9,F,122788932,122789895,50671955,963,916535290,36610,0
392392,OR1K1,chr9,F,122800122,122801073,50672906,951,916536241,36611,0
392399,LCN9,chr9,F,135663321,135666769,50676354,3448,916539689,36612,5
399665,FAM102A,chr9,R,127940581,127981027,50716800,40446,916580135,36613,13
399693,MGC50722,chr9,R,136266537,136306901,50757164,40364,916620499,36614,17
401491,VLDLR-AS1,chr9,R,2535651,2622373,50843886,86722,916707221,36615,3
401492,LINC01235,chr9,R,13406379,13431329,50868836,24950,916732171,36616,2
401494,HACD4,chr9,R,21003620,21031670,50896886,28050,916760221,36617,11
401497,LINC01242,chr9,R,30388934,30408454,50916406,19520,916779741,36618,2
401498,TMEM215,chr9,F,32783498,32789201,50922109,5703,916785444,36619,1
401505,TOMM5,chr9,R,37588412,37592639,50926336,4227,916789671,36620,1
401507,FAM74A1,chr9,F,39371064,39376916,50932188,5852,916795523,36621,1
401508,FAM74A4,chr9,F,61205259,61212373,50939302,7114,916802637,36622,2
401509,ZNF658B,chr9,R,39443814,39464526,50960014,20712,916823349,36623,4
401535,C9orf170,chr9,F,87148643,87159726,50971097,11083,916834432,36624,1
401541,CENPP,chr9,F,92325456,92615164,51260805,289708,917124140,36625,14
401546,C9orf152,chr9,R,110199560,110208133,51269378,8573,917132713,36626,2
401548,SNX30,chr9,F,112749724,112875851,51395505,126127,917258840,36627,11
401551,WDR38,chr9,F,124853346,124857891,51400050,4545,917263385,36628,9
401554,LOC401554,chr9,R,130140314,130144225,51403961,3911,917267296,36629,1
401557,LOC401557,chr9,F,135181608,135187306,51409659,5698,917272994,36630,2
401561,LINC01451,chr9,R,136612027,136617065,51414697,5038,917278032,36631,3
401562,LCNL1,chr9,F,136982992,136985758,51417463,2766,917280798,36632,2
401563,C9orf139,chr9,F,137027463,137037767,51427767,10304,917291102,36633,4
401565,FAM166A,chr9,R,137243582,137251193,51435378,7611,917298713,36634,8
402381,SOHLH1,chr9,R,135693406,135701316,51443288,7910,917306623,36635,8
403313,PPAPDC2,chr9,F,4662293,4665274,51446269,2981,917309604,36636,0
403323,LOC403323,chr9,R,62857855,62898087,51486501,40232,917349836,36637,6
403341,ZBTB34,chr9,F,126860664,126885878,51511715,25214,917375050,36638,3
404770,SPATA31B1P,chr9,R,82057541,82063724,51517898,6183,917381233,36639,3
406881,MIRLET7A1,chr9,F,94175956,94176036,51517978,80,917381313,36640,0
406886,MIRLET7D,chr9,F,94178833,94178920,51518065,87,917381400,36641,0
406888,MIRLET7F1,chr9,F,94176346,94176433,51518152,87,917381487,36642,0
406894,MIR101-2,chr9,F,4850296,4850375,51518231,79,917381566,36643,0
406913,MIR126,chr9,F,136670601,136670686,51518316,85,917381651,36644,0
406939,MIR147A,chr9,R,120244978,120245050,51518388,72,917381723,36645,0
406954,MIR181A2,chr9,F,124692441,124692551,51518498,110,917381833,36646,0
406956,MIR181B2,chr9,F,124693709,124693798,51518587,89,917381922,36647,0
406978,MIR199B,chr9,R,128244720,128244830,51518697,110,917382032,36648,0
406987,MIR204,chr9,R,70809974,70810084,51518807,110,917382142,36649,0
407003,MIR219A2,chr9,R,128392617,128392714,51518904,97,917382239,36650,0
407011,MIR23B,chr9,F,95085207,95085304,51519001,97,917382336,36651,0
407012,MIR24-1,chr9,F,95086020,95086088,51519069,68,917382404,36652,0
407019,MIR27B,chr9,F,95085444,95085541,51519166,97,917382501,36653,0
407035,MIR31,chr9,R,21512114,21512185,51519237,71,917382572,36654,0
407036,MIR32,chr9,R,109046228,109046298,51519307,70,917382642,36655,0
407043,MIR7-1,chr9,R,83969747,83969857,51519417,110,917382752,36656,0
414316,COL5A1-AS1,chr9,R,134649384,134653029,51523062,3645,917386397,36657,1
414318,C9orf106,chr9,F,129321015,129322603,51524650,1588,917387985,36658,1
414319,LINC00587,chr9,F,102519636,102657509,51662523,137873,917525858,36659,4
414328,IDNK,chr9,F,83623048,83644130,51683605,21082,917546940,36660,7
414332,LCN10,chr9,R,136738166,136742959,51688398,4793,917551733,36661,5
415056,CNTFR-AS1,chr9,F,34568011,34583072,51703459,15061,917566794,36662,1
440173,LOC440173,chr9,R,87008450,87042126,51737135,33676,917600470,36663,1
440896,LOC440896,chr9,R,41100984,41107812,51743963,6828,917607298,36664,3
441389,LINC01239,chr9,F,22646199,22824213,51921977,178014,917785312,36665,5
441394,SUGT1P1,chr9,R,33500755,33511166,51932388,10411,917795723,36666,6
441425,ANKRD20A3,chr9,R,66104343,66153187,51981232,48844,917844567,36667,16
441430,ANKRD20A2,chr9,F,40223077,40282461,52040616,59384,917903951,36668,19
441432,AQP7P3,chr9,F,65877573,65912560,52075603,34987,917938938,36669,3
441452,SPATA31C1,chr9,F,87913935,87923657,52085325,9722,917948660,36670,4
441454,LOC441454,chr9,F,96909074,96910455,52086706,1381,917950041,36671,0
441455,LOC441455,chr9,F,96725820,96727467,52088353,1647,917951688,36672,0
441457,NUTM2G,chr9,F,96929003,96942290,52101640,13287,917964975,36673,7
441459,ANKRD18B,chr9,F,33524352,33575969,52153257,51617,918016592,36674,21
441461,STX17-AS1,chr9,R,99886316,99906601,52173542,20285,918036877,36675,2
441476,C9orf173,chr9,F,137250839,137253483,52176186,2644,918039521,36676,6
441478,NRARP,chr9,R,137299630,137302251,52178807,2621,918042142,36677,0
442421,PTGER4P2-CDK2AP2P2,chr9,F,62838444,62847206,52187569,8762,918050904,36678,1
442425,FOXB2,chr9,F,77019654,77020953,52188868,1299,918052203,36679,0
445571,CBWD3,chr9,F,68241865,68300035,52247038,58170,918110373,36680,17
445577,C9orf129,chr9,R,93318198,93346414,52275254,28216,918138589,36681,4
445815,PALM2-AKAP2,chr9,F,109780296,110172512,52667470,392216,918530805,36682,5
493913,PAPPA-AS1,chr9,R,116398156,116400606,52669920,2450,918533255,36683,0
494127,LOC494127,chr9,R,87083885,87085225,52671260,1340,918534595,36684,0
494558,C9orf135-AS1,chr9,R,69819404,69820739,52672595,1335,918535930,36685,1
497256,LOC497256,chr9,R,87844516,87847764,52675843,3248,918539178,36686,3
548645,DNAJC25,chr9,F,111631351,111654351,52698843,23000,918562178,36687,4
552891,DNAJC25-GNG10,chr9,F,111631351,111670246,52737738,38895,918601073,36688,2
554202,MIR31HG,chr9,R,21454267,21559698,52843169,105431,918706504,36689,3
554249,LOC554249,chr9,F,39873856,39875395,52844708,1539,918708043,36690,1
572558,PGM5-AS1,chr9,R,68355163,68357866,52847411,2703,918710746,36691,2
574444,MIR491,chr9,F,20716104,20716188,52847495,84,918710830,36692,0
595135,PGM5P2,chr9,R,41007010,41074625,52915110,67615,918778445,36693,8
613206,LOC613206,chr9,R,124258584,124261310,52917836,2726,918781171,36694,1
619556,MIR455,chr9,F,114209433,114209529,52917932,96,918781267,36695,0
641373,NRON,chr9,R,126407774,126410504,52920662,2730,918783997,36696,0
642236,LOC642236,chr9,R,63832048,63858641,52947255,26593,918810590,36697,8
642515,LOC642515,chr9,F,131549602,131559199,52956852,9597,918820187,36698,3
642929,LOC642929,chr9,R,66159958,66164906,52961800,4948,918825135,36699,4
642943,LOC642943,chr9,F,92882566,92889555,52968789,6989,918832124,36700,3
642968,FAM163B,chr9,R,133577075,133609920,53001634,32845,918864969,36701,8
643210,EHMT1-IT1,chr9,F,137763021,137764772,53003385,1751,918866720,36702,0
643224,TUBBP5,chr9,F,138150112,138177433,53030706,27321,918894041,36703,4
643596,RNF224,chr9,F,137227565,137229640,53032781,2075,918896116,36704,2
643648,LINC01189,chr9,F,62452489,62522018,53102310,69529,918965645,36705,4
643827,CNTNAP3P2,chr9,F,67059459,67294592,53337443,235133,919200778,36706,23
644019,CBWD6,chr9,R,41131308,41189364,53395499,58056,919258834,36707,14
644249,LOC644249,chr9,F,67903027,67920548,53413020,17521,919276355,36708,5
644316,FLJ43315,chr9,F,64016949,64061612,53457683,44663,919321018,36709,6
645961,SPATA31C2,chr9,R,88129304,88134985,53463364,5681,919326699,36710,3
646962,HRCT1,chr9,F,35906191,35907141,53464314,950,919327649,36711,0
647060,SPATA31A1,chr9,F,39355666,39361962,53470610,6296,919333945,36712,3
652972,LRRC37A5P,chr9,R,111602830,111613553,53481333,10723,919344668,36713,2
653123,FAM74A6,chr9,F,60929781,60935727,53487279,5946,919350614,36714,2
653162,RPSAP9,chr9,F,76398598,76400038,53488719,1440,919352054,36715,0
653404,FOXD4L6,chr9,R,41126250,41128975,53491444,2725,919354779,36716,0
653427,FOXD4L5,chr9,R,65282100,65285209,53494553,3109,919357888,36717,0
654466,KGFLP2,chr9,R,39813783,39874566,53555336,60783,919418671,36718,2
654835,FAM138C,chr9,R,34393,35864,53556807,1471,919420142,36719,2
677776,SCARNA8,chr9,R,19063655,19063786,53556938,131,919420273,36720,0
677804,SNORA17,chr9,R,136726746,136726879,53557071,133,919420406,36721,0
677824,SNORA43,chr9,R,136726103,136726237,53557205,134,919420540,36722,0
692093,SNORD62B,chr9,F,131490485,131490571,53557291,86,919420626,36723,0
692094,MSMP,chr9,R,35752989,35754277,53558579,1288,919421914,36724,2
692206,SNORD90,chr9,R,122880212,122880319,53558686,107,919422021,36725,0
693185,MIR600,chr9,R,123111545,123111643,53558784,98,919422119,36726,0
693186,MIR601,chr9,R,123402524,123402603,53558863,79,919422198,36727,0
693187,MIR602,chr9,F,137838418,137838516,53558961,98,919422296,36728,0
727800,RNF208,chr9,R,137220246,137221323,53560038,1077,919423373,36729,0
727830,SPATA31A3,chr9,R,66986300,66992550,53566288,6250,919429623,36730,4
727905,SPATA31A5,chr9,F,60914371,60920653,53572570,6282,919435905,36731,3
728026,LOC728026,chr9,R,94347116,94347586,53573040,470,919436375,36732,0
728489,DNLZ,chr9,R,136361899,136363811,53574952,1912,919438287,36733,2
728495,FAM74A3,chr9,R,66970161,66977317,53582108,7156,919445443,36734,1
728577,CNTNAP3B,chr9,R,41890920,42129504,53820692,238584,919684027,36735,25
728673,LOC728673,chr9,F,62897375,62899777,53823094,2402,919686429,36736,1
728747,ANKRD20A4,chr9,F,64369562,64412691,53866223,43129,919729558,36737,14
730098,LOC730098,chr9,R,34665027,34666050,53867246,1023,919730581,36738,2
730112,FAM166B,chr9,R,35561829,35563899,53869316,2070,919732651,36739,5
100009607,TRH-GTG1-9,chr9,R,14433939,14434011,53869388,72,919732723,36740,0
100048912,CDKN2B-AS1,chr9,F,21994790,22121097,53995695,126307,919859030,36741,20
100113379,SNORD121A,chr9,R,33952763,33952854,53995786,91,919859121,36742,0
100113404,LINC00583,chr9,F,13927970,13945607,54013423,17637,919876758,36743,2
100124534,SNORA84,chr9,R,92292460,92292593,54013556,133,919876891,36744,0
100124538,SNORA70C,chr9,R,117181065,117181201,54013692,136,919877027,36745,0
100126310,MIR876,chr9,R,28863625,28863706,54013773,81,919877108,36746,0
100126316,MIR873,chr9,R,28888878,28888955,54013850,77,919877185,36747,0
100128076,LOC100128076,chr9,F,92132833,92138629,54019646,5796,919882981,36748,12
100128361,LOC100128361,chr9,F,92618049,92620533,54022130,2484,919885465,36749,0
100128385,FAM225B,chr9,R,113104722,113111677,54029085,6955,919892420,36750,2
100128505,ASTN2-AS1,chr9,F,116504282,116562293,54087096,58011,919950431,36751,11
100128593,LOC100128593,chr9,F,136746160,136749911,54090847,3751,919954182,36752,2
100128782,LINC00476,chr9,R,95806087,95875977,54160737,69890,920024072,36753,4
100129034,LOC100129034,chr9,F,124353472,124359186,54166451,5714,920029786,36754,0
100129066,UNQ6494,chr9,F,89639782,89719759,54246428,79977,920109763,36755,5
100129250,TOPORS-AS1,chr9,F,32551143,32566860,54262145,15717,920125480,36756,5
100129316,LOC100129316,chr9,R,91063293,91075132,54273984,11839,920137319,36757,3
100129347,LINC00484,chr9,F,91118604,91182719,54338099,64115,920201434,36758,4
100129385,C9orf92,chr9,R,16203934,16276313,54410478,72379,920273813,36759,4
100129669,IZUMO3,chr9,R,24543213,24545930,54413195,2717,920276530,36760,6
100129722,C9orf173-AS1,chr9,R,137250218,137253497,54416474,3279,920279809,36761,3
100130548,LOC100130548,chr9,F,134054289,134059139,54421324,4850,920284659,36762,2
100130954,LINC01502,chr9,F,135574924,135587112,54433512,12188,920296847,36763,5
100131193,CCDC183-AS1,chr9,R,136803926,136808848,54438434,4922,920301769,36764,4
100131997,FAM27E3,chr9,R,67717497,67719179,54440116,1682,920303451,36765,1
100132004,LOC100132004,chr9,R,40754861,40768065,54453320,13204,920316655,36766,5
100132077,LOC100132077,chr9,F,94332475,94360948,54481793,28473,920345128,36767,2
100132154,LOC100132154,chr9,R,64878466,64889049,54492376,10583,920355711,36768,4
100132167,LOC100132167,chr9,R,39984322,39989420,54497474,5098,920360809,36769,2
100132249,LOC100132249,chr9,R,62834246,62838368,54501596,4122,920364931,36770,0
100132352,LOC100132352,chr9,F,40992336,41014139,54523399,21803,920386734,36771,5
100132403,FAM157B,chr9,F,138215350,138252775,54560824,37425,920424159,36772,15
100132541,GXYLT1P3,chr9,F,40348498,40353658,54565984,5160,920429319,36773,3
100132781,LOC100132781,chr9,F,96868899,96872228,54569313,3329,920432648,36774,1
100132874,LOC100132874,chr9,F,61982795,61986927,54573445,4132,920436780,36775,0
100132948,FAM27C,chr9,F,61854083,61855340,54574702,1257,920438037,36776,1
100133036,FAM95B1,chr9,F,40323570,40329220,54580352,5650,920443687,36777,4
100133077,LOC100133077,chr9,R,137867924,137892570,54604998,24646,920468333,36778,3
100133121,FAM27B,chr9,R,67725482,67726743,54606259,1261,920469594,36779,1
100133204,C9orf147,chr9,R,112469662,112490453,54627050,20791,920490385,36780,4
100151684,RNU6ATAC,chr9,R,134164439,134164564,54627175,125,920490510,36781,0
100188917,ESP33,chr9,F,136249310,136252057,54629922,2747,920493257,36782,1
100188953,LINC00092,chr9,R,96019731,96021755,54631946,2024,920495281,36783,1
100189025,TRR-TCG6-1,chr9,F,110198522,110198595,54632019,73,920495354,36784,0
100189109,TRR-TCT3-2,chr9,R,128340075,128340166,54632110,91,920495445,36785,1
100272217,LOC100272217,chr9,R,130577349,130579494,54634255,2145,920497590,36786,0
100286938,VPS13A-AS1,chr9,R,77176755,77177917,54635417,1162,920498752,36787,1
100287171,WASH1,chr9,R,14510,30487,54651394,15977,920514729,36788,14
100287596,DDX11L5,chr9,F,11986,14525,54653933,2539,920517268,36789,2
100288842,LOC100288842,chr9,F,120793496,120798731,54659168,5235,920522503,36790,1
100289019,SLC25A25-AS1,chr9,R,128111170,128118734,54666732,7564,920530067,36791,4
100289124,FAM27E2,chr9,F,41647673,41649440,54668499,1767,920531834,36792,0
100289137,FAM95C,chr9,R,38540566,38545372,54673305,4806,920536640,36793,2
100289279,LOC100289279,chr9,F,61330591,61461342,54804056,130751,920667391,36794,10
100289341,MAN1B1-AS1,chr9,R,137084945,137086817,54805928,1872,920669263,36795,0
100302167,MIR1299,chr9,R,40929009,40929092,54806011,83,920669346,36796,0
100302223,MIR1302-8,chr9,R,97363553,97363681,54806139,128,920669474,36797,0
100313780,MIR2278,chr9,F,94809961,94810057,54806235,96,920669570,36798,0
100379345,MIR181A2HG,chr9,F,124658435,124698628,54846428,40193,920709763,36799,1
100422831,MIR1302-9,chr9,F,30143,30281,54846566,138,920709901,36800,0
100422842,MIR3074,chr9,R,95086013,95086094,54846647,81,920709982,36801,0
100422860,MIR4292,chr9,F,136830956,136831023,54846714,67,920710049,36802,0
100422869,MIR3152,chr9,F,18573305,18573379,54846788,74,920710123,36803,0
100422893,MIR3154,chr9,R,128244946,128245030,54846872,84,920710207,36804,0
100422910,MIR2861,chr9,F,127785917,127786007,54846962,90,920710297,36805,0
100422927,MIR4291,chr9,F,93819356,93819421,54847027,65,920710362,36806,0
100422936,MIR3153,chr9,F,89312224,89312306,54847109,82,920710444,36807,0
100422963,MIR4290,chr9,R,90023440,90023535,54847204,95,920710539,36808,0
100423015,MIR4289,chr9,R,88745835,88745905,54847274,70,920710609,36809,0
100499483,CCDC180,chr9,F,97307627,97377295,54916942,69668,920780277,36810,50
100499484,LOC100499484,chr9,F,97238425,97297314,54975831,58889,920839166,36811,15
100500811,MIR3621,chr9,R,137169185,137169270,54975916,85,920839251,36812,0
100500821,MIR3910-1,chr9,F,91636250,91636361,54976027,111,920839362,36813,0
100500846,MIR3689A,chr9,R,134849486,134849564,54976105,78,920839440,36814,0
100500872,MIR3911,chr9,R,127690686,127690795,54976214,109,920839549,36815,0
100500898,MIR3927,chr9,R,109511474,109511545,54976285,71,920839620,36816,0
100500902,MIR3910-2,chr9,R,91636263,91636345,54976367,82,920839702,36817,0
100500906,MIR3689B,chr9,R,134850124,134850272,54976515,148,920839850,36818,0
100500918,MIR3651,chr9,R,92292457,92292547,54976605,90,920839940,36819,0
100505478,LOC100505478,chr9,R,114666433,114682089,54992261,15656,920855596,36820,6
100505588,LOC100505588,chr9,R,124007674,124009396,54993983,1722,920857318,36821,1
100505993,TMEM210,chr9,R,137170927,137172046,54995102,1119,920858437,36822,3
100506100,LOC100506100,chr9,F,128724461,128733243,55003884,8782,920867219,36823,1
100506119,LINC01503,chr9,F,129336922,129347477,55014439,10555,920877774,36824,3
100506190,LINC00963,chr9,F,129488659,129513686,55039466,25027,920902801,36825,4
100506331,LOC100506331,chr9,F,15887291,15892688,55044863,5397,920908198,36826,2
100506422,LOC100506422,chr9,F,26066674,26118408,55096597,51734,920959932,36827,6
100506532,LOC100506532,chr9,F,134486280,134545232,55155549,58952,921018884,36828,5
100506599,PPP1R26-AS1,chr9,R,135462717,135472249,55165081,9532,921028416,36829,2
100506710,EBLN3,chr9,F,37079895,37090401,55175587,10506,921038922,36830,1
100506834,LOC100506834,chr9,F,86948697,87002033,55228923,53336,921092258,36831,6
100507103,LOC100507103,chr9,R,91104956,91165723,55289690,60767,921153025,36832,4
100507244,MAMDC2-AS1,chr9,R,70153133,70175888,55312445,22755,921175780,36833,3
100507299,SMC5-AS1,chr9,R,70216058,70258874,55355261,42816,921218596,36834,3
100507346,LOC100507346,chr9,F,95463608,95470019,55361672,6411,921225007,36835,3
100507415,FAM220CP,chr9,F,97120400,97123015,55364287,2615,921227622,36836,0
100507540,LINC01504,chr9,F,72305435,72343210,55402062,37775,921265397,36837,4
100526694,MSANTD3-TMEFF1,chr9,F,100441905,100577636,55537793,135731,921401128,36838,9
100616114,MIR4668,chr9,F,111932099,111932169,55537863,70,921401198,36839,0
100616131,MIR3689D1,chr9,R,134849608,134849682,55537937,74,921401272,36840,0
100616184,MIR4477A,chr9,F,41233754,41233835,55538018,81,921401353,36841,0
100616194,MIR4477B,chr9,F,63819573,63819654,55538099,81,921401434,36842,0
100616212,MIR3689F,chr9,R,134850741,134850807,55538165,66,921401500,36843,0
100616214,MIR4667,chr9,F,35608093,35608159,55538231,66,921401566,36844,0
100616229,MIR4473,chr9,R,20411147,20411238,55538322,91,921401657,36845,0
100616236,MIR4669,chr9,F,134379410,134379472,55538384,62,921401719,36846,0
100616242,MIR4673,chr9,R,136519567,136519626,55538443,59,921401778,36847,0
100616250,MIR3960,chr9,F,127785832,127785923,55538534,91,921401869,36848,0
100616278,MIR4540,chr9,R,36864253,36864308,55538589,55,921401924,36849,0
100616288,MIR4665,chr9,F,6007825,6007904,55538668,79,921402003,36850,0
100616289,MIR4475,chr9,R,36823538,36823599,55538729,61,921402064,36851,0
100616301,MIR4674,chr9,R,136546172,136546259,55538816,87,921402151,36852,0
100616312,MIR4478,chr9,R,122120081,122120167,55538902,86,921402237,36853,0
100616333,MIR3689C,chr9,R,134849297,134849369,55538974,72,921402309,36854,0
100616335,MIR219B,chr9,F,128392620,128392708,55539062,88,921402397,36855,0
100616344,MIR3689D2,chr9,R,134850276,134850356,55539142,80,921402477,36856,0
100616351,MIR4670,chr9,R,92527983,92528058,55539217,75,921402552,36857,0
100616429,MIR4672,chr9,R,127869414,127869495,55539298,81,921402633,36858,0
100616441,MIR4474,chr9,R,20502264,20502342,55539376,78,921402711,36859,0
100616456,MIR4476,chr9,R,36893461,36893531,55539446,70,921402781,36860,0
100616460,MIR3689E,chr9,R,134850569,134850641,55539518,72,921402853,36861,0
100616480,MIR4479,chr9,F,136886732,136886803,55539589,71,921402924,36862,0
100846992,MIR548AW,chr9,F,132945706,132945771,55539654,65,921402989,36863,0
100847045,MIR548AU,chr9,F,93594840,93594894,55539708,54,921403043,36864,0
100873746,RNU6-14P,chr9,R,15776180,15776286,55539814,106,921403149,36865,0
100885775,BANCR,chr9,R,69296680,69307056,55550190,10376,921413525,36866,3
100996569,NAMA,chr9,R,99355339,99375257,55570108,19918,921433443,36867,9
100996574,LOC100996574,chr9,R,133058028,133061567,55573647,3539,921436982,36868,1
100996582,FAM74A7,chr9,F,42198861,42206016,55580802,7155,921444137,36869,1
100996590,LINC01505,chr9,F,106616057,106679802,55644547,63745,921507882,36870,6
100996643,LOC100996643,chr9,F,63334546,63378132,55688133,43586,921551468,36871,8
101060026,LOC101060026,chr9,F,42896306,42955499,55747326,59193,921610661,36872,12
101060445,LOC101060445,chr9,F,32459520,32474910,55762716,15390,921626051,36873,2
101243555,PTENP1-AS,chr9,F,33677267,33688011,55773460,10744,921636795,36874,3
101340252,SNORD121B,chr9,R,33934296,33934375,55773539,79,921636874,36875,0
101448202,LOC101448202,chr9,R,134819414,134872618,55826743,53204,921690078,36876,1
101926900,DNAJB5-AS1,chr9,R,34985409,34989379,55830713,3970,921694048,36877,1
101926917,LOC101926917,chr9,R,97148126,97221318,55903905,73192,921767240,36878,19
101926948,LOC101926948,chr9,F,35646119,35647476,55905262,1357,921768597,36879,1
101927015,LINC01506,chr9,R,68543540,68546602,55908324,3062,921771659,36880,3
101927024,LOC101927024,chr9,R,38694289,38720073,55934108,25784,921797443,36881,2
101927042,LOC101927042,chr9,F,38949646,38998503,55982965,48857,921846300,36882,5
101927069,LOC101927069,chr9,R,68953087,68975841,56005719,22754,921869054,36883,2
101927086,LOC101927086,chr9,F,70418591,70608272,56195400,189681,922058735,36884,6
101927108,LOC101927108,chr9,F,72030059,72090328,56255669,60269,922119004,36885,9
101927191,LOC101927191,chr9,R,72557603,72577348,56275414,19745,922138749,36886,5
101927234,LOC101927234,chr9,R,72514008,72527998,56289404,13990,922152739,36887,3
101927258,LINC01474,chr9,R,72871727,72874109,56291786,2382,922155121,36888,3
101927281,LOC101927281,chr9,F,73259285,73371260,56403761,111975,922267096,36889,7
101927304,LOC101927304,chr9,F,73594207,73608354,56417908,14147,922281243,36890,2
101927329,LOC101927329,chr9,R,74123038,74275363,56570233,152325,922433568,36891,5
101927358,LOC101927358,chr9,F,74371530,74383530,56582233,12000,922445568,36892,2
101927380,C9orf41-AS1,chr9,F,74952964,74997382,56626651,44418,922489986,36893,4
101927422,GNA14-AS1,chr9,F,77447648,77526762,56705765,79114,922569100,36894,4
101927450,LOC101927450,chr9,R,79135421,79145666,56716010,10245,922579345,36895,4
101927477,LINC01507,chr9,F,79824529,80034555,56926036,210026,922789371,36896,5
101927502,LOC101927502,chr9,F,81689712,81776900,57013224,87188,922876559,36897,3
101927529,LOC101927529,chr9,F,83888147,83891288,57016365,3141,922879700,36898,2
101927552,LOC101927552,chr9,F,83817665,83859339,57058039,41674,922921374,36899,13
101927575,LOC101927575,chr9,F,84063442,84094601,57089198,31159,922952533,36900,8
101927602,LOC101927602,chr9,R,67365441,67414309,57138066,48868,923001401,36901,4
101927603,LOC101927603,chr9,R,85534066,85538371,57142371,4305,923005706,36902,1
101927623,LOC101927623,chr9,F,86127539,86157086,57171918,29547,923035253,36903,4
101927680,LOC101927680,chr9,R,88031752,88066151,57206317,34399,923069652,36904,4
101927737,LOC101927737,chr9,F,41958345,41961535,57209507,3190,923072842,36905,1
101927748,LOC101927748,chr9,R,61213964,61220196,57215739,6232,923079074,36906,1
101927804,LOC101927804,chr9,F,42842678,42845860,57218921,3182,923082256,36907,2
101927823,LOC101927823,chr9,F,89817827,89821753,57222847,3926,923086182,36908,1
101927827,LOC101927827,chr9,R,42579804,42586534,57229577,6730,923092912,36909,2
101927847,LOC101927847,chr9,F,89969415,89987486,57247648,18071,923110983,36910,2
101927873,LINC01508,chr9,R,90300895,90433489,57380242,132594,923243577,36911,2
101927916,LOC101927916,chr9,R,91484277,91487307,57383272,3030,923246607,36912,1
101927935,LOC101927935,chr9,R,91851928,91853248,57384592,1320,923247927,36913,2
101927954,LOC101927954,chr9,R,93008114,93014944,57391422,6830,923254757,36914,2
101927993,LOC101927993,chr9,R,93091405,93095543,57395560,4138,923258895,36915,3
101928014,LOC101928014,chr9,F,93808374,93858327,57445513,49953,923308848,36916,2
101928099,PCAT7,chr9,F,94555044,94568141,57458610,13097,923321945,36917,2
101928109,LOC101928109,chr9,R,134161922,134172059,57468747,10137,923332082,36918,1
101928119,LOC101928119,chr9,R,94920338,94937841,57486250,17503,923349585,36919,2
101928193,LOC101928193,chr9,F,133189785,133192966,57489431,3181,923352766,36920,1
101928195,LOC101928195,chr9,R,65820965,65878507,57546973,57542,923410308,36921,12
101928337,PTCSC2,chr9,R,97709919,97853093,57690147,143174,923553482,36922,7
101928381,LOC101928381,chr9,F,65791120,65802027,57701054,10907,923564389,36923,4
101928384,LOC101928384,chr9,F,134219084,134220108,57702078,1024,923565413,36924,1
101928408,LOC101928408,chr9,R,97986550,97988501,57704029,1951,923567364,36925,1
101928438,LOC101928438,chr9,R,99585785,99819889,57938133,234104,923801468,36926,6
101928470,TMEM246-AS1,chr9,F,101468438,101481506,57951201,13068,923814536,36927,4
101928483,LINC01573,chr9,F,136547841,136549744,57953104,1903,923816439,36928,2
101928496,LINC01492,chr9,R,103140527,103325033,58137610,184506,924000945,36929,9
101928523,LOC101928523,chr9,F,103999708,104000482,58138384,774,924001719,36930,1
101928525,LOC101928525,chr9,R,135503272,135506447,58141559,3175,924004894,36931,2
101928550,SMC2-AS1,chr9,R,104080023,104092474,58154010,12451,924017345,36932,2
101928608,LOC101928608,chr9,F,67832800,67853880,58175090,21080,924038425,36933,11
101928609,LOC101928609,chr9,R,105198636,105245168,58221622,46532,924084957,36934,4
101928612,LOC101928612,chr9,R,136648609,136660463,58233476,11854,924096811,36935,1
101928638,PRR31,chr9,F,136968885,136976820,58241411,7935,924104746,36936,8
101928645,LOC101928645,chr9,F,136117030,136121839,58246220,4809,924109555,36937,1
101928720,LINC01509,chr9,R,107420283,107466585,58292522,46302,924155857,36938,7
101928722,LOC101928722,chr9,R,136252192,136266525,58306855,14333,924170190,36939,9
101928748,LOC101928748,chr9,R,115119538,115138409,58325726,18871,924189061,36940,5
101928775,LOC101928775,chr9,R,115739669,115744239,58330296,4570,924193631,36941,2
101928786,LOC101928786,chr9,R,138040502,138045071,58334865,4569,924198200,36942,2
101928797,LOC101928797,chr9,F,117648605,117657027,58343287,8422,924206622,36943,5
101928849,LOC101928849,chr9,F,118852060,118980425,58471652,128365,924334987,36944,8
101928876,LOC101928876,chr9,F,121453965,121463330,58481017,9365,924344352,36945,2
101928906,LOC101928906,chr9,R,41651665,41655197,58484549,3532,924347884,36946,3
101928932,LOC101928932,chr9,R,138199932,138203453,58488070,3521,924351405,36947,1
101929014,LOC101929014,chr9,F,125410222,125412453,58490301,2231,924353636,36948,2
101929116,LOC101929116,chr9,R,126270123,126275915,58496093,5792,924359428,36949,2
101929127,PGM5P3-AS1,chr9,F,72689,88826,58512230,16137,924375565,36950,4
101929157,PGM5P3,chr9,R,45107,73177,58540300,28070,924403635,36951,2
101929179,LOC101929179,chr9,R,100993,114247,58553554,13254,924416889,36952,5
101929247,LINC01231,chr9,F,3181588,3200500,58572466,18912,924435801,36953,4
101929249,LOC101929249,chr9,R,128392008,128395466,58575924,3458,924439259,36954,1
101929270,LOC101929270,chr9,R,128528656,128543478,58590746,14822,924454081,36955,3
101929291,LOC101929291,chr9,R,128909330,128915390,58596806,6060,924460141,36956,2
101929302,RFX3-AS1,chr9,F,3668085,3691756,58620477,23671,924483812,36957,4
101929314,LOC101929314,chr9,R,128993653,129006564,58633388,12911,924496723,36958,3
101929331,LOC101929331,chr9,F,129282415,129285719,58636692,3304,924500027,36959,2
101929351,CDC37L1-AS1,chr9,R,4676599,4679480,58639573,2881,924502908,36960,1
101929407,PTPRD-AS1,chr9,F,8858017,8861727,58643283,3710,924506618,36961,2
101929428,PTPRD-AS2,chr9,F,10613205,10620420,58650498,7215,924513833,36962,2
101929437,PRRX2-AS1,chr9,R,129712890,129719224,58656832,6334,924520167,36963,1
101929446,LOC101929446,chr9,R,11826181,11835013,58665664,8832,924528999,36964,2
101929467,LURAP1L-AS1,chr9,R,12699998,12814389,58780055,114391,924643390,36965,3
101929507,LOC101929507,chr9,R,13808297,14031280,59003038,222983,924866373,36966,2
101929519,LOC101929519,chr9,R,93667341,93673250,59008947,5909,924872282,36967,0
101929548,FOCAD-AS1,chr9,R,20683301,20684750,59010396,1449,924873731,36968,1
101929563,LOC101929563,chr9,R,23500690,23672399,59182105,171709,925045440,36969,27
101929582,LINC01241,chr9,F,25780055,25812968,59215018,32913,925078353,36970,5
101929583,LOC101929583,chr9,F,64638744,64711065,59287339,72321,925150674,36971,4
101929602,IFT74-AS1,chr9,R,26955779,26956307,59287867,528,925151202,36972,1
101929620,LINC01243,chr9,R,31371610,31381490,59297747,9880,925161082,36973,1
101929639,B4GALT1-AS1,chr9,F,33166947,33179983,59310783,13036,925174118,36974,5
101929688,LINC01251,chr9,R,33732974,33738416,59316225,5442,925179560,36975,1
101929748,LOC101929748,chr9,R,92805384,92808644,59319485,3260,925182820,36976,1
101929800,LOC101929800,chr9,F,68321049,68330436,59328872,9387,925192207,36977,9
101929860,LOC101929860,chr9,R,41731956,41733513,59330429,1557,925193764,36978,2
101929959,LOC101929959,chr9,R,40463753,40584232,59450908,120479,925314243,36979,13
101930026,LOC101930026,chr9,F,61917496,61973057,59506469,55561,925369804,36980,3
101930048,LOC101930048,chr9,R,2494264,2507110,59519315,12846,925382650,36981,4
101930053,LOC101930053,chr9,R,2423857,2494223,59589681,70366,925453016,36982,5
101930090,LOC101930090,chr9,R,61063581,61114015,59640115,50434,925503450,36983,8
101930307,LOC101930307,chr9,F,137101683,137104460,59642892,2777,925506227,36984,2
102465431,MIR6722,chr9,R,136746892,136746970,59642970,78,925506305,36985,0
102465512,MIR6851,chr9,R,33467868,33467935,59643037,67,925506372,36986,0
102465513,MIR6852,chr9,R,35710675,35710741,59643103,66,925506438,36987,0
102465514,MIR6854,chr9,R,98229148,98229217,59643172,69,925506507,36988,0
102465515,MIR6856,chr9,F,130626296,130626363,59643239,67,925506574,36989,0
102465528,MIR6877,chr9,F,133051995,133052059,59643303,64,925506638,36990,0
102465688,MIR7150,chr9,R,123485528,123485622,59643397,94,925506732,36991,0
102465800,MIR7702,chr9,R,111271155,111271214,59643456,59,925506791,36992,0
102465995,MIR8081,chr9,F,106600927,106601022,59643551,95,925506886,36993,0
102466201,MIR6853,chr9,F,35732921,35732995,59643625,74,925506960,36994,0
102466223,MIR7114,chr9,R,137450025,137450086,59643686,61,925507021,36995,0
102466518,MIR6081,chr9,F,95065349,95065446,59643783,97,925507118,36996,0
102466750,MIR6855,chr9,F,129869604,129869671,59643850,67,925507185,36997,0
102723309,LOC102723309,chr9,F,120541604,120546266,59648512,4662,925511847,36998,1
102723324,LOC102723324,chr9,F,121370443,121390665,59668734,20222,925532069,36999,4
102723412,LOC102723412,chr9,F,66332779,66348269,59684224,15490,925547559,37000,2
102723468,LOC102723468,chr9,F,125537796,125557920,59704348,20124,925567683,37001,5
102723566,LOC102723566,chr9,F,127816065,127817166,59705449,1101,925568784,37002,0
102723624,LOC102723624,chr9,R,68341959,68351098,59714588,9139,925577923,37003,4
102723678,LOC102723678,chr9,R,61865631,61869154,59718111,3523,925581446,37004,2
102723709,LOC102723709,chr9,F,67711676,67713733,59720168,2057,925583503,37005,2
102723720,LOC102723720,chr9,R,61943098,61945588,59722658,2490,925585993,37006,3
102723803,LOC102723803,chr9,F,1298289,1489023,59913392,190734,925776727,37007,13
102723850,LOC102723850,chr9,F,73452881,73464022,59924533,11141,925787868,37008,2
102723855,LOC102723855,chr9,F,133494940,133500627,59930220,5687,925793555,37009,2
102723932,LOC102723932,chr9,R,79517872,79567765,59980113,49893,925843448,37010,3
102723948,LOC102723948,chr9,F,135162460,135167123,59984776,4663,925848111,37011,4
102723971,LOC102723971,chr9,F,135614221,135619893,59990448,5672,925853783,37012,5
102723989,LOC102723989,chr9,F,83219299,83270833,60041982,51534,925905317,37013,3
102723994,LOC102723994,chr9,R,7343890,7346337,60044429,2447,925907764,37014,2
102724027,LOC102724027,chr9,R,11143879,11195441,60095991,51562,925959326,37015,5
102724036,LOC102724036,chr9,F,84409800,84656485,60342676,246685,926206011,37016,23
102724057,LOC102724057,chr9,R,85756135,85805341,60391882,49206,926255217,37017,11
102724080,LOC102724080,chr9,F,86414219,86452686,60430349,38467,926293684,37018,3
102724090,LOC102724090,chr9,R,86948027,86948519,60430841,492,926294176,37019,1
102724102,LOC102724102,chr9,R,18657651,18694384,60467574,36733,926330909,37020,3
102724156,LOC102724156,chr9,R,88066434,88072796,60473936,6362,926337271,37021,1
102724193,LOC102724193,chr9,F,136649000,136653923,60478859,4923,926342194,37022,2
102724216,LOC102724216,chr9,F,33730174,33748743,60497428,18569,926360763,37023,6
102724237,LOC102724237,chr9,R,89664914,89672876,60505390,7962,926368725,37024,1
102724238,LOC102724238,chr9,R,62375327,62376870,60506933,1543,926370268,37025,1
102724271,LOC102724271,chr9,R,90973803,91000414,60533544,26611,926396879,37026,5
102724322,LOC102724322,chr9,F,36257844,36299529,60575229,41685,926438564,37027,6
102724394,LOC102724394,chr9,F,138273124,138275506,60577611,2382,926440946,37028,2
102724431,LOC102724431,chr9,F,40189070,40214200,60602741,25130,926466076,37029,9
102724478,LOC102724478,chr9,F,95550538,95565938,60618141,15400,926481476,37030,2
102724507,LOC102724507,chr9,R,65132443,65144175,60629873,11732,926493208,37031,9
102724580,LOC102724580,chr9,F,40497864,40635468,60767477,137604,926630812,37032,19
102724581,LOC102724581,chr9,F,65385612,65396023,60777888,10411,926641223,37033,3
102724684,LOC102724684,chr9,R,98868987,98877335,60786236,8348,926649571,37034,2
102724690,LOC102724690,chr9,F,41649664,41653021,60789593,3357,926652928,37035,2
102724739,LOC102724739,chr9,F,41787104,41822008,60824497,34904,926687832,37036,2
102724761,LOC102724761,chr9,F,104906208,104922762,60841051,16554,926704386,37037,4
102724818,LOC102724818,chr9,F,42834174,42840920,60847797,6746,926711132,37038,3
102724904,LOC102724904,chr9,F,43126348,43153730,60875179,27382,926738514,37039,8
102724929,LOC102724929,chr9,R,118644337,118732791,60963633,88454,926826968,37040,7
102724966,LOC102724966,chr9,F,120048191,120066999,60982441,18808,926845776,37041,3
102800446,LINC01230,chr9,F,1048142,1048641,60982940,499,926846275,37042,0
103352539,LINC01410,chr9,F,62801464,62813486,60994962,12022,926858297,37043,4
103752585,RORB-AS1,chr9,R,74473434,74498553,61020081,25119,926883416,37044,4
103908605,LOC103908605,chr9,R,42567858,42569349,61021572,1491,926884907,37045,1
105369200,LOC105369200,chr9,R,87930513,87939304,61030363,8791,926893698,37046,3
105369216,LOC105369216,chr9,R,88036865,88039819,61033317,2954,926896652,37047,0
105369235,LOC105369235,chr9,F,67642929,67644461,61034849,1532,926898184,37048,2
105369249,LOC105369249,chr9,F,40214212,40217916,61038553,3704,926901888,37049,2
105369289,LOC105369289,chr9,F,26676134,26681023,61043442,4889,926906777,37050,2
105369291,LOC105369291,chr9,F,15502171,15510091,61051362,7920,926914697,37051,2
105369293,LOC105369293,chr9,R,18413747,18437554,61075169,23807,926938504,37052,4
105369298,LOC105369298,chr9,R,23482778,23484534,61076925,1756,926940260,37053,2
105369303,LOC105369303,chr9,F,18437901,18439277,61078301,1376,926941636,37054,1
105375942,LOC105375942,chr9,R,131972,133872,61080201,1900,926943536,37055,1
105375943,LOC105375943,chr9,R,190713,199142,61088630,8429,926951965,37056,3
105375944,LOC105375944,chr9,R,453774,470124,61104980,16350,926968315,37057,5
105375945,LOC105375945,chr9,R,355800,364395,61113575,8595,926976910,37058,2
105375946,LOC105375946,chr9,R,252824,275616,61136367,22792,926999702,37059,4
105375947,LOC105375947,chr9,R,500661,504242,61139948,3581,927003283,37060,1
105375948,LOC105375948,chr9,R,746995,763189,61156142,16194,927019477,37061,2
105375949,LOC105375949,chr9,R,805235,826756,61177663,21521,927040998,37062,2
105375950,LOC105375950,chr9,R,971947,976558,61182274,4611,927045609,37063,0
105375951,LOC105375951,chr9,F,1948312,1962500,61196462,14188,927059797,37064,2
105375952,LOC105375952,chr9,R,1927368,1930259,61199353,2891,927062688,37065,2
105375953,LOC105375953,chr9,R,1912497,1918715,61205571,6218,927068906,37066,2
105375954,LOC105375954,chr9,F,2243774,2246216,61208013,2442,927071348,37067,1
105375955,LOC105375955,chr9,F,2289116,2296883,61215780,7767,927079115,37068,3
105375956,LOC105375956,chr9,F,2407792,2431600,61239588,23808,927102923,37069,2
105375957,LOC105375957,chr9,R,2652926,2667976,61254638,15050,927117973,37070,3
105375958,LOC105375958,chr9,R,3198915,3203621,61259344,4706,927122679,37071,2
105375959,LOC105375959,chr9,R,3194303,3196066,61261107,1763,927124442,37072,2
105375960,LOC105375960,chr9,F,3663426,3665653,61263334,2227,927126669,37073,1
105375962,LOC105375962,chr9,F,3791782,3802626,61274178,10844,927137513,37074,3
105375963,LOC105375963,chr9,F,3806394,3809509,61277293,3115,927140628,37075,2
105375964,LOC105375964,chr9,F,3971800,3994658,61300151,22858,927163486,37076,2
105375965,LOC105375965,chr9,R,4347051,4431600,61384700,84549,927248035,37077,2
105375966,LOC105375966,chr9,R,4540096,4544846,61389450,4750,927252785,37078,3
105375967,LOC105375967,chr9,R,5577020,5628911,61441341,51891,927304676,37079,3
105375968,LOC105375968,chr9,F,6704272,6707780,61444849,3508,927308184,37080,2
105375969,LOC105375969,chr9,F,7176076,7210817,61479590,34741,927342925,37081,9
105375970,LOC105375970,chr9,F,7304569,7344574,61519595,40005,927382930,37082,3
105375971,LOC105375971,chr9,R,7914542,7961227,61566280,46685,927429615,37083,8
105375972,LOC105375972,chr9,F,9799391,9803795,61570684,4404,927434019,37084,2
105375973,LOC105375973,chr9,F,10685372,10696693,61582005,11321,927445340,37085,2
105375974,LOC105375974,chr9,R,11253968,11502598,61830635,248630,927693970,37086,6
105375975,LOC105375975,chr9,R,11610221,11618749,61839163,8528,927702498,37087,2
105375976,LOC105375976,chr9,R,12098789,12159115,61899489,60326,927762824,37088,4
105375977,LOC105375977,chr9,F,13440906,13487526,61946109,46620,927809444,37089,3
105375978,LOC105375978,chr9,R,14588796,14602832,61960145,14036,927823480,37090,1
105375979,LOC105375979,chr9,F,14779928,14795530,61975747,15602,927839082,37091,3
105375980,LOC105375980,chr9,R,14987171,14993254,61981830,6083,927845165,37092,4
105375981,LOC105375981,chr9,F,15147000,15165105,61999935,18105,927863270,37093,3
105375982,LOC105375982,chr9,F,16705521,16722471,62016885,16950,927880220,37094,2
105375983,LOC105375983,chr9,F,17014077,17112857,62115665,98780,927979000,37095,6
105375984,LOC105375984,chr9,R,18904788,18926403,62137280,21615,928000615,37096,4
105375985,LOC105375985,chr9,R,18889760,18901103,62148623,11343,928011958,37097,4
105375986,LOC105375986,chr9,R,18797057,18800642,62152208,3585,928015543,37098,2
105375987,LOC105375987,chr9,R,17902146,17907280,62157342,5134,928020677,37099,1
105375988,LOC105375988,chr9,F,19470454,19562872,62249760,92418,928113095,37100,7
105375989,LOC105375989,chr9,F,21030487,21054169,62273442,23682,928136777,37101,4
105375990,LOC105375990,chr9,R,22917084,22934992,62291350,17908,928154685,37102,1
105375991,LOC105375991,chr9,F,22956845,22962233,62296738,5388,928160073,37103,2
105375992,LOC105375992,chr9,F,23826427,23830193,62300504,3766,928163839,37104,2
105375993,LOC105375993,chr9,F,23851159,23949656,62399001,98497,928262336,37105,4
105375994,LOC105375994,chr9,F,24531280,24543670,62411391,12390,928274726,37106,4
105375995,LOC105375995,chr9,R,25412621,25419763,62418533,7142,928281868,37107,2
105375996,LOC105375996,chr9,R,25541924,25570050,62446659,28126,928309994,37108,2
105375997,LOC105375997,chr9,R,25581176,25588569,62454052,7393,928317387,37109,2
105375998,LOC105375998,chr9,R,26328495,26346259,62471816,17764,928335151,37110,2
105375999,LOC105375999,chr9,R,26410978,26426874,62487712,15896,928351047,37111,3
105376000,LOC105376000,chr9,R,26721262,26724931,62491381,3669,928354716,37112,2
105376001,LOC105376001,chr9,R,27496254,27498430,62493557,2176,928356892,37113,1
105376002,LOC105376002,chr9,F,27664331,27684227,62513453,19896,928376788,37114,2
105376003,LOC105376003,chr9,F,28619947,28657726,62551232,37779,928414567,37115,2
105376004,LOC105376004,chr9,F,28539714,28601495,62613013,61781,928476348,37116,7
105376005,LOC105376005,chr9,R,29593123,29597311,62617201,4188,928480536,37117,2
105376006,LOC105376006,chr9,R,29717573,29729544,62629172,11971,928492507,37118,1
105376007,LOC105376007,chr9,R,29832532,29882712,62679352,50180,928542687,37119,2
105376008,LOC105376008,chr9,R,30271681,30349696,62757367,78015,928620702,37120,1
105376009,LOC105376009,chr9,R,31119065,31128552,62766854,9487,928630189,37121,2
105376010,LOC105376010,chr9,F,31578617,31606119,62794356,27502,928657691,37122,3
105376011,LOC105376011,chr9,R,31882442,31917022,62828936,34580,928692271,37123,8
105376012,LOC105376012,chr9,F,31848685,31978375,62958626,129690,928821961,37124,2
105376013,LOC105376013,chr9,R,31836542,31849205,62971289,12663,928834624,37125,2
105376014,LOC105376014,chr9,R,32448444,32454942,62977787,6498,928841122,37126,3
105376015,LOC105376015,chr9,R,32603906,32609001,62982882,5095,928846217,37127,1
105376016,LOC105376016,chr9,F,32738970,32767437,63011349,28467,928874684,37128,6
105376017,LOC105376017,chr9,R,32679858,32783241,63114732,103383,928978067,37129,10
105376018,LOC105376018,chr9,R,33348792,33351595,63117535,2803,928980870,37130,1
105376019,LOC105376019,chr9,F,33290609,33294413,63121339,3804,928984674,37131,2
105376020,LOC105376020,chr9,F,33401678,33410280,63129941,8602,928993276,37132,4
105376021,LOC105376021,chr9,R,33490736,33491594,63130799,858,928994134,37133,1
105376022,LOC105376022,chr9,F,34416929,34424860,63138730,7931,929002065,37134,2
105376023,LOC105376023,chr9,F,34568989,34571027,63140768,2038,929004103,37135,2
105376024,LOC105376024,chr9,R,34667386,34668804,63142186,1418,929005521,37136,1
105376025,LOC105376025,chr9,R,35013290,35024751,63153647,11461,929016982,37137,3
105376026,LOC105376026,chr9,R,35491135,35491732,63154244,597,929017579,37138,1
105376027,LOC105376027,chr9,R,35899269,35904820,63159795,5551,929023130,37139,2
105376028,LOC105376028,chr9,R,36206880,36214010,63166925,7130,929030260,37140,1
105376029,LOC105376029,chr9,R,36392187,36397037,63171775,4850,929035110,37141,2
105376030,LOC105376030,chr9,F,36779757,36825728,63217746,45971,929081081,37142,3
105376031,LOC105376031,chr9,F,37027763,37031333,63221316,3570,929084651,37143,1
105376032,LOC105376032,chr9,F,37002779,37007642,63226179,4863,929089514,37144,2
105376033,LOC105376033,chr9,F,37161530,37187276,63251925,25746,929115260,37145,2
105376034,LOC105376034,chr9,R,37110957,37120088,63261056,9131,929124391,37146,2
105376035,LOC105376035,chr9,F,37365825,37421411,63316642,55586,929179977,37147,7
105376036,LOC105376036,chr9,R,37380679,37395211,63331174,14532,929194509,37148,4
105376037,LOC105376037,chr9,R,37789045,37798671,63340800,9626,929204135,37149,1
105376038,LOC105376038,chr9,R,37942288,37948490,63347002,6202,929210337,37150,2
105376039,LOC105376039,chr9,R,38070281,38074639,63351360,4358,929214695,37151,3
105376040,LOC105376040,chr9,R,38354892,38376369,63372837,21477,929236172,37152,3
105376041,LOC105376041,chr9,F,38424610,38432384,63380611,7774,929243946,37153,2
105376042,LOC105376042,chr9,F,38502038,38504347,63382920,2309,929246255,37154,1
105376043,LOC105376043,chr9,F,38848586,38871999,63406333,23413,929269668,37155,3
105376044,LOC105376044,chr9,R,38901174,38903556,63408715,2382,929272050,37156,3
105376045,LOC105376045,chr9,F,39321341,39322285,63409659,944,929272994,37157,2
105376046,LOC105376046,chr9,R,39674634,39680966,63415991,6332,929279326,37158,2
105376047,LOC105376047,chr9,R,40106731,40110189,63419449,3458,929282784,37159,1
105376048,LOC105376048,chr9,R,40044872,40048713,63423290,3841,929286625,37160,1
105376049,LOC105376049,chr9,R,39951808,39962655,63434137,10847,929297472,37161,2
105376050,LOC105376050,chr9,F,39897457,40001428,63538108,103971,929401443,37162,8
105376051,LOC105376051,chr9,F,39858099,39863825,63543834,5726,929407169,37163,2
105376052,LOC105376052,chr9,F,40415933,40432901,63560802,16968,929424137,37164,2
105376053,LOC105376053,chr9,R,40375669,40387219,63572352,11550,929435687,37165,2
105376054,LOC105376054,chr9,F,40355508,40363850,63580694,8342,929444029,37166,2
105376055,LOC105376055,chr9,R,40348753,40417393,63649334,68640,929512669,37167,3
105376056,LOC105376056,chr9,F,40708763,40711900,63652471,3137,929515806,37168,1
105376057,LOC105376057,chr9,F,41212195,41219978,63660254,7783,929523589,37169,5
105376058,LOC105376058,chr9,F,41080488,41089629,63669395,9141,929532730,37170,3
105376059,LOC105376059,chr9,F,41025449,41036403,63680349,10954,929543684,37171,2
105376060,LOC105376060,chr9,R,41264100,41274051,63690300,9951,929553635,37172,1
105376061,LOC105376061,chr9,F,42569299,42614282,63735283,44983,929598618,37173,2
105376062,LOC105376062,chr9,R,42506453,42507610,63736440,1157,929599775,37174,1
105376063,LOC105376063,chr9,F,41759329,41764976,63742087,5647,929605422,37175,3
105376064,LOC105376064,chr9,R,41683258,41699071,63757900,15813,929621235,37176,2
105376065,LOC105376065,chr9,R,41500063,41565697,63823534,65634,929686869,37177,6
105376066,LOC105376066,chr9,F,41356259,41438754,63906029,82495,929769364,37178,14
105376067,LOC105376067,chr9,R,43092107,43093868,63907790,1761,929771125,37179,1
105376068,LOC105376068,chr9,R,38620800,38622698,63909688,1898,929773023,37180,2
105376069,LOC105376069,chr9,R,68466270,68468985,63912403,2715,929775738,37181,1
105376070,LOC105376070,chr9,R,68371721,68406622,63947304,34901,929810639,37182,4
105376071,LOC105376071,chr9,R,68626283,68635090,63956111,8807,929819446,37183,2
105376072,LOC105376072,chr9,F,68541046,68644441,64059506,103395,929922841,37184,4
105376073,LOC105376073,chr9,R,68823925,68835766,64071347,11841,929934682,37185,2
105376074,LOC105376074,chr9,R,69392262,69399279,64078364,7017,929941699,37186,1
105376075,LOC105376075,chr9,R,69756579,69759709,64081494,3130,929944829,37187,2
105376076,LOC105376076,chr9,F,69760080,69799066,64120480,38986,929983815,37188,4
105376077,LOC105376077,chr9,R,69817190,69820640,64123930,3450,929987265,37189,2
105376078,LOC105376078,chr9,F,70671065,70676221,64129086,5156,929992421,37190,2
105376079,LOC105376079,chr9,R,70466029,70470570,64133627,4541,929996962,37191,2
105376080,LOC105376080,chr9,F,72478110,72485301,64140818,7191,930004153,37192,2
105376081,LOC105376081,chr9,R,73090354,73113916,64164380,23562,930027715,37193,4
105376082,LOC105376082,chr9,R,73240386,73259135,64183129,18749,930046464,37194,5
105376083,LOC105376083,chr9,R,73411653,73430915,64202391,19262,930065726,37195,6
105376084,LOC105376084,chr9,F,73411628,73452886,64243649,41258,930106984,37196,5
105376085,LOC105376085,chr9,F,73573614,73579780,64249815,6166,930113150,37197,2
105376086,LOC105376086,chr9,F,73924034,73938958,64264739,14924,930128074,37198,3
105376087,LOC105376087,chr9,R,74345605,74371417,64290551,25812,930153886,37199,2
105376088,LOC105376088,chr9,R,74630705,74642433,64302279,11728,930165614,37200,4
105376089,LOC105376089,chr9,R,74921136,74927985,64309128,6849,930172463,37201,3
105376090,LOC105376090,chr9,F,75151634,75180672,64338166,29038,930201501,37202,3
105376091,LOC105376091,chr9,F,75852852,75879360,64364674,26508,930228009,37203,2
105376092,LOC105376092,chr9,R,76218618,76233440,64379496,14822,930242831,37204,2
105376093,LOC105376093,chr9,F,76515627,76565728,64429597,50101,930292932,37205,5
105376094,LOC105376094,chr9,F,76644890,76678115,64462822,33225,930326157,37206,6
105376095,LOC105376095,chr9,F,76605854,76644806,64501774,38952,930365109,37207,7
105376096,LOC105376096,chr9,R,77034898,77055130,64522006,20232,930385341,37208,3
105376097,LOC105376097,chr9,R,78861066,78881933,64542873,20867,930406208,37209,5
105376098,LOC105376098,chr9,F,79728663,79733869,64548079,5206,930411414,37210,2
105376099,LOC105376099,chr9,R,79985219,79987899,64550759,2680,930414094,37211,2
105376100,LOC105376100,chr9,F,79887959,79892009,64554809,4050,930418144,37212,1
105376101,LOC105376101,chr9,R,79862206,79887883,64580486,25677,930443821,37213,4
105376102,LOC105376102,chr9,R,80269528,80304971,64615929,35443,930479264,37214,2
105376103,LOC105376103,chr9,F,80360124,80451467,64707272,91343,930570607,37215,2
105376104,LOC105376104,chr9,F,80617998,80642381,64731655,24383,930594990,37216,2
105376105,LOC105376105,chr9,R,80870109,80871206,64732752,1097,930596087,37217,2
105376106,LOC105376106,chr9,F,81587787,81590158,64735123,2371,930598458,37218,1
105376107,LOC105376107,chr9,F,81977176,82426373,65184320,449197,931047655,37219,8
105376108,LOC105376108,chr9,R,81961101,81977698,65200917,16597,931064252,37220,5
105376109,LOC105376109,chr9,R,81877081,81911614,65235450,34533,931098785,37221,3
105376110,LOC105376110,chr9,R,82531051,82540408,65244807,9357,931108142,37222,2
105376111,LOC105376111,chr9,F,82451610,82455231,65248428,3621,931111763,37223,3
105376112,LOC105376112,chr9,R,83065212,83074143,65257359,8931,931120694,37224,1
105376113,LOC105376113,chr9,R,83573851,83585798,65269306,11947,931132641,37225,2
105376114,LOC105376114,chr9,F,83707834,83713496,65274968,5662,931138303,37226,2
105376115,LOC105376115,chr9,R,83719179,83734087,65289876,14908,931153211,37227,1
105376116,LOC105376116,chr9,F,84278312,84290136,65301700,11824,931165035,37228,2
105376117,LOC105376117,chr9,R,84825478,84832791,65309013,7313,931172348,37229,1
105376118,LOC105376118,chr9,R,85030440,85040934,65319507,10494,931182842,37230,5
105376119,LOC105376119,chr9,R,85261553,85289479,65347433,27926,931210768,37231,4
105376120,LOC105376120,chr9,R,85482159,85485364,65350638,3205,931213973,37232,2
105376121,LOC105376121,chr9,R,85401358,85479962,65429242,78604,931292577,37233,2
105376122,LOC105376122,chr9,R,85526166,85529187,65432263,3021,931295598,37234,2
105376123,LOC105376123,chr9,F,86590918,86595010,65436355,4092,931299690,37235,2
105376124,LOC105376124,chr9,R,86669271,86708305,65475389,39034,931338724,37236,3
105376125,LOC105376125,chr9,F,86751036,86758048,65482401,7012,931345736,37237,1
105376126,LOC105376126,chr9,R,87220387,87280515,65542529,60128,931405864,37238,6
105376127,LOC105376127,chr9,R,87384845,87386759,65544443,1914,931407778,37239,2
105376128,LOC105376128,chr9,R,87751752,87759256,65551947,7504,931415282,37240,2
105376129,LOC105376129,chr9,F,87824672,87833420,65560695,8748,931424030,37241,2
105376130,LOC105376130,chr9,R,87847982,87853395,65566108,5413,931429443,37242,3
105376131,LOC105376131,chr9,F,87974080,87994235,65586263,20155,931449598,37243,3
105376132,LOC105376132,chr9,F,87967133,87968871,65588001,1738,931451336,37244,1
105376133,LOC105376133,chr9,F,88113636,88179227,65653592,65591,931516927,37245,7
105376134,LOC105376134,chr9,R,88527959,88534100,65659733,6141,931523068,37246,1
105376135,LOC105376135,chr9,F,88652026,88652623,65660330,597,931523665,37247,1
105376136,LOC105376136,chr9,R,89288577,89311105,65682858,22528,931546193,37248,3
105376137,LOC105376137,chr9,F,89527556,89556920,65712222,29364,931575557,37249,3
105376138,LOC105376138,chr9,R,89565906,89574565,65720881,8659,931584216,37250,2
105376139,LOC105376139,chr9,R,89598782,89604896,65726995,6114,931590330,37251,1
105376140,LOC105376140,chr9,R,89696900,89702412,65732507,5512,931595842,37252,3
105376141,LOC105376141,chr9,F,89654415,89662115,65740207,7700,931603542,37253,1
105376142,LOC105376142,chr9,F,90158809,90161228,65742626,2419,931605961,37254,2
105376143,LOC105376143,chr9,F,90931900,90934309,65745035,2409,931608370,37255,4
105376144,LOC105376144,chr9,F,90997706,91001881,65749210,4175,931612545,37256,2
105376145,LOC105376145,chr9,R,91119141,91125134,65755203,5993,931618538,37257,1
105376146,LOC105376146,chr9,F,91424703,91427140,65757640,2437,931620975,37258,1
105376147,LOC105376147,chr9,R,91691892,91718922,65784670,27030,931648005,37259,3
105376148,LOC105376148,chr9,R,91966545,91986056,65804181,19511,931667516,37260,1
105376149,LOC105376149,chr9,F,92621620,92631713,65814274,10093,931677609,37261,1
105376150,LOC105376150,chr9,F,93133011,93148244,65829507,15233,931692842,37262,2
105376151,LOC105376151,chr9,F,93321230,93327581,65835858,6351,931699193,37263,1
105376152,LOC105376152,chr9,R,94144668,94147468,65838658,2800,931701993,37264,1
105376153,LOC105376153,chr9,R,94361250,94374815,65852223,13565,931715558,37265,1
105376154,LOC105376154,chr9,F,94309960,94323998,65866261,14038,931729596,37266,2
105376155,LOC105376155,chr9,R,95355307,95367189,65878143,11882,931741478,37267,1
105376156,LOC105376156,chr9,R,95387441,95426832,65917534,39391,931780869,37268,3
105376157,LOC105376157,chr9,R,95523218,95550471,65944787,27253,931808122,37269,4
105376158,LOC105376158,chr9,R,95599492,95603968,65949263,4476,931812598,37270,2
105376159,LOC105376159,chr9,R,96024346,96027963,65952880,3617,931816215,37271,1
105376160,LOC105376160,chr9,R,95852071,95869580,65970389,17509,931833724,37272,1
105376161,LOC105376161,chr9,F,95764921,95776282,65981750,11361,931845085,37273,3
105376162,LOC105376162,chr9,F,96245434,96263454,65999770,18020,931863105,37274,5
105376163,LOC105376163,chr9,F,96599430,96614270,66014610,14840,931877945,37275,4
105376164,LOC105376164,chr9,F,96620027,96621416,66015999,1389,931879334,37276,2
105376165,LOC105376165,chr9,F,97222571,97234983,66028411,12412,931891746,37277,3
105376166,LOC105376166,chr9,R,97128241,97130679,66030849,2438,931894184,37278,2
105376167,LOC105376167,chr9,F,97396117,97409352,66044084,13235,931907419,37279,2
105376168,LOC105376168,chr9,R,97513031,97516842,66047895,3811,931911230,37280,2
105376169,LOC105376169,chr9,F,97786665,97793879,66055109,7214,931918444,37281,1
105376170,LOC105376170,chr9,F,97682436,97683355,66056028,919,931919363,37282,1
105376171,LOC105376171,chr9,R,97633921,97636453,66058560,2532,931921895,37283,2
105376172,LOC105376172,chr9,F,97985126,97993713,66067147,8587,931930482,37284,2
105376173,LOC105376173,chr9,F,98697533,98701700,66071314,4167,931934649,37285,2
105376174,LOC105376174,chr9,F,99184322,99185536,66072528,1214,931935863,37286,1
105376175,LOC105376175,chr9,F,99665595,99750922,66157855,85327,932021190,37287,3
105376176,LOC105376176,chr9,F,100016603,100033095,66174347,16492,932037682,37288,3
105376177,LOC105376177,chr9,F,100353035,100390489,66211801,37454,932075136,37289,5
105376178,LOC105376178,chr9,R,100471134,100472968,66213635,1834,932076970,37290,2
105376179,LOC105376179,chr9,F,100805619,100852621,66260637,47002,932123972,37291,5
105376180,LOC105376180,chr9,F,100891624,100898673,66267686,7049,932131021,37292,2
105376181,LOC105376181,chr9,F,100901511,100906823,66272998,5312,932136333,37293,3
105376182,LOC105376182,chr9,R,101226764,101238760,66284994,11996,932148329,37294,2
105376183,LOC105376183,chr9,R,101213669,101222768,66294093,9099,932157428,37295,4
105376184,LOC105376184,chr9,F,101443041,101459046,66310098,16005,932173433,37296,2
105376185,LOC105376185,chr9,R,101527773,101533727,66316052,5954,932179387,37297,2
105376186,LOC105376186,chr9,F,101595105,101597925,66318872,2820,932182207,37298,1
105376187,LOC105376187,chr9,R,101822503,101848699,66345068,26196,932208403,37299,2
105376188,LOC105376188,chr9,F,102216900,102236462,66364630,19562,932227965,37300,3
105376189,LOC105376189,chr9,F,102236531,102259725,66387824,23194,932251159,37301,3
105376190,LOC105376190,chr9,R,102503403,102514607,66399028,11204,932262363,37302,2
105376191,LOC105376191,chr9,R,103126740,103129179,66401467,2439,932264802,37303,2
105376192,LOC105376192,chr9,R,103916595,103926196,66411068,9601,932274403,37304,2
105376193,LOC105376193,chr9,R,103956314,103999643,66454397,43329,932317732,37305,10
105376194,LOC105376194,chr9,F,104270223,104281266,66465440,11043,932328775,37306,2
105376195,LOC105376195,chr9,F,104392444,104463583,66536579,71139,932399914,37307,10
105376196,LOC105376196,chr9,F,104927176,104939050,66548453,11874,932411788,37308,2
105376197,LOC105376197,chr9,F,105091514,105154960,66611899,63446,932475234,37309,3
105376198,LOC105376198,chr9,R,105181440,105194244,66624703,12804,932488038,37310,2
105376199,LOC105376199,chr9,R,105554034,105558280,66628949,4246,932492284,37311,2
105376200,LOC105376200,chr9,F,105645433,105656218,66639734,10785,932503069,37312,2
105376201,LOC105376201,chr9,R,106025472,106041350,66655612,15878,932518947,37313,2
105376202,LOC105376202,chr9,F,106310440,106323864,66669036,13424,932532371,37314,2
105376203,LOC105376203,chr9,R,106615079,106615965,66669922,886,932533257,37315,2
105376204,LOC105376204,chr9,R,106857662,106861009,66673269,3347,932536604,37316,0
105376205,LOC105376205,chr9,F,107566822,107665327,66771774,98505,932635109,37317,11
105376206,LOC105376206,chr9,F,107505083,107515215,66781906,10132,932645241,37318,2
105376207,LOC105376207,chr9,R,107704388,107717309,66794827,12921,932658162,37319,4
105376208,LOC105376208,chr9,F,107798223,107812147,66808751,13924,932672086,37320,3
105376209,LOC105376209,chr9,R,107758533,107799871,66850089,41338,932713424,37321,3
105376210,LOC105376210,chr9,F,107734799,107766225,66881515,31426,932744850,37322,3
105376211,LOC105376211,chr9,F,107951185,107999710,66930040,48525,932793375,37323,3
105376212,LOC105376212,chr9,R,108214658,108273699,66989081,59041,932852416,37324,4
105376213,LOC105376213,chr9,F,108078529,108083760,66994312,5231,932857647,37325,3
105376214,LOC105376214,chr9,R,108048184,108416996,67363124,368812,933226459,37326,5
105376215,LOC105376215,chr9,F,109021799,109080553,67421878,58754,933285213,37327,2
105376216,LOC105376216,chr9,F,108984442,109006950,67444386,22508,933307721,37328,7
105376217,LOC105376217,chr9,R,110174701,110179240,67448925,4539,933312260,37329,2
105376218,LOC105376218,chr9,F,110617150,110620609,67452384,3459,933315719,37330,2
105376219,LOC105376219,chr9,R,111121879,111285148,67615653,163269,933478988,37331,6
105376220,LOC105376220,chr9,R,112028537,112031297,67618413,2760,933481748,37332,1
105376221,LOC105376221,chr9,R,113588968,113590340,67619785,1372,933483120,37333,1
105376222,LOC105376222,chr9,F,113614956,113628746,67633575,13790,933496910,37334,6
105376223,LOC105376223,chr9,F,113647894,113682855,67668536,34961,933531871,37335,2
105376224,LOC105376224,chr9,R,114304679,114318337,67682194,13658,933545529,37336,2
105376225,LOC105376225,chr9,R,114144276,114152681,67690599,8405,933553934,37337,2
105376226,LOC105376226,chr9,F,114058603,114064348,67696344,5745,933559679,37338,2
105376227,LOC105376227,chr9,F,114388105,114391520,67699759,3415,933563094,37339,2
105376228,LOC105376228,chr9,F,114493398,114497437,67703798,4039,933567133,37340,1
105376229,LOC105376229,chr9,R,114558685,114566443,67711556,7758,933574891,37341,2
105376230,LOC105376230,chr9,R,114656303,114658336,67713589,2033,933576924,37342,1
105376231,LOC105376231,chr9,F,114697067,114700173,67716695,3106,933580030,37343,2
105376232,LOC105376232,chr9,R,115353978,115367921,67730638,13943,933593973,37344,5
105376233,LOC105376233,chr9,R,115253242,115262527,67739923,9285,933603258,37345,1
105376234,LOC105376234,chr9,F,115744013,115826737,67822647,82724,933685982,37346,3
105376235,LOC105376235,chr9,F,115596657,115672726,67898716,76069,933762051,37347,6
105376236,LOC105376236,chr9,F,115989960,116013910,67922666,23950,933786001,37348,2
105376237,LOC105376237,chr9,F,117196309,117259296,67985653,62987,933848988,37349,5
105376238,LOC105376238,chr9,F,116845338,116848386,67988701,3048,933852036,37350,1
105376239,LOC105376239,chr9,F,116838469,116843126,67993358,4657,933856693,37351,2
105376240,LOC105376240,chr9,F,116597542,116644642,68040458,47100,933903793,37352,4
105376241,LOC105376241,chr9,R,116288603,116319945,68071800,31342,933935135,37353,3
105376242,LOC105376242,chr9,R,117431358,117466163,68106605,34805,933969940,37354,4
105376243,LOC105376243,chr9,R,117840281,117876249,68142573,35968,934005908,37355,2
105376244,LOC105376244,chr9,F,117759344,117871225,68254454,111881,934117789,37356,10
105376245,LOC105376245,chr9,R,117768393,117773510,68259571,5117,934122906,37357,2
105376246,LOC105376246,chr9,R,117997647,118024353,68286277,26706,934149612,37358,2
105376247,LOC105376247,chr9,F,118057109,118070509,68299677,13400,934163012,37359,3
105376248,LOC105376248,chr9,R,118514717,118523497,68308457,8780,934171792,37360,3
105376249,LOC105376249,chr9,R,118593060,118597172,68312569,4112,934175904,37361,2
105376250,LOC105376250,chr9,R,119424011,119524055,68412613,100044,934275948,37362,3
105376251,LOC105376251,chr9,R,120120673,120127022,68418962,6349,934282297,37363,2
105376252,LOC105376252,chr9,R,120380872,120383349,68421439,2477,934284774,37364,1
105376253,LOC105376253,chr9,R,120163024,120384779,68643194,221755,934506529,37365,4
105376254,LOC105376254,chr9,F,120581227,120583640,68645607,2413,934508942,37366,2
105376255,LOC105376255,chr9,F,121052513,121060104,68653198,7591,934516533,37367,2
105376256,LOC105376256,chr9,R,121292215,121299157,68660140,6942,934523475,37368,1
105376257,LOC105376257,chr9,R,121731743,121737106,68665503,5363,934528838,37369,2
105376258,LOC105376258,chr9,R,121695350,121698908,68669061,3558,934532396,37370,3
105376259,LOC105376259,chr9,F,121679197,121685218,68675082,6021,934538417,37371,1
105376260,LOC105376260,chr9,F,122083076,122092679,68684685,9603,934548020,37372,2
105376261,LOC105376261,chr9,R,121884610,121896783,68696858,12173,934560193,37373,1
105376262,LOC105376262,chr9,F,122406569,122437964,68728253,31395,934591588,37374,3
105376263,LOC105376263,chr9,F,122755755,122785108,68757606,29353,934620941,37375,3
105376264,LOC105376264,chr9,F,123079493,123087380,68765493,7887,934628828,37376,1
105376265,LOC105376265,chr9,R,123304824,123322610,68783279,17786,934646614,37377,4
105376266,LOC105376266,chr9,R,123567250,123573554,68789583,6304,934652918,37378,1
105376267,LOC105376267,chr9,R,123996148,123999377,68792812,3229,934656147,37379,2
105376268,LOC105376268,chr9,R,124031426,124032423,68793809,997,934657144,37380,2
105376269,LOC105376269,chr9,R,124282101,124284039,68795747,1938,934659082,37381,1
105376270,LOC105376270,chr9,R,124446669,124452364,68801442,5695,934664777,37382,3
105376271,LOC105376271,chr9,R,125199528,125200396,68802310,868,934665645,37383,1
105376272,LOC105376272,chr9,F,125567657,125573156,68807809,5499,934671144,37384,3
105376273,LOC105376273,chr9,R,126051987,126052986,68808808,999,934672143,37385,2
105376274,LOC105376274,chr9,R,126124918,126149127,68833017,24209,934696352,37386,2
105376275,LOC105376275,chr9,R,126226088,126235851,68842780,9763,934706115,37387,2
105376276,LOC105376276,chr9,F,126516490,126518861,68845151,2371,934708486,37388,1
105376277,LOC105376277,chr9,R,126608093,126613724,68850782,5631,934714117,37389,4
105376278,LOC105376278,chr9,R,127174788,127188018,68864012,13230,934727347,37390,5
105376279,LOC105376279,chr9,F,127022555,127023250,68864707,695,934728042,37391,1
105376280,LOC105376280,chr9,R,127243161,127245177,68866723,2016,934730058,37392,2
105376281,LOC105376281,chr9,R,127536584,127537336,68867475,752,934730810,37393,1
105376282,LOC105376282,chr9,F,127579127,127592233,68880581,13106,934743916,37394,2
105376283,LOC105376283,chr9,F,127693175,127695181,68882587,2006,934745922,37395,1
105376284,LOC105376284,chr9,F,127939711,127941509,68884385,1798,934747720,37396,1
105376285,LOC105376285,chr9,R,128196831,128199962,68887516,3131,934750851,37397,2
105376286,LOC105376286,chr9,F,128313824,128315559,68889251,1735,934752586,37398,2
105376287,LOC105376287,chr9,R,128663130,128685777,68911898,22647,934775233,37399,2
105376288,LOC105376288,chr9,F,128771157,128781872,68922613,10715,934785948,37400,2
105376289,LOC105376289,chr9,F,129203648,129209885,68928850,6237,934792185,37401,2
105376290,LOC105376290,chr9,F,129257777,129260922,68931995,3145,934795330,37402,2
105376291,LOC105376291,chr9,F,129438620,129447098,68940473,8478,934803808,37403,4
105376292,LOC105376292,chr9,F,129575416,129582686,68947743,7270,934811078,37404,3
105376293,LOC105376293,chr9,R,130260277,130266936,68954402,6659,934817737,37405,2
105376294,LOC105376294,chr9,R,130490657,130502550,68966295,11893,934829630,37406,2
105376295,LOC105376295,chr9,F,130532451,130536194,68970038,3743,934833373,37407,1
105376296,LOC105376296,chr9,R,130782358,130817460,69005140,35102,934868475,37408,4
105376297,LOC105376297,chr9,F,130940345,130945524,69010319,5179,934873654,37409,2
105376298,LOC105376298,chr9,R,131088124,131093868,69016063,5744,934879398,37410,2
105376299,LOC105376299,chr9,F,131347305,131358960,69027718,11655,934891053,37411,2
105376300,LOC105376300,chr9,R,131346985,131350546,69031279,3561,934894614,37412,3
105376301,LOC105376301,chr9,R,131516557,131517803,69032525,1246,934895860,37413,1
105376302,LOC105376302,chr9,F,132103219,132104582,69033888,1363,934897223,37414,2
105376303,LOC105376303,chr9,F,132374797,132375522,69034613,725,934897948,37415,2
105376304,LOC105376304,chr9,F,132411324,132415957,69039246,4633,934902581,37416,2
105376305,LOC105376305,chr9,R,133010566,133023931,69052611,13365,934915946,37417,2
105376306,LOC105376306,chr9,R,133028146,133030492,69054957,2346,934918292,37418,1
105376307,LOC105376307,chr9,F,133140689,133145462,69059730,4773,934923065,37419,1
105376308,LOC105376308,chr9,F,133663963,133664749,69060516,786,934923851,37420,1
105376309,LOC105376309,chr9,F,134179346,134207375,69088545,28029,934951880,37421,2
105376310,LOC105376310,chr9,R,134293929,134295491,69090107,1562,934953442,37422,1
105376311,LOC105376311,chr9,F,134472768,134483232,69100571,10464,934963906,37423,6
105376312,LOC105376312,chr9,F,134648115,134649288,69101744,1173,934965079,37424,2
105376313,LOC105376313,chr9,F,134944535,134949027,69106236,4492,934969571,37425,2
105376314,LOC105376314,chr9,F,134934955,134943558,69114839,8603,934978174,37426,3
105376315,LOC105376315,chr9,R,135268141,135277644,69124342,9503,934987677,37427,2
105376316,LOC105376316,chr9,R,135577425,135585270,69132187,7845,934995522,37428,1
105376317,LOC105376317,chr9,R,135675199,135685111,69142099,9912,935005434,37429,3
105376318,LOC105376318,chr9,F,135678045,135679562,69143616,1517,935006951,37430,2
105376319,LOC105376319,chr9,R,135793055,135795400,69145961,2345,935009296,37431,3
105376320,LOC105376320,chr9,R,135708264,135714313,69152010,6049,935015345,37432,2
105376321,LOC105376321,chr9,R,135702111,135704361,69154260,2250,935017595,37433,2
105376322,LOC105376322,chr9,F,136013955,136016099,69156404,2144,935019739,37434,1
105376323,LOC105376323,chr9,R,136107828,136109787,69158363,1959,935021698,37435,3
105376324,LOC105376324,chr9,F,136523198,136533069,69168234,9871,935031569,37436,2
105376325,LOC105376325,chr9,R,136640165,136644479,69172548,4314,935035883,37437,2
105376326,LOC105376326,chr9,R,136881925,136886256,69176879,4331,935040214,37438,3
105376327,LOC105376327,chr9,F,137052357,137053375,69177897,1018,935041232,37439,1
105376328,LOC105376328,chr9,R,137155021,137156661,69179537,1640,935042872,37440,1
105376329,LOC105376329,chr9,R,137224108,137225233,69180662,1125,935043997,37441,1
105376330,LOC105376330,chr9,R,137814481,137834342,69200523,19861,935063858,37442,2
105376331,LOC105376331,chr9,R,137943653,137947022,69203892,3369,935067227,37443,2
105376332,LOC105376332,chr9,F,138286329,138317732,69235295,31403,935098630,37444,4
105376333,LOC105376333,chr9,F,138276874,138279535,69237956,2661,935101291,37445,2
105376335,LOC105376335,chr9,F,83920900,83924902,69241958,4002,935105293,37446,2
105376336,LOC105376336,chr9,R,107267049,107283631,69258540,16582,935121875,37447,1
105376337,LOC105376337,chr9,F,121194173,121212539,69276906,18366,935140241,37448,2
105379249,LOC105379249,chr9,F,61174251,61175665,69278320,1414,935141655,37449,1
105379250,LOC105379250,chr9,F,65720104,65723902,69282118,3798,935145453,37450,1
105379251,LOC105379251,chr9,F,65655750,65664509,69290877,8759,935154212,37451,2
105379252,LOC105379252,chr9,R,66047078,66109222,69353021,62144,935216356,37452,11
105379253,LOC105379253,chr9,R,65941570,65960384,69371835,18814,935235170,37453,2
105379254,LOC105379254,chr9,F,65917794,65927987,69382028,10193,935245363,37454,1
105379255,LOC105379255,chr9,F,63549216,63560997,69393809,11781,935257144,37455,2
105379256,LOC105379256,chr9,F,64711979,64715140,69396970,3161,935260305,37456,3
105379257,LOC105379257,chr9,R,64603834,64618296,69411432,14462,935274767,37457,2
105379258,LOC105379258,chr9,F,64556009,64573031,69428454,17022,935291789,37458,2
105379259,LOC105379259,chr9,R,64516016,64527283,69439721,11267,935303056,37459,2
105379260,LOC105379260,chr9,F,64832221,64835363,69442863,3142,935306198,37460,1
105379262,LOC105379262,chr9,F,62288066,62298373,69453170,10307,935316505,37461,2
105379263,LOC105379263,chr9,R,62254326,62353265,69552109,98939,935415444,37462,8
105379434,LOC105379434,chr9,F,60898313,60899726,69553522,1413,935416857,37463,1
105379435,LOC105379435,chr9,R,61296747,61297691,69554466,944,935417801,37464,2
105379436,LOC105379436,chr9,R,61600870,61609320,69562916,8450,935426251,37465,2
105379437,LOC105379437,chr9,R,61549133,61555128,69568911,5995,935432246,37466,3
105379438,LOC105379438,chr9,R,61894979,61911166,69585098,16187,935448433,37467,2
105379439,LOC105379439,chr9,R,62125620,62129209,69588687,3589,935452022,37468,4
105379440,LOC105379440,chr9,R,62877497,62880628,69591818,3131,935455153,37469,1
105379441,LOC105379441,chr9,F,63254474,63270221,69607565,15747,935470900,37470,2
105379442,LOC105379442,chr9,R,63408509,63422122,69621178,13613,935484513,37471,4
105379443,LOC105379443,chr9,F,65143072,65203646,69681752,60574,935545087,37472,12
105379444,LOC105379444,chr9,F,65383314,65384351,69682789,1037,935546124,37473,1
105379445,LOC105379445,chr9,F,65400318,65403841,69686312,3523,935549647,37474,3
105379446,LOC105379446,chr9,R,65445306,65454950,69695956,9644,935559291,37475,2
105379447,LOC105379447,chr9,F,65546930,65551631,69700657,4701,935563992,37476,1
105379448,LOC105379448,chr9,F,66593658,66599035,69706034,5377,935569369,37477,2
105379449,LOC105379449,chr9,F,66695988,66702329,69712375,6341,935575710,37478,2
105379450,LOC105379450,chr9,R,67006924,67009079,69714530,2155,935577865,37479,2
105379451,LOC105379451,chr9,F,67459182,67462788,69718136,3606,935581471,37480,4
105379452,LOC105379452,chr9,R,67492449,67515381,69741068,22932,935604403,37481,3
105379453,LOC105379453,chr9,F,67670263,67686251,69757056,15988,935620391,37482,2
105379454,LOC105379454,chr9,R,67651434,67668172,69773794,16738,935637129,37483,2
22,ABCB7,chrX,R,75053171,75156340,103169,103169,935740298,37484,15
186,AGTR2,chrX,F,116170704,116174972,107437,4268,935744566,37485,2
190,NR0B1,chrX,R,30304421,30309378,112394,4957,935749523,37486,1
212,ALAS2,chrX,R,55009054,55031064,134404,22010,935771533,37487,11
215,ABCD1,chrX,F,153724850,153744762,154316,19912,935791445,37488,10
265,AMELX,chrX,F,11292577,11300761,162500,8184,935799629,37489,7
292,SLC25A5,chrX,F,119468399,119471396,165497,2997,935802626,37490,3
293,SLC25A6,chrX,R,1386151,1392146,171492,5995,935808621,37491,3
331,XIAP,chrX,F,123859811,123913979,225660,54168,935862789,37492,8
357,SHROOM2,chrX,F,9786401,9949443,388702,163042,936025831,37493,10
367,AR,chrX,F,67544031,67730619,575290,186588,936212419,37494,8
369,ARAF,chrX,F,47561099,47571921,586112,10822,936223241,37495,17
393,ARHGAP4,chrX,R,153907375,153926260,604997,18885,936242126,37496,22
395,ARHGAP6,chrX,R,11137542,11665701,1133156,528159,936770285,37497,16
407,ARR3,chrX,F,70263502,70281840,1151494,18338,936788623,37498,14
412,STS,chrX,F,7146516,7354641,1359619,208125,936996748,37499,15
414,ARSD,chrX,R,2903969,2929375,1385025,25406,937022154,37500,10
415,ARSE,chrX,R,2934631,2968310,1418704,33679,937055833,37501,12
416,ARSF,chrX,F,3040233,3112729,1491200,72496,937128329,37502,13
438,ASMT,chrX,F,1595454,1643081,1538827,47627,937175956,37503,9
492,ATP2B3,chrX,F,153517664,153582929,1604092,65265,937241221,37504,24
537,ATP6AP1,chrX,F,154428631,154436517,1611978,7886,937249107,37505,10
538,ATP7A,chrX,F,77910655,78050395,1751718,139740,937388847,37506,22
546,ATRX,chrX,R,77504877,77786269,2033110,281392,937670239,37507,34
554,AVPR2,chrX,F,153902530,153907166,2037746,4636,937674875,37508,3
633,BGN,chrX,F,153494888,153509546,2052404,14658,937689533,37509,7
660,BMX,chrX,F,15500776,15556529,2108157,55753,937745286,37510,19
680,BRS3,chrX,F,136463814,136493774,2138117,29960,937775246,37511,4
695,BTK,chrX,R,101349446,101390796,2179467,41350,937816596,37512,20
778,CACNA1F,chrX,R,49205062,49233671,2208076,28609,937845205,37513,47
795,S100G,chrX,F,16650157,16654668,2212587,4511,937849716,37514,2
827,CAPN6,chrX,R,111245098,111270546,2238035,25448,937875164,37515,12
959,CD40LG,chrX,F,136648176,136660390,2250249,12214,937887378,37516,4
1038,CDR1,chrX,R,140783259,140784558,2251548,1299,937888677,37517,0
1046,CDX4,chrX,F,73447253,73454585,2258880,7332,937896009,37518,2
1069,CETN2,chrX,R,152827326,152830757,2262311,3431,937899440,37519,4
1121,CHM,chrX,R,85861179,86047562,2448694,186383,938085823,37520,17
1183,CLCN4,chrX,F,10156944,10237660,2529410,80716,938166539,37521,12
1184,CLCN5,chrX,F,49922614,50099235,2706031,176621,938343160,37522,17
1193,CLIC2,chrX,R,155276206,155334681,2764506,58475,938401635,37523,5
1260,CNGA2,chrX,F,151734745,151745564,2775325,10819,938412454,37524,6
1287,COL4A5,chrX,F,108439735,108697545,3033135,257810,938670264,37525,56
1288,COL4A6,chrX,R,108155606,108439497,3317026,283891,938954155,37526,48
1349,COX7B,chrX,F,77899463,77905384,3322947,5921,938960076,37527,2
1438,CSF2RA,chrX,F,1268799,1325078,3379226,56279,939016355,37528,18
1478,CSTF2,chrX,F,100820358,100841520,3400388,21162,939037517,37529,15
1485,CTAG1B,chrX,R,154617608,154619271,3402051,1663,939039180,37530,2
1527,TEX28,chrX,R,154271264,154295351,3426138,24087,939063267,37531,8
1536,CYBB,chrX,F,37780016,37813465,3459587,33449,939096716,37532,13
1538,CYLC1,chrX,F,83861125,83886700,3485162,25575,939122291,37533,4
1641,DCX,chrX,R,111293778,111412232,3603616,118454,939240745,37534,7
1654,DDX3X,chrX,F,41333307,41364472,3634781,31165,939271910,37535,19
1678,TIMM8A,chrX,R,101345655,101348969,3638095,3314,939275224,37536,2
1730,DIAPH2,chrX,F,96684662,97600598,4554031,915936,940191160,37537,27
1736,DKC1,chrX,F,154762741,154777689,4568979,14948,940206108,37538,11
1741,DLG3,chrX,F,70444849,70505490,4629620,60641,940266749,37539,22
1756,DMD,chrX,R,31119218,33339609,6850011,2220391,942487140,37540,86
1774,DNASE1L1,chrX,R,154401235,154412091,6860867,10856,942497996,37541,9
1821,DRP2,chrX,F,101219943,101264496,6905420,44553,942542549,37542,23
1831,TSC22D3,chrX,R,107713220,107777329,6969529,64109,942606658,37543,6
1852,DUSP9,chrX,F,153642442,153651326,6978413,8884,942615542,37544,6
1896,EDA,chrX,F,69616066,70039472,7401819,423406,943038948,37545,10
1947,EFNB1,chrX,F,68828996,68842164,7414987,13168,943052116,37546,4
1964,EIF1AX,chrX,R,20124517,20141848,7432318,17331,943069447,37547,6
1968,EIF2S3,chrX,F,24054947,24078810,7456181,23863,943093310,37548,11
2000,ELF4,chrX,R,130064919,130110713,7501975,45794,943139104,37549,10
2002,ELK1,chrX,R,47635519,47650604,7517060,15085,943154189,37550,6
2010,EMD,chrX,F,154379236,154381523,7519347,2287,943156476,37551,5
2157,F8,chrX,R,154835787,155026934,7710494,191147,943347623,37552,27
2158,F9,chrX,F,139530733,139563464,7743225,32731,943380354,37553,7
2182,ACSL4,chrX,R,109641334,109733392,7835283,92058,943472412,37554,16
2187,FANCB,chrX,R,14796152,14873317,7912448,77165,943549577,37555,12
2239,GPC4,chrX,R,133301035,133415177,8026590,114142,943663719,37556,8
2245,FGD1,chrX,R,54445453,54496166,8077303,50713,943714432,37557,17
2258,FGF13,chrX,R,138631572,139222889,8668620,591317,944305749,37558,12
2273,FHL1,chrX,F,136146701,136211359,8733278,64658,944370407,37559,13
2277,FIGF,chrX,R,15345590,15384413,8772101,38823,944409230,37560,6
2316,FLNA,chrX,R,154348528,154374638,8798211,26110,944435340,37561,47
2332,FMR1,chrX,F,147911950,147951127,8837388,39177,944474517,37562,16
2334,AFF2,chrX,F,148500618,149000663,9337433,500045,944974562,37563,21
2491,CENPI,chrX,F,101098158,101163678,9402953,65520,945040082,37564,24
2539,G6PD,chrX,R,154531389,154547586,9419150,16197,945056279,37565,13
2543,GAGE1,chrX,F,49598994,49608536,9428692,9542,945065821,37566,6
2556,GABRA3,chrX,R,152166233,152451359,9713818,285126,945350947,37567,10
2564,GABRE,chrX,R,151953123,151974684,9735379,21561,945372508,37568,9
2623,GATA1,chrX,F,48786559,48794311,9743131,7752,945380260,37569,5
2652,OPN1MW,chrX,F,154182595,154196861,9757397,14266,945394526,37570,5
2664,GDI1,chrX,F,154436912,154443467,9763952,6555,945401081,37571,10
2705,GJB1,chrX,F,71215211,71225215,9773956,10004,945411085,37572,3
2710,GK,chrX,F,30653358,30731462,9852060,78104,945489189,37573,22
2717,GLA,chrX,R,101397790,101408013,9862283,10223,945499412,37574,7
2719,GPC3,chrX,R,133535744,133985646,10312185,449902,945949314,37575,8
2742,GLRA2,chrX,F,14448778,14731812,10595219,283034,946232348,37576,11
2747,GLUD2,chrX,F,121047607,121049942,10597554,2335,946234683,37577,0
2824,GPM6B,chrX,R,13770938,13938732,10765348,167794,946402477,37578,9
2833,CXCR3,chrX,R,71615913,71618517,10767952,2604,946405081,37579,1
2846,LPAR4,chrX,F,78747708,78757754,10777998,10046,946415127,37580,5
2857,GPR34,chrX,F,41688958,41697277,10786317,8319,946423446,37581,2
2892,GRIA3,chrX,F,123184242,123490915,11092990,306673,946730119,37582,18
2925,GRPR,chrX,F,16123300,16153518,11123208,30218,946760337,37583,2
2986,GUCY2F,chrX,R,109372016,109482056,11233248,110040,946870377,37584,21
3028,HSD17B10,chrX,R,53431257,53434376,11236367,3119,946873496,37585,5
3052,HCCS,chrX,F,11111285,11123086,11248168,11801,946885297,37586,6
3054,HCFC1,chrX,R,153947556,153971833,11272445,24277,946909574,37587,25
3149,HMGB3,chrX,F,150980507,150990775,11282713,10268,946919842,37588,6
3188,HNRNPH2,chrX,F,101408132,101414140,11288721,6008,946925850,37589,4
3251,HPRT1,chrX,F,134452841,134500668,11336548,47827,946973677,37590,10
3266,ERAS,chrX,F,48826512,48829869,11339905,3357,946977034,37591,1
3358,HTR2C,chrX,F,114584077,114910061,11665889,325984,947303018,37592,6
3421,IDH3G,chrX,R,153785765,153794523,11674647,8758,947311776,37593,11
3423,IDS,chrX,R,149478763,149505354,11701238,26591,947338367,37594,10
3476,IGBP1,chrX,F,70133448,70166324,11734114,32876,947371243,37595,6
3547,IGSF1,chrX,R,131273505,131289457,11750066,15952,947387195,37596,21
3561,IL2RG,chrX,R,71107403,71111631,11754294,4228,947391423,37597,7
3563,IL3RA,chrX,F,1336586,1382689,11800397,46103,947437526,37598,11
3581,IL9R,chrX,F,155997335,156011349,11814411,14014,947451540,37599,10
3597,IL13RA1,chrX,F,118726953,118794533,11881991,67580,947519120,37600,12
3598,IL13RA2,chrX,R,115003974,115017644,11895661,13670,947532790,37601,9
3654,IRAK1,chrX,R,154010505,154024584,11909740,14079,947546869,37602,12
3730,KAL1,chrX,R,8528873,8732186,12113053,203313,947750182,37603,14
3750,KCND1,chrX,R,48960982,48971844,12123915,10862,947761044,37604,5
3897,L1CAM,chrX,R,153861513,153886174,12148576,24661,947785705,37605,28
3920,LAMP2,chrX,R,120426147,120469349,12191778,43202,947828907,37606,9
4007,PRICKLE3,chrX,R,49174840,49186528,12203466,11688,947840595,37607,9
4068,SH2D1A,chrX,F,124346281,124373160,12230345,26879,947867474,37608,3
4100,MAGEA1,chrX,F,153179283,153183878,12234940,4595,947872069,37609,2
4101,MAGEA2,chrX,R,152749862,152753884,12238962,4022,947876091,37610,4
4102,MAGEA3,chrX,F,152698731,152702347,12242578,3616,947879707,37611,5
4103,MAGEA4,chrX,F,151912888,151925170,12254860,12282,947891989,37612,7
4104,MAGEA5,chrX,R,152114048,152117939,12258751,3891,947895880,37613,2
4105,MAGEA6,chrX,R,152766135,152769716,12262332,3581,947899461,37614,3
4107,MAGEA8,chrX,F,149881140,149885835,12267027,4695,947904156,37615,3
4108,MAGEA9,chrX,F,149781920,149787739,12272846,5819,947909975,37616,4
4109,MAGEA10,chrX,R,152133309,152138578,12278115,5269,947915244,37617,3
4110,MAGEA11,chrX,F,149688197,149717268,12307186,29071,947944315,37618,9
4111,MAGEA12,chrX,F,152733778,152737669,12311077,3891,947948206,37619,3
4112,MAGEB1,chrX,F,30243730,30252038,12319385,8308,947956514,37620,4
4113,MAGEB2,chrX,F,30215557,30220089,12323917,4532,947961046,37621,1
4114,MAGEB3,chrX,F,30230435,30237493,12330975,7058,947968104,37622,5
4115,MAGEB4,chrX,F,30241939,30244193,12333229,2254,947970358,37623,0
4128,MAOA,chrX,F,43654906,43746824,12425147,91918,948062276,37624,15
4129,MAOB,chrX,R,43766609,43882475,12541013,115866,948178142,37625,16
4168,MCF2,chrX,R,139581770,139708243,12667486,126473,948304615,37626,32
4204,MECP2,chrX,R,154021812,154097731,12743405,75919,948380534,37627,9
4267,CD99,chrX,F,2691186,2741309,12793528,50123,948430657,37628,11
4281,MID1,chrX,R,10445309,11111177,13459396,665868,949096525,37629,18
4303,FOXO4,chrX,F,71096148,71103534,13466782,7386,949103911,37630,3
4354,MPP1,chrX,R,154778683,154805527,13493626,26844,949130755,37631,13
4435,CITED1,chrX,R,72301637,72307187,13499176,5550,949136305,37632,5
4478,MSN,chrX,F,65588381,65741931,13652726,153550,949289855,37633,15
4515,MTCP1,chrX,R,155064033,155071272,13659965,7239,949297094,37634,2
4534,MTM1,chrX,F,150562657,150673143,13770451,110486,949407580,37635,18
4674,NAP1L2,chrX,R,73212298,73214874,13773027,2576,949410156,37636,0
4675,NAP1L3,chrX,R,93670925,93673683,13775785,2758,949412914,37637,0
4693,NDP,chrX,R,43948775,43973675,13800685,24900,949437814,37638,2
4694,NDUFA1,chrX,F,119871770,119876666,13805581,4896,949442710,37639,2
4810,NHS,chrX,F,17375419,17735994,14166156,360575,949803285,37640,10
4841,NONO,chrX,F,71283191,71301168,14184133,17977,949821262,37641,12
4935,GPR143,chrX,R,9725412,9765965,14224686,40553,949861815,37642,9
4943,TBC1D25,chrX,F,48539686,48562609,14247609,22923,949884738,37643,5
4952,OCRL,chrX,F,129532739,129592556,14307426,59817,949944555,37644,28
4983,OPHN1,chrX,R,68042343,68433841,14698924,391498,950336053,37645,25
5009,OTC,chrX,F,38352482,38421450,14767892,68968,950405021,37646,9
5030,P2RY4,chrX,R,70258165,70259804,14769531,1639,950406660,37647,0
5063,PAK3,chrX,F,110944284,111227361,15052608,283077,950689737,37648,28
5127,CDK16,chrX,F,47217880,47229997,15064725,12117,950701854,37649,18
5160,PDHA1,chrX,F,19343892,19361707,15082540,17815,950719669,37650,11
5165,PDK3,chrX,F,24465226,24550466,15167780,85240,950804909,37651,11
5199,CFP,chrX,R,47624212,47630305,15173873,6093,950811002,37652,9
5207,PFKFB1,chrX,R,54933133,54999597,15240337,66464,950877466,37653,18
5230,PGK1,chrX,F,78104168,78126827,15262996,22659,950900125,37654,10
5251,PHEX,chrX,F,22032326,22251310,15481980,218984,951119109,37655,25
5255,PHKA1,chrX,R,72578813,72714181,15617348,135368,951254477,37656,31
5256,PHKA2,chrX,R,18892297,18984362,15709413,92065,951346542,37657,32
5277,PIGA,chrX,R,15319450,15335554,15725517,16104,951362646,37658,6
5303,PIN4,chrX,F,72181675,72263964,15807806,82289,951444935,37659,4
5354,PLP1,chrX,F,103776505,103792619,15823920,16114,951461049,37660,7
5355,PLP2,chrX,F,49171836,49175120,15827204,3284,951464333,37661,4
5358,PLS3,chrX,F,115560849,115650861,15917216,90012,951554345,37662,20
5365,PLXNB3,chrX,F,153764195,153779346,15932367,15151,951569496,37663,36
5422,POLA1,chrX,F,24693873,24996986,16235480,303113,951872609,37664,37
5456,POU3F4,chrX,F,83508260,83509767,16236987,1507,951874116,37665,0
5475,PPEF1,chrX,F,18675908,18827921,16389000,152013,952026129,37666,21
5613,PRKX,chrX,R,3604342,3713644,16498302,109302,952135431,37667,10
5631,PRPS1,chrX,F,107628423,107651026,16520905,22603,952158034,37668,6
5634,PRPS2,chrX,F,12791354,12824227,16553778,32873,952190907,37669,6
5638,PRRG1,chrX,F,37349274,37457295,16661799,108021,952298928,37670,5
5716,PSMD10,chrX,R,108084204,108091644,16669239,7440,952306368,37671,4
5931,RBBP7,chrX,R,16844649,16870442,16695032,25793,952332161,37672,13
5935,RBM3,chrX,F,48574352,48581165,16701845,6813,952338974,37673,6
5956,OPN1LW,chrX,F,154144223,154159032,16716654,14809,952353783,37674,5
5973,RENBP,chrX,R,153935268,153944780,16726166,9512,952363295,37675,10
6102,RP2,chrX,F,46836911,46882358,16771613,45447,952408742,37676,4
6103,RPGR,chrX,R,38269169,38327564,16830008,58395,952467137,37677,18
6134,RPL10,chrX,F,154398064,154402339,16834283,4275,952471412,37678,5
6170,RPL39,chrX,R,119786503,119791659,16839439,5156,952476568,37679,2
6173,RPL36A,chrX,F,101390889,101396154,16844704,5265,952481833,37680,4
6191,RPS4X,chrX,R,72272602,72277291,16849393,4689,952486522,37681,6
6197,RPS6KA3,chrX,R,20149910,20267095,16966578,117185,952603707,37682,25
6247,RS1,chrX,R,18639687,18672103,16998994,32416,952636123,37683,5
6303,SAT1,chrX,F,23783157,23786223,17002060,3066,952639189,37684,6
6322,SCML1,chrX,F,17737448,17754988,17019600,17540,952656729,37685,7
6399,TRAPPC2,chrX,R,13712241,13734635,17041994,22394,952679123,37686,6
6451,SH3BGRL,chrX,F,81201803,81298547,17138738,96744,952775867,37687,6
6473,SHOX,chrX,F,624343,659411,17173806,35068,952810935,37688,6
6535,SLC6A8,chrX,F,153688296,153696593,17182103,8297,952819232,37689,13
6567,SLC16A2,chrX,F,74421492,74533929,17294540,112437,952931669,37690,6
6594,SMARCA1,chrX,R,129446500,129523513,17371553,77013,953008682,37691,24
6611,SMS,chrX,F,21940572,21994837,17425818,54265,953062947,37692,12
6658,SOX3,chrX,R,140502986,140505060,17427892,2074,953065021,37693,0
6719,SRD5A1P1,chrX,F,139446818,139448973,17430047,2155,953067176,37694,0
6748,SSR4,chrX,F,153794174,153798512,17434385,4338,953071514,37695,9
6756,SSX1,chrX,F,48255316,48267444,17446513,12128,953083642,37696,8
6757,SSX2,chrX,R,52696895,52707227,17456845,10332,953093974,37697,8
6758,SSX5,chrX,R,48186219,48196798,17467424,10579,953104553,37698,9
6759,SSX4,chrX,F,48383526,48393343,17477241,9817,953114370,37699,7
6792,CDKL5,chrX,F,18425604,18660858,17712495,235254,953349624,37700,24
6839,SUV39H1,chrX,F,48695553,48709016,17725958,13463,953363087,37701,6
6845,VAMP7,chrX,F,155881279,155943769,17788448,62490,953425577,37702,7
6853,SYN1,chrX,R,47571900,47619857,17836405,47957,953473534,37703,12
6855,SYP,chrX,R,49187811,49200202,17848796,12391,953485925,37704,6
6872,TAF1,chrX,F,71366217,71530525,18013104,164308,953650233,37705,44
6901,TAZ,chrX,F,154411517,154421726,18023313,10209,953660442,37706,9
6906,SERPINA7,chrX,R,106033198,106038727,18028842,5529,953665971,37707,4
6907,TBL1X,chrX,F,9463294,9719740,18285288,256446,953922417,37708,19
6990,DYNLT3,chrX,R,37838835,37847636,18294089,8801,953931218,37709,4
6998,TDGF1P3,chrX,F,110520311,110523021,18296799,2710,953933928,37710,0
7030,TFE3,chrX,R,49028725,49043517,18311591,14792,953948720,37711,10
7076,TIMP1,chrX,F,47582290,47586791,18316092,4501,953953221,37712,4
7102,TSPAN7,chrX,F,38561477,38688918,18443533,127441,954080662,37713,7
7105,TSPAN6,chrX,R,100627107,100637104,18453530,9997,954090659,37714,7
7114,TMSB4X,chrX,F,12975106,12977227,18455651,2121,954092780,37715,2
7216,TRO,chrX,F,54920562,54931436,18466525,10874,954103654,37716,12
7224,TRPC5,chrX,R,111774313,112082776,18774988,308463,954412117,37717,10
7317,UBA1,chrX,F,47190799,47215128,18799317,24329,954436446,37718,30
7319,UBE2A,chrX,F,119574466,119584429,18809280,9963,954446409,37719,5
7355,SLC35A2,chrX,R,48903179,48911958,18818059,8779,954455188,37720,5
7403,KDM6A,chrX,F,44873174,45112779,19057664,239605,954694793,37721,31
7411,VBP1,chrX,F,155197006,155239841,19100499,42835,954737628,37722,7
7454,WAS,chrX,F,48683789,48691427,19108137,7638,954745266,37723,11
7499,XG,chrX,F,2751819,2816500,19172818,64681,954809947,37724,11
7503,XIST,chrX,R,73820650,73852753,19204921,32103,954842050,37725,5
7504,XK,chrX,F,37685780,37732130,19251271,46350,954888400,37726,3
7512,XPNPEP2,chrX,F,129738969,129769549,19281851,30580,954918980,37727,20
7543,ZFX,chrX,F,24148933,24216255,19349173,67322,954986302,37728,16
7547,ZIC3,chrX,F,137566186,137572100,19355087,5914,954992216,37729,2
7552,ZNF711,chrX,F,85243819,85273362,19384630,29543,955021759,37730,9
7569,ZNF182,chrX,R,47974850,48003995,19413775,29145,955050904,37731,6
7592,ZNF41,chrX,R,47444778,47483234,19452231,38456,955089360,37732,5
7626,ZNF75D,chrX,R,135248588,135344618,19548261,96030,955185390,37733,9
7712,ZNF157,chrX,F,47370599,47413699,19591361,43100,955228490,37734,3
7737,RNF113A,chrX,R,119870531,119871828,19592658,1297,955229787,37735,0
7739,ZNF185,chrX,F,152898131,152973481,19668008,75350,955305137,37736,26
7789,ZXDA,chrX,R,57905429,57910633,19673212,5204,955310341,37737,0
8225,GTPBP6,chrX,R,303356,318819,19688675,15463,955325804,37738,12
8226,HDHD1,chrX,R,7048919,7148190,19787946,99271,955425075,37739,5
8227,AKAP17A,chrX,F,1591592,1602520,19798874,10928,955436003,37740,5
8228,PNPLA4,chrX,R,7898762,7928587,19828699,29825,955465828,37741,7
8233,ZRSR2,chrX,F,15790268,15823260,19861691,32992,955498820,37742,11
8237,USP11,chrX,F,47232914,47248328,19877105,15414,955514234,37743,22
8239,USP9X,chrX,F,41085432,41236579,20028252,151147,955665381,37744,44
8241,RBM10,chrX,F,47145217,47186815,20069850,41598,955706979,37745,24
8242,KDM5C,chrX,R,53158725,53225422,20136547,66697,955773676,37746,30
8243,SMC1A,chrX,R,53374148,53422728,20185127,48580,955822256,37747,25
8260,NAA10,chrX,R,153929826,153935154,20190455,5328,955827584,37748,7
8263,F8A1,chrX,F,154886359,154888061,20192157,1702,955829286,37749,0
8266,UBL4A,chrX,R,154483716,154486670,20195111,2954,955832240,37750,3
8269,TMEM187,chrX,F,153972539,153983195,20205767,10656,955842896,37751,2
8270,LAGE3,chrX,R,154477768,154479257,20207256,1489,955844385,37752,2
8273,SLC10A3,chrX,R,154487305,154490690,20210641,3385,955847770,37753,4
8277,TKTL1,chrX,F,154295673,154330363,20245331,34690,955882460,37754,12
8406,SRPX,chrX,R,38149334,38220924,20316921,71590,955954050,37755,9
8409,UXT,chrX,R,47651791,47659180,20324310,7389,955961439,37756,6
8450,CUL4B,chrX,R,120524588,120575829,20375551,51241,956012680,37757,25
8471,IRS4,chrX,R,108719948,108736584,20392187,16636,956029316,37758,3
8473,OGT,chrX,F,71533061,71575897,20435023,42836,956072152,37759,21
8481,OFD1,chrX,F,13715422,13771402,20491003,55980,956128132,37760,27
8517,IKBKG,chrX,F,154541203,154568573,20518373,27370,956155502,37761,14
8544,PIR,chrX,R,15384798,15493588,20627163,108790,956264292,37762,9
8551,INE2,chrX,R,15785715,15787589,20629037,1874,956266166,37763,0
8552,INE1,chrX,F,47204847,47205861,20630051,1014,956267180,37764,0
8573,CASK,chrX,R,41514933,41923078,21038196,408145,956675325,37765,27
8623,ASMTL,chrX,R,1403138,1453795,21088853,50657,956725982,37766,14
8712,PAGE1,chrX,R,49687449,49696017,21097421,8568,956734550,37767,6
8776,MTMR1,chrX,F,150692982,150765102,21169541,72120,956806670,37768,20
8823,FGF16,chrX,F,77447674,77456522,21178389,8848,956815518,37769,2
8852,AKAP4,chrX,R,50190767,50201013,21188635,10246,956825764,37770,6
8862,APLN,chrX,R,129645258,129654956,21198333,9698,956835462,37771,2
8905,AP1S2,chrX,R,15825805,15855014,21227542,29209,956864671,37772,9
8908,GYG2,chrX,F,2828821,2882820,21281541,53999,956918670,37773,12
8933,FAM127A,chrX,F,135032302,135033546,21282785,1244,956919914,37774,0
9016,SLC25A14,chrX,F,130339887,130373361,21316259,33474,956953388,37775,11
9075,CLDN2,chrX,F,106900163,106930861,21346957,30698,956984086,37776,3
9104,RGN,chrX,F,47078354,47093314,21361917,14960,956999046,37777,7
9130,FAM50A,chrX,F,154444125,154450654,21368446,6529,957005575,37778,12
9131,AIFM1,chrX,R,130129361,130165887,21404972,36526,957042101,37779,16
9142,TMEM257,chrX,F,145827409,145829856,21407419,2447,957044548,37780,0
9185,REPS2,chrX,F,16946690,17220732,21681461,274042,957318590,37781,21
9189,ZBED1,chrX,R,2486413,2500967,21696015,14554,957333144,37782,2
9203,ZMYM3,chrX,R,71239623,71255261,21711653,15638,957348782,37783,25
9210,BMP15,chrX,F,50910734,50916641,21717560,5907,957354689,37784,1
9248,GPR50,chrX,F,151176583,151182855,21723832,6272,957360961,37785,1
9282,MED14,chrX,R,40649542,40736122,21810412,86580,957447541,37786,33
9338,TCEAL1,chrX,F,103628719,103630953,21812646,2234,957449775,37787,3
9363,RAB33A,chrX,F,130171798,130184870,21825718,13072,957462847,37788,1
9367,RAB9A,chrX,F,13689120,13709825,21846423,20705,957483552,37789,2
9383,TSIX,chrX,F,73792204,73829231,21883450,37027,957520579,37790,0
9452,ITM2A,chrX,R,79360383,79367552,21890619,7169,957527748,37791,5
9459,ARHGEF6,chrX,R,136665546,136781656,22006729,116110,957643858,37792,24
9468,PCYT1B,chrX,R,24558086,24672862,22121505,114776,957758634,37793,9
9500,MAGED1,chrX,F,51803058,51902354,22220801,99296,957857930,37794,15
9502,XAGE2,chrX,F,52368810,52375683,22227674,6873,957864803,37795,5
9506,PAGE4,chrX,F,49829264,49834037,22232447,4773,957869576,37796,5
9643,MORF4L2,chrX,R,103675497,103688158,22245108,12661,957882237,37797,5
9737,GPRASP1,chrX,F,102651365,102659083,22252826,7718,957889955,37798,5
9754,STARD8,chrX,F,68647668,68725842,22331000,78174,957968129,37799,16
9758,FRMPD4,chrX,F,12138465,12724523,22917058,586058,958554187,37800,17
9767,JADE3,chrX,F,46912275,47061242,23066025,148967,958703154,37801,11
9823,ARMCX2,chrX,R,101655280,101659891,23070636,4611,958707765,37802,5
9843,HEPH,chrX,F,66162518,66267389,23175507,104871,958812636,37803,21
9947,MAGEC1,chrX,F,141903855,141909401,23181053,5546,958818182,37804,3
9949,AMMECR1,chrX,R,110194185,110440233,23427101,246048,959064230,37805,7
9968,MED12,chrX,F,71118555,71142454,23451000,23899,959088129,37806,44
10009,ZBTB33,chrX,F,120250751,120258396,23458645,7645,959095774,37807,2
10013,HDAC6,chrX,F,48801895,48824976,23481726,23081,959118855,37808,30
10046,MAMLD1,chrX,F,150361588,150514178,23634316,152590,959271445,37809,10
10075,HUWE1,chrX,R,53532095,53686729,23788950,154634,959426079,37810,89
10084,PQBP1,chrX,F,48897911,48903145,23794184,5234,959431313,37811,6
10134,BCAP31,chrX,R,153700491,153724746,23818439,24255,959455568,37812,8
10149,ADGRG2,chrX,R,18989306,19122931,23952064,133625,959589193,37813,31
10159,ATP6AP2,chrX,F,40580963,40606637,23977738,25674,959614867,37814,8
10178,TENM1,chrX,R,124375902,125204358,24806194,828456,960443323,37815,39
10214,SSX3,chrX,R,48346427,48356753,24816520,10326,960453649,37816,8
10245,TIMM17B,chrX,R,48893446,48898143,24821217,4697,960458346,37817,7
10251,SPRY3,chrX,F,155610949,155782459,24992727,171510,960629856,37818,5
10325,RRAGB,chrX,F,55717676,55759333,25034384,41657,960671513,37819,12
10389,SCML2,chrX,R,18239312,18354724,25149796,115412,960786925,37820,15
10479,SLC9A6,chrX,F,135985423,136047269,25211642,61846,960848771,37821,15
10495,ENOX2,chrX,R,130623378,130903317,25491581,279939,961128710,37822,21
10549,PRDX4,chrX,F,23664259,23686399,25513721,22140,961150850,37823,7
10682,EBP,chrX,F,48521775,48528716,25520662,6941,961157791,37824,4
10735,STAG2,chrX,F,123960559,124102656,25662759,142097,961299888,37825,38
10742,RAI2,chrX,R,17800048,17861346,25724057,61298,961361186,37826,4
10761,PLAC1,chrX,R,134565837,134764312,25922532,198475,961559661,37827,5
10800,CYSLTR1,chrX,R,78271467,78327691,25978756,56224,961615885,37828,4
10813,UTP14A,chrX,F,129906120,129929762,26002398,23642,961639527,37829,17
10824,DIAPH2-AS1,chrX,R,97528363,97564535,26038570,36172,961675699,37830,2
10838,ZNF275,chrX,F,153334154,153352926,26057342,18772,961694471,37831,3
10857,PGRMC1,chrX,F,119236244,119244466,26065564,8222,961702693,37832,2
10916,MAGED2,chrX,F,54807598,54816015,26073981,8417,961711110,37833,14
10943,MSL3,chrX,F,11758158,11775753,26091576,17595,961728705,37834,13
11013,TMSB15A,chrX,R,102513681,102516771,26094666,3090,961731795,37835,2
11040,PIM2,chrX,R,48913181,48919136,26100621,5955,961737750,37836,5
11043,MID2,chrX,F,107824646,107931637,26207612,106991,961844741,37837,10
11141,IL1RAPL1,chrX,F,28587563,29956350,27576399,1368787,963213528,37838,12
11152,WDR45,chrX,R,49074432,49101121,27603088,26689,963240217,37839,12
11219,TREX2,chrX,R,153444719,153446487,27604856,1768,963241985,37840,1
11230,PRAF2,chrX,R,49071155,49074045,27607746,2890,963244875,37841,2
11238,CA5B,chrX,F,15738249,15787625,27657122,49376,963294251,37842,8
11254,SLC6A14,chrX,F,116436578,116461458,27682002,24880,963319131,37843,13
11279,KLF8,chrX,F,56232355,56291527,27741174,59172,963378303,37844,6
11326,VSIG4,chrX,R,66021737,66040125,27759562,18388,963396691,37845,6
22866,CNKSR2,chrX,F,21374413,21654695,28039844,280282,963676973,37846,22
23096,IQSEC2,chrX,R,53227453,53321350,28133741,93897,963770870,37847,22
23133,PHF8,chrX,R,53936679,54048935,28245997,112256,963883126,37848,26
23157,SEPT6,chrX,R,119615723,119693370,28323644,77647,963960773,37849,11
23229,ARHGEF9,chrX,R,63634966,63785546,28474224,150580,964111353,37850,11
23439,ATP1B4,chrX,F,120362084,120383249,28495389,21165,964132518,37851,7
23597,ACOT9,chrX,R,23703659,23743290,28535020,39631,964172149,37852,15
23630,KCNE5,chrX,R,109623699,109625164,28536485,1465,964173614,37853,0
23641,LDOC1,chrX,R,141175744,141177214,28537955,1470,964175084,37854,0
23676,SMPX,chrX,R,21705971,21758160,28590144,52189,964227273,37855,5
23708,GSPT2,chrX,F,51743384,51746232,28592992,2848,964230121,37856,0
24137,KIF4A,chrX,F,70290028,70420924,28723888,130896,964361017,37857,30
24140,FTSJ1,chrX,F,48476020,48486364,28734232,10344,964371361,37858,14
25763,HYPM,chrX,F,37990816,37991317,28734733,501,964371862,37859,0
25878,MXRA5,chrX,R,3308564,3347092,28773261,38528,964410390,37860,6
25975,EGFL6,chrX,F,13569574,13633575,28837262,64001,964474391,37861,11
26071,FAM127B,chrX,R,135050931,135052191,28838522,1260,964475651,37862,0
26280,IL1RAPL2,chrX,F,104566198,105769729,30042053,1203531,965679182,37863,12
26548,ITGB1BP2,chrX,F,71301747,71305371,30045677,3624,965682806,37864,10
26576,SRPK3,chrX,F,153781000,153785732,30050409,4732,965687538,37865,14
26609,VCX,chrX,F,7842261,7844143,30052291,1882,965689420,37866,2
26778,SNORA70,chrX,F,154400280,154400415,30052426,135,965689555,37867,0
26779,SNORA69,chrX,R,119787352,119787484,30052558,132,965689687,37868,0
26787,SNORD61,chrX,R,136879198,136879271,30052631,73,965689760,37869,0
27018,NGFRAP1,chrX,F,103376322,103378164,30054473,1842,965691602,37870,2
27035,NOX1,chrX,R,100843323,100874345,30085495,31022,965722624,37871,12
27112,FAM155B,chrX,F,69505200,69532508,30112803,27308,965749932,37872,5
27160,INGX,chrX,R,71491680,71492449,30113572,769,965750701,37873,0
27197,GPR82,chrX,F,41724154,41730135,30119553,5981,965756682,37874,2
27238,GPKOW,chrX,R,49113384,49123801,30129970,10417,965767099,37875,10
27286,SRPX2,chrX,F,100644165,100671299,30157104,27134,965794233,37876,10
27301,APEX2,chrX,F,55000322,55007873,30164655,7551,965801784,37877,5
27316,RBMX,chrX,R,136869193,136880780,30176242,11587,965813371,37878,10
27328,PCDH11X,chrX,F,91779310,92623230,31020162,843920,966657291,37879,13
27330,RPS6KA6,chrX,R,84058345,84187964,31149781,129619,966786910,37880,25
27334,P2RY10,chrX,F,78945331,78963727,31168177,18396,966805306,37881,3
27336,HTATSF1,chrX,F,136496931,136512346,31183592,15415,966820721,37882,9
27344,PCSK1N,chrX,R,48831091,48835638,31188139,4547,966825268,37883,2
28227,PPP2R3B,chrX,R,333932,386955,31241162,53023,966878291,37884,13
28952,CCDC22,chrX,F,49235466,49250526,31256222,15060,966893351,37885,16
28985,MCTS1,chrX,F,120603888,120621159,31273493,17271,966910622,37886,6
28986,MAGEH1,chrX,F,55452088,55453568,31274973,1480,966912102,37887,0
29057,FAM156A,chrX,R,52947253,52995472,31323192,48219,966960321,37888,6
29071,C1GALT1C1,chrX,R,120625673,120630150,31327669,4477,966964798,37889,2
29934,SNX12,chrX,R,71056739,71073426,31344356,16687,966981485,37890,5
29935,RPA4,chrX,F,96883907,96885467,31345916,1560,966983045,37891,0
29944,PNMA3,chrX,F,153056408,153060467,31349975,4059,966987104,37892,1
29978,UBQLN2,chrX,F,56563592,56567010,31353393,3418,966990522,37893,0
30011,SH3KBP1,chrX,R,19533964,19887626,31707055,353662,967344184,37894,24
30014,SPANXA1,chrX,R,141583673,141584738,31708120,1065,967345249,37895,1
30848,CTAG2,chrX,R,154651971,154653579,31709728,1608,967346857,37896,1
50814,NSDHL,chrX,F,152830966,152869363,31748125,38397,967385254,37897,9
50943,FOXP3,chrX,R,49250435,49269727,31767417,19292,967404546,37898,11
50945,TBX22,chrX,F,80014727,80035828,31788518,21101,967425647,37899,9
51114,ZDHHC9,chrX,R,129803287,129843934,31829165,40647,967466294,37900,12
51132,RLIM,chrX,R,74582975,74614626,31860816,31651,967497945,37901,4
51186,WBP5,chrX,F,103356451,103358469,31862834,2018,967499963,37902,2
51209,RAB9B,chrX,R,103822324,103832282,31872792,9958,967509921,37903,2
51213,LUZP4,chrX,F,115289716,115307556,31890632,17840,967527761,37904,3
51248,PDZD11,chrX,R,70286360,70289948,31894220,3588,967531349,37905,7
51260,PBDC1,chrX,F,76172928,76178310,31899602,5382,967536731,37906,5
51270,TFDP3,chrX,R,133216668,133218348,31901282,1680,967538411,37907,0
51284,TLR7,chrX,F,12867082,12890361,31924561,23279,967561690,37908,2
51309,ARMCX1,chrX,F,101550530,101554700,31928731,4170,967565860,37909,3
51311,TLR8,chrX,F,12906619,12923169,31945281,16550,967582410,37910,2
51360,MBTPS2,chrX,F,21839537,21885423,31991167,45886,967628296,37911,10
51438,MAGEC2,chrX,R,142202341,142205290,31994116,2949,967631245,37912,2
51442,VGLL1,chrX,F,136532151,136556807,32018772,24656,967655901,37913,4
51480,VCX2,chrX,R,8169943,8171267,32020096,1324,967657225,37914,2
51481,VCX3A,chrX,R,6533617,6535118,32021597,1501,967658726,37915,2
51566,ARMCX3,chrX,F,101623126,101627843,32026314,4717,967663443,37916,4
51616,TAF9B,chrX,R,78129747,78139682,32036249,9935,967673378,37917,6
51634,RBMX2,chrX,F,130401968,130413343,32047624,11375,967684753,37918,5
51765,STK26,chrX,F,132023216,132075943,32100351,52727,967737480,37919,12
53336,CPXCR1,chrX,F,88747224,88754785,32107912,7561,967745041,37920,2
53344,CHIC1,chrX,F,73563147,73687109,32231874,123962,967869003,37921,5
53940,FTHL17,chrX,R,31071240,31072053,32232687,813,967869816,37922,0
54328,GPR173,chrX,F,53049323,53080615,32263979,31292,967901108,37923,3
54413,NLGN3,chrX,F,71144822,71175307,32294464,30485,967931593,37924,9
54440,SASH3,chrX,F,129779915,129795201,32309750,15286,967946879,37925,6
54457,TAF7L,chrX,R,101268252,101293071,32334569,24819,967971698,37926,13
54466,SPIN2A,chrX,R,57135649,57137644,32336564,1995,967973693,37927,2
54470,ARMCX6,chrX,R,101615117,101618001,32339448,2884,967976577,37928,3
54521,WDR44,chrX,F,118346072,118449961,32443337,103889,968080466,37929,19
54539,NDUFB11,chrX,R,47142215,47145210,32446332,2995,968083461,37930,2
54552,GNL3L,chrX,F,54530210,54621565,32537687,91355,968174816,37931,16
54821,ERCC6L,chrX,R,72204656,72239008,32572039,34352,968209168,37932,1
54830,NUP62CL,chrX,R,107119536,107206440,32658943,86904,968296072,37933,9
54857,GDPD2,chrX,F,70423030,70433391,32669304,10361,968306433,37934,16
54880,BCOR,chrX,R,40051245,40177390,32795449,126145,968432578,37935,18
54885,TBC1D8B,chrX,F,106802685,106876150,32868914,73465,968506043,37936,21
54954,FAM120C,chrX,R,54068323,54183281,32983872,114958,968621001,37937,17
54960,GEMIN8,chrX,R,14002123,14029916,33011665,27793,968648794,37938,6
54967,CT55,chrX,R,135156535,135171827,33026957,15292,968664086,37939,4
55026,TMEM255A,chrX,R,120251001,120311556,33087512,60555,968724641,37940,10
55086,CXorf57,chrX,F,106611929,106679443,33155026,67514,968792155,37941,13
55190,NUDT11,chrX,R,51490010,51496607,33161623,6597,968798752,37942,1
55217,TMLHE,chrX,R,155489010,155612961,33285574,123951,968922703,37943,9
55285,RBM41,chrX,R,107061884,107118827,33342517,56943,968979646,37944,9
55344,PLCXD1,chrX,F,276323,303356,33369550,27033,969006679,37945,9
55511,SAGE1,chrX,F,135893633,135913061,33388978,19428,969026107,37946,19
55558,PLXNA3,chrX,F,154458280,154473646,33404344,15366,969041473,37947,33
55559,HAUS7,chrX,R,153447664,153495525,33452205,47861,969089334,37948,13
55593,OTUD5,chrX,R,48922023,48958624,33488806,36601,969125935,37949,10
55609,ZNF280C,chrX,R,130202698,130269068,33555176,66370,969192305,37950,19
55613,MTMR8,chrX,R,64268080,64395453,33682549,127373,969319678,37951,13
55634,KRBOX4,chrX,F,46447188,46474639,33710000,27451,969347129,37952,6
55787,TXLNG,chrX,F,16786431,16844519,33768088,58088,969405217,37953,11
55796,MBNL3,chrX,R,132369313,132490030,33888805,120717,969525934,37954,16
55841,WWC3,chrX,F,10015754,10144478,34017529,128724,969654658,37955,22
55855,FAM45B,chrX,F,130494940,130497448,34020037,2508,969657166,37956,0
55859,BEX1,chrX,R,103062652,103064240,34021625,1588,969658754,37957,2
55869,HDAC8,chrX,R,72329515,72573103,34265213,243588,969902342,37958,15
55879,GABRQ,chrX,F,152637894,152659510,34286829,21616,969923958,37959,9
55906,ZC4H2,chrX,R,64915801,65034744,34405772,118943,970042901,37960,5
55916,NXT2,chrX,F,109535780,109544698,34414690,8918,970051819,37961,6
55922,NKRF,chrX,R,119588336,119606435,34432789,18099,970069918,37962,3
55998,NXF5,chrX,R,101832111,101857577,34458255,25466,970095384,37963,20
55999,NXF4,chrX,F,102549964,102571693,34479984,21729,970117113,37964,16
56000,NXF3,chrX,R,103075820,103093094,34497258,17274,970134387,37965,19
56001,NXF2,chrX,F,102247099,102326720,34576879,79621,970214008,37966,22
56062,KLHL4,chrX,F,87517540,87670050,34729389,152510,970366518,37967,10
56156,TEX13B,chrX,R,107980863,107982370,34730896,1507,970368025,37968,2
56157,TEX13A,chrX,R,105218928,105220693,34732661,1765,970369790,37969,2
56159,TEX11,chrX,R,70525560,70908717,35115818,383157,970752947,37970,33
56180,MOSPD1,chrX,R,134887625,134915267,35143460,27642,970780589,37971,6
56271,BEX4,chrX,F,103215091,103217200,35145569,2109,970782698,37972,2
56474,CTPS2,chrX,R,16587998,16712979,35270550,124981,970907679,37973,22
56548,CHST7,chrX,F,46573686,46598496,35295360,24810,970932489,37974,1
56849,TCEAL7,chrX,F,103330185,103332323,35297498,2138,970934627,37975,2
56850,GRIPAP1,chrX,R,48973719,49002264,35326043,28545,970963172,37976,26
57187,THOC2,chrX,R,123600560,123733054,35458537,132494,971095666,37977,40
57232,ZNF630,chrX,R,48058177,48071658,35472018,13481,971109147,37978,5
57393,TMEM27,chrX,R,15627315,15665031,35509734,37716,971146863,37979,5
57477,SHROOM4,chrX,R,50576992,50814139,35746881,237147,971384010,37980,11
57481,KIAA1210,chrX,R,119078634,119150579,35818826,71945,971455955,37981,14
57502,NLGN4X,chrX,R,5890025,6228882,36157683,338857,971794812,37982,11
57526,PCDH19,chrX,R,100291643,100410273,36276313,118630,971913442,37983,5
57529,RGAG1,chrX,F,110358775,110456334,36373872,97559,972011001,37984,4
57595,PDZD4,chrX,R,153802165,153830567,36402274,28402,972039403,37985,9
57631,LRCH2,chrX,R,115110615,115234075,36525734,123460,972162863,37986,21
57692,MAGEE1,chrX,F,76427652,76431353,36529435,3701,972166564,37987,0
57826,RAP2C,chrX,R,132203023,132219480,36545892,16457,972183021,37988,6
58526,MID1IP1,chrX,F,38801431,38806532,36550993,5101,972188122,37989,2
59272,ACE2,chrX,R,15494401,15602069,36658661,107668,972295790,37990,21
59353,TMEM35,chrX,F,101078846,101096367,36676182,17521,972313311,37991,1
60343,FAM3A,chrX,R,154506158,154516247,36686271,10089,972323400,37992,9
60401,EDA2R,chrX,R,66594383,66639298,36731186,44915,972368315,37993,7
60506,NYX,chrX,F,41445636,41476421,36761971,30785,972399100,37994,2
63035,BCORL1,chrX,F,129980282,130058083,36839772,77801,972476901,37995,19
63904,DUSP21,chrX,F,44844002,44844888,36840658,886,972477787,37996,0
63932,CXorf56,chrX,R,119538148,119565434,36867944,27286,972505073,37997,6
63947,DMRTC1,chrX,R,72872024,72943653,36939573,71629,972576702,37998,8
64061,TSPYL2,chrX,F,53082359,53088546,36945760,6187,972582889,37999,6
64102,TNMD,chrX,F,100584792,100600983,36961951,16191,972599080,38000,8
64109,CRLF2,chrX,R,1190448,1212815,36984318,22367,972621447,38001,8
64219,PJA1,chrX,R,69160737,69165522,36989103,4785,972626232,38002,1
64648,SPANXD,chrX,R,141697400,141698739,36990442,1339,972627571,38003,1
64663,SPANXC,chrX,R,141241462,141242550,36991530,1088,972628659,38004,1
64743,WDR13,chrX,F,48590042,48605194,37006682,15152,972643811,38005,8
64840,PORCN,chrX,F,48508958,48520814,37018538,11856,972655667,38006,14
64860,ARMCX5,chrX,F,102599167,102604159,37023530,4992,972660659,38007,4
65109,UPF3B,chrX,R,119805310,119853028,37071248,47718,972708377,38008,15
65267,WNK3,chrX,R,54192822,54358695,37237121,165873,972874250,38009,25
65991,FUNDC2,chrX,F,155026788,155056916,37267249,30128,972904378,38010,4
79057,PRRG3,chrX,F,151694675,151705924,37278498,11249,972915627,38011,7
79135,APOO,chrX,R,23833347,23907940,37353091,74593,972990220,38012,9
79184,BRCC3,chrX,F,155071419,155123074,37404746,51655,973041875,38013,11
79366,HMGN5,chrX,R,81113700,81201942,37492988,88242,973130117,38014,6
79576,NKAP,chrX,R,119925049,119943772,37511711,18723,973148840,38015,8
79589,RNF128,chrX,F,106693837,106797016,37614890,103179,973252019,38016,7
79649,MAP7D3,chrX,R,136213219,136256482,37658153,43263,973295282,38017,20
79710,MORC4,chrX,R,106940733,107000244,37717664,59511,973354793,38018,16
79742,CXorf36,chrX,R,45148372,45200901,37770193,52529,973407322,38019,5
79836,LONRF3,chrX,F,118974613,119018856,37814436,44243,973451565,38020,12
79868,ALG13,chrX,F,111680741,111764164,37897859,83423,973534988,38021,31
79917,MAGIX,chrX,F,49162563,49168157,37903453,5594,973540582,38022,9
79921,TCEAL4,chrX,F,103576230,103587736,37914959,11506,973552088,38023,4
79979,TRMT2B,chrX,R,100973643,101052116,37993432,78473,973630561,38024,15
79983,POF1B,chrX,R,85276893,85379743,38096282,102850,973733411,38025,16
80161,ASMTL-AS1,chrX,F,1400530,1415421,38111173,14891,973748302,38026,5
80231,CXorf21,chrX,R,30558823,30577916,38130266,19093,973767395,38027,2
80258,EFHC2,chrX,R,44146253,44343677,38327690,197424,973964819,38028,16
80311,KLHL15,chrX,R,23983715,24027186,38371161,43471,974008290,38029,3
80316,PPP1R2P9,chrX,R,42777365,42778235,38372031,870,974009160,38030,0
80712,ESX1,chrX,R,104250037,104254918,38376912,4881,974014041,38031,3
80823,BHLHB9,chrX,F,102720713,102752441,38408640,31728,974045769,38032,4
81557,MAGED4B,chrX,R,52061826,52069272,38416086,7446,974053215,38033,14
81887,LAS1L,chrX,R,65512581,65534806,38438311,22225,974075440,38034,15
83550,GPR101,chrX,R,137030147,137031674,38439838,1527,974076967,38035,0
83604,TMEM47,chrX,R,34627063,34657288,38470063,30225,974107192,38036,2
83692,CD99L2,chrX,R,150766335,150898816,38602544,132481,974239673,38037,12
83740,H2AFB3,chrX,R,155459418,155459935,38603061,517,974240190,38038,0
83844,USP26,chrX,R,133025478,133028272,38605855,2794,974242984,38039,0
83957,FRMD8P1,chrX,R,65550621,65552421,38607655,1800,974244784,38040,0
84061,MAGT1,chrX,R,77826363,77895568,38676860,69205,974313989,38041,9
84187,TMEM164,chrX,F,110002412,110184038,38858486,181626,974495615,38042,13
84295,PHF6,chrX,F,134373311,134428792,38913967,55481,974551096,38043,9
84443,FRMPD3,chrX,F,107522449,107605244,38996762,82795,974633891,38044,17
84460,ZMAT1,chrX,R,101882287,101932135,39046610,49848,974683739,38045,8
84528,RHOXF2,chrX,F,120158538,120164027,39052099,5489,974689228,38046,3
84548,TMEM185A,chrX,R,149596555,149631912,39087456,35357,974724585,38047,6
84631,SLITRK2,chrX,F,145817828,145825842,39095470,8014,974732599,38048,4
84636,GPR174,chrX,F,79170971,79172229,39096728,1258,974733857,38049,0
84679,SLC9A7,chrX,R,46599245,46759172,39256655,159927,974893784,38050,17
84707,BEX2,chrX,R,103309345,103311046,39258356,1701,974895485,38051,2
84848,MIR503HG,chrX,R,134543376,134546630,39261610,3254,974898739,38052,2
84889,SLC7A3,chrX,R,70925578,70931125,39267157,5547,974904286,38053,11
84968,PNMA6A,chrX,F,153072413,153075019,39269763,2606,974906892,38054,1
85012,TCEAL3,chrX,F,103607905,103609927,39271785,2022,974908914,38055,2
85417,CCNB3,chrX,F,50281420,50351914,39342279,70494,974979408,38056,12
89801,PPP1R3F,chrX,F,49269828,49288095,39360546,18267,974997675,38057,3
89885,FATE1,chrX,F,151716035,151723194,39367705,7159,975004834,38058,4
90060,CCDC120,chrX,F,49053431,49069858,39384132,16427,975021261,38059,10
90121,TSR2,chrX,F,54440419,54445297,39389010,4878,975026139,38060,4
90161,HS6ST2,chrX,R,132626009,132961395,39724396,335386,975361525,38061,9
90167,FRMD7,chrX,R,132076992,132128022,39775426,51030,975412555,38062,11
90293,KLHL13,chrX,R,117897812,118117340,39994954,219528,975632083,38063,12
90316,TGIF2LX,chrX,F,89921940,89922883,39995897,943,975633026,38064,1
90736,FAM104B,chrX,R,55143101,55161195,40013991,18094,975651120,38065,5
90737,PAGE5,chrX,F,55220346,55224108,40017753,3762,975654882,38066,4
90843,TCEAL8,chrX,R,103252994,103255193,40019952,2199,975657081,38067,2
91851,CHRDL1,chrX,R,110673855,110796058,40142155,122203,975779284,38068,11
91966,CXorf40A,chrX,F,149540714,149555340,40156781,14626,975793910,38069,8
92002,FAM58A,chrX,R,153587924,153599177,40168034,11253,975805163,38070,6
92129,RIPPLY1,chrX,R,106900062,106903331,40171303,3269,975808432,38071,3
92249,LINC01278,chrX,R,63426558,63560993,40305738,134435,975942867,38072,3
92552,ATXN3L,chrX,R,13318646,13320399,40307491,1753,975944620,38073,0
92745,SLC38A5,chrX,R,48458536,48470256,40319211,11720,975956340,38074,19
93380,MMGT1,chrX,R,135962071,135973975,40331115,11904,975968244,38075,3
93953,ACRC,chrX,F,71578023,71613583,40366675,35560,976003804,38076,16
94056,SYAP1,chrX,F,16719583,16762684,40409776,43101,976046905,38077,8
94121,SYTL4,chrX,R,100674490,100732148,40467434,57658,976104563,38078,19
94122,SYTL5,chrX,F,37906067,38129294,40690661,223227,976327790,38079,21
114824,PNMA5,chrX,R,152988823,152994127,40695965,5304,976333094,38080,3
114928,GPRASP2,chrX,F,102712175,102717733,40701523,5558,976338652,38081,6
115201,ATG4A,chrX,F,108088915,108154671,40767279,65756,976404408,38082,14
116442,RAB39B,chrX,R,155258233,155264589,40773635,6356,976410764,38083,1
117154,DACH2,chrX,F,86148450,86832602,41457787,684152,977094916,38084,12
139065,SLITRK4,chrX,R,143622789,143636107,41471105,13318,977108234,38085,5
139067,SPANXN3,chrX,R,143508734,143517475,41479846,8741,977116975,38086,1
139081,MAGEC3,chrX,F,141838315,141897832,41539363,59517,977176492,38087,10
139105,BEND2,chrX,R,18162930,18220904,41597337,57974,977234466,38088,14
139135,PASD1,chrX,F,151563534,151676739,41710542,113205,977347671,38089,15
139170,DCAF12L1,chrX,R,126549382,126552859,41714019,3477,977351148,38090,1
139189,DGKK,chrX,R,50365406,50470738,41819351,105332,977456480,38091,27
139201,MAP2K4P1,chrX,R,73524274,73563085,41858162,38811,977495291,38092,1
139212,PIH1D3,chrX,F,107206558,107244243,41895847,37685,977532976,38093,7
139221,MUM1L1,chrX,F,106168277,106208961,41936531,40684,977573660,38094,5
139231,FAM199X,chrX,F,104166474,104195902,41965959,29428,977603088,38095,5
139285,AMER1,chrX,R,64185116,64206398,41987241,21282,977624370,38096,2
139322,APOOL,chrX,F,85003891,85093317,42076667,89426,977713796,38097,11
139324,HDX,chrX,R,84317873,84502584,42261378,184711,977898507,38098,11
139341,FUNDC1,chrX,R,44523638,44542975,42280715,19337,977917844,38099,4
139378,ADGRG4,chrX,F,136300962,136416907,42396660,115945,978033789,38100,27
139411,PTCHD1,chrX,F,23334353,23396801,42459108,62448,978096237,38101,3
139420,SMEK3P,chrX,R,27460210,27463341,42462239,3131,978099368,38102,0
139422,MAGEB10,chrX,F,27807449,27823532,42478322,16083,978115451,38103,3
139425,DCAF8L1,chrX,R,27977992,27981449,42481779,3457,978118908,38104,0
139538,VENTXP1,chrX,F,26558336,26561052,42484495,2716,978121624,38105,0
139562,OTUD6A,chrX,F,70062490,70064179,42486184,1689,978123313,38106,0
139596,UPRT,chrX,F,75274058,75304897,42517023,30839,978154152,38107,8
139599,MAGEE2,chrX,R,75782987,75785244,42519280,2257,978156409,38108,0
139604,MAGEB16,chrX,F,35795540,35803762,42527502,8222,978164631,38109,3
139628,FOXR2,chrX,F,55623399,55626188,42530291,2789,978167420,38110,0
139629,XAGE-4,chrX,R,55654691,55657961,42533561,3270,978170690,38111,3
139716,GAB3,chrX,R,154675248,154751583,42609896,76335,978247025,38112,10
139728,PNCK,chrX,R,153669732,153687768,42627932,18036,978265061,38113,21
139735,ZFP92,chrX,F,153411469,153426481,42642944,15012,978280073,38114,6
139741,ACTRT1,chrX,R,128050961,128052403,42644386,1442,978281515,38115,0
139760,GPR119,chrX,R,130384344,130385537,42645579,1193,978282708,38116,0
139793,PAGE3,chrX,R,55258414,55463452,42850617,205038,978487746,38117,6
139804,RBMXL3,chrX,F,115189399,115192868,42854086,3469,978491215,38118,0
139818,DOCK11,chrX,F,118495908,118686160,43044338,190252,978681467,38119,57
139886,SPIN4,chrX,R,63347227,63351339,43048450,4112,978685579,38120,0
140456,ASB11,chrX,R,15275643,15315667,43088474,40024,978725603,38121,9
140462,ASB9,chrX,R,15243986,15270467,43114955,26481,978752084,38122,6
140597,TCEAL2,chrX,F,102125687,102127712,43116980,2025,978754109,38123,2
140886,PABPC5,chrX,F,91434597,91438584,43120967,3987,978758096,38124,1
142684,RAB40A,chrX,R,103499135,103519489,43141321,20354,978778450,38125,4
142689,ASB12,chrX,R,64224191,64230631,43147761,6440,978784890,38126,2
154796,AMOT,chrX,R,112774876,112840961,43213846,66085,978850975,38127,16
158506,ZNF645,chrX,F,22272912,22274461,43215395,1549,978852524,38128,0
158511,CSAG1,chrX,R,152727483,152733736,43221648,6253,978858777,38129,4
158521,FMR1NB,chrX,F,147981328,148026667,43266987,45339,978904116,38130,5
158572,USP27X-AS1,chrX,R,49876723,49879356,43269620,2633,978906749,38131,1
158584,FAAH2,chrX,F,57121878,57489196,43636938,367318,979274067,38132,16
158586,ZXDB,chrX,F,57591835,57597477,43642580,5642,979279709,38133,0
158696,LINC00889,chrX,R,138614730,138617638,43645488,2908,979282617,38134,0
158724,FAM47A,chrX,R,34129751,34132330,43648067,2579,979285196,38135,0
158747,MOSPD2,chrX,F,14873404,14922166,43696829,48762,979333958,38136,16
158763,ARHGAP36,chrX,F,131056485,131089885,43730229,33400,979367358,38137,13
158787,RIBC1,chrX,F,53422781,53431120,43738568,8339,979375697,38138,6
158798,AKAP14,chrX,F,119895972,119920716,43763312,24744,979400441,38139,6
158800,RHOXF1,chrX,R,120109048,120117709,43771973,8661,979409102,38140,3
158801,NKAPP1,chrX,R,120236451,120245267,43780789,8816,979417918,38141,2
158809,MAGEB6,chrX,F,26192439,26195646,43783996,3207,979421125,38142,1
158830,CXorf65,chrX,R,71103888,71106972,43787080,3084,979424209,38143,5
158833,AWAT1,chrX,F,70234654,70240661,43793087,6007,979430216,38144,6
158835,AWAT2,chrX,R,70040541,70049965,43802511,9424,979439640,38145,7
158866,ZDHHC15,chrX,R,75368426,75523626,43957711,155200,979594840,38146,11
158880,USP51,chrX,R,55484615,55489868,43962964,5253,979600093,38147,0
158931,TCEAL6,chrX,R,102139960,102142416,43965420,2456,979602549,38148,2
158960,LOC158960,chrX,R,154424379,154428479,43969520,4100,979606649,38149,1
158983,H2BFWT,chrX,R,104011146,104013687,43972061,2541,979609190,38150,2
159013,CXorf38,chrX,R,40626920,40647567,43992708,20647,979629837,38151,7
159090,FAM122B,chrX,R,134769565,134797232,44020375,27667,979657504,38152,9
159091,FAM122C,chrX,F,134796412,134855135,44079098,58723,979716227,38153,23
168400,DDX53,chrX,F,22999960,23002089,44081227,2129,979718356,38154,0
169966,FAM46D,chrX,F,80335503,80446885,44192609,111382,979829738,38155,6
169981,SPIN3,chrX,R,56976369,56995601,44211841,19232,979848970,38156,4
170062,FAM47B,chrX,F,34942795,34944917,44213963,2122,979851092,38157,0
170067,SUPT20HL2,chrX,R,24310861,24313315,44216417,2454,979853546,38158,0
170082,TCEANC,chrX,F,13652645,13665409,44229181,12764,979866310,38159,5
170261,ZCCHC12,chrX,F,118823823,118826968,44232326,3145,979869455,38160,3
170302,ARX,chrX,R,25003693,25015948,44244581,12255,979881710,38161,4
170626,XAGE3,chrX,R,52862527,52868135,44250189,5608,979887318,38162,7
170627,XAGE5,chrX,F,52811293,52818298,44257194,7005,979894323,38163,6
170685,NUDT10,chrX,F,51332230,51337525,44262489,5295,979899618,38164,2
171482,FAM9A,chrX,R,8790773,8801383,44273099,10610,979910228,38165,9
171483,FAM9B,chrX,R,9024231,9197249,44446117,173018,980083246,38166,16
171484,FAM9C,chrX,R,13035616,13044798,44455299,9182,980092428,38167,7
203413,CT83,chrX,R,116461685,116463033,44456647,1348,980093776,38168,1
203414,LINC01560,chrX,F,47482715,47485227,44459159,2512,980096288,38169,0
203427,SLC25A43,chrX,F,119399294,119454478,44514343,55184,980151472,38170,6
203429,FAM226A,chrX,R,72941727,72943750,44516366,2023,980153495,38171,0
203430,ZCCHC5,chrX,R,78656068,78659502,44519800,3434,980156929,38172,2
203447,NRK,chrX,F,105821855,105958612,44656557,136757,980293686,38173,29
203522,DDX26B,chrX,F,135520629,135582535,44718463,61906,980355592,38174,20
203523,ZNF449,chrX,F,135344756,135363413,44737120,18657,980374249,38175,6
203547,VMA21,chrX,F,151396744,151409364,44749740,12620,980386869,38176,3
203562,TMEM31,chrX,F,103710908,103714032,44752864,3124,980389993,38177,2
203569,PAGE2,chrX,F,55089051,55092836,44756649,3785,980393778,38178,4
207063,DHRSX,chrX,R,2219505,2500974,45038118,281469,980675247,38179,6
246100,CTAG1A,chrX,F,154585153,154586816,45039781,1663,980676910,38180,2
254065,BRWD3,chrX,R,80669487,80809734,45180028,140247,980817157,38181,41
254158,CXorf58,chrX,F,23907931,23939507,45211604,31576,980848733,38182,8
255313,CT47A11,chrX,R,120933839,120937198,45214963,3359,980852092,38183,3
256643,CXorf23,chrX,R,19912859,19990934,45293038,78075,980930167,38184,16
256714,MAP7D2,chrX,R,20006712,20116996,45403322,110284,981040451,38185,19
257240,KLHL34,chrX,R,21655348,21658387,45406361,3039,981043490,38186,0
257397,TAB3,chrX,R,30827441,30889394,45468314,61953,981105443,38187,12
266740,MAGEA2B,chrX,F,152714501,152718607,45472420,4106,981109549,38188,6
280657,SSX6,chrX,F,48107981,48120686,45485125,12705,981122254,38189,7
280658,SSX7,chrX,R,52644060,52654900,45495965,10840,981133094,38190,7
280659,SSX8,chrX,F,52622934,52633948,45506979,11014,981144108,38191,7
280660,SSX9,chrX,R,48301549,48306179,45511609,4630,981148738,38192,4
282808,RAB40AL,chrX,F,102937271,102938300,45512638,1029,981149767,38193,0
283981,LINC00685,chrX,F,319144,321332,45514826,2188,981151955,38194,0
286410,ATP11C,chrX,R,139726345,139945234,45733715,218889,981370844,38195,37
286411,LINC00632,chrX,F,140709758,140772677,45796634,62919,981433763,38196,4
286436,H2BFM,chrX,F,104039908,104042454,45799180,2546,981436309,38197,2
286437,LOC286437,chrX,R,104122304,104124632,45801508,2328,981438637,38198,0
286442,LINC01281,chrX,R,39304955,39327362,45823915,22407,981461044,38199,3
286451,YIPF6,chrX,F,68498373,68572330,45897872,73957,981535001,38200,7
286464,CFAP47,chrX,F,35919733,36385319,46363458,465586,982000587,38201,63
286467,FIRRE,chrX,R,131702649,131830643,46491452,127994,982128581,38202,12
286480,UBE2E4P,chrX,F,14244264,14245423,46492611,1159,982129740,38203,0
286495,TTC3P1,chrX,R,75740537,75743079,46495153,2542,982132282,38204,0
286499,FAM133A,chrX,F,93673735,93712274,46533692,38539,982170821,38205,8
286514,MAGEB18,chrX,F,26138342,26140736,46536086,2394,982173215,38206,2
286527,TMSB15B,chrX,F,103962626,103965990,46539450,3364,982176579,38207,2
286530,P2RY8,chrX,R,1462571,1537506,46614385,74935,982251514,38208,5
286967,FAM223B,chrX,R,154632469,154633182,46615098,713,982252227,38209,0
340526,RGAG4,chrX,R,72127109,72131901,46619890,4792,982257019,38210,1
340527,NHSL2,chrX,F,71911072,72153286,46862104,242214,982499233,38211,9
340529,PABPC1L2A,chrX,R,73077337,73079512,46864279,2175,982501408,38212,0
340533,KIAA2022,chrX,R,74732855,74925452,47056876,192597,982694005,38213,4
340542,BEX5,chrX,R,102153706,102156014,47059184,2308,982696313,38214,3
340543,TCEAL5,chrX,R,103273689,103276869,47062364,3180,982699493,38215,2
340544,MORF4L2-AS1,chrX,F,103687283,103692560,47067641,5277,982704770,38216,2
340547,VSIG1,chrX,F,108018905,108079184,47127920,60279,982765049,38217,9
340554,ZC3H12B,chrX,F,65034798,65507887,47601009,473089,983238138,38218,13
340562,SATL1,chrX,R,85092285,85116178,47624902,23893,983262031,38219,5
340578,DCAF12L2,chrX,R,126163498,126166097,47627501,2599,983264630,38220,0
340581,LOC340581,chrX,F,134949549,134953382,47631334,3833,983268463,38221,2
340591,CA5BP1,chrX,F,15674915,15703351,47659770,28436,983296899,38222,4
340595,ZCCHC16,chrX,F,112083024,112457245,48033991,374221,983671120,38223,4
340596,LHFPL1,chrX,R,112625636,112680178,48088533,54542,983725662,38224,4
340602,CXorf67,chrX,F,51406914,51408838,48090457,1924,983727586,38225,0
347344,ZNF81,chrX,F,47836870,47925624,48179211,88754,983816340,38226,7
347365,ITIH6,chrX,R,54748898,54798240,48228553,49342,983865682,38227,12
347404,LANCL3,chrX,F,37571568,37677499,48334484,105931,983971613,38228,7
347411,MPC1L,chrX,F,40617504,40624139,48341119,6635,983978248,38229,1
347442,DCAF8L2,chrX,F,27746808,27748821,48343132,2013,983980261,38230,0
347454,SOWAHD,chrX,F,119758612,119760202,48344722,1590,983981851,38231,0
347468,OR13H1,chrX,F,131544073,131545000,48345649,927,983982778,38232,0
347475,CCDC160,chrX,F,134237046,134246207,48354810,9161,983991939,38233,2
347487,CXorf66,chrX,R,139955724,139965518,48364604,9794,984001733,38234,2
347516,DGAT2L6,chrX,F,70177482,70205705,48392827,28223,984029956,38235,7
347517,RAB41,chrX,F,70281390,70285800,48397237,4410,984034366,38236,6
347527,ARSH,chrX,F,3006612,3033385,48424010,26773,984061139,38237,8
347541,MAGEB5,chrX,F,26216080,26218270,48426200,2190,984063329,38238,1
349408,TLR8-AS1,chrX,R,12902816,12943300,48466684,40484,984103813,38239,4
389840,MAP3K15,chrX,R,19360057,19515261,48621888,155204,984259017,38240,32
389852,SPACA5,chrX,F,48004335,48010162,48627715,5827,984264844,38241,5
389856,USP27X,chrX,F,49879866,49882565,48630414,2699,984267543,38242,0
389857,CENPVP1,chrX,F,51710828,51712131,48631717,1303,984268846,38243,0
389860,PAGE2B,chrX,F,55029539,55078909,48681087,49370,984318216,38244,6
389874,ZCCHC13,chrX,F,74304189,74305034,48681932,845,984319061,38245,0
389895,LOC389895,chrX,F,140091666,140092911,48683177,1245,984320306,38246,0
389898,UBE2NL,chrX,F,143884070,143885255,48684362,1185,984321491,38247,0
389903,CSAG3,chrX,F,152753920,152760222,48690664,6302,984327793,38248,4
389906,LOC389906,chrX,R,3817534,3843894,48717024,26360,984354153,38249,4
392452,LOC392452,chrX,F,45731087,45731757,48717694,670,984354823,38250,0
392459,CXXC1P1,chrX,F,47707190,47736628,48747132,29438,984384261,38251,3
392465,GLOD5,chrX,F,48761705,48773648,48759075,11943,984396204,38252,5
392490,FLJ44635,chrX,F,72144183,72161750,48776642,17567,984413771,38253,1
392509,ARL13A,chrX,F,100969039,100990831,48798434,21792,984435563,38254,8
399668,LINC00086,chrX,F,135421942,135426300,48802792,4358,984439921,38255,1
401577,CD99P1,chrX,F,2609264,2657229,48850757,47965,984487886,38256,10
401585,LOC401585,chrX,R,45848073,45851490,48854174,3417,984491303,38257,2
401588,ZNF674-AS1,chrX,F,46545489,46548475,48857160,2986,984494289,38258,1
401589,LOC401589,chrX,R,52051170,52054255,48860245,3085,984497374,38259,1
401612,SLC25A53,chrX,R,104099213,104157027,48918059,57814,984555188,38260,4
401613,LINC00890,chrX,F,111511661,111522399,48928797,10738,984565926,38261,2
402415,XKRX,chrX,R,100886923,100957401,48999275,70478,984636404,38262,5
404281,YY2,chrX,F,21855986,21858727,49002016,2741,984639145,38263,0
406889,MIRLET7F2,chrX,R,53557191,53557274,49002099,83,984639228,38264,0
406897,MIR105-1,chrX,R,152392218,152392299,49002180,81,984639309,38265,0
406898,MIR105-2,chrX,R,152394411,152394492,49002261,81,984639390,38266,0
406899,MIR106A,chrX,R,134170197,134170278,49002342,81,984639471,38267,0
406964,MIR188,chrX,F,50003502,50003588,49002428,86,984639557,38268,0
406981,MIR19B2,chrX,R,134169670,134169766,49002524,96,984639653,38269,0
407006,MIR221,chrX,R,45746156,45746266,49002634,110,984639763,38270,0
407007,MIR222,chrX,R,45747014,45747124,49002744,110,984639873,38271,0
407008,MIR223,chrX,F,66018869,66018979,49002854,110,984639983,38272,0
407009,MIR224,chrX,R,151958577,151958658,49002935,81,984640064,38273,0
407049,MIR92A2,chrX,R,134169537,134169612,49003010,75,984640139,38274,0
407054,MIR98,chrX,R,53556222,53556341,49003129,119,984640258,38275,0
425054,VCX3B,chrX,F,8464829,8466510,49004810,1681,984641939,38276,2
441490,FTH1P18,chrX,R,37042881,37043794,49005723,913,984642852,38277,0
441495,CENPVP2,chrX,R,51681211,51682514,49007026,1303,984644155,38278,0
441501,LINC00891,chrX,F,71697195,71703406,49013237,6211,984650366,38279,2
441502,RPS26P11,chrX,F,72044408,72044974,49013803,566,984650932,38280,0
441509,GLRA4,chrX,R,103707343,103728624,49035084,21281,984672213,38281,8
441518,FAM127C,chrX,R,135020503,135022536,49037117,2033,984674246,38282,0
441519,CT45A3,chrX,R,135760066,135777544,49054595,17478,984691724,38283,5
441521,CT45A5,chrX,R,135777129,135794806,49072272,17677,984709401,38284,5
441525,SPANXN4,chrX,F,143025917,143034280,49080635,8363,984717764,38285,1
441531,PGAM4,chrX,R,77967960,77969638,49082313,1678,984719442,38286,0
442444,FAM47C,chrX,F,37008358,37011666,49085621,3308,984722750,38287,0
442454,UQCRBP1,chrX,R,56736787,56737584,49086418,797,984723547,38288,0
442459,XRCC6P5,chrX,R,99461601,99939843,49564660,478242,985201789,38289,10
442899,MIR325,chrX,R,77005403,77005501,49564758,98,985201887,38290,0
442919,MIR374A,chrX,R,74287285,74287357,49564830,72,985201959,38291,0
474343,SPIN2B,chrX,R,57119681,57121556,49566705,1875,985203834,38292,2
474381,H2AFB2,chrX,F,155380705,155381299,49567299,594,985204428,38293,0
474382,H2AFB1,chrX,F,154885041,154885558,49567816,517,985204945,38294,0
474383,F8A2,chrX,F,155382114,155383230,49568932,1116,985206061,38295,0
474384,F8A3,chrX,R,155457484,155458600,49570048,1116,985207177,38296,0
494118,SPANXN1,chrX,F,145247586,145256208,49578670,8622,985215799,38297,1
494119,SPANXN2,chrX,R,143712034,143720668,49587304,8634,985224433,38298,1
494197,SPANXN5,chrX,R,52796145,52797348,49588507,1203,985225636,38299,1
494323,MIR361,chrX,R,85903635,85903707,49588579,72,985225708,38300,0
494333,MIR384,chrX,R,76919272,76919360,49588667,88,985225796,38301,0
494336,MIR424,chrX,R,134546613,134546711,49588765,98,985225894,38302,0
541465,CT45A6,chrX,R,135794686,135812082,49606161,17396,985243290,38303,5
541466,CT45A1,chrX,F,135708397,135723318,49621082,14921,985258211,38304,5
541578,CXorf40B,chrX,R,149924156,149938850,49635776,14694,985272905,38305,7
548313,SSX4B,chrX,R,48402081,48411910,49645605,9829,985282734,38306,7
550643,LINC01420,chrX,F,56729284,56817571,49733892,88287,985371021,38307,2
554203,JPX,chrX,F,73944323,74070384,49859953,126061,985497082,38308,4
554212,MIR448,chrX,F,114823453,114823564,49860064,111,985497193,38309,0
554214,MIR450A1,chrX,R,134540340,134540431,49860155,91,985497284,38310,0
574030,MIR362,chrX,F,50008963,50009028,49860220,65,985497349,38311,0
574031,MIR363,chrX,R,134169377,134169452,49860295,75,985497424,38312,0
574032,MIR20B,chrX,R,134169808,134169877,49860364,69,985497493,38313,0
574033,MIR18B,chrX,R,134170040,134170111,49860435,71,985497564,38314,0
574412,MIR452,chrX,R,151959627,151959712,49860520,85,985497649,38315,0
574502,MIR500A,chrX,F,50008430,50008514,49860604,84,985497733,38316,0
574503,MIR501,chrX,F,50009721,50009805,49860688,84,985497817,38317,0
574504,MIR502,chrX,F,50014597,50014683,49860774,86,985497903,38318,0
574505,MIR450A2,chrX,R,134540507,134540607,49860874,100,985498003,38319,0
574506,MIR503,chrX,R,134546327,134546398,49860945,71,985498074,38320,0
574507,MIR504,chrX,R,138667710,138667793,49861028,83,985498157,38321,0
574508,MIR505,chrX,R,139924147,139924231,49861112,84,985498241,38322,0
574509,MIR513A1,chrX,R,147213462,147213591,49861241,129,985498370,38323,0
574510,MIR513A2,chrX,R,147225825,147225952,49861368,127,985498497,38324,0
574511,MIR506,chrX,R,147230719,147230843,49861492,124,985498621,38325,0
574512,MIR507,chrX,R,147230983,147231077,49861586,94,985498715,38326,0
574513,MIR508,chrX,R,147236912,147237027,49861701,115,985498830,38327,0
574514,MIR509-1,chrX,R,147260531,147260625,49861795,94,985498924,38328,0
574515,MIR510,chrX,R,147272334,147272408,49861869,74,985498998,38329,0
574516,MIR514A1,chrX,R,147279246,147279344,49861967,98,985499096,38330,0
574517,MIR514A2,chrX,R,147281942,147282030,49862055,88,985499184,38331,0
574518,MIR514A3,chrX,R,147284640,147284728,49862143,88,985499272,38332,0
619455,SPANXA2-OT1,chrX,F,141502848,141649939,50009234,147091,985646363,38333,3
641339,ZNF674,chrX,R,46497724,46545459,50056969,47735,985694098,38334,8
642776,LOC642776,chrX,R,115917270,115969111,50108810,51841,985745939,38335,2
643311,CT47B1,chrX,R,120872596,120875925,50112139,3329,985749268,38336,2
643486,BRDTP1,chrX,R,96337085,96337902,50112956,817,985750085,38337,0
644353,ZCCHC18,chrX,F,104112415,104115847,50116388,3432,985753517,38338,2
644538,SMIM10,chrX,F,134990937,134992473,50117924,1536,985755053,38339,0
644596,LINC00087,chrX,R,135094984,135098703,50121643,3719,985758772,38340,1
644717,SAGE2P,chrX,R,135638041,135688495,50172097,50454,985809226,38341,21
645037,GAGE2B,chrX,F,49331614,49338933,50179416,7319,985816545,38342,4
645073,GAGE12G,chrX,F,49570399,49577757,50186774,7358,985823903,38343,4
645188,LOC645188,chrX,F,141625867,141626733,50187640,866,985824769,38344,1
645864,MAGEB17,chrX,F,16167480,16172097,50192257,4617,985829386,38345,2
645974,PABPC1L2B,chrX,F,73003512,73005712,50194457,2200,985831586,38346,0
645996,NAP1L6,chrX,R,73126036,73128080,50196501,2044,985833630,38347,0
646127,LOC646127,chrX,R,75325135,75359455,50230821,34320,985867950,38348,1
653067,XAGE1E,chrX,R,52512076,52517221,50235966,5145,985873095,38349,3
653220,XAGE1B,chrX,F,52495667,52500812,50241111,5145,985878240,38350,3
653282,CT47A7,chrX,R,120953281,120956600,50244430,3319,985881559,38351,3
653687,FAM226B,chrX,F,72777072,72779095,50246453,2023,985883582,38352,0
664614,MIR545,chrX,R,74287103,74287209,50246559,106,985883688,38353,0
664617,MIR542,chrX,R,134541340,134541437,50246656,97,985883785,38354,0
677773,SCARNA23,chrX,F,24744440,24744570,50246786,130,985883915,38355,0
677799,SNORA11,chrX,F,54814369,54814500,50246917,131,985884046,38356,0
677816,SNORA35,chrX,F,114630796,114630924,50247045,128,985884174,38357,0
677817,SNORA36A,chrX,F,154768527,154768659,50247177,132,985884306,38358,0
677835,SNORA56,chrX,F,154774997,154775126,50247306,129,985884435,38359,0
692226,SNORD96B,chrX,R,110224988,110225060,50247378,72,985884507,38360,0
693122,MIR421,chrX,R,74218376,74218461,50247463,85,985884592,38361,0
693124,MIR532,chrX,F,50003147,50003238,50247554,91,985884683,38362,0
723779,MIR651,chrX,F,8126964,8127061,50247651,97,985884780,38363,0
724022,MIR652,chrX,F,110055328,110055426,50247749,98,985884878,38364,0
724030,MIR660,chrX,F,50013240,50013337,50247846,97,985884975,38365,0
724087,LINC01545,chrX,R,46887416,46899704,50260134,12288,985897263,38366,3
727837,SSX2B,chrX,F,52751203,52761536,50270467,10333,985907596,38367,8
727856,DDX11L16,chrX,R,156025657,156028183,50272993,2526,985910122,38368,2
727866,FAM156B,chrX,F,52891305,52908560,50290248,17255,985927377,38369,5
727940,RHOXF2B,chrX,R,120072263,120077742,50295727,5479,985932856,38370,3
728036,CT47A10,chrX,R,120938700,120942059,50299086,3359,985936215,38371,3
728042,CT47A9,chrX,R,120943560,120946919,50302445,3359,985939574,38372,3
728049,CT47A8,chrX,R,120948421,120951780,50305804,3359,985942933,38373,3
728062,CT47A6,chrX,R,120958164,120961483,50309123,3319,985946252,38374,2
728072,CT47A5,chrX,R,120963025,120966384,50312482,3359,985949611,38375,3
728075,CT47A4,chrX,R,120967885,120971244,50315841,3359,985952970,38376,3
728082,CT47A3,chrX,R,120972745,120976104,50319200,3359,985956329,38377,3
728090,CT47A2,chrX,R,120977605,120980964,50322559,3359,985959688,38378,3
728096,CT47A1,chrX,R,120982465,120985824,50325918,3359,985963047,38379,3
728239,MAGED4,chrX,F,52184822,52192268,50333364,7446,985970493,38380,13
728269,MAGEA9B,chrX,R,149581650,149587468,50339182,5818,985976311,38381,4
728343,NXF2B,chrX,R,102360394,102440008,50418796,79614,986055925,38382,22
728458,OPN1MW2,chrX,F,154219733,154233286,50432349,13553,986069478,38383,5
728656,DMRTC1B,chrX,F,72777169,72848802,50503982,71633,986141111,38384,8
728660,LOC728660,chrX,F,140017242,140017694,50504434,452,986141563,38385,1
728695,SPANXB1,chrX,F,141002590,141003706,50505550,1116,986142679,38386,1
728712,SPANXA2,chrX,F,141589707,141590772,50506615,1065,986143744,38387,1
728911,CT45A2,chrX,R,135811978,135829348,50523985,17370,986161114,38388,5
729162,LOC729162,chrX,R,3890927,3926111,50559169,35184,986196298,38389,3
729201,SPACA5B,chrX,F,48130656,48132613,50561126,1957,986198255,38390,3
729396,GAGE12J,chrX,F,49322029,49329387,50568484,7358,986205613,38391,4
729408,GAGE2D,chrX,F,49560843,49568208,50575849,7365,986212978,38392,4
729422,GAGE12C,chrX,F,49532176,49539541,50583214,7365,986220343,38393,4
729428,GAGE12B,chrX,F,49341182,49529921,50771953,188739,986409082,38394,4
729431,GAGE12E,chrX,F,49551288,49558649,50779314,7361,986416443,38395,4
729442,GAGE12H,chrX,F,49579948,49587304,50786670,7356,986423799,38396,4
729447,GAGE2A,chrX,F,49589514,49596827,50793983,7313,986431112,38397,4
729609,LOC729609,chrX,R,19986816,19989779,50796946,2963,986434075,38398,1
751580,LINC00106,chrX,F,1397024,1399412,50799334,2388,986436463,38399,2
767811,H2BFXP,chrX,F,103975923,103978357,50801768,2434,986438897,38400,3
768215,MIR767,chrX,R,152393420,152393529,50801877,109,986439006,38401,0
768218,MIR766,chrX,R,119646737,119646848,50801988,111,986439117,38402,0
100093698,GS1-600G8.3,chrX,F,13310651,13319933,50811270,9282,986448399,38403,16
100101478,LOC100101478,chrX,R,104060503,104062938,50813705,2435,986450834,38404,3
100124540,SNORA11C,chrX,F,47388649,47388776,50813832,127,986450961,38405,0
100124541,SNORA11D,chrX,F,52190621,52190748,50813959,127,986451088,38406,0
100126270,FMR1-AS1,chrX,R,147909430,147922158,50826687,12728,986463816,38407,1
100126301,MIR509-2,chrX,R,147258759,147258850,50826778,91,986463907,38408,0
100126302,MIR450B,chrX,R,134540184,134540262,50826856,78,986463985,38409,0
100126303,MIR890,chrX,R,145994274,145994351,50826933,77,986464062,38410,0
100126304,MIR891B,chrX,R,146001052,146001131,50827012,79,986464141,38411,0
100126306,MIR888,chrX,R,145994783,145994860,50827089,77,986464218,38412,0
100126307,MIR892B,chrX,R,145997197,145997274,50827166,77,986464295,38413,0
100126317,MIR374B,chrX,R,74218546,74218618,50827238,72,986464367,38414,0
100126324,MIR934,chrX,F,136550877,136550960,50827321,83,986464450,38415,0
100126337,MIR509-3,chrX,R,147259651,147259726,50827396,75,986464525,38416,0
100126341,MIR891A,chrX,R,146027793,146027872,50827475,79,986464604,38417,0
100126342,MIR892A,chrX,R,145996668,145996743,50827550,75,986464679,38418,0
100126447,LOC100126447,chrX,R,116810930,116817860,50834480,6930,986471609,38419,1
100128420,LINC00892,chrX,F,136639542,136642429,50837367,2887,986474496,38420,2
100128594,LL0XNC01-116E7.2,chrX,R,103916983,103920025,50840409,3042,986477538,38421,3
100129239,CXorf51A,chrX,R,146814103,146814731,50841037,628,986478166,38422,1
100129291,LOC100129291,chrX,R,71662994,71666785,50844828,3791,986481957,38423,5
100129407,LINC00684,chrX,F,72938162,72938958,50845624,796,986482753,38424,2
100129464,LINC01546,chrX,F,3271819,3284653,50858458,12834,986495587,38425,2
100129515,LINC00633,chrX,R,135118954,135120477,50859981,1523,986497110,38426,2
100129520,LOC100129520,chrX,F,125319810,125325214,50865385,5404,986502514,38427,1
100129662,FGF13-AS1,chrX,F,138712106,138716605,50869884,4499,986507013,38428,2
100129860,LOC100129860,chrX,F,52199839,52201430,50871475,1591,986508604,38429,1
100130086,HSFX2,chrX,R,149592511,149595310,50874274,2799,986511403,38430,1
100130302,SUPT20HL1,chrX,F,24362760,24365424,50876938,2664,986514067,38431,0
100130361,CXorf49,chrX,R,71714373,71718285,50880850,3912,986517979,38432,5
100130613,PRR32,chrX,F,126819763,126821786,50882873,2023,986520002,38433,1
100130935,CSAG4,chrX,F,152733826,152740985,50890032,7159,986527161,38434,3
100131434,LINC00893,chrX,R,149527590,149539752,50902194,12162,986539323,38435,9
100131755,ARMCX4,chrX,F,101418262,101535988,51019920,117726,986657049,38436,17
100131816,UBE2DNL,chrX,F,84934150,84934890,51020660,740,986657789,38437,0
100132163,PHKA2-AS1,chrX,F,18890295,18894975,51025340,4680,986662469,38438,2
100132304,LOC100132304,chrX,R,72781864,72782660,51026136,796,986663265,38439,2
100132399,GAGE12D,chrX,F,49541721,49549107,51033522,7386,986670651,38440,4
100132741,LOC100132741,chrX,R,71778168,71784378,51039732,6210,986676861,38441,2
100132831,LOC100132831,chrX,R,40831216,40833196,51041712,1980,986678841,38442,0
100132963,SMIM9,chrX,R,154823347,154834662,51053027,11315,986690156,38443,4
100132967,FAM223A,chrX,F,154571247,154571960,51053740,713,986690869,38444,0
100132994,CXorf49B,chrX,F,71763289,71767201,51057652,3912,986694781,38445,5
100133053,CXorf51B,chrX,F,146809783,146810411,51058280,628,986695409,38446,1
100133123,LINC01203,chrX,F,13335240,13341825,51064865,6585,986701994,38447,6
100133957,UXT-AS1,chrX,F,47658832,47660111,51066144,1279,986703273,38448,1
100158262,SCARNA9L,chrX,R,20136065,20136413,51066492,348,986703621,38449,0
100189050,TRI-GAT1-2,chrX,R,3876800,3876874,51066566,74,986703695,38450,0
100189132,TRI-GAT1-1,chrX,R,3838376,3838450,51066640,74,986703769,38451,0
100189191,TRV-TAC1-2,chrX,R,18674908,18674981,51066713,73,986703842,38452,0
100189427,TRI-GAT1-3,chrX,R,3915229,3915303,51066787,74,986703916,38453,0
100272147,CMC4,chrX,R,155061621,155071272,51076438,9651,986713567,38454,2
100272228,LINC00894,chrX,F,149938547,150016787,51154678,78240,986791807,38455,11
100287728,LOC100287728,chrX,F,135120620,135123601,51157659,2981,986794788,38456,1
100287765,LINC00630,chrX,F,102769166,102885410,51273903,116244,986911032,38457,7
100288814,LOC100288814,chrX,F,9961358,9968373,51280918,7015,986918047,38458,1
100302111,MIR1184-1,chrX,R,154887359,154887458,51281017,99,986918146,38459,0
100302114,MIR513C,chrX,R,147189703,147189787,51281101,84,986918230,38460,0
100302115,MIR1468,chrX,R,63786001,63786087,51281187,86,986918316,38461,0
100302144,MIR1912,chrX,F,114651543,114651623,51281267,80,986918396,38462,0
100302153,MIR1298,chrX,F,114715232,114715344,51281379,112,986918508,38463,0
100302169,MIR320D2,chrX,R,140926171,140926219,51281427,48,986918556,38464,0
100302171,MIR1321,chrX,F,85835779,85835858,51281506,79,986918635,38465,0
100302191,MIR548I4,chrX,R,84225751,84225828,51281583,77,986918712,38466,0
100302214,MIR1277,chrX,F,118386393,118386471,51281661,78,986918790,38467,0
100302222,MIR1911,chrX,F,114763183,114763263,51281741,80,986918870,38468,0
100302239,MIR548F5,chrX,R,32641473,32641559,51281827,86,986918956,38469,0
100302251,MIR1264,chrX,F,114652654,114652723,51281896,69,986919025,38470,0
100302692,FTX,chrX,R,74028135,74293574,51547335,265439,987184464,38471,6
100303728,SLC25A5-AS1,chrX,R,119466032,119469120,51550423,3088,987187552,38472,0
100313772,MIR548M,chrX,R,95063140,95063226,51550509,86,987187638,38473,0
100313781,MIR718,chrX,R,154019919,154019989,51550579,70,987187708,38474,0
100313822,MIR513B,chrX,R,147199043,147199127,51550663,84,987187792,38475,0
100313838,MIR764,chrX,F,114639434,114639519,51550748,85,987187877,38476,0
100313839,MIR2114,chrX,F,150228003,150228083,51550828,80,987187957,38477,0
100329135,TRPC5OS,chrX,F,111876050,111903990,51578768,27940,987215897,38478,5
100359394,LINC00102,chrX,R,2612990,2615347,51581125,2357,987218254,38479,1
100421746,LOC100421746,chrX,F,55280087,55288786,51589824,8699,987226953,38480,4
100422847,MIR514B,chrX,R,147250150,147250230,51589904,80,987227033,38481,0
100422877,MIR3202-2,chrX,R,153981097,153981176,51589983,79,987227112,38482,0
100422911,MIR500B,chrX,F,50010671,50010750,51590062,79,987227191,38483,0
100422930,MIR4330,chrX,F,151168221,151168326,51590167,105,987227296,38484,0
100422932,MIR4328,chrX,R,78901193,78901249,51590223,56,987227352,38485,0
100422977,MIR1184-3,chrX,F,155457516,155457615,51590322,99,987227451,38486,0
100422985,MIR1184-2,chrX,R,155383099,155383198,51590421,99,987227550,38487,0
100422987,MIR3202-1,chrX,F,153981096,153981177,51590502,81,987227631,38488,0
100423009,MIR4329,chrX,R,112780717,112780788,51590573,71,987227702,38489,0
100463488,MTRNR2L10,chrX,R,55181390,55182511,51591694,1121,987228823,38490,0
100500807,MIR374C,chrX,F,74218548,74218618,51591764,70,987228893,38491,0
100500809,MIR23C,chrX,R,20017087,20017187,51591864,100,987228993,38492,0
100500822,MIR3937,chrX,F,39661215,39661321,51591970,106,987229099,38493,0
100500869,MIR3672,chrX,F,121370971,121371053,51592052,82,987229181,38494,0
100500887,MIR676,chrX,F,70022856,70022923,51592119,67,987229248,38495,0
100500894,MIR3690,chrX,F,1293917,1293992,51592194,75,987229323,38496,0
100500915,MIR3915,chrX,R,32583655,32583752,51592291,97,987229420,38497,0
100506164,HSFX1,chrX,F,149774067,149776870,51595094,2803,987232223,38498,1
100506757,LINC00629,chrX,F,134550023,134560398,51605469,10375,987242598,38499,2
100506790,LOC100506790,chrX,F,135396428,135397749,51606790,1321,987243919,38500,1
100506901,LOC100506901,chrX,F,103404776,103519242,51721256,114466,987358385,38501,16
100507170,CT47A12,chrX,R,120877489,120932297,51776064,54808,987413193,38502,2
100507404,TMLHE-AS1,chrX,F,155466539,155494110,51803635,27571,987440764,38503,3
100528062,ARMCX5-GPRASP2,chrX,F,102599347,102717733,51922021,118386,987559150,38504,6
100529097,RPL36A-HNRNPH2,chrX,F,101390889,101414140,51945272,23251,987582401,38505,4
100532742,PIR-FIGF,chrX,R,15345590,15491309,52090991,145719,987728120,38506,14
100533997,MAGEA10-MAGEA5,chrX,R,152114048,152138578,52115521,24530,987752650,38507,3
100616144,MIR548AN,chrX,F,106639813,106639896,52115604,83,987752733,38508,0
100616147,MIR4769,chrX,F,47587428,47587505,52115681,77,987752810,38509,0
100616155,MIR4536-1,chrX,R,55451494,55451582,52115769,88,987752898,38510,0
100616249,MIR4768,chrX,F,17425880,17425954,52115843,74,987752972,38511,0
100616251,MIR1587,chrX,F,39837560,39837613,52115896,53,987753025,38512,0
100616252,MIR548AJ2,chrX,R,38023894,38023986,52115988,92,987753117,38513,0
100616373,MIR4770,chrX,R,6383905,6383963,52116046,58,987753175,38514,0
100616428,MIR548AM,chrX,R,16627011,16627085,52116120,74,987753249,38515,0
100616467,MIR4767,chrX,F,7147859,7147937,52116198,78,987753327,38516,0
100616491,MIR3978,chrX,F,110082117,110082218,52116299,101,987753428,38517,0
100847047,MIR4666B,chrX,F,29574277,29574358,52116380,81,987753509,38518,0
100847052,MIR664B,chrX,F,154768595,154768656,52116441,61,987753570,38519,0
100847061,MIR4536-2,chrX,F,55451494,55451582,52116529,88,987753658,38520,0
100847063,MIR548AX,chrX,R,11318613,11318686,52116602,73,987753731,38521,0
100873065,PTCHD1-AS,chrX,R,22259796,23293146,53149952,1033350,988787081,38522,5
100873747,RNU6-30P,chrX,R,101634005,101634112,53150059,107,988787188,38523,0
100873920,NHS-AS1,chrX,R,17552348,17559127,53156838,6779,988793967,38524,2
100873921,SYP-AS1,chrX,F,49198838,49202454,53160454,3616,988797583,38525,1
100873922,ZFX-AS1,chrX,R,24146224,24149654,53163884,3430,988801013,38526,2
100873930,DLG3-AS1,chrX,R,70452955,70455994,53166923,3039,988804052,38527,2
100873942,PHEX-AS1,chrX,R,22162731,22172983,53177175,10252,988814304,38528,4
100873944,PRKX-AS1,chrX,F,3659486,3668192,53185881,8706,988823010,38529,2
100873985,MED14OS,chrX,F,40735395,40738701,53189187,3306,988826316,38530,1
100873990,HCFC1-AS1,chrX,F,153968764,153970091,53190514,1327,988827643,38531,2
100874004,PPEF1-AS1,chrX,R,18688642,18692687,53194559,4045,988831688,38532,2
100874078,EIF1AX-AS1,chrX,F,20139967,20140444,53195036,477,988832165,38533,1
100874088,PCYT1B-AS1,chrX,F,24650072,24658237,53203201,8165,988840330,38534,1
100874102,HS6ST2-AS1,chrX,F,132667641,132669888,53205448,2247,988842577,38535,2
100874118,DDX26B-AS1,chrX,R,135520082,135520674,53206040,592,988843169,38536,1
100874120,ZNF630-AS1,chrX,F,48056309,48066583,53216314,10274,988853443,38537,1
100874122,FRMPD3-AS1,chrX,R,107512982,107545821,53249153,32839,988886282,38538,1
100874211,MID1IP1-AS1,chrX,R,38801247,38803883,53251789,2636,988888918,38539,1
100874355,ARHGEF9-IT1,chrX,R,63670195,63671502,53253096,1307,988890225,38540,1
100996279,LINC00269,chrX,F,69179556,69209924,53283464,30368,988920593,38541,4
100996465,LCA10,chrX,F,153880671,153888990,53291783,8319,988928912,38542,6
100996631,TCP11X1,chrX,F,102215255,102248522,53325050,33267,988962179,38543,12
100996648,TCP11X2,chrX,R,102460318,102471812,53336544,11494,988973673,38544,9
101059915,LOC101059915,chrX,F,71667778,71720811,53389577,53033,989026706,38545,6
101060146,CHMP1B2P,chrX,R,80228488,80335318,53496407,106830,989133536,38546,5
101060211,CT45A7,chrX,R,135829228,135846600,53513779,17372,989150908,38547,6
101060233,LOC101060233,chrX,F,154257619,154271805,53527965,14186,989165094,38548,5
101241891,LINC00850,chrX,F,149825707,149879799,53582057,54092,989219186,38549,2
101340250,SNORA11E,chrX,R,52063346,52063473,53582184,127,989219313,38550,0
101410537,MAGEA8-AS1,chrX,R,149878762,149897006,53600428,18244,989237557,38551,4
101926971,LINC01284,chrX,R,51095835,51117830,53622423,21995,989259552,38552,8
101927352,PLS3-AS1,chrX,R,115518188,115562731,53666966,44543,989304095,38553,4
101927449,LINC01282,chrX,R,39367284,39391774,53691456,24490,989328585,38554,5
101927476,LOC101927476,chrX,F,40262916,40287721,53716261,24805,989353390,38555,2
101927501,LOC101927501,chrX,F,43176993,43226598,53765866,49605,989402995,38556,5
101927528,LINC01204,chrX,F,45505387,45527239,53787718,21852,989424847,38557,3
101927574,LINC01186,chrX,R,46325923,46327674,53789469,1751,989426598,38558,1
101927635,LOC101927635,chrX,R,48506526,48508839,53791782,2313,989428911,38559,1
101927685,LOC101927685,chrX,F,149929623,149931821,53793980,2198,989431109,38560,1
101927830,LOC101927830,chrX,R,155347136,155374174,53821018,27038,989458147,38561,3
101928055,LOC101928055,chrX,R,1337147,1382456,53866327,45309,989503456,38562,16
101928070,LOC101928070,chrX,F,2320641,2337998,53883684,17357,989520813,38563,6
101928092,LOC101928092,chrX,R,2566026,2574621,53892279,8595,989529408,38564,2
101928128,LOC101928128,chrX,F,85210705,85219289,53900863,8584,989537992,38565,3
101928201,LOC101928201,chrX,R,4627199,4633572,53907236,6373,989544365,38566,2
101928228,LOC101928228,chrX,R,5719170,5726143,53914209,6973,989551338,38567,1
101928242,LOC101928242,chrX,F,118769311,118770201,53915099,890,989552228,38568,0
101928259,LOC101928259,chrX,F,72688948,72712348,53938499,23400,989575628,38569,4
101928286,LOC101928286,chrX,R,103766868,103797864,53969495,30996,989606624,38570,8
101928287,LINC01285,chrX,F,118839555,118882015,54011955,42460,989649084,38571,6
101928335,LOC101928335,chrX,R,107894596,107935980,54053339,41384,989690468,38572,3
101928336,LOC101928336,chrX,F,119291528,119335610,54097421,44082,989734550,38573,3
101928345,PABPC1L2B-AS1,chrX,R,72998387,73002856,54101890,4469,989739019,38574,3
101928358,LOC101928358,chrX,F,108736539,108738903,54104254,2364,989741383,38575,2
101928359,LOC101928359,chrX,F,122421981,122478081,54160354,56100,989797483,38576,3
101928380,LOC101928380,chrX,F,73079994,73087708,54168068,7714,989805197,38577,4
101928389,LOC101928389,chrX,F,17528090,17587160,54227138,59070,989864267,38578,1
101928402,LOC101928402,chrX,R,123959232,123961341,54229247,2109,989866376,38579,1
101928415,LOC101928415,chrX,F,18984201,19083978,54329024,99777,989966153,38580,5
101928437,LOC101928437,chrX,F,113042726,113520614,54806912,477888,990444041,38581,3
101928469,MIR325HG,chrX,R,76657797,77014532,55163647,356735,990800776,38582,6
101928481,LOC101928481,chrX,F,27590226,27716779,55290200,126553,990927329,38583,6
101928495,LOC101928495,chrX,F,126109761,126115562,55296001,5801,990933130,38584,2
101928522,LOC101928522,chrX,R,129072906,129128364,55351459,55458,990988588,38585,4
101928578,RAP2C-AS1,chrX,F,132218506,132432811,55565764,214305,991202893,38586,2
101928589,LOC101928589,chrX,F,110175772,110177788,55567780,2016,991204909,38587,1
101928627,LOC101928627,chrX,R,36365625,36440292,55642447,74667,991279576,38588,7
101928677,LOC101928677,chrX,F,135252011,135254496,55644932,2485,991282061,38589,2
101928692,LOC101928692,chrX,F,55488959,55491513,55647486,2554,991284615,38590,1
101928747,LOC101928747,chrX,F,136874660,136879312,55652138,4652,991289267,38591,2
101928808,LOC101928808,chrX,F,146394681,146401858,55659315,7177,991296444,38592,1
101928832,LOC101928832,chrX,F,146941755,146954196,55671756,12441,991308885,38593,3
101928833,LOC101928833,chrX,R,140681105,140687834,55678485,6729,991315614,38594,2
101928863,LOC101928863,chrX,R,147280988,147286475,55683972,5487,991321101,38595,4
101928917,LOC101928917,chrX,R,149547678,149549870,55686164,2192,991323293,38596,1
101928941,LOC101928941,chrX,R,119986529,120015622,55715257,29093,991352386,38597,4
101928969,LOC101928969,chrX,F,120119706,120146855,55742406,27149,991379535,38598,6
101930105,LOC101930105,chrX,R,3854392,3886550,55774564,32158,991411693,38599,3
102464835,MIR6087,chrX,F,109054541,109054590,55774613,49,991411742,38600,0
102464837,MIR6089,chrX,F,2609190,2609254,55774677,64,991411806,38601,0
102465140,MIR6134,chrX,R,28495554,28495663,55774786,109,991411915,38602,0
102465516,MIR6857,chrX,R,53405672,53405765,55774879,93,991412008,38603,0
102465517,MIR6858,chrX,F,154450319,154450386,55774946,67,991412075,38604,0
102465539,MIR6895,chrX,R,53195410,53195488,55775024,78,991412153,38605,0
102466519,MIR6086,chrX,F,13590291,13590346,55775079,55,991412208,38606,0
102466721,MIR892C,chrX,R,145992749,145992826,55775156,77,991412285,38607,0
102466759,MIR6894,chrX,R,53198888,53198945,55775213,57,991412342,38608,0
102466880,MIR8088,chrX,R,52336556,52336642,55775299,86,991412428,38609,0
102723417,LOC102723417,chrX,R,123768971,123777284,55783612,8313,991420741,38610,2
102723426,LINC01496,chrX,R,51499908,51507441,55791145,7533,991428274,38611,4
102723508,KANTR,chrX,F,53094156,53144072,55841061,49916,991478190,38612,2
102723546,LOC102723546,chrX,R,131361193,131399832,55879700,38639,991516829,38613,4
102723547,CSAG2,chrX,R,152708260,152714012,55885452,5752,991522581,38614,4
102723591,LOC102723591,chrX,R,153761628,153766466,55890290,4838,991527419,38615,4
102723631,CT45A10,chrX,R,135880751,135893577,55903116,12826,991540245,38616,7
102723680,CT45A9,chrX,R,135863775,135881166,55920507,17391,991557636,38617,5
102723737,CT45A8,chrX,R,135846496,135863879,55937890,17383,991575019,38618,5
102723840,LOC102723840,chrX,F,430264,470745,55978371,40481,991615500,38619,9
102723911,LOC102723911,chrX,F,69031042,69040276,55987605,9234,991624734,38620,5
102724092,LOC102724092,chrX,R,15232233,15236715,55992087,4482,991629216,38621,2
102724124,LOC102724124,chrX,R,16153387,16167455,56006155,14068,991643284,38622,4
102724150,LOC102724150,chrX,F,89403133,89455254,56058276,52121,991695405,38623,3
102724167,PABPC5-AS1,chrX,R,91414902,91434999,56078373,20097,991715502,38624,3
102724212,LOC102724212,chrX,F,101663712,101671221,56085882,7509,991723011,38625,2
102724252,LOC102724252,chrX,F,102909430,102964523,56140975,55093,991778104,38626,3
102724400,LOC102724400,chrX,F,49299394,49301465,56143046,2071,991780175,38627,1
102724473,GAGE10,chrX,F,49303645,49319844,56159245,16199,991796374,38628,4
102724491,LOC102724491,chrX,F,113970745,113977143,56165643,6398,991802772,38629,2
104266960,LINC01201,chrX,R,131016468,131058146,56207321,41678,991844450,38630,2
104797536,LINC01402,chrX,R,120117641,120119700,56209380,2059,991846509,38631,2
104798195,LOC104798195,chrX,F,15602880,15621484,56227984,18604,991865113,38632,1
105369163,LOC105369163,chrX,R,85140945,85243794,56330833,102849,991967962,38633,4
105373102,LOC105373102,chrX,F,1392348,1396881,56335366,4533,991972495,38634,2
105373103,LOC105373103,chrX,F,1744534,1776605,56367437,32071,992004566,38635,4
105373104,LOC105373104,chrX,F,1744770,1745632,56368299,862,992005428,38636,1
105373105,LOC105373105,chrX,F,1732555,1744502,56380246,11947,992017375,38637,5
105373123,LOC105373123,chrX,F,3455912,3466739,56391073,10827,992028202,38638,3
105373125,LOC105373125,chrX,R,8923780,8927194,56394487,3414,992031616,38639,3
105373126,LOC105373126,chrX,F,9738684,9741053,56396856,2369,992033985,38640,1
105373127,LOC105373127,chrX,F,10949874,10964637,56411619,14763,992048748,38641,2
105373128,LOC105373128,chrX,F,11463676,11469150,56417093,5474,992054222,38642,2
105373129,LOC105373129,chrX,F,11425837,11433652,56424908,7815,992062037,38643,2
105373130,LOC105373130,chrX,R,11367769,11370523,56427662,2754,992064791,38644,2
105373131,LOC105373131,chrX,F,11732697,11735266,56430231,2569,992067360,38645,3
105373133,LOC105373133,chrX,F,13044543,13140666,56526354,96123,992163483,38646,3
105373134,LOC105373134,chrX,R,13155709,13164864,56535509,9155,992172638,38647,2
105373135,LOC105373135,chrX,R,13243493,13251172,56543188,7679,992180317,38648,2
105373136,LOC105373136,chrX,F,13320799,13334817,56557206,14018,992194335,38649,18
105373137,LOC105373137,chrX,F,13368908,13403006,56591304,34098,992228433,38650,6
105373138,LOC105373138,chrX,R,13985729,13996343,56601918,10614,992239047,38651,2
105373141,LOC105373141,chrX,F,15951821,16091874,56741971,140053,992379100,38652,3
105373142,LOC105373142,chrX,R,17635558,17651719,56758132,16161,992395261,38653,2
105373144,LOC105373144,chrX,R,17970166,17982594,56770560,12428,992407689,38654,2
105373145,LOC105373145,chrX,F,18832057,18833960,56772463,1903,992409592,38655,1
105373146,LOC105373146,chrX,R,21285870,21374119,56860712,88249,992497841,38656,2
105373147,LOC105373147,chrX,R,22225867,22254078,56888923,28211,992526052,38657,3
105373148,LOC105373148,chrX,R,23756275,23782901,56915549,26626,992552678,38658,4
105373149,LOC105373149,chrX,R,26391929,26410110,56933730,18181,992570859,38659,2
105373150,LOC105373150,chrX,R,27153616,27399005,57179119,245389,992816248,38660,15
105373151,LOC105373151,chrX,F,27983891,28018116,57213344,34225,992850473,38661,2
105373152,LOC105373152,chrX,F,28065864,28073183,57220663,7319,992857792,38662,2
105373153,LOC105373153,chrX,F,33726355,34076569,57570877,350214,993208006,38663,3
105373154,LOC105373154,chrX,R,36816329,36959103,57713651,142774,993350780,38664,3
105373155,LOC105373155,chrX,F,36719764,36744117,57738004,24353,993375133,38665,3
105373156,LOC105373156,chrX,F,6226360,6230313,57741957,3953,993379086,38666,1
105373173,LOC105373173,chrX,F,38327850,38344669,57758776,16819,993395905,38667,2
105373174,LOC105373174,chrX,R,38779500,38800658,57779934,21158,993417063,38668,1
105373175,LOC105373175,chrX,R,39258100,39299786,57821620,41686,993458749,38669,2
105373176,LOC105373176,chrX,F,39383652,39386773,57824741,3121,993461870,38670,1
105373177,LOC105373177,chrX,F,39774118,39808433,57859056,34315,993496185,38671,2
105373178,LOC105373178,chrX,F,39759836,39766745,57865965,6909,993503094,38672,2
105373179,LOC105373179,chrX,R,39726791,39849655,57988829,122864,993625958,38673,2
105373180,LOC105373180,chrX,F,39928980,39939216,57999065,10236,993636194,38674,4
105373181,LOC105373181,chrX,F,40170646,40176262,58004681,5616,993641810,38675,1
105373182,LOC105373182,chrX,F,40318228,40322408,58008861,4180,993645990,38676,2
105373183,LOC105373183,chrX,F,40309530,40312544,58011875,3014,993649004,38677,2
105373184,LOC105373184,chrX,R,41276688,41287911,58023098,11223,993660227,38678,2
105373185,LOC105373185,chrX,F,41275712,41276778,58024164,1066,993661293,38679,1
105373186,LOC105373186,chrX,R,42695960,42727047,58055251,31087,993692380,38680,2
105373187,LOC105373187,chrX,F,42456598,42710060,58308713,253462,993945842,38681,2
105373188,LOC105373188,chrX,F,42920388,42945056,58333381,24668,993970510,38682,4
105373189,LOC105373189,chrX,R,43855660,43873724,58351445,18064,993988574,38683,2
105373190,LOC105373190,chrX,F,44866862,44870825,58355408,3963,993992537,38684,2
105373191,LOC105373191,chrX,F,45324907,45333307,58363808,8400,994000937,38685,3
105373192,LOC105373192,chrX,R,45766091,45771315,58369032,5224,994006161,38686,2
105373193,LOC105373193,chrX,R,47125808,47129454,58372678,3646,994009807,38687,2
105373194,LOC105373194,chrX,R,47204139,47218588,58387127,14449,994024256,38688,2
105373195,LOC105373195,chrX,R,49139604,49156253,58403776,16649,994040905,38689,2
105373197,LOC105373197,chrX,F,49307855,49315804,58411725,7949,994048854,38690,2
105373202,LOC105373202,chrX,F,50979158,50984221,58416788,5063,994053917,38691,1
105373203,LOC105373203,chrX,R,51159779,51171366,58428375,11587,994065504,38692,2
105373204,LOC105373204,chrX,R,51171382,51396466,58653459,225084,994290588,38693,11
105373205,LOC105373205,chrX,F,51629460,51644084,58668083,14624,994305212,38694,4
105373214,LOC105373214,chrX,R,54528082,54530055,58670056,1973,994307185,38695,2
105373216,LOC105373216,chrX,F,55908179,56205098,58966975,296919,994604104,38696,3
105373237,LOC105373237,chrX,F,64205969,64308111,59069117,102142,994706246,38697,4
105373239,LOC105373239,chrX,F,64842759,64851049,59077407,8290,994714536,38698,4
105373240,LOC105373240,chrX,F,66757148,66780371,59100630,23223,994737759,38699,2
105373241,LOC105373241,chrX,R,67745788,67761958,59116800,16170,994753929,38700,3
105373242,LOC105373242,chrX,R,69031632,69083878,59169046,52246,994806175,38701,5
105373243,LOC105373243,chrX,R,70223428,70281252,59226870,57824,994863999,38702,3
105373244,LOC105373244,chrX,R,70427360,70435494,59235004,8134,994872133,38703,3
105373245,LOC105373245,chrX,F,70928226,70947559,59254337,19333,994891466,38704,3
105373246,LOC105373246,chrX,R,71143187,71151226,59262376,8039,994899505,38705,2
105373247,LOC105373247,chrX,F,71254912,71272322,59279786,17410,994916915,38706,3
105373248,LOC105373248,chrX,F,71337700,71350152,59292238,12452,994929367,38707,2
105373250,LOC105373250,chrX,F,72306057,72311741,59297922,5684,994935051,38708,3
105373252,LOC105373252,chrX,R,74413026,74421393,59306289,8367,994943418,38709,3
105373253,LOC105373253,chrX,R,75215718,75226003,59316574,10285,994953703,38710,2
105373254,LOC105373254,chrX,F,77070602,77081473,59327445,10871,994964574,38711,3
105373256,LOC105373256,chrX,F,76149151,76150413,59328707,1262,994965836,38712,1
105373282,LOC105373282,chrX,F,79450725,79453953,59331935,3228,994969064,38713,3
105373283,LOC105373283,chrX,F,80842045,80847124,59337014,5079,994974143,38714,1
105373284,LOC105373284,chrX,F,81420991,81425448,59341471,4457,994978600,38715,3
105373285,LOC105373285,chrX,F,81476860,81498238,59362849,21378,994999978,38716,3
105373286,LOC105373286,chrX,R,82119280,82125542,59369111,6262,995006240,38717,2
105373287,LOC105373287,chrX,R,82741216,82765809,59393704,24593,995030833,38718,2
105373288,LOC105373288,chrX,F,82769184,82799411,59423931,30227,995061060,38719,2
105373290,LOC105373290,chrX,F,86161043,86176516,59439404,15473,995076533,38720,2
105373292,LOC105373292,chrX,F,90234590,90265420,59470234,30830,995107363,38721,4
105373293,LOC105373293,chrX,R,91772226,91776815,59474823,4589,995111952,38722,1
105373294,LOC105373294,chrX,R,96363954,96391856,59502725,27902,995139854,38723,2
105373295,LOC105373295,chrX,R,96393023,96402393,59512095,9370,995149224,38724,2
105373296,LOC105373296,chrX,F,96499407,96503136,59515824,3729,995152953,38725,2
105373297,LOC105373297,chrX,F,97841745,97849585,59523664,7840,995160793,38726,2
105373298,LOC105373298,chrX,R,100605361,100622156,59540459,16795,995177588,38727,3
105373299,LOC105373299,chrX,F,102141727,102143946,59542678,2219,995179807,38728,4
105373300,LOC105373300,chrX,R,103538190,103585507,59589995,47317,995227124,38729,4
105373301,LOC105373301,chrX,R,103609676,103615966,59596285,6290,995233414,38730,1
105373302,LOC105373302,chrX,R,103591363,103629550,59634472,38187,995271601,38731,2
105373303,LOC105373303,chrX,R,105663130,105773377,59744719,110247,995381848,38732,3
105373304,LOC105373304,chrX,R,105949715,106007917,59802921,58202,995440050,38733,2
105373305,LOC105373305,chrX,F,106008171,106009400,59804150,1229,995441279,38734,3
105373306,LOC105373306,chrX,R,106465248,106468013,59806915,2765,995444044,38735,2
105373307,LOC105373307,chrX,F,107144176,107145943,59808682,1767,995445811,38736,2
105373308,LOC105373308,chrX,R,107589566,107597286,59816402,7720,995453531,38737,2
105373309,LOC105373309,chrX,F,107935765,107938625,59819262,2860,995456391,38738,2
105373311,LOC105373311,chrX,F,109730964,109734332,59822630,3368,995459759,38739,0
105373312,LOC105373312,chrX,F,110318267,110333372,59837735,15105,995474864,38740,3
105373313,LOC105373313,chrX,R,114713925,114810776,59934586,96851,995571715,38741,6
105373314,LOC105373314,chrX,R,115454265,115465479,59945800,11214,995582929,38742,3
105373315,LOC105373315,chrX,R,115694841,115713201,59964160,18360,995601289,38743,4
105373320,LOC105373320,chrX,R,116726935,116751276,59988501,24341,995625630,38744,2
105373321,LOC105373321,chrX,F,118556488,118557504,59989517,1016,995626646,38745,2
105373322,LOC105373322,chrX,F,118698545,118703478,59994450,4933,995631579,38746,2
105373323,LOC105373323,chrX,F,119990252,119993869,59998067,3617,995635196,38747,2
105373326,LOC105373326,chrX,R,120431503,120435086,60001650,3583,995638779,38748,1
105373327,LOC105373327,chrX,F,120575902,120595990,60021738,20088,995658867,38749,3
105373328,LOC105373328,chrX,R,121019061,121047453,60050130,28392,995687259,38750,3
105373329,LOC105373329,chrX,R,123367722,123471972,60154380,104250,995791509,38751,5
105373330,LOC105373330,chrX,R,123187595,123226632,60193417,39037,995830546,38752,2
105373331,LOC105373331,chrX,F,124380906,124389830,60202341,8924,995839470,38753,1
105373332,LOC105373332,chrX,R,127492644,127499469,60209166,6825,995846295,38754,2
105373333,LOC105373333,chrX,R,127939301,127945639,60215504,6338,995852633,38755,2
105373334,LOC105373334,chrX,R,129675887,129678412,60218029,2525,995855158,38756,1
105373335,LOC105373335,chrX,R,129882291,129934390,60270128,52099,995907257,38757,3
105373336,LOC105373336,chrX,R,130527283,130530102,60272947,2819,995910076,38758,2
105373337,LOC105373337,chrX,F,130827895,130836188,60281240,8293,995918369,38759,2
105373338,LOC105373338,chrX,F,130802635,130811799,60290404,9164,995927533,38760,4
105373339,LOC105373339,chrX,R,133090717,133097304,60296991,6587,995934120,38761,3
105373340,LOC105373340,chrX,R,135007750,135020204,60309445,12454,995946574,38762,2
105373341,LOC105373341,chrX,F,135034405,135040358,60315398,5953,995952527,38763,1
105373342,LOC105373342,chrX,F,135326902,135330459,60318955,3557,995956084,38764,1
105373343,LOC105373343,chrX,R,140216025,140216767,60319697,742,995956826,38765,1
105373344,LOC105373344,chrX,F,140517762,140520395,60322330,2633,995959459,38766,2
105373345,LOC105373345,chrX,F,142546404,142624656,60400582,78252,996037711,38767,2
105373347,LOC105373347,chrX,F,147180940,147271895,60491537,90955,996128666,38768,7
105373348,LOC105373348,chrX,R,147323979,147332136,60499694,8157,996136823,38769,2
105373349,LOC105373349,chrX,F,147877984,147885470,60507180,7486,996144309,38770,3
105373366,LOC105373366,chrX,R,149511553,149526523,60522150,14970,996159279,38771,2
105373367,LOC105373367,chrX,R,151512702,151538489,60547937,25787,996185066,38772,2
105373368,LOC105373368,chrX,R,151904430,151912859,60556366,8429,996193495,38773,5
105373369,LOC105373369,chrX,F,152111234,152125008,60570140,13774,996207269,38774,7
105373370,LOC105373370,chrX,R,152554382,152698714,60714472,144332,996351601,38775,5
105373372,LOC105373372,chrX,R,152930262,152931310,60715520,1048,996352649,38776,1
105373373,LOC105373373,chrX,F,153225648,153230357,60720229,4709,996357358,38777,3
105373374,LOC105373374,chrX,F,153084382,153092263,60728110,7881,996365239,38778,3
105373377,LOC105373377,chrX,R,153317682,153320123,60730551,2441,996367680,38779,1
105373378,LOC105373378,chrX,F,153355528,153366474,60741497,10946,996378626,38780,3
105373379,LOC105373379,chrX,F,153401582,153406606,60746521,5024,996383650,38781,2
105373381,LOC105373381,chrX,F,153484795,153487088,60748814,2293,996385943,38782,1
105373382,LOC105373382,chrX,F,153477155,153483800,60755459,6645,996392588,38783,6
105373383,LOC105373383,chrX,F,153599346,153599897,60756010,551,996393139,38784,1
105373385,LOC105373385,chrX,F,153841577,153859194,60773627,17617,996410756,38785,3
105373386,LOC105373386,chrX,R,154333978,154342742,60782391,8764,996419520,38786,2
105373387,LOC105373387,chrX,F,154653687,154655374,60784078,1687,996421207,38787,1
105377208,LOC105377208,chrX,F,52054056,52058594,60788616,4538,996425745,38788,3
105377209,LOC105377209,chrX,R,52195500,52265905,60859021,70405,996496150,38789,4
105377210,LOC105377210,chrX,F,56560877,56573249,60871393,12372,996508522,38790,3
105377211,LOC105377211,chrX,F,63136066,63155860,60891187,19794,996528316,38791,5
105377212,LOC105377212,chrX,R,63237521,63242881,60896547,5360,996533676,38792,3
105377213,LOC105377213,chrX,F,151515545,151516270,60897272,725,996534401,38793,1
105377214,LOC105377214,chrX,F,120057289,120061414,60901397,4125,996538526,38794,2
266,AMELY,chrY,R,6865917,6911937,46020,46020,996584546,38795,7
293,SLC25A6,chrY,R,1386151,1392146,52015,5995,996590541,38796,3
438,ASMT,chrY,F,1595454,1643081,99642,47627,996638168,38797,9
1438,CSF2RA,chrY,F,1268799,1325078,155921,56279,996694447,38798,18
1617,DAZ1,chrY,R,23129354,23199123,225690,69769,996764216,38799,27
3563,IL3RA,chrY,F,1336586,1382689,271793,46103,996810319,38800,11
3581,IL9R,chrY,F,57183855,57197869,285807,14014,996824333,38801,10
4267,CD99,chrY,F,2691186,2741309,335930,50123,996874456,38802,11
5616,PRKY,chrY,F,7273971,7381547,443506,107576,996982032,38803,7
5940,RBMY1A1,chrY,F,21534901,21561014,469619,26113,997008145,38804,14
6192,RPS4Y1,chrY,F,2841581,2866956,494994,25375,997033520,38805,6
6473,SHOX,chrY,F,624343,659411,530062,35068,997068588,38806,6
6736,SRY,chrY,R,2786854,2787741,530949,887,997069475,38807,0
6845,VAMP7,chrY,F,57067799,57130289,593439,62490,997131965,38808,7
7258,TSPY1,chrY,F,9466954,9469749,596234,2795,997134760,38809,5
7404,UTY,chrY,R,13233919,13480670,842985,246751,997381511,38810,42
7544,ZFY,chrY,F,2934415,2982508,891078,48093,997429604,38811,9
8225,GTPBP6,chrY,R,303356,318819,906541,15463,997445067,38812,12
8227,AKAP17A,chrY,F,1591592,1602520,917469,10928,997455995,38813,5
8284,KDM5D,chrY,R,19705414,19744939,956994,39525,997495520,38814,26
8287,USP9Y,chrY,F,12701230,12860844,1116608,159614,997655134,38815,48
8623,ASMTL,chrY,R,1403138,1453795,1167265,50657,997705791,38816,14
8653,DDX3Y,chrY,F,12904107,12920478,1183636,16371,997722162,38817,19
9081,PRY,chrY,F,22484279,22515543,1214900,31264,997753426,38818,5
9082,XKRY,chrY,R,17768979,17770560,1216481,1581,997755007,38819,0
9083,BPY2,chrY,F,22984262,23005465,1237684,21203,997776210,38820,8
9084,VCY,chrY,R,13985771,13986512,1238425,741,997776951,38821,1
9085,CDY1,chrY,F,25622114,25634745,1251056,12631,997789582,38822,3
9086,EIF1AY,chrY,F,20575710,20593154,1268500,17444,997807026,38823,6
9087,TMSB4Y,chrY,F,13703566,13706024,1270958,2458,997809484,38824,1
9189,ZBED1,chrY,R,2486413,2500967,1285512,14554,997824038,38825,2
9426,CDY2A,chrY,F,18025786,18027746,1287472,1960,997825998,38826,0
10251,SPRY3,chrY,F,56954254,56968979,1302197,14725,997840723,38827,1
22829,NLGN4Y,chrY,F,14522607,14844945,1624535,322338,998163061,38828,14
28227,PPP2R3B,chrY,R,333932,386955,1677558,53023,998216084,38829,13
50858,TTTY1,chrY,R,9753155,9774289,1698692,21134,998237218,38830,4
55344,PLCXD1,chrY,F,276323,303356,1725725,27033,998264251,38831,9
57054,DAZ3,chrY,R,24763068,24813505,1776162,50437,998314688,38832,20
57055,DAZ2,chrY,F,23219456,23291356,1848062,71900,998386588,38833,23
57135,DAZ4,chrY,F,24833799,24907040,1921303,73241,998459829,38834,28
60439,TTTY2,chrY,F,9736285,9758476,1943494,22191,998482020,38835,7
64109,CRLF2,chrY,R,1190448,1212815,1965861,22367,998504387,38836,8
64591,TSPY2,chrY,F,6246222,6249018,1968657,2796,998507183,38837,5
64593,RBMY3AP,chrY,R,9610720,9615153,1973090,4433,998511616,38838,2
64595,TTTY15,chrY,F,12662366,12692224,2002948,29858,998541474,38839,3
80161,ASMTL-AS1,chrY,F,1400530,1415421,2017839,14891,998556365,38840,5
83259,PCDH11Y,chrY,F,5000225,5742228,2759842,742003,999298368,38841,12
83863,TTTY5,chrY,R,22296797,22298876,2761921,2079,999300447,38842,1
83864,TTTY9A,chrY,F,18729881,18739197,2771237,9316,999309763,38843,4
83866,TTTY11,chrY,R,8783312,8817382,2805307,34070,999343833,38844,4
83867,TTTY12,chrY,F,7804923,7810683,2811067,5760,999349593,38845,1
83868,TTTY13,chrY,R,21583599,21594666,2822134,11067,999360660,38846,5
83869,TTTY14,chrY,R,18872500,19077547,3027181,205047,999565707,38847,11
84559,GOLGA2P2Y,chrY,R,24209966,24214831,3032046,4865,999570572,38848,8
84672,TTTY6,chrY,R,22439592,22441459,3033913,1867,999572439,38849,2
84673,TTTY8,chrY,F,9691099,9693699,3036513,2600,999575039,38850,2
86614,HSFY1,chrY,F,18546684,18588963,3078792,42279,999617318,38851,6
90655,TGIF2LY,chrY,F,3579084,3580041,3079749,957,999618275,38852,1
90665,TBL1Y,chrY,F,6910685,7091749,3260813,181064,999799339,38853,18
114758,CSPG4P1Y,chrY,F,25482907,25486705,3264611,3798,999803137,38854,1
114760,TTTY3,chrY,F,25728489,25733388,3269510,4899,999808036,38855,2
114761,TTTY4,chrY,F,22936454,22973284,3306340,36830,999844866,38856,3
140032,RPS4Y2,chrY,F,20756067,20781056,3331329,24989,999869855,38857,7
159119,HSFY2,chrY,R,18731439,18773735,3373625,42296,999912151,38858,6
159125,RBMY2EP,chrY,R,21395147,21401562,3380040,6415,999918566,38859,4
159162,RBMY2FP,chrY,F,22308858,22316205,3387387,7347,999925913,38860,3
159163,RBMY1F,chrY,R,22168180,22183008,3402215,14828,999940741,38861,13
203611,CDY2B,chrY,R,17878259,17880219,3404175,1960,999942701,38862,0
207063,DHRSX,chrY,R,2219505,2500974,3685644,281469,1000224170,38863,6
246119,TTTY10,chrY,R,20465667,20519228,3739205,53561,1000277731,38864,5
246122,TTTY7,chrY,F,6449467,6457906,3747644,8439,1000286170,38865,6
246126,TXLNGY,chrY,F,19567357,19607170,3787457,39813,1000325983,38866,10
252946,FAM197Y2,chrY,R,9519665,9525268,3793060,5603,1000331586,38867,3
252948,TTTY16,chrY,R,7699356,7701247,3794951,1891,1000333477,38868,1
252949,TTTY17A,chrY,F,22851583,22852715,3796083,1132,1000334609,38869,1
252950,TTTY18,chrY,R,8683369,8683878,3796592,509,1000335118,38870,1
252951,TTTY20,chrY,R,9329879,9334832,3801545,4953,1000340071,38871,1
252952,TTTY19,chrY,F,8704471,8705283,3802357,812,1000340883,38872,1
252953,TTTY21,chrY,R,9717652,9721296,3806001,3644,1000344527,38873,1
252954,TTTY22,chrY,F,9801152,9813245,3818094,12093,1000356620,38874,4
252955,TTTY23,chrY,F,9910797,9911962,3819259,1165,1000357785,38875,2
253175,CDY1B,chrY,R,24035385,24048016,3831890,12631,1000370416,38876,3
283981,LINC00685,chrY,F,319144,321332,3834078,2188,1000372604,38877,0
286530,P2RY8,chrY,R,1462571,1537506,3909013,74935,1000447539,38878,5
286554,BCORP1,chrY,R,19455430,19503153,3956736,47723,1000495262,38879,10
286557,RBMY1A3P,chrY,R,9317060,9322874,3962550,5814,1000501076,38880,3
340618,FAM41AY1,chrY,F,17500957,17516742,3978335,15785,1000516861,38881,9
352887,GYG2P1,chrY,R,12406115,12421590,3993810,15475,1000532336,38882,4
353513,VCY1B,chrY,F,14056221,14056958,3994547,737,1000533073,38883,1
353515,XKRY2,chrY,F,18135448,18137029,3996128,1581,1000534654,38884,0
378948,RBMY1B,chrY,F,21511337,21525786,4010577,14449,1000549103,38885,13
378949,RBMY1D,chrY,R,21868387,21900745,4042935,32358,1000581461,38886,16
378950,RBMY1E,chrY,R,21902180,21918044,4058799,15864,1000597325,38887,14
378951,RBMY1J,chrY,F,22403475,22424890,4080214,21415,1000618740,38888,16
401577,CD99P1,chrY,F,2609264,2657229,4128179,47965,1000666705,38889,10
401629,FAM224B,chrY,R,17575160,17579452,4132471,4292,1000670997,38890,2
401630,FAM224A,chrY,F,18326532,18330827,4136766,4295,1000675292,38891,2
401634,GOLGA2P3Y,chrY,F,25455310,25460175,4141631,4865,1000680157,38892,8
425057,TTTY9B,chrY,R,18581205,18590521,4150947,9316,1000689473,38893,4
441543,TTTY6B,chrY,F,22144986,22146834,4152795,1848,1000691321,38894,2
442862,PRY2,chrY,R,22071755,22096007,4177047,24252,1000715573,38895,4
442867,BPY2B,chrY,F,24618003,24639207,4198251,21204,1000736777,38896,8
442868,BPY2C,chrY,R,25030900,25052104,4219455,21204,1000757981,38897,8
474148,TTTY3B,chrY,R,23936726,23941622,4224351,4896,1000762877,38898,2
474149,TTTY4B,chrY,F,24570201,24607025,4261175,36824,1000799701,38899,3
474150,TTTY4C,chrY,R,25063082,25099892,4297985,36810,1000836511,38900,3
474151,TTTY17B,chrY,F,24485331,24486463,4299117,1132,1000837643,38901,1
474152,TTTY17C,chrY,R,25183642,25184773,4300248,1131,1000838774,38902,1
727856,DDX11L16,chrY,R,57212177,57214703,4302774,2526,1000841300,38903,2
728137,TSPY3,chrY,F,9398420,9401222,4305576,2802,1000844102,38904,5
728395,TSPY4,chrY,F,9337482,9340283,4308377,2801,1000846903,38905,5
728403,TSPY8,chrY,F,9357827,9360598,4311148,2771,1000849674,38906,5
751580,LINC00106,chrY,F,1397024,1399412,4313536,2388,1000852062,38907,2
100101115,TTTY21B,chrY,F,6443433,6447077,4317180,3644,1000855706,38908,1
100101116,TTTY1B,chrY,F,6390400,6411564,4338344,21164,1000876870,38909,4
100101117,TTTY2B,chrY,R,6406243,6428444,4360545,22201,1000899071,38910,7
100101118,TTTY8B,chrY,R,6471030,6473630,4363145,2600,1000901671,38911,2
100101120,TTTY7B,chrY,R,9706823,9715262,4371584,8439,1000910110,38912,5
100101121,TTTY23B,chrY,R,6242445,6243610,4372749,1165,1000911275,38913,2
100132596,XGY2,chrY,F,2752295,2774996,4395450,22701,1000933976,38914,2
100289087,TSPY10,chrY,F,9527898,9530683,4398235,2785,1000936761,38915,5
100289150,FAM197Y5,chrY,R,9458742,9464345,4403838,5603,1000942364,38916,3
100289188,FAM197Y4,chrY,R,9484322,9485810,4405326,1488,1000943852,38917,2
100302526,FAM41AY2,chrY,R,18389269,18405046,4421103,15777,1000959629,38918,9
100359394,LINC00102,chrY,R,2612990,2615347,4423460,2357,1000961986,38919,1
100500894,MIR3690,chrY,F,1293917,1293992,4423535,75,1000962061,38920,0
100533178,PRORY,chrY,R,21382960,21454622,4495197,71662,1001033723,38921,4
100652931,LOC100652931,chrY,F,22316677,22320384,4498904,3707,1001037430,38922,2
100873962,LINC00278,chrY,F,3002995,3102272,4598181,99277,1001136707,38923,3
100873963,LINC00279,chrY,F,8638293,8644842,4604730,6549,1001143256,38924,2
100873964,LINC00280,chrY,R,6357218,6361413,4608925,4195,1001147451,38925,2
100874056,NLGN4Y-AS1,chrY,R,14793641,14804033,4619317,10392,1001157843,38926,3
101927008,LOC101927008,chrY,R,2566026,2574621,4627912,8595,1001166438,38927,2
101928032,LOC101928032,chrY,R,1337147,1382456,4673221,45309,1001211747,38928,16
101929148,LOC101929148,chrY,R,22101691,22147484,4719014,45793,1001257540,38929,12
102464837,MIR6089,chrY,F,2609190,2609254,4719078,64,1001257604,38930,0
102723951,LOC102723951,chrY,F,24142344,24153231,4729965,10887,1001268491,38931,3
102724004,LOC102724004,chrY,R,25516912,25527799,4740852,10887,1001279378,38932,3
102724521,LOC102724521,chrY,F,430264,470745,4781333,40481,1001319859,38933,9
105369193,LOC105369193,chrY,F,2320641,2337998,4798690,17357,1001337216,38934,6
105377215,LOC105377215,chrY,R,12662322,12663793,4800161,1471,1001338687,38935,1
105377216,LOC105377216,chrY,F,15455988,15460850,4805023,4862,1001343549,38936,2
105377217,LOC105377217,chrY,R,17553293,17558834,4810564,5541,1001349090,38937,4
105377218,LOC105377218,chrY,R,17688836,17689263,4810991,427,1001349517,38938,2
105377219,LOC105377219,chrY,F,18216750,18217177,4811418,427,1001349944,38939,2
105377220,LOC105377220,chrY,F,18347176,18352716,4816958,5540,1001355484,38940,4
105377221,LOC105377221,chrY,F,18484188,18517866,4850636,33678,1001389162,38941,7
105377222,LOC105377222,chrY,R,18802539,18836212,4884309,33673,1001422835,38942,6
105377223,LOC105377223,chrY,R,19553778,19567251,4897782,13473,1001436308,38943,4
105377224,LOC105377224,chrY,F,19744787,19756924,4909919,12137,1001448445,38944,2
105377225,LOC105377225,chrY,F,21138587,21170218,4941550,31631,1001480076,38945,7
105377226,LOC105377226,chrY,F,3111309,3115972,4946213,4663,1001484739,38946,1
105377227,LOC105377227,chrY,F,3803910,3836025,4978328,32115,1001516854,38947,5
105377228,LOC105377228,chrY,R,6262177,6265007,4981158,2830,1001519684,38948,3
105377229,LOC105377229,chrY,R,7831621,7858758,5008295,27137,1001546821,38949,3
105377230,LOC105377230,chrY,R,8094271,8126268,5040292,31997,1001578818,38950,2
105377231,LOC105377231,chrY,F,8395046,8407314,5052560,12268,1001591086,38951,3
105377232,LOC105377232,chrY,R,8549056,8551268,5054772,2212,1001593298,38952,2
105377233,LOC105377233,chrY,R,8673874,8677525,5058423,3651,1001596949,38953,2
105377234,LOC105377234,chrY,R,8693335,8695298,5060386,1963,1001598912,38954,2
105377235,LOC105377235,chrY,R,8721850,8727521,5066057,5671,1001604583,38955,4
105377236,LOC105377236,chrY,R,21809152,21823816,5080721,14664,1001619247,38956,4
105377237,LOC105377237,chrY,F,21837426,21839144,5082439,1718,1001620965,38957,2
105377238,LOC105377238,chrY,R,23106396,23109726,5085769,3330,1001624295,38958,2
105377239,LOC105377239,chrY,F,23310984,23314314,5089099,3330,1001627625,38959,2
105377240,LOC105377240,chrY,F,23435270,23474400,5128229,39130,1001666755,38960,2
105377241,LOC105377241,chrY,R,24740118,24743448,5131559,3330,1001670085,38961,2
105377242,LOC105377242,chrY,F,24926664,24929994,5134889,3330,1001673415,38962,2
105377243,LOC105377243,chrY,R,26196210,26235345,5174024,39135,1001712550,38963,2
105377244,LOC105377244,chrY,R,26404925,26409003,5178102,4078,1001716628,38964,2
105379264,LOC105379264,chrY,F,9264843,9269708,5182967,4865,1001721493,38965,3
105379265,LOC105379265,chrY,F,9274396,9282943,5191514,8547,1001730040,38966,3
105379266,LOC105379266,chrY,F,9288976,9291228,5193766,2252,1001732292,38967,2
105379267,LOC105379267,chrY,F,9292383,9304613,5205996,12230,1001744522,38968,2
105379268,LOC105379268,chrY,R,9354850,9355431,5206577,581,1001745103,38969,2
105379269,LOC105379269,chrY,R,9375130,9376612,5208059,1482,1001746585,38970,2
105379270,LOC105379270,chrY,R,9394047,9396694,5210706,2647,1001749232,38971,3
105379273,LOC105379273,chrY,R,11161844,11214984,5263846,53140,1001802372,38972,2
105379413,LOC105379413,chrY,F,1744534,1776605,5295917,32071,1001834443,38973,4
105379414,LOC105379414,chrY,F,1744770,1745632,5296779,862,1001835305,38974,1
105379415,LOC105379415,chrY,F,1732555,1744502,5308726,11947,1001847252,38975,5
105379416,LOC105379416,chrY,F,1392007,1395560,5312279,3553,1001850805,38976,2
